Date,ValueDate,Description,Category,BusinessUnit,Debit,Credit,Currency,PaymentRail,Counterparty,CounterpartyAccount,InvoiceID,PONumber,Intercompany,EliminateInConsolidation,Reference,Bank,AccountNumberMasked,Company,Jurisdiction,Balance
01/09/2023,01/09/2023,Account Maintenance Fee,Bank/Merchant Fees,ALL,2500,0,USD,ACH Debit,First Continental Bank,***7902,,,FALSE,FALSE,REF-936740,First Continental Bank,***1750,"Globex International Holdings, Inc.",US,11997500
01/09/2023,01/09/2023,Client Receipt - CloudBridge Co. #14,Sales Receipt,SaaS-GL,0,1892.22,USD,Card Settlement,CloudBridge Co. #14,***2956,INV-202309-SaaS-GL-0004,,FALSE,FALSE,REF-841493,First Continental Bank,***9077,"Globex International Holdings, Inc.",US,11999392.22
01/09/2023,01/09/2023,Client Receipt - CloudBridge Co. #22,Sales Receipt,SaaS-GL,0,53858.86,USD,Card Settlement,CloudBridge Co. #22,***9907,INV-202309-SaaS-GL-0013,,FALSE,FALSE,REF-685094,First Continental Bank,***4909,"Globex International Holdings, Inc.",US,12053251.08
01/09/2023,01/09/2023,Client Receipt - Vertex Advisory Client #47,Sales Receipt,PS-GL,0,127262.27,USD,Card Settlement,Vertex Advisory Client #47,***3910,INV-202309-PS-GL-0003,,FALSE,FALSE,REF-651683,First Continental Bank,***9723,"Globex International Holdings, Inc.",US,12180513.35
02/09/2023,02/09/2023,Client Receipt - CloudBridge Co. #31,Sales Receipt,SaaS-GL,0,114835.16,USD,Fedwire Credit,CloudBridge Co. #31,***9937,INV-202309-SaaS-GL-0005,,FALSE,FALSE,REF-249369,First Continental Bank,***2644,"Globex International Holdings, Inc.",US,12295348.51
03/09/2023,03/09/2023,Supplier Payment - NorthRiver Apparel Mfg #12,Supplier Payment,Retail-NA,361537,0,USD,Wire Transfer,NorthRiver Apparel Mfg #12,***9340,,PO-202309-Retail-NA-0007,FALSE,FALSE,REF-514947,First Continental Bank,***6917,"Globex International Holdings, Inc.",US,11933811.51
04/09/2023,04/09/2023,Supplier Payment - CodeCraft Contractors #1,Supplier Payment,SaaS-GL,7534.57,0,USD,Fedwire,CodeCraft Contractors #1,***3116,,PO-202309-SaaS-GL-0007,FALSE,FALSE,REF-473923,First Continental Bank,***7227,"Globex International Holdings, Inc.",US,11926276.94
04/09/2023,04/09/2023,BluePeak Property Mgmt,Rent & Utilities,ALL,8117.35,0,USD,Wire Transfer,BluePeak Property Mgmt,***3288,,,FALSE,FALSE,REF-799458,First Continental Bank,***2841,"Globex International Holdings, Inc.",US,11918159.59
04/09/2023,04/09/2023,Supplier Payment - ExpertNet Subcontractors #15,Supplier Payment,PS-GL,19162.72,0,USD,ACH Debit,ExpertNet Subcontractors #15,***7533,,PO-202309-PS-GL-0004,FALSE,FALSE,REF-961648,First Continental Bank,***7018,"Globex International Holdings, Inc.",US,11898996.87
04/09/2023,04/09/2023,Client Receipt - Vertex Advisory Client #45,Sales Receipt,PS-GL,0,59412.44,USD,Fedwire Credit,Vertex Advisory Client #45,***8867,INV-202309-PS-GL-0002,,FALSE,FALSE,REF-726354,First Continental Bank,***9833,"Globex International Holdings, Inc.",US,11958409.31
04/09/2023,04/09/2023,Client Receipt - CloudBridge Co. #36,Sales Receipt,SaaS-GL,0,66492.28,USD,Card Settlement,CloudBridge Co. #36,***5597,INV-202309-SaaS-GL-0001,,FALSE,FALSE,REF-960527,First Continental Bank,***6419,"Globex International Holdings, Inc.",US,12024901.59
04/09/2023,04/09/2023,Client Receipt - ShopSphere Partner #76,Sales Receipt,Retail-NA,0,481561.65,USD,Fedwire Credit,ShopSphere Partner #76,***3816,INV-202309-Retail-NA-0006,,FALSE,FALSE,REF-751156,First Continental Bank,***4539,"Globex International Holdings, Inc.",US,12506463.24
05/09/2023,05/09/2023,Merchant Processing Fees,Bank/Merchant Fees,ALL,452.15,0,USD,Wire Transfer,First Continental Bank,***6086,,,FALSE,FALSE,REF-362779,First Continental Bank,***2815,"Globex International Holdings, Inc.",US,12506011.09
05/09/2023,05/09/2023,Supplier Payment - HyperCloud Infra #14,Supplier Payment,SaaS-GL,8848.01,0,USD,Wire Transfer,HyperCloud Infra #14,***9766,,PO-202309-SaaS-GL-0009,FALSE,FALSE,REF-269636,First Continental Bank,***4449,"Globex International Holdings, Inc.",US,12497163.08
05/09/2023,05/09/2023,Client Receipt - ShopSphere Partner #46,Sales Receipt,Retail-NA,0,12561.65,USD,ACH Credit,ShopSphere Partner #46,***4368,INV-202309-Retail-NA-0005,,FALSE,FALSE,REF-921142,First Continental Bank,***1578,"Globex International Holdings, Inc.",US,12509724.73
05/09/2023,05/09/2023,Client Receipt - CloudBridge Co. #33,Sales Receipt,SaaS-GL,0,31759.38,USD,ACH Credit,CloudBridge Co. #33,***7909,INV-202309-SaaS-GL-0014,,FALSE,FALSE,REF-272942,First Continental Bank,***1192,"Globex International Holdings, Inc.",US,12541484.11
05/09/2023,05/09/2023,Client Receipt - Vertex Advisory Client #11,Sales Receipt,PS-GL,0,39601.85,USD,Fedwire Credit,Vertex Advisory Client #11,***1701,INV-202309-PS-GL-0008,,FALSE,FALSE,REF-539939,First Continental Bank,***8827,"Globex International Holdings, Inc.",US,12581085.96
05/09/2023,05/09/2023,Client Receipt - ShopSphere Partner #4,Sales Receipt,Retail-NA,0,208596,USD,ACH Credit,ShopSphere Partner #4,***2405,INV-202309-Retail-NA-0003,,FALSE,FALSE,REF-844497,First Continental Bank,***9163,"Globex International Holdings, Inc.",US,12789681.96
06/09/2023,06/09/2023,Supplier Payment - NorthRiver Apparel Mfg #25,Supplier Payment,Retail-NA,3872.24,0,USD,ACH Debit,NorthRiver Apparel Mfg #25,***5323,,PO-202309-Retail-NA-0001,FALSE,FALSE,REF-993670,First Continental Bank,***3396,"Globex International Holdings, Inc.",US,12785809.72
06/09/2023,06/09/2023,Supplier Payment - NorthRiver Apparel Mfg #24,Supplier Payment,Retail-NA,36333.02,0,USD,Wire Transfer,NorthRiver Apparel Mfg #24,***3401,,PO-202309-Retail-NA-0006,FALSE,FALSE,REF-752236,First Continental Bank,***2480,"Globex International Holdings, Inc.",US,12749476.7
06/09/2023,06/09/2023,Client Receipt - CloudBridge Co. #70,Sales Receipt,SaaS-GL,0,12824.14,USD,Fedwire Credit,CloudBridge Co. #70,***7964,INV-202309-SaaS-GL-0017,,FALSE,FALSE,REF-529513,First Continental Bank,***5896,"Globex International Holdings, Inc.",US,12762300.84
06/09/2023,06/09/2023,Client Receipt - ShopSphere Partner #23,Sales Receipt,Retail-NA,0,22454.1,USD,Card Settlement,ShopSphere Partner #23,***8914,INV-202309-Retail-NA-0009,,FALSE,FALSE,REF-719299,First Continental Bank,***8331,"Globex International Holdings, Inc.",US,12784754.94
07/09/2023,07/09/2023,Supplier Payment - ExpertNet Subcontractors #12,Supplier Payment,PS-GL,37688.23,0,USD,ACH Debit,ExpertNet Subcontractors #12,***6165,,PO-202309-PS-GL-0003,FALSE,FALSE,REF-136770,First Continental Bank,***5853,"Globex International Holdings, Inc.",US,12747066.71
07/09/2023,07/09/2023,Client Receipt - Vertex Advisory Client #20,Sales Receipt,PS-GL,0,248488.78,USD,Fedwire Credit,Vertex Advisory Client #20,***2415,INV-202309-PS-GL-0004,,FALSE,FALSE,REF-337499,First Continental Bank,***2019,"Globex International Holdings, Inc.",US,12995555.49
08/09/2023,08/09/2023,Merchant Processing Fees,Bank/Merchant Fees,ALL,9176.55,0,USD,Wire Transfer,First Continental Bank,***2299,,,FALSE,FALSE,REF-969562,First Continental Bank,***2331,"Globex International Holdings, Inc.",US,12986378.94
08/09/2023,08/09/2023,Client Receipt - CloudBridge Co. #60,Sales Receipt,SaaS-GL,0,61737.83,USD,Card Settlement,CloudBridge Co. #60,***4221,INV-202309-SaaS-GL-0011,,FALSE,FALSE,REF-891621,First Continental Bank,***8520,"Globex International Holdings, Inc.",US,13048116.77
09/09/2023,09/09/2023,Supplier Payment - NorthRiver Apparel Mfg #19,Supplier Payment,Retail-NA,42815.78,0,USD,ACH Debit,NorthRiver Apparel Mfg #19,***3780,,PO-202309-Retail-NA-0008,FALSE,FALSE,REF-143007,First Continental Bank,***2970,"Globex International Holdings, Inc.",US,13005300.99
10/09/2023,10/09/2023,Supplier Payment - CodeCraft Contractors #9,Supplier Payment,SaaS-GL,41354.31,0,USD,Wire Transfer,CodeCraft Contractors #9,***6929,,PO-202309-SaaS-GL-0006,FALSE,FALSE,REF-657477,First Continental Bank,***4595,"Globex International Holdings, Inc.",US,12963946.68
11/09/2023,11/09/2023,Supplier Payment - ExpertNet Subcontractors #3,Supplier Payment,PS-GL,405.57,0,USD,Fedwire,ExpertNet Subcontractors #3,***1051,,PO-202309-PS-GL-0007,FALSE,FALSE,REF-510435,First Continental Bank,***7266,"Globex International Holdings, Inc.",US,12963541.11
11/09/2023,11/09/2023,Client Receipt - CloudBridge Co. #38,Sales Receipt,SaaS-GL,0,3808.63,USD,ACH Credit,CloudBridge Co. #38,***2501,INV-202309-SaaS-GL-0012,,FALSE,FALSE,REF-208531,First Continental Bank,***9666,"Globex International Holdings, Inc.",US,12967349.74
12/09/2023,12/09/2023,Supplier Payment - NorthRiver Apparel Mfg #8,Supplier Payment,Retail-NA,107711.63,0,USD,Fedwire,NorthRiver Apparel Mfg #8,***8243,,PO-202309-Retail-NA-0003,FALSE,FALSE,REF-107959,First Continental Bank,***1606,"Globex International Holdings, Inc.",US,12859638.11
12/09/2023,12/09/2023,Intercompany Settlement - Globex APAC Logistics Pte. Ltd.,Intercompany Transfer,ALL,334623,0,USD,Internal Transfer,Globex APAC Logistics Pte. Ltd.,***4560,,,TRUE,TRUE,REF-612460,First Continental Bank,***2002,"Globex International Holdings, Inc.",US,12525015.11
13/09/2023,13/09/2023,Supplier Payment - ExpertNet Subcontractors #14,Supplier Payment,PS-GL,7494.09,0,USD,Fedwire,ExpertNet Subcontractors #14,***3626,,PO-202309-PS-GL-0002,FALSE,FALSE,REF-717962,First Continental Bank,***7788,"Globex International Holdings, Inc.",US,12517521.02
13/09/2023,13/09/2023,Supplier Payment - ExpertNet Subcontractors #9,Supplier Payment,PS-GL,38908.25,0,USD,ACH Debit,ExpertNet Subcontractors #9,***1559,,PO-202309-PS-GL-0008,FALSE,FALSE,REF-541812,First Continental Bank,***7398,"Globex International Holdings, Inc.",US,12478612.77
13/09/2023,13/09/2023,Supplier Payment - ExpertNet Subcontractors #5,Supplier Payment,PS-GL,83111.42,0,USD,Wire Transfer,ExpertNet Subcontractors #5,***2041,,PO-202309-PS-GL-0010,FALSE,FALSE,REF-887692,First Continental Bank,***9429,"Globex International Holdings, Inc.",US,12395501.35
13/09/2023,13/09/2023,Client Receipt - CloudBridge Co. #50,Sales Receipt,SaaS-GL,0,34463.53,USD,ACH Credit,CloudBridge Co. #50,***8361,INV-202309-SaaS-GL-0006,,FALSE,FALSE,REF-135420,First Continental Bank,***1916,"Globex International Holdings, Inc.",US,12429964.88
14/09/2023,14/09/2023,Marketing - Aurelia Media #10,Marketing,ALL,65722.56,0,USD,Fedwire,Aurelia Media #10,***5658,,,FALSE,FALSE,REF-551209,First Continental Bank,***9081,"Globex International Holdings, Inc.",US,12364242.32
14/09/2023,14/09/2023,Client Receipt - CloudBridge Co. #2,Sales Receipt,SaaS-GL,0,10931.85,USD,ACH Credit,CloudBridge Co. #2,***1931,INV-202309-SaaS-GL-0008,,FALSE,FALSE,REF-664758,First Continental Bank,***8292,"Globex International Holdings, Inc.",US,12375174.17
14/09/2023,14/09/2023,Client Receipt - CloudBridge Co. #59,Sales Receipt,SaaS-GL,0,35007.23,USD,Card Settlement,CloudBridge Co. #59,***4576,INV-202309-SaaS-GL-0003,,FALSE,FALSE,REF-370971,First Continental Bank,***3449,"Globex International Holdings, Inc.",US,12410181.4
14/09/2023,14/09/2023,Client Receipt - Card Settlement Batch #6,Sales Receipt,Retail-NA,0,202723.67,USD,Fedwire Credit,Card Settlement Batch #6,***2404,INV-202309-Retail-NA-0008,,FALSE,FALSE,REF-953829,First Continental Bank,***8767,"Globex International Holdings, Inc.",US,12612905.07
15/09/2023,15/09/2023,Supplier Payment - HyperCloud Infra #9,Supplier Payment,SaaS-GL,2935.32,0,USD,Fedwire,HyperCloud Infra #9,***2515,,PO-202309-SaaS-GL-0004,FALSE,FALSE,REF-267806,First Continental Bank,***4510,"Globex International Holdings, Inc.",US,12609969.75
15/09/2023,15/09/2023,Supplier Payment - CodeCraft Contractors #12,Supplier Payment,SaaS-GL,49610.89,0,USD,Wire Transfer,CodeCraft Contractors #12,***5833,,PO-202309-SaaS-GL-0002,FALSE,FALSE,REF-697469,First Continental Bank,***1777,"Globex International Holdings, Inc.",US,12560358.86
15/09/2023,15/09/2023,Loan Interest Payment,Loan Interest,ALL,85000,0,USD,Fedwire,First Continental Bank - Corporate Lending,***9923,,,FALSE,FALSE,REF-700682,First Continental Bank,***7910,"Globex International Holdings, Inc.",US,12475358.86
15/09/2023,15/09/2023,Loan Principal Repayment,Loan Principal,ALL,500000,0,USD,Wire Transfer,First Continental Bank - Corporate Lending,***1112,,,FALSE,FALSE,REF-307039,First Continental Bank,***2160,"Globex International Holdings, Inc.",US,11975358.86
16/09/2023,16/09/2023,Client Receipt - Vertex Advisory Client #27,Sales Receipt,PS-GL,0,34708.49,USD,Fedwire Credit,Vertex Advisory Client #27,***5950,INV-202309-PS-GL-0007,,FALSE,FALSE,REF-386983,First Continental Bank,***6591,"Globex International Holdings, Inc.",US,12010067.35
16/09/2023,16/09/2023,Client Receipt - CloudBridge Co. #35,Sales Receipt,SaaS-GL,0,125259.17,USD,ACH Credit,CloudBridge Co. #35,***6540,INV-202309-SaaS-GL-0022,,FALSE,FALSE,REF-495498,First Continental Bank,***1387,"Globex International Holdings, Inc.",US,12135326.52
17/09/2023,17/09/2023,Client Receipt - CloudBridge Co. #57,Sales Receipt,SaaS-GL,0,78602.81,USD,Fedwire Credit,CloudBridge Co. #57,***7790,INV-202309-SaaS-GL-0015,,FALSE,FALSE,REF-953284,First Continental Bank,***3704,"Globex International Holdings, Inc.",US,12213929.33
17/09/2023,17/09/2023,Client Receipt - Vertex Advisory Client #42,Sales Receipt,PS-GL,0,89215.71,USD,Fedwire Credit,Vertex Advisory Client #42,***7923,INV-202309-PS-GL-0001,,FALSE,FALSE,REF-185773,First Continental Bank,***7880,"Globex International Holdings, Inc.",US,12303145.04
18/09/2023,18/09/2023,Supplier Payment - ExpertNet Subcontractors #19,Supplier Payment,PS-GL,12140.14,0,USD,Fedwire,ExpertNet Subcontractors #19,***1267,,PO-202309-PS-GL-0005,FALSE,FALSE,REF-662440,First Continental Bank,***8006,"Globex International Holdings, Inc.",US,12291004.9
18/09/2023,18/09/2023,VAT/GST Remittance - US IRS,Tax Payment,ALL,198477.59,0,USD,SWIFT MT103,US IRS,***1578,,,FALSE,FALSE,REF-636554,First Continental Bank,***5330,"Globex International Holdings, Inc.",US,12092527.31
18/09/2023,18/09/2023,Client Receipt - Card Settlement Batch #8,Sales Receipt,Retail-NA,0,23910.07,USD,Card Settlement,Card Settlement Batch #8,***3680,INV-202309-Retail-NA-0010,,FALSE,FALSE,REF-290871,First Continental Bank,***3925,"Globex International Holdings, Inc.",US,12116437.38
18/09/2023,18/09/2023,Client Receipt - CloudBridge Co. #63,Sales Receipt,SaaS-GL,0,30373.54,USD,ACH Credit,CloudBridge Co. #63,***1606,INV-202309-SaaS-GL-0010,,FALSE,FALSE,REF-179562,First Continental Bank,***5330,"Globex International Holdings, Inc.",US,12146810.92
19/09/2023,19/09/2023,Supplier Payment - NorthRiver Apparel Mfg #17,Supplier Payment,Retail-NA,17167.2,0,USD,ACH Debit,NorthRiver Apparel Mfg #17,***5056,,PO-202309-Retail-NA-0004,FALSE,FALSE,REF-899460,First Continental Bank,***8692,"Globex International Holdings, Inc.",US,12129643.72
19/09/2023,19/09/2023,Client Receipt - CloudBridge Co. #14,Sales Receipt,SaaS-GL,0,11571.32,USD,ACH Credit,CloudBridge Co. #14,***3280,INV-202309-SaaS-GL-0019,,FALSE,FALSE,REF-448653,First Continental Bank,***8052,"Globex International Holdings, Inc.",US,12141215.04
19/09/2023,19/09/2023,Client Receipt - ShopSphere Partner #54,Sales Receipt,Retail-NA,0,22130.98,USD,ACH Credit,ShopSphere Partner #54,***9398,INV-202309-Retail-NA-0004,,FALSE,FALSE,REF-758155,First Continental Bank,***8066,"Globex International Holdings, Inc.",US,12163346.02
19/09/2023,19/09/2023,Client Receipt - ShopSphere Partner #69,Sales Receipt,Retail-NA,0,27208.66,USD,Fedwire Credit,ShopSphere Partner #69,***9520,INV-202309-Retail-NA-0011,,FALSE,FALSE,REF-305109,First Continental Bank,***2872,"Globex International Holdings, Inc.",US,12190554.68
19/09/2023,19/09/2023,Client Receipt - CloudBridge Co. #14,Sales Receipt,SaaS-GL,0,102222.64,USD,Fedwire Credit,CloudBridge Co. #14,***5726,INV-202309-SaaS-GL-0002,,FALSE,FALSE,REF-668492,First Continental Bank,***5993,"Globex International Holdings, Inc.",US,12292777.32
20/09/2023,20/09/2023,Client Receipt - CloudBridge Co. #12,Sales Receipt,SaaS-GL,0,38885.81,USD,Fedwire Credit,CloudBridge Co. #12,***1261,INV-202309-SaaS-GL-0009,,FALSE,FALSE,REF-926516,First Continental Bank,***7176,"Globex International Holdings, Inc.",US,12331663.13
20/09/2023,20/09/2023,Client Receipt - CloudBridge Co. #79,Sales Receipt,SaaS-GL,0,54943.58,USD,Card Settlement,CloudBridge Co. #79,***7760,INV-202309-SaaS-GL-0016,,FALSE,FALSE,REF-172954,First Continental Bank,***4906,"Globex International Holdings, Inc.",US,12386606.71
21/09/2023,21/09/2023,Northshore Power,Rent & Utilities,ALL,18218.03,0,USD,Wire Transfer,Northshore Power,***1364,,,FALSE,FALSE,REF-330896,First Continental Bank,***3507,"Globex International Holdings, Inc.",US,12368388.68
21/09/2023,21/09/2023,Client Receipt - CloudBridge Co. #72,Sales Receipt,SaaS-GL,0,42350.79,USD,Card Settlement,CloudBridge Co. #72,***1844,INV-202309-SaaS-GL-0018,,FALSE,FALSE,REF-966690,First Continental Bank,***5667,"Globex International Holdings, Inc.",US,12410739.47
21/09/2023,21/09/2023,Client Receipt - ShopSphere Partner #35,Sales Receipt,Retail-NA,0,105582.41,USD,Fedwire Credit,ShopSphere Partner #35,***1230,INV-202309-Retail-NA-0002,,FALSE,FALSE,REF-331776,First Continental Bank,***8455,"Globex International Holdings, Inc.",US,12516321.88
22/09/2023,22/09/2023,Supplier Payment - CodeCraft Contractors #1,Supplier Payment,SaaS-GL,15908.35,0,USD,ACH Debit,CodeCraft Contractors #1,***9053,,PO-202309-SaaS-GL-0008,FALSE,FALSE,REF-514255,First Continental Bank,***6738,"Globex International Holdings, Inc.",US,12500413.53
23/09/2023,23/09/2023,Client Receipt - Vertex Advisory Client #44,Sales Receipt,PS-GL,0,143107.6,USD,Fedwire Credit,Vertex Advisory Client #44,***7747,INV-202309-PS-GL-0006,,FALSE,FALSE,REF-405792,First Continental Bank,***6237,"Globex International Holdings, Inc.",US,12643521.13
25/09/2023,25/09/2023,Supplier Payment - ExpertNet Subcontractors #12,Supplier Payment,PS-GL,19241.02,0,USD,Wire Transfer,ExpertNet Subcontractors #12,***5470,,PO-202309-PS-GL-0009,FALSE,FALSE,REF-854150,First Continental Bank,***3763,"Globex International Holdings, Inc.",US,12624280.11
26/09/2023,26/09/2023,Supplier Payment - HyperCloud Infra #14,Supplier Payment,SaaS-GL,64519.47,0,USD,Fedwire,HyperCloud Infra #14,***6189,,PO-202309-SaaS-GL-0005,FALSE,FALSE,REF-894324,First Continental Bank,***4645,"Globex International Holdings, Inc.",US,12559760.64
26/09/2023,26/09/2023,Supplier Payment - NorthRiver Apparel Mfg #33,Supplier Payment,Retail-NA,134918.71,0,USD,Fedwire,NorthRiver Apparel Mfg #33,***2808,,PO-202309-Retail-NA-0002,FALSE,FALSE,REF-750601,First Continental Bank,***8581,"Globex International Holdings, Inc.",US,12424841.93
26/09/2023,26/09/2023,Intercompany Settlement - Globex APAC Logistics Pte. Ltd.,Intercompany Transfer,ALL,422611,0,USD,Internal Transfer,Globex APAC Logistics Pte. Ltd.,***1000,,,TRUE,TRUE,REF-729228,First Continental Bank,***7326,"Globex International Holdings, Inc.",US,12002230.93
26/09/2023,26/09/2023,Client Receipt - Card Settlement Batch #16,Sales Receipt,Retail-NA,0,66987.93,USD,Fedwire Credit,Card Settlement Batch #16,***7040,INV-202309-Retail-NA-0007,,FALSE,FALSE,REF-699834,First Continental Bank,***5608,"Globex International Holdings, Inc.",US,12069218.86
26/09/2023,26/09/2023,Client Receipt - CloudBridge Co. #15,Sales Receipt,SaaS-GL,0,157129.67,USD,ACH Credit,CloudBridge Co. #15,***8712,INV-202309-SaaS-GL-0021,,FALSE,FALSE,REF-938373,First Continental Bank,***8366,"Globex International Holdings, Inc.",US,12226348.53
26/09/2023,26/09/2023,Client Receipt - ShopSphere Partner #49,Sales Receipt,Retail-NA,0,202142.79,USD,Card Settlement,ShopSphere Partner #49,***6866,INV-202309-Retail-NA-0001,,FALSE,FALSE,REF-236632,First Continental Bank,***4145,"Globex International Holdings, Inc.",US,12428491.32
27/09/2023,27/09/2023,Supplier Payment - ExpertNet Subcontractors #14,Supplier Payment,PS-GL,5093.19,0,USD,Fedwire,ExpertNet Subcontractors #14,***1959,,PO-202309-PS-GL-0001,FALSE,FALSE,REF-142650,First Continental Bank,***6172,"Globex International Holdings, Inc.",US,12423398.13
27/09/2023,27/09/2023,Marketing - Beacon Digital #7,Marketing,ALL,16502.99,0,USD,Wire Transfer,Beacon Digital #7,***4232,,,FALSE,FALSE,REF-993317,First Continental Bank,***6688,"Globex International Holdings, Inc.",US,12406895.14
27/09/2023,27/09/2023,Client Receipt - CloudBridge Co. #54,Sales Receipt,SaaS-GL,0,31051.22,USD,Fedwire Credit,CloudBridge Co. #54,***1382,INV-202309-SaaS-GL-0007,,FALSE,FALSE,REF-270466,First Continental Bank,***4696,"Globex International Holdings, Inc.",US,12437946.36
28/09/2023,28/09/2023,Supplier Payment - NorthRiver Apparel Mfg #3,Supplier Payment,Retail-NA,52367.37,0,USD,Fedwire,NorthRiver Apparel Mfg #3,***2304,,PO-202309-Retail-NA-0005,FALSE,FALSE,REF-389036,First Continental Bank,***4283,"Globex International Holdings, Inc.",US,12385578.99
29/09/2023,29/09/2023,Supplier Payment - ExpertNet Subcontractors #6,Supplier Payment,PS-GL,1896.08,0,USD,Fedwire,ExpertNet Subcontractors #6,***4117,,PO-202309-PS-GL-0006,FALSE,FALSE,REF-793060,First Continental Bank,***8049,"Globex International Holdings, Inc.",US,12383682.91
29/09/2023,29/09/2023,Supplier Payment - HyperCloud Infra #2,Supplier Payment,SaaS-GL,30064.21,0,USD,ACH Debit,HyperCloud Infra #2,***3279,,PO-202309-SaaS-GL-0001,FALSE,FALSE,REF-867442,First Continental Bank,***5825,"Globex International Holdings, Inc.",US,12353618.7
29/09/2023,29/09/2023,Payroll - GlobalPay Services Ltd,Payroll,ALL,259389.55,0,USD,ACH Debit,GlobalPay Services Ltd,***2107,,,FALSE,FALSE,REF-544064,First Continental Bank,***8753,"Globex International Holdings, Inc.",US,12094229.15
29/09/2023,29/09/2023,Client Receipt - Vertex Advisory Client #56,Sales Receipt,PS-GL,0,8290.85,USD,Fedwire Credit,Vertex Advisory Client #56,***7182,INV-202309-PS-GL-0005,,FALSE,FALSE,REF-914689,First Continental Bank,***1292,"Globex International Holdings, Inc.",US,12102520
29/09/2023,29/09/2023,Client Receipt - CloudBridge Co. #32,Sales Receipt,SaaS-GL,0,25701.9,USD,ACH Credit,CloudBridge Co. #32,***2287,INV-202309-SaaS-GL-0020,,FALSE,FALSE,REF-454292,First Continental Bank,***9877,"Globex International Holdings, Inc.",US,12128221.9
30/09/2023,30/09/2023,Supplier Payment - HyperCloud Infra #3,Supplier Payment,SaaS-GL,26879.65,0,USD,Wire Transfer,HyperCloud Infra #3,***2677,,PO-202309-SaaS-GL-0003,FALSE,FALSE,REF-442736,First Continental Bank,***1480,"Globex International Holdings, Inc.",US,12101342.25
30/09/2023,30/09/2023,Payroll - GlobalPay Services Ltd,Payroll,ALL,259389.55,0,USD,ACH Debit,GlobalPay Services Ltd,***6071,,,FALSE,FALSE,REF-223066,First Continental Bank,***1290,"Globex International Holdings, Inc.",US,11841952.7
30/09/2023,30/09/2023,Client Receipt - Vertex Advisory Client #49,Sales Receipt,PS-GL,0,381.05,USD,Card Settlement,Vertex Advisory Client #49,***5185,INV-202309-PS-GL-0009,,FALSE,FALSE,REF-664970,First Continental Bank,***5555,"Globex International Holdings, Inc.",US,11842333.75
30/09/2023,30/09/2023,Interest Earned,Interest Income,ALL,0,12643.84,USD,Card Settlement,First Continental Bank,***1293,,,FALSE,FALSE,REF-246141,First Continental Bank,***3384,"Globex International Holdings, Inc.",US,11854977.59
01/10/2023,01/10/2023,Account Maintenance Fee,Bank/Merchant Fees,ALL,2500,0,USD,ACH Debit,First Continental Bank,***2505,,,FALSE,FALSE,REF-727410,First Continental Bank,***2446,"Globex International Holdings, Inc.",US,11852477.59
01/10/2023,01/10/2023,Supplier Payment - CodeCraft Contractors #12,Supplier Payment,SaaS-GL,23271.87,0,USD,ACH Debit,CodeCraft Contractors #12,***7585,,PO-202310-SaaS-GL-0001,FALSE,FALSE,REF-353610,First Continental Bank,***6127,"Globex International Holdings, Inc.",US,11829205.72
02/10/2023,02/10/2023,Supplier Payment - ExpertNet Subcontractors #6,Supplier Payment,PS-GL,7079.55,0,USD,Fedwire,ExpertNet Subcontractors #6,***8843,,PO-202310-PS-GL-0002,FALSE,FALSE,REF-266127,First Continental Bank,***7404,"Globex International Holdings, Inc.",US,11822126.17
02/10/2023,02/10/2023,Client Receipt - CloudBridge Co. #67,Sales Receipt,SaaS-GL,0,5141.94,USD,Card Settlement,CloudBridge Co. #67,***9387,INV-202310-SaaS-GL-0007,,FALSE,FALSE,REF-519868,First Continental Bank,***3913,"Globex International Holdings, Inc.",US,11827268.11
02/10/2023,02/10/2023,Client Receipt - Vertex Advisory Client #8,Sales Receipt,PS-GL,0,91251.83,USD,Card Settlement,Vertex Advisory Client #8,***4367,INV-202310-PS-GL-0005,,FALSE,FALSE,REF-505833,First Continental Bank,***1025,"Globex International Holdings, Inc.",US,11918519.94
02/10/2023,02/10/2023,Client Receipt - ShopSphere Partner #2,Sales Receipt,Retail-NA,0,139552.47,USD,Fedwire Credit,ShopSphere Partner #2,***2340,INV-202310-Retail-NA-0001,,FALSE,FALSE,REF-578669,First Continental Bank,***6343,"Globex International Holdings, Inc.",US,12058072.41
03/10/2023,03/10/2023,Supplier Payment - ExpertNet Subcontractors #8,Supplier Payment,PS-GL,20114.06,0,USD,Wire Transfer,ExpertNet Subcontractors #8,***4576,,PO-202310-PS-GL-0004,FALSE,FALSE,REF-475139,First Continental Bank,***3410,"Globex International Holdings, Inc.",US,12037958.35
03/10/2023,03/10/2023,Supplier Payment - NorthRiver Apparel Mfg #13,Supplier Payment,Retail-NA,237480.34,0,USD,ACH Debit,NorthRiver Apparel Mfg #13,***2374,,PO-202310-Retail-NA-0006,FALSE,FALSE,REF-359884,First Continental Bank,***3286,"Globex International Holdings, Inc.",US,11800478.01
03/10/2023,03/10/2023,Client Receipt - Vertex Advisory Client #8,Sales Receipt,PS-GL,0,7885.6,USD,Fedwire Credit,Vertex Advisory Client #8,***8966,INV-202310-PS-GL-0002,,FALSE,FALSE,REF-715767,First Continental Bank,***1051,"Globex International Holdings, Inc.",US,11808363.61
03/10/2023,03/10/2023,Client Receipt - CloudBridge Co. #32,Sales Receipt,SaaS-GL,0,39981.53,USD,Card Settlement,CloudBridge Co. #32,***2535,INV-202310-SaaS-GL-0013,,FALSE,FALSE,REF-953695,First Continental Bank,***9579,"Globex International Holdings, Inc.",US,11848345.14
03/10/2023,03/10/2023,Client Receipt - Vertex Advisory Client #46,Sales Receipt,PS-GL,0,144663.87,USD,ACH Credit,Vertex Advisory Client #46,***5596,INV-202310-PS-GL-0001,,FALSE,FALSE,REF-937410,First Continental Bank,***4179,"Globex International Holdings, Inc.",US,11993009.01
04/10/2023,04/10/2023,Supplier Payment - NorthRiver Apparel Mfg #33,Supplier Payment,Retail-NA,64957.04,0,USD,Fedwire,NorthRiver Apparel Mfg #33,***6340,,PO-202310-Retail-NA-0003,FALSE,FALSE,REF-704308,First Continental Bank,***8932,"Globex International Holdings, Inc.",US,11928051.97
04/10/2023,04/10/2023,Client Receipt - ShopSphere Partner #37,Sales Receipt,Retail-NA,0,7675.47,USD,Card Settlement,ShopSphere Partner #37,***1564,INV-202310-Retail-NA-0002,,FALSE,FALSE,REF-972749,First Continental Bank,***3727,"Globex International Holdings, Inc.",US,11935727.44
04/10/2023,04/10/2023,Client Receipt - ShopSphere Partner #9,Sales Receipt,Retail-NA,0,175828.71,USD,Fedwire Credit,ShopSphere Partner #9,***2621,INV-202310-Retail-NA-0007,,FALSE,FALSE,REF-963068,First Continental Bank,***3091,"Globex International Holdings, Inc.",US,12111556.15
05/10/2023,05/10/2023,Supplier Payment - HyperCloud Infra #12,Supplier Payment,SaaS-GL,13164.96,0,USD,Fedwire,HyperCloud Infra #12,***6985,,PO-202310-SaaS-GL-0003,FALSE,FALSE,REF-191890,First Continental Bank,***4343,"Globex International Holdings, Inc.",US,12098391.19
05/10/2023,05/10/2023,Supplier Payment - HyperCloud Infra #19,Supplier Payment,SaaS-GL,26415.63,0,USD,ACH Debit,HyperCloud Infra #19,***7893,,PO-202310-SaaS-GL-0005,FALSE,FALSE,REF-352411,First Continental Bank,***1563,"Globex International Holdings, Inc.",US,12071975.56
05/10/2023,05/10/2023,Client Receipt - CloudBridge Co. #17,Sales Receipt,SaaS-GL,0,140586.04,USD,ACH Credit,CloudBridge Co. #17,***4015,INV-202310-SaaS-GL-0019,,FALSE,FALSE,REF-221666,First Continental Bank,***8130,"Globex International Holdings, Inc.",US,12212561.6
06/10/2023,06/10/2023,Supplier Payment - ExpertNet Subcontractors #18,Supplier Payment,PS-GL,67410.23,0,USD,Fedwire,ExpertNet Subcontractors #18,***9877,,PO-202310-PS-GL-0006,FALSE,FALSE,REF-572485,First Continental Bank,***2225,"Globex International Holdings, Inc.",US,12145151.37
06/10/2023,06/10/2023,Marketing - Beacon Digital #1,Marketing,ALL,89819.62,0,USD,ACH Debit,Beacon Digital #1,***4664,,,FALSE,FALSE,REF-175320,First Continental Bank,***2526,"Globex International Holdings, Inc.",US,12055331.75
07/10/2023,07/10/2023,Supplier Payment - HyperCloud Infra #19,Supplier Payment,SaaS-GL,13066.8,0,USD,Wire Transfer,HyperCloud Infra #19,***6155,,PO-202310-SaaS-GL-0004,FALSE,FALSE,REF-767725,First Continental Bank,***6118,"Globex International Holdings, Inc.",US,12042264.95
07/10/2023,07/10/2023,Metro Water & Waste,Rent & Utilities,ALL,28557.89,0,USD,Wire Transfer,Metro Water & Waste,***2805,,,FALSE,FALSE,REF-460284,First Continental Bank,***4788,"Globex International Holdings, Inc.",US,12013707.06
08/10/2023,08/10/2023,Client Receipt - CloudBridge Co. #65,Sales Receipt,SaaS-GL,0,31444.25,USD,ACH Credit,CloudBridge Co. #65,***3668,INV-202310-SaaS-GL-0023,,FALSE,FALSE,REF-865830,First Continental Bank,***1623,"Globex International Holdings, Inc.",US,12045151.31
09/10/2023,09/10/2023,Client Receipt - CloudBridge Co. #41,Sales Receipt,SaaS-GL,0,23122.07,USD,Card Settlement,CloudBridge Co. #41,***2910,INV-202310-SaaS-GL-0018,,FALSE,FALSE,REF-168168,First Continental Bank,***2010,"Globex International Holdings, Inc.",US,12068273.38
10/10/2023,10/10/2023,Supplier Payment - PackFast Fulfillment #16,Supplier Payment,Retail-NA,62100.84,0,USD,ACH Debit,PackFast Fulfillment #16,***1064,,PO-202310-Retail-NA-0005,FALSE,FALSE,REF-198379,First Continental Bank,***1989,"Globex International Holdings, Inc.",US,12006172.54
10/10/2023,10/10/2023,Client Receipt - CloudBridge Co. #71,Sales Receipt,SaaS-GL,0,11971.51,USD,ACH Credit,CloudBridge Co. #71,***8954,INV-202310-SaaS-GL-0010,,FALSE,FALSE,REF-602987,First Continental Bank,***6749,"Globex International Holdings, Inc.",US,12018144.05
10/10/2023,10/10/2023,Client Receipt - ShopSphere Partner #27,Sales Receipt,Retail-NA,0,17247.92,USD,Fedwire Credit,ShopSphere Partner #27,***2883,INV-202310-Retail-NA-0003,,FALSE,FALSE,REF-249868,First Continental Bank,***3579,"Globex International Holdings, Inc.",US,12035391.97
10/10/2023,10/10/2023,Client Receipt - CloudBridge Co. #49,Sales Receipt,SaaS-GL,0,35461.54,USD,Card Settlement,CloudBridge Co. #49,***1274,INV-202310-SaaS-GL-0003,,FALSE,FALSE,REF-282689,First Continental Bank,***2111,"Globex International Holdings, Inc.",US,12070853.51
11/10/2023,11/10/2023,Supplier Payment - HyperCloud Infra #4,Supplier Payment,SaaS-GL,1493.57,0,USD,Wire Transfer,HyperCloud Infra #4,***9496,,PO-202310-SaaS-GL-0012,FALSE,FALSE,REF-371648,First Continental Bank,***3704,"Globex International Holdings, Inc.",US,12069359.94
11/10/2023,11/10/2023,Supplier Payment - PackFast Fulfillment #21,Supplier Payment,Retail-NA,34552.8,0,USD,ACH Debit,PackFast Fulfillment #21,***8213,,PO-202310-Retail-NA-0007,FALSE,FALSE,REF-654117,First Continental Bank,***5370,"Globex International Holdings, Inc.",US,12034807.14
11/10/2023,11/10/2023,Supplier Payment - ExpertNet Subcontractors #6,Supplier Payment,PS-GL,36986.87,0,USD,Wire Transfer,ExpertNet Subcontractors #6,***5886,,PO-202310-PS-GL-0009,FALSE,FALSE,REF-445574,First Continental Bank,***4186,"Globex International Holdings, Inc.",US,11997820.27
11/10/2023,11/10/2023,Supplier Payment - NorthRiver Apparel Mfg #32,Supplier Payment,Retail-NA,148450.5,0,USD,Fedwire,NorthRiver Apparel Mfg #32,***9327,,PO-202310-Retail-NA-0008,FALSE,FALSE,REF-851945,First Continental Bank,***1752,"Globex International Holdings, Inc.",US,11849369.77
11/10/2023,11/10/2023,Client Receipt - ShopSphere Partner #18,Sales Receipt,Retail-NA,0,79522.39,USD,Card Settlement,ShopSphere Partner #18,***2817,INV-202310-Retail-NA-0004,,FALSE,FALSE,REF-743543,First Continental Bank,***8011,"Globex International Holdings, Inc.",US,11928892.16
11/10/2023,11/10/2023,Client Receipt - ShopSphere Partner #72,Sales Receipt,Retail-NA,0,109101.06,USD,Card Settlement,ShopSphere Partner #72,***5050,INV-202310-Retail-NA-0012,,FALSE,FALSE,REF-451607,First Continental Bank,***1628,"Globex International Holdings, Inc.",US,12037993.22
12/10/2023,12/10/2023,Supplier Payment - HyperCloud Infra #5,Supplier Payment,SaaS-GL,9999.68,0,USD,Fedwire,HyperCloud Infra #5,***2555,,PO-202310-SaaS-GL-0010,FALSE,FALSE,REF-650418,First Continental Bank,***4703,"Globex International Holdings, Inc.",US,12027993.54
12/10/2023,12/10/2023,Supplier Payment - ExpertNet Subcontractors #11,Supplier Payment,PS-GL,30832.38,0,USD,ACH Debit,ExpertNet Subcontractors #11,***4748,,PO-202310-PS-GL-0008,FALSE,FALSE,REF-997641,First Continental Bank,***6235,"Globex International Holdings, Inc.",US,11997161.16
12/10/2023,12/10/2023,Intercompany Settlement - Globex Consulting UK Ltd.,Intercompany Transfer,ALL,803881,0,USD,Internal Transfer,Globex Consulting UK Ltd.,***7460,,,TRUE,TRUE,REF-724690,First Continental Bank,***7683,"Globex International Holdings, Inc.",US,11193280.16
12/10/2023,12/10/2023,Client Receipt - CloudBridge Co. #27,Sales Receipt,SaaS-GL,0,21160.8,USD,Card Settlement,CloudBridge Co. #27,***7500,INV-202310-SaaS-GL-0022,,FALSE,FALSE,REF-727828,First Continental Bank,***5623,"Globex International Holdings, Inc.",US,11214440.96
12/10/2023,12/10/2023,Client Receipt - Card Settlement Batch #2,Sales Receipt,Retail-NA,0,60566.31,USD,Fedwire Credit,Card Settlement Batch #2,***8528,INV-202310-Retail-NA-0011,,FALSE,FALSE,REF-327639,First Continental Bank,***3613,"Globex International Holdings, Inc.",US,11275007.27
12/10/2023,12/10/2023,Client Receipt - Vertex Advisory Client #1,Sales Receipt,PS-GL,0,119940.18,USD,Card Settlement,Vertex Advisory Client #1,***5818,INV-202310-PS-GL-0008,,FALSE,FALSE,REF-639194,First Continental Bank,***4297,"Globex International Holdings, Inc.",US,11394947.45
13/10/2023,13/10/2023,Merchant Processing Fees,Bank/Merchant Fees,ALL,2033.23,0,USD,Fedwire,First Continental Bank,***2907,,,FALSE,FALSE,REF-360783,First Continental Bank,***6988,"Globex International Holdings, Inc.",US,11392914.22
13/10/2023,13/10/2023,Supplier Payment - NorthRiver Apparel Mfg #1,Supplier Payment,Retail-NA,18904.73,0,USD,ACH Debit,NorthRiver Apparel Mfg #1,***7085,,PO-202310-Retail-NA-0002,FALSE,FALSE,REF-140754,First Continental Bank,***1424,"Globex International Holdings, Inc.",US,11374009.49
13/10/2023,13/10/2023,Client Receipt - CloudBridge Co. #53,Sales Receipt,SaaS-GL,0,19899.44,USD,Fedwire Credit,CloudBridge Co. #53,***3090,INV-202310-SaaS-GL-0006,,FALSE,FALSE,REF-655584,First Continental Bank,***5498,"Globex International Holdings, Inc.",US,11393908.93
13/10/2023,13/10/2023,Client Receipt - ShopSphere Partner #73,Sales Receipt,Retail-NA,0,22916.27,USD,Card Settlement,ShopSphere Partner #73,***2576,INV-202310-Retail-NA-0013,,FALSE,FALSE,REF-913607,First Continental Bank,***3134,"Globex International Holdings, Inc.",US,11416825.2
13/10/2023,13/10/2023,Client Receipt - CloudBridge Co. #4,Sales Receipt,SaaS-GL,0,57078.88,USD,ACH Credit,CloudBridge Co. #4,***6383,INV-202310-SaaS-GL-0004,,FALSE,FALSE,REF-826667,First Continental Bank,***3402,"Globex International Holdings, Inc.",US,11473904.08
13/10/2023,13/10/2023,Client Receipt - Vertex Advisory Client #27,Sales Receipt,PS-GL,0,111300.26,USD,ACH Credit,Vertex Advisory Client #27,***3896,INV-202310-PS-GL-0009,,FALSE,FALSE,REF-531627,First Continental Bank,***4153,"Globex International Holdings, Inc.",US,11585204.34
14/10/2023,14/10/2023,Supplier Payment - HyperCloud Infra #6,Supplier Payment,SaaS-GL,17920.53,0,USD,Fedwire,HyperCloud Infra #6,***1848,,PO-202310-SaaS-GL-0009,FALSE,FALSE,REF-603474,First Continental Bank,***5368,"Globex International Holdings, Inc.",US,11567283.81
14/10/2023,14/10/2023,Client Receipt - CloudBridge Co. #76,Sales Receipt,SaaS-GL,0,38214.51,USD,Fedwire Credit,CloudBridge Co. #76,***1843,INV-202310-SaaS-GL-0017,,FALSE,FALSE,REF-883379,First Continental Bank,***7147,"Globex International Holdings, Inc.",US,11605498.32
14/10/2023,14/10/2023,Client Receipt - Card Settlement Batch #16,Sales Receipt,Retail-NA,0,50213.42,USD,ACH Credit,Card Settlement Batch #16,***2151,INV-202310-Retail-NA-0014,,FALSE,FALSE,REF-688998,First Continental Bank,***7106,"Globex International Holdings, Inc.",US,11655711.74
15/10/2023,15/10/2023,Loan Interest Payment,Loan Interest,ALL,85000,0,USD,ACH Debit,First Continental Bank - Corporate Lending,***8077,,,FALSE,FALSE,REF-661261,First Continental Bank,***5384,"Globex International Holdings, Inc.",US,11570711.74
15/10/2023,15/10/2023,Loan Principal Repayment,Loan Principal,ALL,500000,0,USD,Wire Transfer,First Continental Bank - Corporate Lending,***4178,,,FALSE,FALSE,REF-732247,First Continental Bank,***3940,"Globex International Holdings, Inc.",US,11070711.74
15/10/2023,15/10/2023,Client Receipt - Vertex Advisory Client #56,Sales Receipt,PS-GL,0,56522.57,USD,Fedwire Credit,Vertex Advisory Client #56,***2977,INV-202310-PS-GL-0006,,FALSE,FALSE,REF-871902,First Continental Bank,***5446,"Globex International Holdings, Inc.",US,11127234.31
15/10/2023,15/10/2023,Client Receipt - CloudBridge Co. #7,Sales Receipt,SaaS-GL,0,62669.56,USD,Fedwire Credit,CloudBridge Co. #7,***2292,INV-202310-SaaS-GL-0011,,FALSE,FALSE,REF-388012,First Continental Bank,***3902,"Globex International Holdings, Inc.",US,11189903.87
16/10/2023,16/10/2023,Supplier Payment - ExpertNet Subcontractors #1,Supplier Payment,PS-GL,8293.21,0,USD,ACH Debit,ExpertNet Subcontractors #1,***4141,,PO-202310-PS-GL-0003,FALSE,FALSE,REF-662524,First Continental Bank,***8015,"Globex International Holdings, Inc.",US,11181610.66
16/10/2023,16/10/2023,Supplier Payment - ExpertNet Subcontractors #11,Supplier Payment,PS-GL,68612.75,0,USD,ACH Debit,ExpertNet Subcontractors #11,***3284,,PO-202310-PS-GL-0001,FALSE,FALSE,REF-918082,First Continental Bank,***9873,"Globex International Holdings, Inc.",US,11112997.91
16/10/2023,16/10/2023,Client Receipt - ShopSphere Partner #15,Sales Receipt,Retail-NA,0,12373.41,USD,Card Settlement,ShopSphere Partner #15,***8049,INV-202310-Retail-NA-0008,,FALSE,FALSE,REF-475140,First Continental Bank,***2051,"Globex International Holdings, Inc.",US,11125371.32
16/10/2023,16/10/2023,Client Receipt - CloudBridge Co. #14,Sales Receipt,SaaS-GL,0,42032.04,USD,Card Settlement,CloudBridge Co. #14,***6497,INV-202310-SaaS-GL-0005,,FALSE,FALSE,REF-510730,First Continental Bank,***3355,"Globex International Holdings, Inc.",US,11167403.36
16/10/2023,16/10/2023,Client Receipt - Vertex Advisory Client #31,Sales Receipt,PS-GL,0,82097.02,USD,ACH Credit,Vertex Advisory Client #31,***8120,INV-202310-PS-GL-0004,,FALSE,FALSE,REF-541678,First Continental Bank,***4287,"Globex International Holdings, Inc.",US,11249500.38
16/10/2023,16/10/2023,Client Receipt - CloudBridge Co. #62,Sales Receipt,SaaS-GL,0,164426.74,USD,ACH Credit,CloudBridge Co. #62,***7615,INV-202310-SaaS-GL-0002,,FALSE,FALSE,REF-657782,First Continental Bank,***7188,"Globex International Holdings, Inc.",US,11413927.12
17/10/2023,17/10/2023,Supplier Payment - ExpertNet Subcontractors #4,Supplier Payment,PS-GL,2813.96,0,USD,Fedwire,ExpertNet Subcontractors #4,***6703,,PO-202310-PS-GL-0007,FALSE,FALSE,REF-774981,First Continental Bank,***7854,"Globex International Holdings, Inc.",US,11411113.16
17/10/2023,17/10/2023,Supplier Payment - PackFast Fulfillment #7,Supplier Payment,Retail-NA,3941.81,0,USD,ACH Debit,PackFast Fulfillment #7,***4671,,PO-202310-Retail-NA-0004,FALSE,FALSE,REF-383156,First Continental Bank,***1993,"Globex International Holdings, Inc.",US,11407171.35
17/10/2023,17/10/2023,Merchant Processing Fees,Bank/Merchant Fees,ALL,8364.24,0,USD,Fedwire,First Continental Bank,***3110,,,FALSE,FALSE,REF-691308,First Continental Bank,***5047,"Globex International Holdings, Inc.",US,11398807.11
17/10/2023,17/10/2023,Client Receipt - CloudBridge Co. #44,Sales Receipt,SaaS-GL,0,146223.49,USD,Fedwire Credit,CloudBridge Co. #44,***2514,INV-202310-SaaS-GL-0001,,FALSE,FALSE,REF-940714,First Continental Bank,***8012,"Globex International Holdings, Inc.",US,11545030.6
18/10/2023,18/10/2023,Marketing - Aurelia Media #3,Marketing,ALL,47.15,0,USD,ACH Debit,Aurelia Media #3,***1590,,,FALSE,FALSE,REF-888780,First Continental Bank,***1827,"Globex International Holdings, Inc.",US,11544983.45
18/10/2023,18/10/2023,Supplier Payment - HyperCloud Infra #15,Supplier Payment,SaaS-GL,55282.49,0,USD,ACH Debit,HyperCloud Infra #15,***7949,,PO-202310-SaaS-GL-0008,FALSE,FALSE,REF-827903,First Continental Bank,***2806,"Globex International Holdings, Inc.",US,11489700.96
18/10/2023,18/10/2023,Supplier Payment - NorthRiver Apparel Mfg #3,Supplier Payment,Retail-NA,140787.05,0,USD,Wire Transfer,NorthRiver Apparel Mfg #3,***3802,,PO-202310-Retail-NA-0009,FALSE,FALSE,REF-107360,First Continental Bank,***6254,"Globex International Holdings, Inc.",US,11348913.91
19/10/2023,19/10/2023,Client Receipt - Card Settlement Batch #3,Sales Receipt,Retail-NA,0,426120.96,USD,ACH Credit,Card Settlement Batch #3,***1584,INV-202310-Retail-NA-0015,,FALSE,FALSE,REF-568407,First Continental Bank,***1873,"Globex International Holdings, Inc.",US,11775034.87
20/10/2023,20/10/2023,Supplier Payment - ExpertNet Subcontractors #15,Supplier Payment,PS-GL,5511.77,0,USD,ACH Debit,ExpertNet Subcontractors #15,***8903,,PO-202310-PS-GL-0005,FALSE,FALSE,REF-297527,First Continental Bank,***4706,"Globex International Holdings, Inc.",US,11769523.1
20/10/2023,20/10/2023,Client Receipt - ShopSphere Partner #27,Sales Receipt,Retail-NA,0,185483.92,USD,Card Settlement,ShopSphere Partner #27,***9205,INV-202310-Retail-NA-0009,,FALSE,FALSE,REF-496746,First Continental Bank,***6479,"Globex International Holdings, Inc.",US,11955007.02
21/10/2023,21/10/2023,VAT/GST Remittance - US IRS,Tax Payment,ALL,213557.11,0,USD,Fedwire,US IRS,***6021,,,FALSE,FALSE,REF-889228,First Continental Bank,***5466,"Globex International Holdings, Inc.",US,11741449.91
21/10/2023,21/10/2023,Client Receipt - CloudBridge Co. #47,Sales Receipt,SaaS-GL,0,59934.3,USD,Fedwire Credit,CloudBridge Co. #47,***5828,INV-202310-SaaS-GL-0021,,FALSE,FALSE,REF-698917,First Continental Bank,***8469,"Globex International Holdings, Inc.",US,11801384.21
21/10/2023,21/10/2023,Client Receipt - Vertex Advisory Client #52,Sales Receipt,PS-GL,0,197618.81,USD,Fedwire Credit,Vertex Advisory Client #52,***5192,INV-202310-PS-GL-0003,,FALSE,FALSE,REF-608291,First Continental Bank,***9558,"Globex International Holdings, Inc.",US,11999003.02
22/10/2023,22/10/2023,Supplier Payment - CodeCraft Contractors #8,Supplier Payment,SaaS-GL,17703.2,0,USD,ACH Debit,CodeCraft Contractors #8,***2522,,PO-202310-SaaS-GL-0007,FALSE,FALSE,REF-637034,First Continental Bank,***3609,"Globex International Holdings, Inc.",US,11981299.82
22/10/2023,22/10/2023,Client Receipt - CloudBridge Co. #77,Sales Receipt,SaaS-GL,0,14504.47,USD,Fedwire Credit,CloudBridge Co. #77,***7593,INV-202310-SaaS-GL-0008,,FALSE,FALSE,REF-860264,First Continental Bank,***6554,"Globex International Holdings, Inc.",US,11995804.29
23/10/2023,23/10/2023,Supplier Payment - NorthRiver Apparel Mfg #3,Supplier Payment,Retail-NA,121220.14,0,USD,Wire Transfer,NorthRiver Apparel Mfg #3,***4476,,PO-202310-Retail-NA-0001,FALSE,FALSE,REF-174657,First Continental Bank,***1328,"Globex International Holdings, Inc.",US,11874584.15
23/10/2023,23/10/2023,Client Receipt - CloudBridge Co. #69,Sales Receipt,SaaS-GL,0,7483.38,USD,ACH Credit,CloudBridge Co. #69,***9057,INV-202310-SaaS-GL-0015,,FALSE,FALSE,REF-865837,First Continental Bank,***6265,"Globex International Holdings, Inc.",US,11882067.53
23/10/2023,23/10/2023,Client Receipt - CloudBridge Co. #15,Sales Receipt,SaaS-GL,0,33416.8,USD,ACH Credit,CloudBridge Co. #15,***4726,INV-202310-SaaS-GL-0012,,FALSE,FALSE,REF-482911,First Continental Bank,***7963,"Globex International Holdings, Inc.",US,11915484.33
24/10/2023,24/10/2023,Client Receipt - Card Settlement Batch #18,Sales Receipt,Retail-NA,0,14860.19,USD,Card Settlement,Card Settlement Batch #18,***4222,INV-202310-Retail-NA-0005,,FALSE,FALSE,REF-948875,First Continental Bank,***3806,"Globex International Holdings, Inc.",US,11930344.52
24/10/2023,24/10/2023,Client Receipt - CloudBridge Co. #20,Sales Receipt,SaaS-GL,0,33067.54,USD,ACH Credit,CloudBridge Co. #20,***6505,INV-202310-SaaS-GL-0009,,FALSE,FALSE,REF-925027,First Continental Bank,***5918,"Globex International Holdings, Inc.",US,11963412.06
24/10/2023,24/10/2023,Client Receipt - ShopSphere Partner #67,Sales Receipt,Retail-NA,0,36713.97,USD,Card Settlement,ShopSphere Partner #67,***9794,INV-202310-Retail-NA-0006,,FALSE,FALSE,REF-778594,First Continental Bank,***4379,"Globex International Holdings, Inc.",US,12000126.03
24/10/2023,24/10/2023,Client Receipt - CloudBridge Co. #59,Sales Receipt,SaaS-GL,0,43987.58,USD,Card Settlement,CloudBridge Co. #59,***7491,INV-202310-SaaS-GL-0024,,FALSE,FALSE,REF-771626,First Continental Bank,***1717,"Globex International Holdings, Inc.",US,12044113.61
26/10/2023,26/10/2023,Intercompany Settlement - Globex Retail NA LLC,Intercompany Transfer,ALL,337742,0,USD,Internal Transfer,Globex Retail NA LLC,***7427,,,TRUE,TRUE,REF-114443,First Continental Bank,***8766,"Globex International Holdings, Inc.",US,11706371.61
26/10/2023,26/10/2023,Client Receipt - CloudBridge Co. #34,Sales Receipt,SaaS-GL,0,14425.34,USD,Fedwire Credit,CloudBridge Co. #34,***4292,INV-202310-SaaS-GL-0014,,FALSE,FALSE,REF-324273,First Continental Bank,***3821,"Globex International Holdings, Inc.",US,11720796.95
26/10/2023,26/10/2023,Client Receipt - Card Settlement Batch #20,Sales Receipt,Retail-NA,0,175269.43,USD,ACH Credit,Card Settlement Batch #20,***5058,INV-202310-Retail-NA-0010,,FALSE,FALSE,REF-254852,First Continental Bank,***7056,"Globex International Holdings, Inc.",US,11896066.38
27/10/2023,27/10/2023,Supplier Payment - HyperCloud Infra #4,Supplier Payment,SaaS-GL,38813.94,0,USD,ACH Debit,HyperCloud Infra #4,***6362,,PO-202310-SaaS-GL-0006,FALSE,FALSE,REF-516038,First Continental Bank,***7155,"Globex International Holdings, Inc.",US,11857252.44
27/10/2023,27/10/2023,Payroll - GlobalPay Services Ltd,Payroll,ALL,574427.99,0,USD,Wire Transfer,GlobalPay Services Ltd,***8504,,,FALSE,FALSE,REF-406037,First Continental Bank,***4979,"Globex International Holdings, Inc.",US,11282824.45
27/10/2023,27/10/2023,Client Receipt - Vertex Advisory Client #12,Sales Receipt,PS-GL,0,14235.81,USD,Fedwire Credit,Vertex Advisory Client #12,***4687,INV-202310-PS-GL-0007,,FALSE,FALSE,REF-328275,First Continental Bank,***4926,"Globex International Holdings, Inc.",US,11297060.26
27/10/2023,27/10/2023,Client Receipt - CloudBridge Co. #37,Sales Receipt,SaaS-GL,0,67482.77,USD,ACH Credit,CloudBridge Co. #37,***6818,INV-202310-SaaS-GL-0020,,FALSE,FALSE,REF-277289,First Continental Bank,***2657,"Globex International Holdings, Inc.",US,11364543.03
28/10/2023,28/10/2023,Corporate Tax Estimate,Tax Payment,ALL,160274.65,0,USD,Wire Transfer,US IRS,***8990,,,FALSE,FALSE,REF-960128,First Continental Bank,***4877,"Globex International Holdings, Inc.",US,11204268.38
30/10/2023,30/10/2023,Supplier Payment - HyperCloud Infra #3,Supplier Payment,SaaS-GL,44596.56,0,USD,Fedwire,HyperCloud Infra #3,***9537,,PO-202310-SaaS-GL-0002,FALSE,FALSE,REF-675332,First Continental Bank,***9261,"Globex International Holdings, Inc.",US,11159671.82
30/10/2023,30/10/2023,Interest Earned,Interest Income,ALL,0,12339.37,USD,ACH Credit,First Continental Bank,***5871,,,FALSE,FALSE,REF-752498,First Continental Bank,***4016,"Globex International Holdings, Inc.",US,11172011.19
31/10/2023,31/10/2023,Supplier Payment - HyperCloud Infra #3,Supplier Payment,SaaS-GL,10691.03,0,USD,Fedwire,HyperCloud Infra #3,***3881,,PO-202310-SaaS-GL-0011,FALSE,FALSE,REF-659340,First Continental Bank,***7292,"Globex International Holdings, Inc.",US,11161320.16
31/10/2023,31/10/2023,Client Receipt - CloudBridge Co. #53,Sales Receipt,SaaS-GL,0,19652.3,USD,Fedwire Credit,CloudBridge Co. #53,***7064,INV-202310-SaaS-GL-0016,,FALSE,FALSE,REF-669710,First Continental Bank,***4626,"Globex International Holdings, Inc.",US,11180972.46
31/10/2023,31/10/2023,Client Receipt - CloudBridge Co. #17,Sales Receipt,SaaS-GL,0,104905.1,USD,Fedwire Credit,CloudBridge Co. #17,***1219,INV-202310-SaaS-GL-0025,,FALSE,FALSE,REF-862073,First Continental Bank,***6921,"Globex International Holdings, Inc.",US,11285877.56
01/11/2023,01/11/2023,Account Maintenance Fee,Bank/Merchant Fees,ALL,2500,0,USD,Fedwire,First Continental Bank,***5986,,,FALSE,FALSE,REF-398557,First Continental Bank,***2431,"Globex International Holdings, Inc.",US,11283377.56
01/11/2023,01/11/2023,Supplier Payment - NorthRiver Apparel Mfg #33,Supplier Payment,Retail-NA,220110.78,0,USD,ACH Debit,NorthRiver Apparel Mfg #33,***9075,,PO-202311-Retail-NA-0001,FALSE,FALSE,REF-899631,First Continental Bank,***3767,"Globex International Holdings, Inc.",US,11063266.78
01/11/2023,01/11/2023,Client Receipt - ShopSphere Partner #33,Sales Receipt,Retail-NA,0,19675.19,USD,Card Settlement,ShopSphere Partner #33,***6750,INV-202311-Retail-NA-0002,,FALSE,FALSE,REF-897875,First Continental Bank,***4439,"Globex International Holdings, Inc.",US,11082941.97
01/11/2023,01/11/2023,Client Receipt - CloudBridge Co. #10,Sales Receipt,SaaS-GL,0,28262.95,USD,ACH Credit,CloudBridge Co. #10,***2037,INV-202311-SaaS-GL-0023,,FALSE,FALSE,REF-341871,First Continental Bank,***4881,"Globex International Holdings, Inc.",US,11111204.92
02/11/2023,02/11/2023,Supplier Payment - NorthRiver Apparel Mfg #32,Supplier Payment,Retail-NA,103100.43,0,USD,Fedwire,NorthRiver Apparel Mfg #32,***6043,,PO-202311-Retail-NA-0006,FALSE,FALSE,REF-465040,First Continental Bank,***7498,"Globex International Holdings, Inc.",US,11008104.49
02/11/2023,02/11/2023,Supplier Payment - NorthRiver Apparel Mfg #5,Supplier Payment,Retail-NA,191105.99,0,USD,ACH Debit,NorthRiver Apparel Mfg #5,***5267,,PO-202311-Retail-NA-0007,FALSE,FALSE,REF-216759,First Continental Bank,***6843,"Globex International Holdings, Inc.",US,10816998.5
02/11/2023,02/11/2023,Client Receipt - CloudBridge Co. #75,Sales Receipt,SaaS-GL,0,8909.46,USD,Fedwire Credit,CloudBridge Co. #75,***7115,INV-202311-SaaS-GL-0014,,FALSE,FALSE,REF-737401,First Continental Bank,***4620,"Globex International Holdings, Inc.",US,10825907.96
02/11/2023,02/11/2023,Client Receipt - Vertex Advisory Client #15,Sales Receipt,PS-GL,0,11653.55,USD,Fedwire Credit,Vertex Advisory Client #15,***1327,INV-202311-PS-GL-0010,,FALSE,FALSE,REF-328726,First Continental Bank,***5512,"Globex International Holdings, Inc.",US,10837561.51
02/11/2023,02/11/2023,Client Receipt - CloudBridge Co. #59,Sales Receipt,SaaS-GL,0,29811.44,USD,ACH Credit,CloudBridge Co. #59,***4295,INV-202311-SaaS-GL-0010,,FALSE,FALSE,REF-248552,First Continental Bank,***4818,"Globex International Holdings, Inc.",US,10867372.95
02/11/2023,02/11/2023,Client Receipt - Vertex Advisory Client #51,Sales Receipt,PS-GL,0,47843.67,USD,ACH Credit,Vertex Advisory Client #51,***7664,INV-202311-PS-GL-0007,,FALSE,FALSE,REF-177370,First Continental Bank,***5944,"Globex International Holdings, Inc.",US,10915216.62
02/11/2023,02/11/2023,Client Receipt - CloudBridge Co. #69,Sales Receipt,SaaS-GL,0,137944.7,USD,Fedwire Credit,CloudBridge Co. #69,***6607,INV-202311-SaaS-GL-0001,,FALSE,FALSE,REF-231339,First Continental Bank,***4626,"Globex International Holdings, Inc.",US,11053161.32
02/11/2023,02/11/2023,Client Receipt - CloudBridge Co. #46,Sales Receipt,SaaS-GL,0,191881.99,USD,Fedwire Credit,CloudBridge Co. #46,***1296,INV-202311-SaaS-GL-0021,,FALSE,FALSE,REF-870524,First Continental Bank,***8600,"Globex International Holdings, Inc.",US,11245043.31
03/11/2023,03/11/2023,Client Receipt - Card Settlement Batch #12,Sales Receipt,Retail-NA,0,83397.89,USD,Card Settlement,Card Settlement Batch #12,***7710,INV-202311-Retail-NA-0005,,FALSE,FALSE,REF-248395,First Continental Bank,***6796,"Globex International Holdings, Inc.",US,11328441.2
03/11/2023,03/11/2023,Client Receipt - Vertex Advisory Client #45,Sales Receipt,PS-GL,0,114908.78,USD,Fedwire Credit,Vertex Advisory Client #45,***8545,INV-202311-PS-GL-0001,,FALSE,FALSE,REF-147255,First Continental Bank,***1905,"Globex International Holdings, Inc.",US,11443349.98
05/11/2023,05/11/2023,Client Receipt - CloudBridge Co. #39,Sales Receipt,SaaS-GL,0,37385.59,USD,Fedwire Credit,CloudBridge Co. #39,***2443,INV-202311-SaaS-GL-0019,,FALSE,FALSE,REF-106805,First Continental Bank,***1258,"Globex International Holdings, Inc.",US,11480735.57
06/11/2023,06/11/2023,Supplier Payment - CodeCraft Contractors #10,Supplier Payment,SaaS-GL,3747.84,0,USD,ACH Debit,CodeCraft Contractors #10,***3621,,PO-202311-SaaS-GL-0008,FALSE,FALSE,REF-571139,First Continental Bank,***8564,"Globex International Holdings, Inc.",US,11476987.73
06/11/2023,06/11/2023,Supplier Payment - CodeCraft Contractors #9,Supplier Payment,SaaS-GL,8913.39,0,USD,ACH Debit,CodeCraft Contractors #9,***3771,,PO-202311-SaaS-GL-0003,FALSE,FALSE,REF-920950,First Continental Bank,***5658,"Globex International Holdings, Inc.",US,11468074.34
06/11/2023,06/11/2023,Supplier Payment - ExpertNet Subcontractors #2,Supplier Payment,PS-GL,9128.43,0,USD,ACH Debit,ExpertNet Subcontractors #2,***4885,,PO-202311-PS-GL-0001,FALSE,FALSE,REF-222290,First Continental Bank,***6453,"Globex International Holdings, Inc.",US,11458945.91
06/11/2023,06/11/2023,Supplier Payment - CodeCraft Contractors #4,Supplier Payment,SaaS-GL,146203.26,0,USD,Wire Transfer,CodeCraft Contractors #4,***9207,,PO-202311-SaaS-GL-0006,FALSE,FALSE,REF-290311,First Continental Bank,***1661,"Globex International Holdings, Inc.",US,11312742.65
06/11/2023,06/11/2023,Client Receipt - ShopSphere Partner #63,Sales Receipt,Retail-NA,0,313811.03,USD,Fedwire Credit,ShopSphere Partner #63,***1064,INV-202311-Retail-NA-0012,,FALSE,FALSE,REF-300097,First Continental Bank,***8594,"Globex International Holdings, Inc.",US,11626553.68
07/11/2023,07/11/2023,Supplier Payment - CodeCraft Contractors #14,Supplier Payment,SaaS-GL,4913.88,0,USD,Wire Transfer,CodeCraft Contractors #14,***8007,,PO-202311-SaaS-GL-0005,FALSE,FALSE,REF-515498,First Continental Bank,***4547,"Globex International Holdings, Inc.",US,11621639.8
07/11/2023,07/11/2023,Client Receipt - CloudBridge Co. #34,Sales Receipt,SaaS-GL,0,75171.03,USD,Fedwire Credit,CloudBridge Co. #34,***9054,INV-202311-SaaS-GL-0012,,FALSE,FALSE,REF-900724,First Continental Bank,***1995,"Globex International Holdings, Inc.",US,11696810.83
07/11/2023,07/11/2023,Client Receipt - Vertex Advisory Client #15,Sales Receipt,PS-GL,0,160718.58,USD,ACH Credit,Vertex Advisory Client #15,***3461,INV-202311-PS-GL-0002,,FALSE,FALSE,REF-447576,First Continental Bank,***5992,"Globex International Holdings, Inc.",US,11857529.41
07/11/2023,07/11/2023,Client Receipt - ShopSphere Partner #35,Sales Receipt,Retail-NA,0,171490.11,USD,Card Settlement,ShopSphere Partner #35,***1274,INV-202311-Retail-NA-0016,,FALSE,FALSE,REF-980824,First Continental Bank,***9403,"Globex International Holdings, Inc.",US,12029019.52
07/11/2023,07/11/2023,Client Receipt - ShopSphere Partner #47,Sales Receipt,Retail-NA,0,283850.51,USD,Fedwire Credit,ShopSphere Partner #47,***2257,INV-202311-Retail-NA-0013,,FALSE,FALSE,REF-183984,First Continental Bank,***4727,"Globex International Holdings, Inc.",US,12312870.03
08/11/2023,08/11/2023,Supplier Payment - CodeCraft Contractors #12,Supplier Payment,SaaS-GL,48228.33,0,USD,ACH Debit,CodeCraft Contractors #12,***3749,,PO-202311-SaaS-GL-0004,FALSE,FALSE,REF-431819,First Continental Bank,***6707,"Globex International Holdings, Inc.",US,12264641.7
08/11/2023,08/11/2023,Client Receipt - CloudBridge Co. #24,Sales Receipt,SaaS-GL,0,41788.46,USD,Fedwire Credit,CloudBridge Co. #24,***2695,INV-202311-SaaS-GL-0011,,FALSE,FALSE,REF-404545,First Continental Bank,***9250,"Globex International Holdings, Inc.",US,12306430.16
08/11/2023,08/11/2023,Client Receipt - CloudBridge Co. #13,Sales Receipt,SaaS-GL,0,60292.25,USD,ACH Credit,CloudBridge Co. #13,***8339,INV-202311-SaaS-GL-0013,,FALSE,FALSE,REF-375351,First Continental Bank,***9023,"Globex International Holdings, Inc.",US,12366722.41
08/11/2023,08/11/2023,Client Receipt - ShopSphere Partner #15,Sales Receipt,Retail-NA,0,61372.46,USD,Fedwire Credit,ShopSphere Partner #15,***4853,INV-202311-Retail-NA-0011,,FALSE,FALSE,REF-951649,First Continental Bank,***7809,"Globex International Holdings, Inc.",US,12428094.87
09/11/2023,09/11/2023,Supplier Payment - ExpertNet Subcontractors #19,Supplier Payment,PS-GL,5888.08,0,USD,Wire Transfer,ExpertNet Subcontractors #19,***3552,,PO-202311-PS-GL-0003,FALSE,FALSE,REF-729872,First Continental Bank,***5352,"Globex International Holdings, Inc.",US,12422206.79
09/11/2023,09/11/2023,Client Receipt - ShopSphere Partner #46,Sales Receipt,Retail-NA,0,4613.04,USD,Card Settlement,ShopSphere Partner #46,***1728,INV-202311-Retail-NA-0015,,FALSE,FALSE,REF-894681,First Continental Bank,***2866,"Globex International Holdings, Inc.",US,12426819.83
09/11/2023,09/11/2023,Client Receipt - CloudBridge Co. #69,Sales Receipt,SaaS-GL,0,7254.59,USD,Fedwire Credit,CloudBridge Co. #69,***2995,INV-202311-SaaS-GL-0009,,FALSE,FALSE,REF-496144,First Continental Bank,***9337,"Globex International Holdings, Inc.",US,12434074.42
09/11/2023,09/11/2023,Client Receipt - ShopSphere Partner #10,Sales Receipt,Retail-NA,0,49237.69,USD,Card Settlement,ShopSphere Partner #10,***3633,INV-202311-Retail-NA-0007,,FALSE,FALSE,REF-837720,First Continental Bank,***1360,"Globex International Holdings, Inc.",US,12483312.11
10/11/2023,10/11/2023,Supplier Payment - ExpertNet Subcontractors #5,Supplier Payment,PS-GL,17077.18,0,USD,Fedwire,ExpertNet Subcontractors #5,***8779,,PO-202311-PS-GL-0009,FALSE,FALSE,REF-121524,First Continental Bank,***8839,"Globex International Holdings, Inc.",US,12466234.93
10/11/2023,10/11/2023,Client Receipt - ShopSphere Partner #41,Sales Receipt,Retail-NA,0,44817.39,USD,Fedwire Credit,ShopSphere Partner #41,***4792,INV-202311-Retail-NA-0004,,FALSE,FALSE,REF-238766,First Continental Bank,***2905,"Globex International Holdings, Inc.",US,12511052.32
10/11/2023,10/11/2023,Client Receipt - CloudBridge Co. #67,Sales Receipt,SaaS-GL,0,48150.53,USD,Card Settlement,CloudBridge Co. #67,***8300,INV-202311-SaaS-GL-0005,,FALSE,FALSE,REF-808989,First Continental Bank,***9740,"Globex International Holdings, Inc.",US,12559202.85
10/11/2023,10/11/2023,Client Receipt - Card Settlement Batch #10,Sales Receipt,Retail-NA,0,177979.09,USD,Fedwire Credit,Card Settlement Batch #10,***3463,INV-202311-Retail-NA-0003,,FALSE,FALSE,REF-776289,First Continental Bank,***7903,"Globex International Holdings, Inc.",US,12737181.94
11/11/2023,11/11/2023,Client Receipt - Card Settlement Batch #17,Sales Receipt,Retail-NA,0,79333.95,USD,Card Settlement,Card Settlement Batch #17,***4838,INV-202311-Retail-NA-0010,,FALSE,FALSE,REF-598911,First Continental Bank,***5600,"Globex International Holdings, Inc.",US,12816515.89
12/11/2023,12/11/2023,Intercompany Settlement - Globex EMEA Manufacturing Ltd.,Intercompany Transfer,ALL,822091,0,USD,Internal Transfer,Globex EMEA Manufacturing Ltd.,***8114,,,TRUE,TRUE,REF-377302,First Continental Bank,***3580,"Globex International Holdings, Inc.",US,11994424.89
12/11/2023,12/11/2023,Client Receipt - Vertex Advisory Client #22,Sales Receipt,PS-GL,0,159404.62,USD,Fedwire Credit,Vertex Advisory Client #22,***9702,INV-202311-PS-GL-0009,,FALSE,FALSE,REF-532021,First Continental Bank,***6580,"Globex International Holdings, Inc.",US,12153829.51
13/11/2023,13/11/2023,Supplier Payment - ExpertNet Subcontractors #14,Supplier Payment,PS-GL,14033.13,0,USD,Wire Transfer,ExpertNet Subcontractors #14,***2367,,PO-202311-PS-GL-0005,FALSE,FALSE,REF-863477,First Continental Bank,***2033,"Globex International Holdings, Inc.",US,12139796.38
13/11/2023,13/11/2023,Supplier Payment - PackFast Fulfillment #11,Supplier Payment,Retail-NA,48278.71,0,USD,ACH Debit,PackFast Fulfillment #11,***1313,,PO-202311-Retail-NA-0003,FALSE,FALSE,REF-298924,First Continental Bank,***5725,"Globex International Holdings, Inc.",US,12091517.67
13/11/2023,13/11/2023,Supplier Payment - ExpertNet Subcontractors #8,Supplier Payment,PS-GL,51181.43,0,USD,ACH Debit,ExpertNet Subcontractors #8,***6533,,PO-202311-PS-GL-0010,FALSE,FALSE,REF-993355,First Continental Bank,***2896,"Globex International Holdings, Inc.",US,12040336.24
13/11/2023,13/11/2023,Client Receipt - CloudBridge Co. #44,Sales Receipt,SaaS-GL,0,19771.86,USD,ACH Credit,CloudBridge Co. #44,***1876,INV-202311-SaaS-GL-0008,,FALSE,FALSE,REF-783617,First Continental Bank,***1804,"Globex International Holdings, Inc.",US,12060108.1
14/11/2023,14/11/2023,Supplier Payment - ExpertNet Subcontractors #10,Supplier Payment,PS-GL,31912.77,0,USD,Fedwire,ExpertNet Subcontractors #10,***6423,,PO-202311-PS-GL-0012,FALSE,FALSE,REF-481482,First Continental Bank,***5199,"Globex International Holdings, Inc.",US,12028195.33
14/11/2023,14/11/2023,Client Receipt - CloudBridge Co. #45,Sales Receipt,SaaS-GL,0,831.66,USD,ACH Credit,CloudBridge Co. #45,***4193,INV-202311-SaaS-GL-0015,,FALSE,FALSE,REF-894692,First Continental Bank,***7409,"Globex International Holdings, Inc.",US,12029026.99
14/11/2023,14/11/2023,Client Receipt - CloudBridge Co. #38,Sales Receipt,SaaS-GL,0,39990.93,USD,Card Settlement,CloudBridge Co. #38,***8174,INV-202311-SaaS-GL-0007,,FALSE,FALSE,REF-969942,First Continental Bank,***2138,"Globex International Holdings, Inc.",US,12069017.92
14/11/2023,14/11/2023,Client Receipt - ShopSphere Partner #3,Sales Receipt,Retail-NA,0,71288.59,USD,Fedwire Credit,ShopSphere Partner #3,***7730,INV-202311-Retail-NA-0006,,FALSE,FALSE,REF-755714,First Continental Bank,***9503,"Globex International Holdings, Inc.",US,12140306.51
14/11/2023,14/11/2023,Client Receipt - CloudBridge Co. #41,Sales Receipt,SaaS-GL,0,155992.04,USD,Fedwire Credit,CloudBridge Co. #41,***1726,INV-202311-SaaS-GL-0020,,FALSE,FALSE,REF-616129,First Continental Bank,***8687,"Globex International Holdings, Inc.",US,12296298.55
14/11/2023,14/11/2023,Client Receipt - Vertex Advisory Client #58,Sales Receipt,PS-GL,0,174068.82,USD,Fedwire Credit,Vertex Advisory Client #58,***1497,INV-202311-PS-GL-0004,,FALSE,FALSE,REF-950221,First Continental Bank,***3242,"Globex International Holdings, Inc.",US,12470367.37
15/11/2023,15/11/2023,Loan Interest Payment,Loan Interest,ALL,85000,0,USD,ACH Debit,First Continental Bank - Corporate Lending,***3894,,,FALSE,FALSE,REF-549210,First Continental Bank,***3798,"Globex International Holdings, Inc.",US,12385367.37
15/11/2023,15/11/2023,Loan Principal Repayment,Loan Principal,ALL,500000,0,USD,Fedwire,First Continental Bank - Corporate Lending,***4981,,,FALSE,FALSE,REF-580737,First Continental Bank,***2020,"Globex International Holdings, Inc.",US,11885367.37
15/11/2023,15/11/2023,Client Receipt - CloudBridge Co. #58,Sales Receipt,SaaS-GL,0,34982.11,USD,Card Settlement,CloudBridge Co. #58,***2166,INV-202311-SaaS-GL-0016,,FALSE,FALSE,REF-109665,First Continental Bank,***8113,"Globex International Holdings, Inc.",US,11920349.48
15/11/2023,15/11/2023,Client Receipt - CloudBridge Co. #1,Sales Receipt,SaaS-GL,0,63571,USD,Fedwire Credit,CloudBridge Co. #1,***4793,INV-202311-SaaS-GL-0022,,FALSE,FALSE,REF-667437,First Continental Bank,***6449,"Globex International Holdings, Inc.",US,11983920.48
16/11/2023,16/11/2023,Supplier Payment - NorthRiver Apparel Mfg #18,Supplier Payment,Retail-NA,17924.48,0,USD,Fedwire,NorthRiver Apparel Mfg #18,***1245,,PO-202311-Retail-NA-0008,FALSE,FALSE,REF-857548,First Continental Bank,***6170,"Globex International Holdings, Inc.",US,11965996
16/11/2023,16/11/2023,Client Receipt - CloudBridge Co. #17,Sales Receipt,SaaS-GL,0,4229.18,USD,Card Settlement,CloudBridge Co. #17,***7582,INV-202311-SaaS-GL-0006,,FALSE,FALSE,REF-970357,First Continental Bank,***7997,"Globex International Holdings, Inc.",US,11970225.18
16/11/2023,16/11/2023,Client Receipt - CloudBridge Co. #59,Sales Receipt,SaaS-GL,0,65982.68,USD,Fedwire Credit,CloudBridge Co. #59,***4019,INV-202311-SaaS-GL-0018,,FALSE,FALSE,REF-694242,First Continental Bank,***3396,"Globex International Holdings, Inc.",US,12036207.86
17/11/2023,17/11/2023,Client Receipt - ShopSphere Partner #53,Sales Receipt,Retail-NA,0,27515.15,USD,Card Settlement,ShopSphere Partner #53,***3352,INV-202311-Retail-NA-0014,,FALSE,FALSE,REF-815334,First Continental Bank,***2205,"Globex International Holdings, Inc.",US,12063723.01
18/11/2023,18/11/2023,Merchant Processing Fees,Bank/Merchant Fees,ALL,11198.51,0,USD,Wire Transfer,First Continental Bank,***6232,,,FALSE,FALSE,REF-271928,First Continental Bank,***1020,"Globex International Holdings, Inc.",US,12052524.5
18/11/2023,18/11/2023,VAT/GST Remittance - US IRS,Tax Payment,ALL,232200.63,0,USD,Fedwire,US IRS,***7160,,,FALSE,FALSE,REF-110543,First Continental Bank,***9885,"Globex International Holdings, Inc.",US,11820323.87
18/11/2023,18/11/2023,Client Receipt - ShopSphere Partner #20,Sales Receipt,Retail-NA,0,59671.6,USD,Card Settlement,ShopSphere Partner #20,***5958,INV-202311-Retail-NA-0009,,FALSE,FALSE,REF-479740,First Continental Bank,***2868,"Globex International Holdings, Inc.",US,11879995.47
18/11/2023,18/11/2023,Client Receipt - ShopSphere Partner #50,Sales Receipt,Retail-NA,0,140591.17,USD,Fedwire Credit,ShopSphere Partner #50,***6633,INV-202311-Retail-NA-0001,,FALSE,FALSE,REF-908260,First Continental Bank,***7252,"Globex International Holdings, Inc.",US,12020586.64
19/11/2023,19/11/2023,Supplier Payment - PackFast Fulfillment #19,Supplier Payment,Retail-NA,75291.58,0,USD,Wire Transfer,PackFast Fulfillment #19,***7754,,PO-202311-Retail-NA-0004,FALSE,FALSE,REF-563695,First Continental Bank,***7057,"Globex International Holdings, Inc.",US,11945295.06
20/11/2023,20/11/2023,Supplier Payment - NorthRiver Apparel Mfg #33,Supplier Payment,Retail-NA,26698.05,0,USD,Wire Transfer,NorthRiver Apparel Mfg #33,***8701,,PO-202311-Retail-NA-0005,FALSE,FALSE,REF-532717,First Continental Bank,***7223,"Globex International Holdings, Inc.",US,11918597.01
20/11/2023,20/11/2023,Alphagrid Utilities,Rent & Utilities,ALL,32635.71,0,USD,Fedwire,Alphagrid Utilities,***6087,,,FALSE,FALSE,REF-815721,First Continental Bank,***2412,"Globex International Holdings, Inc.",US,11885961.3
20/11/2023,20/11/2023,Client Receipt - CloudBridge Co. #48,Sales Receipt,SaaS-GL,0,20152.12,USD,Card Settlement,CloudBridge Co. #48,***1191,INV-202311-SaaS-GL-0002,,FALSE,FALSE,REF-344067,First Continental Bank,***6065,"Globex International Holdings, Inc.",US,11906113.42
20/11/2023,20/11/2023,Client Receipt - CloudBridge Co. #49,Sales Receipt,SaaS-GL,0,42731.02,USD,ACH Credit,CloudBridge Co. #49,***8195,INV-202311-SaaS-GL-0003,,FALSE,FALSE,REF-846113,First Continental Bank,***9326,"Globex International Holdings, Inc.",US,11948844.44
20/11/2023,20/11/2023,Client Receipt - Vertex Advisory Client #16,Sales Receipt,PS-GL,0,79965.64,USD,Fedwire Credit,Vertex Advisory Client #16,***9312,INV-202311-PS-GL-0008,,FALSE,FALSE,REF-392085,First Continental Bank,***1654,"Globex International Holdings, Inc.",US,12028810.08
20/11/2023,20/11/2023,Client Receipt - CloudBridge Co. #29,Sales Receipt,SaaS-GL,0,172372.56,USD,ACH Credit,CloudBridge Co. #29,***1258,INV-202311-SaaS-GL-0004,,FALSE,FALSE,REF-780495,First Continental Bank,***2967,"Globex International Holdings, Inc.",US,12201182.64
21/11/2023,21/11/2023,Supplier Payment - ExpertNet Subcontractors #5,Supplier Payment,PS-GL,9560.82,0,USD,ACH Debit,ExpertNet Subcontractors #5,***5593,,PO-202311-PS-GL-0006,FALSE,FALSE,REF-317215,First Continental Bank,***3679,"Globex International Holdings, Inc.",US,12191621.82
21/11/2023,21/11/2023,Supplier Payment - CodeCraft Contractors #1,Supplier Payment,SaaS-GL,10395.96,0,USD,Wire Transfer,CodeCraft Contractors #1,***3671,,PO-202311-SaaS-GL-0002,FALSE,FALSE,REF-825295,First Continental Bank,***2520,"Globex International Holdings, Inc.",US,12181225.86
21/11/2023,21/11/2023,Marketing - Aurelia Media #4,Marketing,ALL,21977.58,0,USD,ACH Debit,Aurelia Media #4,***8351,,,FALSE,FALSE,REF-751266,First Continental Bank,***4792,"Globex International Holdings, Inc.",US,12159248.28
22/11/2023,22/11/2023,Client Receipt - CloudBridge Co. #53,Sales Receipt,SaaS-GL,0,119669.31,USD,ACH Credit,CloudBridge Co. #53,***2350,INV-202311-SaaS-GL-0017,,FALSE,FALSE,REF-661514,First Continental Bank,***9203,"Globex International Holdings, Inc.",US,12278917.59
24/11/2023,24/11/2023,Supplier Payment - ExpertNet Subcontractors #4,Supplier Payment,PS-GL,8265.36,0,USD,Fedwire,ExpertNet Subcontractors #4,***1257,,PO-202311-PS-GL-0002,FALSE,FALSE,REF-993190,First Continental Bank,***1231,"Globex International Holdings, Inc.",US,12270652.23
24/11/2023,24/11/2023,Marketing - Aurelia Media #3,Marketing,ALL,52112.07,0,USD,Fedwire,Aurelia Media #3,***1404,,,FALSE,FALSE,REF-313748,First Continental Bank,***4491,"Globex International Holdings, Inc.",US,12218540.16
24/11/2023,24/11/2023,Client Receipt - Vertex Advisory Client #9,Sales Receipt,PS-GL,0,23277.6,USD,Fedwire Credit,Vertex Advisory Client #9,***5160,INV-202311-PS-GL-0006,,FALSE,FALSE,REF-280983,First Continental Bank,***2078,"Globex International Holdings, Inc.",US,12241817.76
26/11/2023,26/11/2023,Supplier Payment - ExpertNet Subcontractors #19,Supplier Payment,PS-GL,47584.22,0,USD,Fedwire,ExpertNet Subcontractors #19,***1907,,PO-202311-PS-GL-0004,FALSE,FALSE,REF-401393,First Continental Bank,***9040,"Globex International Holdings, Inc.",US,12194233.54
26/11/2023,26/11/2023,Intercompany Settlement - Globex Consulting UK Ltd.,Intercompany Transfer,ALL,605949,0,USD,Internal Transfer,Globex Consulting UK Ltd.,***9124,,,TRUE,TRUE,REF-358488,First Continental Bank,***7467,"Globex International Holdings, Inc.",US,11588284.54
26/11/2023,26/11/2023,Payroll - GlobalPay Services Ltd,Payroll,ALL,640121.58,0,USD,Wire Transfer,GlobalPay Services Ltd,***4463,,,FALSE,FALSE,REF-665493,First Continental Bank,***4126,"Globex International Holdings, Inc.",US,10948162.96
27/11/2023,27/11/2023,Supplier Payment - CodeCraft Contractors #12,Supplier Payment,SaaS-GL,26018.4,0,USD,Fedwire,CodeCraft Contractors #12,***5466,,PO-202311-SaaS-GL-0001,FALSE,FALSE,REF-435845,First Continental Bank,***5516,"Globex International Holdings, Inc.",US,10922144.56
27/11/2023,27/11/2023,Supplier Payment - ExpertNet Subcontractors #11,Supplier Payment,PS-GL,29806.86,0,USD,Fedwire,ExpertNet Subcontractors #11,***7210,,PO-202311-PS-GL-0011,FALSE,FALSE,REF-781737,First Continental Bank,***7135,"Globex International Holdings, Inc.",US,10892337.7
27/11/2023,27/11/2023,Client Receipt - Vertex Advisory Client #57,Sales Receipt,PS-GL,0,8780.31,USD,Fedwire Credit,Vertex Advisory Client #57,***6646,INV-202311-PS-GL-0005,,FALSE,FALSE,REF-853941,First Continental Bank,***5052,"Globex International Holdings, Inc.",US,10901118.01
27/11/2023,27/11/2023,Client Receipt - ShopSphere Partner #59,Sales Receipt,Retail-NA,0,131180.03,USD,Fedwire Credit,ShopSphere Partner #59,***2330,INV-202311-Retail-NA-0008,,FALSE,FALSE,REF-348330,First Continental Bank,***1354,"Globex International Holdings, Inc.",US,11032298.04
28/11/2023,28/11/2023,Supplier Payment - ExpertNet Subcontractors #17,Supplier Payment,PS-GL,17836.76,0,USD,Fedwire,ExpertNet Subcontractors #17,***9928,,PO-202311-PS-GL-0007,FALSE,FALSE,REF-466091,First Continental Bank,***5807,"Globex International Holdings, Inc.",US,11014461.28
28/11/2023,28/11/2023,Marketing - Beacon Digital #7,Marketing,ALL,27326.86,0,USD,Wire Transfer,Beacon Digital #7,***7900,,,FALSE,FALSE,REF-473976,First Continental Bank,***2219,"Globex International Holdings, Inc.",US,10987134.42
28/11/2023,28/11/2023,Supplier Payment - ExpertNet Subcontractors #3,Supplier Payment,PS-GL,39150.85,0,USD,Fedwire,ExpertNet Subcontractors #3,***1142,,PO-202311-PS-GL-0008,FALSE,FALSE,REF-269551,First Continental Bank,***5747,"Globex International Holdings, Inc.",US,10947983.57
29/11/2023,29/11/2023,Supplier Payment - HyperCloud Infra #9,Supplier Payment,SaaS-GL,33183.01,0,USD,Wire Transfer,HyperCloud Infra #9,***2571,,PO-202311-SaaS-GL-0007,FALSE,FALSE,REF-147195,First Continental Bank,***5586,"Globex International Holdings, Inc.",US,10914800.56
29/11/2023,29/11/2023,Client Receipt - Vertex Advisory Client #22,Sales Receipt,PS-GL,0,157464.73,USD,ACH Credit,Vertex Advisory Client #22,***2272,INV-202311-PS-GL-0003,,FALSE,FALSE,REF-438145,First Continental Bank,***6198,"Globex International Holdings, Inc.",US,11072265.29
30/11/2023,30/11/2023,Merchant Processing Fees,Bank/Merchant Fees,ALL,886.2,0,USD,Fedwire,First Continental Bank,***6910,,,FALSE,FALSE,REF-504285,First Continental Bank,***9942,"Globex International Holdings, Inc.",US,11071379.09
30/11/2023,30/11/2023,Supplier Payment - CodeCraft Contractors #10,Supplier Payment,SaaS-GL,27964.41,0,USD,ACH Debit,CodeCraft Contractors #10,***9685,,PO-202311-SaaS-GL-0009,FALSE,FALSE,REF-518978,First Continental Bank,***3927,"Globex International Holdings, Inc.",US,11043414.68
30/11/2023,30/11/2023,Supplier Payment - NorthRiver Apparel Mfg #3,Supplier Payment,Retail-NA,263393.67,0,USD,Wire Transfer,NorthRiver Apparel Mfg #3,***8575,,PO-202311-Retail-NA-0002,FALSE,FALSE,REF-223355,First Continental Bank,***3351,"Globex International Holdings, Inc.",US,10780021.01
30/11/2023,30/11/2023,Interest Earned,Interest Income,ALL,0,10526.16,USD,Card Settlement,First Continental Bank,***2889,,,FALSE,FALSE,REF-205967,First Continental Bank,***1071,"Globex International Holdings, Inc.",US,10790547.17
01/12/2023,01/12/2023,Account Maintenance Fee,Bank/Merchant Fees,ALL,2500,0,USD,Fedwire,First Continental Bank,***1723,,,FALSE,FALSE,REF-397560,First Continental Bank,***3757,"Globex International Holdings, Inc.",US,10788047.17
01/12/2023,01/12/2023,Supplier Payment - PackFast Fulfillment #2,Supplier Payment,Retail-NA,61947.8,0,USD,Fedwire,PackFast Fulfillment #2,***1970,,PO-202312-Retail-NA-0005,FALSE,FALSE,REF-446704,First Continental Bank,***4029,"Globex International Holdings, Inc.",US,10726099.37
01/12/2023,01/12/2023,Supplier Payment - NorthRiver Apparel Mfg #27,Supplier Payment,Retail-NA,195123.9,0,USD,ACH Debit,NorthRiver Apparel Mfg #27,***1887,,PO-202312-Retail-NA-0010,FALSE,FALSE,REF-301601,First Continental Bank,***6296,"Globex International Holdings, Inc.",US,10530975.47
01/12/2023,01/12/2023,Client Receipt - Vertex Advisory Client #45,Sales Receipt,PS-GL,0,201526.69,USD,ACH Credit,Vertex Advisory Client #45,***8016,INV-202312-PS-GL-0010,,FALSE,FALSE,REF-942420,First Continental Bank,***2563,"Globex International Holdings, Inc.",US,10732502.16
02/12/2023,02/12/2023,Supplier Payment - NorthRiver Apparel Mfg #2,Supplier Payment,Retail-NA,157717.82,0,USD,Fedwire,NorthRiver Apparel Mfg #2,***9164,,PO-202312-Retail-NA-0012,FALSE,FALSE,REF-736943,First Continental Bank,***6118,"Globex International Holdings, Inc.",US,10574784.34
03/12/2023,03/12/2023,BluePeak Property Mgmt,Rent & Utilities,ALL,23484.89,0,USD,Fedwire,BluePeak Property Mgmt,***2417,,,FALSE,FALSE,REF-158354,First Continental Bank,***9464,"Globex International Holdings, Inc.",US,10551299.45
04/12/2023,04/12/2023,Supplier Payment - CodeCraft Contractors #5,Supplier Payment,SaaS-GL,23168.45,0,USD,ACH Debit,CodeCraft Contractors #5,***9122,,PO-202312-SaaS-GL-0006,FALSE,FALSE,REF-379756,First Continental Bank,***7567,"Globex International Holdings, Inc.",US,10528131
04/12/2023,04/12/2023,Marketing - Beacon Digital #5,Marketing,ALL,57076.44,0,USD,Wire Transfer,Beacon Digital #5,***9615,,,FALSE,FALSE,REF-154466,First Continental Bank,***8714,"Globex International Holdings, Inc.",US,10471054.56
04/12/2023,04/12/2023,Supplier Payment - CodeCraft Contractors #3,Supplier Payment,SaaS-GL,108152.21,0,USD,Fedwire,CodeCraft Contractors #3,***7335,,PO-202312-SaaS-GL-0007,FALSE,FALSE,REF-633140,First Continental Bank,***1127,"Globex International Holdings, Inc.",US,10362902.35
04/12/2023,04/12/2023,Client Receipt - CloudBridge Co. #63,Sales Receipt,SaaS-GL,0,13416.24,USD,Card Settlement,CloudBridge Co. #63,***5892,INV-202312-SaaS-GL-0023,,FALSE,FALSE,REF-587040,First Continental Bank,***9852,"Globex International Holdings, Inc.",US,10376318.59
05/12/2023,05/12/2023,Client Receipt - CloudBridge Co. #19,Sales Receipt,SaaS-GL,0,38183.6,USD,Fedwire Credit,CloudBridge Co. #19,***7335,INV-202312-SaaS-GL-0003,,FALSE,FALSE,REF-754839,First Continental Bank,***6448,"Globex International Holdings, Inc.",US,10414502.19
05/12/2023,05/12/2023,Client Receipt - CloudBridge Co. #56,Sales Receipt,SaaS-GL,0,44498.13,USD,Card Settlement,CloudBridge Co. #56,***4813,INV-202312-SaaS-GL-0024,,FALSE,FALSE,REF-964962,First Continental Bank,***5931,"Globex International Holdings, Inc.",US,10459000.32
05/12/2023,05/12/2023,Client Receipt - Card Settlement Batch #23,Sales Receipt,Retail-NA,0,74931.7,USD,Card Settlement,Card Settlement Batch #23,***5955,INV-202312-Retail-NA-0011,,FALSE,FALSE,REF-366667,First Continental Bank,***4512,"Globex International Holdings, Inc.",US,10533932.02
06/12/2023,06/12/2023,Supplier Payment - HyperCloud Infra #2,Supplier Payment,SaaS-GL,17725.12,0,USD,Wire Transfer,HyperCloud Infra #2,***5938,,PO-202312-SaaS-GL-0004,FALSE,FALSE,REF-337609,First Continental Bank,***5812,"Globex International Holdings, Inc.",US,10516206.9
06/12/2023,06/12/2023,Marketing - Beacon Digital #4,Marketing,ALL,33016.27,0,USD,ACH Debit,Beacon Digital #4,***5172,,,FALSE,FALSE,REF-537889,First Continental Bank,***3670,"Globex International Holdings, Inc.",US,10483190.63
06/12/2023,06/12/2023,Client Receipt - CloudBridge Co. #9,Sales Receipt,SaaS-GL,0,54900.46,USD,ACH Credit,CloudBridge Co. #9,***1642,INV-202312-SaaS-GL-0016,,FALSE,FALSE,REF-209644,First Continental Bank,***9274,"Globex International Holdings, Inc.",US,10538091.09
06/12/2023,06/12/2023,Client Receipt - CloudBridge Co. #56,Sales Receipt,SaaS-GL,0,63636.71,USD,Fedwire Credit,CloudBridge Co. #56,***4936,INV-202312-SaaS-GL-0006,,FALSE,FALSE,REF-370236,First Continental Bank,***1433,"Globex International Holdings, Inc.",US,10601727.8
06/12/2023,06/12/2023,Client Receipt - CloudBridge Co. #38,Sales Receipt,SaaS-GL,0,82590.6,USD,Fedwire Credit,CloudBridge Co. #38,***1258,INV-202312-SaaS-GL-0013,,FALSE,FALSE,REF-710239,First Continental Bank,***9280,"Globex International Holdings, Inc.",US,10684318.4
07/12/2023,07/12/2023,Supplier Payment - ExpertNet Subcontractors #14,Supplier Payment,PS-GL,7679.3,0,USD,ACH Debit,ExpertNet Subcontractors #14,***2261,,PO-202312-PS-GL-0007,FALSE,FALSE,REF-159254,First Continental Bank,***5276,"Globex International Holdings, Inc.",US,10676639.1
07/12/2023,07/12/2023,Supplier Payment - ExpertNet Subcontractors #4,Supplier Payment,PS-GL,9295.72,0,USD,Wire Transfer,ExpertNet Subcontractors #4,***4953,,PO-202312-PS-GL-0005,FALSE,FALSE,REF-295546,First Continental Bank,***6909,"Globex International Holdings, Inc.",US,10667343.38
08/12/2023,08/12/2023,Client Receipt - CloudBridge Co. #22,Sales Receipt,SaaS-GL,0,13538.62,USD,Fedwire Credit,CloudBridge Co. #22,***5107,INV-202312-SaaS-GL-0015,,FALSE,FALSE,REF-175195,First Continental Bank,***9524,"Globex International Holdings, Inc.",US,10680882
09/12/2023,09/12/2023,Client Receipt - ShopSphere Partner #2,Sales Receipt,Retail-NA,0,100748.32,USD,ACH Credit,ShopSphere Partner #2,***4212,INV-202312-Retail-NA-0008,,FALSE,FALSE,REF-310491,First Continental Bank,***9267,"Globex International Holdings, Inc.",US,10781630.32
10/12/2023,10/12/2023,Client Receipt - CloudBridge Co. #60,Sales Receipt,SaaS-GL,0,16539.82,USD,ACH Credit,CloudBridge Co. #60,***2625,INV-202312-SaaS-GL-0007,,FALSE,FALSE,REF-160426,First Continental Bank,***1430,"Globex International Holdings, Inc.",US,10798170.14
10/12/2023,10/12/2023,Client Receipt - CloudBridge Co. #70,Sales Receipt,SaaS-GL,0,22588.08,USD,Card Settlement,CloudBridge Co. #70,***4325,INV-202312-SaaS-GL-0011,,FALSE,FALSE,REF-179646,First Continental Bank,***4992,"Globex International Holdings, Inc.",US,10820758.22
10/12/2023,10/12/2023,Client Receipt - CloudBridge Co. #70,Sales Receipt,SaaS-GL,0,85008.25,USD,Fedwire Credit,CloudBridge Co. #70,***1922,INV-202312-SaaS-GL-0025,,FALSE,FALSE,REF-464109,First Continental Bank,***5823,"Globex International Holdings, Inc.",US,10905766.47
11/12/2023,11/12/2023,Supplier Payment - ExpertNet Subcontractors #7,Supplier Payment,PS-GL,3596.95,0,USD,ACH Debit,ExpertNet Subcontractors #7,***7881,,PO-202312-PS-GL-0009,FALSE,FALSE,REF-234571,First Continental Bank,***1627,"Globex International Holdings, Inc.",US,10902169.52
11/12/2023,11/12/2023,Merchant Processing Fees,Bank/Merchant Fees,ALL,3609.01,0,USD,Fedwire,First Continental Bank,***6889,,,FALSE,FALSE,REF-803915,First Continental Bank,***7391,"Globex International Holdings, Inc.",US,10898560.51
11/12/2023,11/12/2023,Supplier Payment - ExpertNet Subcontractors #4,Supplier Payment,PS-GL,96245.06,0,USD,Wire Transfer,ExpertNet Subcontractors #4,***1453,,PO-202312-PS-GL-0003,FALSE,FALSE,REF-639715,First Continental Bank,***5081,"Globex International Holdings, Inc.",US,10802315.45
11/12/2023,11/12/2023,Client Receipt - Vertex Advisory Client #17,Sales Receipt,PS-GL,0,13683.07,USD,Card Settlement,Vertex Advisory Client #17,***9562,INV-202312-PS-GL-0008,,FALSE,FALSE,REF-242802,First Continental Bank,***3499,"Globex International Holdings, Inc.",US,10815998.52
11/12/2023,11/12/2023,Client Receipt - CloudBridge Co. #13,Sales Receipt,SaaS-GL,0,21245.77,USD,Fedwire Credit,CloudBridge Co. #13,***3742,INV-202312-SaaS-GL-0019,,FALSE,FALSE,REF-329294,First Continental Bank,***8987,"Globex International Holdings, Inc.",US,10837244.29
11/12/2023,11/12/2023,Client Receipt - CloudBridge Co. #64,Sales Receipt,SaaS-GL,0,23305.52,USD,Card Settlement,CloudBridge Co. #64,***1034,INV-202312-SaaS-GL-0020,,FALSE,FALSE,REF-938144,First Continental Bank,***3868,"Globex International Holdings, Inc.",US,10860549.81
11/12/2023,11/12/2023,Client Receipt - Vertex Advisory Client #5,Sales Receipt,PS-GL,0,174699.09,USD,Fedwire Credit,Vertex Advisory Client #5,***2089,INV-202312-PS-GL-0004,,FALSE,FALSE,REF-560937,First Continental Bank,***3549,"Globex International Holdings, Inc.",US,11035248.9
12/12/2023,12/12/2023,Supplier Payment - ExpertNet Subcontractors #8,Supplier Payment,PS-GL,8273.88,0,USD,Wire Transfer,ExpertNet Subcontractors #8,***2775,,PO-202312-PS-GL-0011,FALSE,FALSE,REF-584995,First Continental Bank,***7782,"Globex International Holdings, Inc.",US,11026975.02
12/12/2023,12/12/2023,Supplier Payment - ExpertNet Subcontractors #10,Supplier Payment,PS-GL,32080.97,0,USD,Wire Transfer,ExpertNet Subcontractors #10,***6902,,PO-202312-PS-GL-0006,FALSE,FALSE,REF-256588,First Continental Bank,***9164,"Globex International Holdings, Inc.",US,10994894.05
12/12/2023,12/12/2023,Intercompany Settlement - Globex Retail NA LLC,Intercompany Transfer,ALL,421903,0,USD,Internal Transfer,Globex Retail NA LLC,***6620,,,TRUE,TRUE,REF-648689,First Continental Bank,***1855,"Globex International Holdings, Inc.",US,10572991.05
12/12/2023,12/12/2023,Client Receipt - CloudBridge Co. #69,Sales Receipt,SaaS-GL,0,32326.27,USD,ACH Credit,CloudBridge Co. #69,***6361,INV-202312-SaaS-GL-0004,,FALSE,FALSE,REF-640185,First Continental Bank,***5808,"Globex International Holdings, Inc.",US,10605317.32
12/12/2023,12/12/2023,Intercompany Reimbursement - Globex Retail NA LLC,Intercompany Transfer,ALL,0,168761.2,USD,Internal Transfer,Globex Retail NA LLC,***3265,,,TRUE,TRUE,REF-181906,First Continental Bank,***4020,"Globex International Holdings, Inc.",US,10774078.52
12/12/2023,12/12/2023,Client Receipt - Card Settlement Batch #16,Sales Receipt,Retail-NA,0,175483.83,USD,ACH Credit,Card Settlement Batch #16,***7294,INV-202312-Retail-NA-0010,,FALSE,FALSE,REF-954595,First Continental Bank,***3874,"Globex International Holdings, Inc.",US,10949562.35
13/12/2023,13/12/2023,Supplier Payment - CodeCraft Contractors #9,Supplier Payment,SaaS-GL,7694.28,0,USD,Fedwire,CodeCraft Contractors #9,***8656,,PO-202312-SaaS-GL-0009,FALSE,FALSE,REF-334777,First Continental Bank,***3763,"Globex International Holdings, Inc.",US,10941868.07
13/12/2023,13/12/2023,Client Receipt - ShopSphere Partner #31,Sales Receipt,Retail-NA,0,9657.78,USD,Card Settlement,ShopSphere Partner #31,***9675,INV-202312-Retail-NA-0003,,FALSE,FALSE,REF-188479,First Continental Bank,***2170,"Globex International Holdings, Inc.",US,10951525.85
13/12/2023,13/12/2023,Client Receipt - ShopSphere Partner #68,Sales Receipt,Retail-NA,0,119732.33,USD,ACH Credit,ShopSphere Partner #68,***3077,INV-202312-Retail-NA-0004,,FALSE,FALSE,REF-708664,First Continental Bank,***5854,"Globex International Holdings, Inc.",US,11071258.18
14/12/2023,14/12/2023,Supplier Payment - ExpertNet Subcontractors #7,Supplier Payment,PS-GL,6073.36,0,USD,Wire Transfer,ExpertNet Subcontractors #7,***6437,,PO-202312-PS-GL-0001,FALSE,FALSE,REF-199691,First Continental Bank,***3309,"Globex International Holdings, Inc.",US,11065184.82
14/12/2023,14/12/2023,Client Receipt - Vertex Advisory Client #41,Sales Receipt,PS-GL,0,16506.03,USD,ACH Credit,Vertex Advisory Client #41,***3424,INV-202312-PS-GL-0005,,FALSE,FALSE,REF-490654,First Continental Bank,***3449,"Globex International Holdings, Inc.",US,11081690.85
14/12/2023,14/12/2023,Client Receipt - CloudBridge Co. #17,Sales Receipt,SaaS-GL,0,41641.31,USD,Fedwire Credit,CloudBridge Co. #17,***3385,INV-202312-SaaS-GL-0022,,FALSE,FALSE,REF-437846,First Continental Bank,***9225,"Globex International Holdings, Inc.",US,11123332.16
14/12/2023,14/12/2023,Client Receipt - Vertex Advisory Client #24,Sales Receipt,PS-GL,0,47514.85,USD,Card Settlement,Vertex Advisory Client #24,***9008,INV-202312-PS-GL-0002,,FALSE,FALSE,REF-585005,First Continental Bank,***9351,"Globex International Holdings, Inc.",US,11170847.01
14/12/2023,14/12/2023,Client Receipt - CloudBridge Co. #61,Sales Receipt,SaaS-GL,0,67940.05,USD,Fedwire Credit,CloudBridge Co. #61,***1969,INV-202312-SaaS-GL-0014,,FALSE,FALSE,REF-654419,First Continental Bank,***5353,"Globex International Holdings, Inc.",US,11238787.06
14/12/2023,14/12/2023,Client Receipt - CloudBridge Co. #34,Sales Receipt,SaaS-GL,0,84033.06,USD,Fedwire Credit,CloudBridge Co. #34,***1318,INV-202312-SaaS-GL-0010,,FALSE,FALSE,REF-105995,First Continental Bank,***9512,"Globex International Holdings, Inc.",US,11322820.12
14/12/2023,14/12/2023,Client Receipt - ShopSphere Partner #20,Sales Receipt,Retail-NA,0,164155.22,USD,Card Settlement,ShopSphere Partner #20,***3933,INV-202312-Retail-NA-0006,,FALSE,FALSE,REF-330430,First Continental Bank,***2904,"Globex International Holdings, Inc.",US,11486975.34
15/12/2023,15/12/2023,Loan Interest Payment,Loan Interest,ALL,85000,0,USD,Wire Transfer,First Continental Bank - Corporate Lending,***5121,,,FALSE,FALSE,REF-197015,First Continental Bank,***3735,"Globex International Holdings, Inc.",US,11401975.34
15/12/2023,15/12/2023,Loan Principal Repayment,Loan Principal,ALL,500000,0,USD,Wire Transfer,First Continental Bank - Corporate Lending,***1209,,,FALSE,FALSE,REF-383449,First Continental Bank,***7043,"Globex International Holdings, Inc.",US,10901975.34
15/12/2023,15/12/2023,Client Receipt - Vertex Advisory Client #29,Sales Receipt,PS-GL,0,70698.45,USD,Card Settlement,Vertex Advisory Client #29,***7787,INV-202312-PS-GL-0001,,FALSE,FALSE,REF-721576,First Continental Bank,***8376,"Globex International Holdings, Inc.",US,10972673.79
15/12/2023,15/12/2023,Client Receipt - CloudBridge Co. #14,Sales Receipt,SaaS-GL,0,113598.97,USD,ACH Credit,CloudBridge Co. #14,***4845,INV-202312-SaaS-GL-0012,,FALSE,FALSE,REF-176740,First Continental Bank,***1440,"Globex International Holdings, Inc.",US,11086272.76
17/12/2023,17/12/2023,Supplier Payment - CodeCraft Contractors #1,Supplier Payment,SaaS-GL,16225.33,0,USD,ACH Debit,CodeCraft Contractors #1,***3456,,PO-202312-SaaS-GL-0005,FALSE,FALSE,REF-454976,First Continental Bank,***3956,"Globex International Holdings, Inc.",US,11070047.43
18/12/2023,18/12/2023,Client Receipt - Vertex Advisory Client #6,Sales Receipt,PS-GL,0,12593.4,USD,Card Settlement,Vertex Advisory Client #6,***1042,INV-202312-PS-GL-0007,,FALSE,FALSE,REF-787756,First Continental Bank,***6585,"Globex International Holdings, Inc.",US,11082640.83
18/12/2023,18/12/2023,Client Receipt - Vertex Advisory Client #34,Sales Receipt,PS-GL,0,38538.77,USD,Card Settlement,Vertex Advisory Client #34,***6384,INV-202312-PS-GL-0009,,FALSE,FALSE,REF-617662,First Continental Bank,***1460,"Globex International Holdings, Inc.",US,11121179.6
19/12/2023,19/12/2023,Supplier Payment - CodeCraft Contractors #1,Supplier Payment,SaaS-GL,3960.11,0,USD,ACH Debit,CodeCraft Contractors #1,***1052,,PO-202312-SaaS-GL-0001,FALSE,FALSE,REF-718334,First Continental Bank,***3986,"Globex International Holdings, Inc.",US,11117219.49
19/12/2023,19/12/2023,Supplier Payment - CodeCraft Contractors #7,Supplier Payment,SaaS-GL,8092.02,0,USD,ACH Debit,CodeCraft Contractors #7,***2553,,PO-202312-SaaS-GL-0002,FALSE,FALSE,REF-703969,First Continental Bank,***9268,"Globex International Holdings, Inc.",US,11109127.47
19/12/2023,19/12/2023,Supplier Payment - ExpertNet Subcontractors #5,Supplier Payment,PS-GL,19411.9,0,USD,ACH Debit,ExpertNet Subcontractors #5,***7646,,PO-202312-PS-GL-0008,FALSE,FALSE,REF-966334,First Continental Bank,***2189,"Globex International Holdings, Inc.",US,11089715.57
19/12/2023,19/12/2023,Supplier Payment - HyperCloud Infra #17,Supplier Payment,SaaS-GL,68076.76,0,USD,Fedwire,HyperCloud Infra #17,***3878,,PO-202312-SaaS-GL-0003,FALSE,FALSE,REF-686504,First Continental Bank,***1532,"Globex International Holdings, Inc.",US,11021638.81
19/12/2023,19/12/2023,Supplier Payment - CodeCraft Contractors #8,Supplier Payment,SaaS-GL,93622.42,0,USD,ACH Debit,CodeCraft Contractors #8,***4478,,PO-202312-SaaS-GL-0008,FALSE,FALSE,REF-476901,First Continental Bank,***6646,"Globex International Holdings, Inc.",US,10928016.39
19/12/2023,19/12/2023,Supplier Payment - PackFast Fulfillment #16,Supplier Payment,Retail-NA,205009.93,0,USD,ACH Debit,PackFast Fulfillment #16,***8133,,PO-202312-Retail-NA-0007,FALSE,FALSE,REF-462131,First Continental Bank,***9483,"Globex International Holdings, Inc.",US,10723006.46
19/12/2023,19/12/2023,VAT/GST Remittance - US IRS,Tax Payment,ALL,271925.25,0,USD,ACH Debit,US IRS,***4563,,,FALSE,FALSE,REF-925994,First Continental Bank,***9613,"Globex International Holdings, Inc.",US,10451081.21
19/12/2023,19/12/2023,Client Receipt - ShopSphere Partner #5,Sales Receipt,Retail-NA,0,50850.59,USD,ACH Credit,ShopSphere Partner #5,***3805,INV-202312-Retail-NA-0012,,FALSE,FALSE,REF-918548,First Continental Bank,***6410,"Globex International Holdings, Inc.",US,10501931.8
19/12/2023,19/12/2023,Client Receipt - Vertex Advisory Client #1,Sales Receipt,PS-GL,0,196232.71,USD,ACH Credit,Vertex Advisory Client #1,***7355,INV-202312-PS-GL-0011,,FALSE,FALSE,REF-333091,First Continental Bank,***5871,"Globex International Holdings, Inc.",US,10698164.51
20/12/2023,20/12/2023,Merchant Processing Fees,Bank/Merchant Fees,ALL,10054.9,0,USD,ACH Debit,First Continental Bank,***9483,,,FALSE,FALSE,REF-582699,First Continental Bank,***8266,"Globex International Holdings, Inc.",US,10688109.61
20/12/2023,20/12/2023,Supplier Payment - ExpertNet Subcontractors #15,Supplier Payment,PS-GL,40577.55,0,USD,Fedwire,ExpertNet Subcontractors #15,***8483,,PO-202312-PS-GL-0002,FALSE,FALSE,REF-912063,First Continental Bank,***5703,"Globex International Holdings, Inc.",US,10647532.06
20/12/2023,20/12/2023,Client Receipt - CloudBridge Co. #50,Sales Receipt,SaaS-GL,0,405.59,USD,ACH Credit,CloudBridge Co. #50,***5078,INV-202312-SaaS-GL-0026,,FALSE,FALSE,REF-234536,First Continental Bank,***6404,"Globex International Holdings, Inc.",US,10647937.65
20/12/2023,20/12/2023,Client Receipt - CloudBridge Co. #35,Sales Receipt,SaaS-GL,0,156515.95,USD,Fedwire Credit,CloudBridge Co. #35,***8016,INV-202312-SaaS-GL-0018,,FALSE,FALSE,REF-596642,First Continental Bank,***6778,"Globex International Holdings, Inc.",US,10804453.6
21/12/2023,21/12/2023,Client Receipt - CloudBridge Co. #2,Sales Receipt,SaaS-GL,0,61602.17,USD,Card Settlement,CloudBridge Co. #2,***2430,INV-202312-SaaS-GL-0008,,FALSE,FALSE,REF-591834,First Continental Bank,***7021,"Globex International Holdings, Inc.",US,10866055.77
22/12/2023,22/12/2023,Supplier Payment - ExpertNet Subcontractors #14,Supplier Payment,PS-GL,27870.3,0,USD,ACH Debit,ExpertNet Subcontractors #14,***2891,,PO-202312-PS-GL-0010,FALSE,FALSE,REF-620192,First Continental Bank,***6647,"Globex International Holdings, Inc.",US,10838185.47
22/12/2023,22/12/2023,Supplier Payment - PackFast Fulfillment #16,Supplier Payment,Retail-NA,32553.8,0,USD,Wire Transfer,PackFast Fulfillment #16,***8834,,PO-202312-Retail-NA-0009,FALSE,FALSE,REF-854458,First Continental Bank,***7492,"Globex International Holdings, Inc.",US,10805631.67
22/12/2023,22/12/2023,Client Receipt - CloudBridge Co. #17,Sales Receipt,SaaS-GL,0,70762.81,USD,Card Settlement,CloudBridge Co. #17,***4218,INV-202312-SaaS-GL-0021,,FALSE,FALSE,REF-189430,First Continental Bank,***4579,"Globex International Holdings, Inc.",US,10876394.48
22/12/2023,22/12/2023,Client Receipt - ShopSphere Partner #61,Sales Receipt,Retail-NA,0,130115.85,USD,Card Settlement,ShopSphere Partner #61,***6244,INV-202312-Retail-NA-0001,,FALSE,FALSE,REF-374836,First Continental Bank,***6530,"Globex International Holdings, Inc.",US,11006510.33
22/12/2023,22/12/2023,Client Receipt - Card Settlement Batch #9,Sales Receipt,Retail-NA,0,299646.4,USD,Card Settlement,Card Settlement Batch #9,***8481,INV-202312-Retail-NA-0005,,FALSE,FALSE,REF-739051,First Continental Bank,***3428,"Globex International Holdings, Inc.",US,11306156.73
25/12/2023,25/12/2023,Client Receipt - CloudBridge Co. #4,Sales Receipt,SaaS-GL,0,3620.74,USD,Fedwire Credit,CloudBridge Co. #4,***4500,INV-202312-SaaS-GL-0001,,FALSE,FALSE,REF-696565,First Continental Bank,***9098,"Globex International Holdings, Inc.",US,11309777.47
25/12/2023,25/12/2023,Client Receipt - CloudBridge Co. #65,Sales Receipt,SaaS-GL,0,74475.68,USD,ACH Credit,CloudBridge Co. #65,***7533,INV-202312-SaaS-GL-0017,,FALSE,FALSE,REF-732388,First Continental Bank,***6915,"Globex International Holdings, Inc.",US,11384253.15
25/12/2023,25/12/2023,Client Receipt - CloudBridge Co. #61,Sales Receipt,SaaS-GL,0,87750.78,USD,Card Settlement,CloudBridge Co. #61,***9830,INV-202312-SaaS-GL-0002,,FALSE,FALSE,REF-614286,First Continental Bank,***5729,"Globex International Holdings, Inc.",US,11472003.93
26/12/2023,26/12/2023,Supplier Payment - NorthRiver Apparel Mfg #17,Supplier Payment,Retail-NA,9316.04,0,USD,Fedwire,NorthRiver Apparel Mfg #17,***5163,,PO-202312-Retail-NA-0006,FALSE,FALSE,REF-896833,First Continental Bank,***4678,"Globex International Holdings, Inc.",US,11462687.89
26/12/2023,26/12/2023,Supplier Payment - PackFast Fulfillment #11,Supplier Payment,Retail-NA,53199.92,0,USD,Fedwire,PackFast Fulfillment #11,***8454,,PO-202312-Retail-NA-0001,FALSE,FALSE,REF-183953,First Continental Bank,***7960,"Globex International Holdings, Inc.",US,11409487.97
26/12/2023,26/12/2023,Intercompany Settlement - Globex EMEA Manufacturing Ltd.,Intercompany Transfer,ALL,612784,0,USD,Internal Transfer,Globex EMEA Manufacturing Ltd.,***6991,,,TRUE,TRUE,REF-976853,First Continental Bank,***2241,"Globex International Holdings, Inc.",US,10796703.97
26/12/2023,26/12/2023,Client Receipt - CloudBridge Co. #22,Sales Receipt,SaaS-GL,0,59303.46,USD,Fedwire Credit,CloudBridge Co. #22,***6672,INV-202312-SaaS-GL-0009,,FALSE,FALSE,REF-673414,First Continental Bank,***2955,"Globex International Holdings, Inc.",US,10856007.43
26/12/2023,26/12/2023,Client Receipt - CloudBridge Co. #58,Sales Receipt,SaaS-GL,0,64367.55,USD,Fedwire Credit,CloudBridge Co. #58,***7800,INV-202312-SaaS-GL-0028,,FALSE,FALSE,REF-832766,First Continental Bank,***7763,"Globex International Holdings, Inc.",US,10920374.98
27/12/2023,27/12/2023,Supplier Payment - ExpertNet Subcontractors #2,Supplier Payment,PS-GL,14354.12,0,USD,ACH Debit,ExpertNet Subcontractors #2,***3755,,PO-202312-PS-GL-0012,FALSE,FALSE,REF-710282,First Continental Bank,***8116,"Globex International Holdings, Inc.",US,10906020.86
27/12/2023,27/12/2023,Supplier Payment - PackFast Fulfillment #16,Supplier Payment,Retail-NA,37096.86,0,USD,Wire Transfer,PackFast Fulfillment #16,***5826,,PO-202312-Retail-NA-0008,FALSE,FALSE,REF-989378,First Continental Bank,***1212,"Globex International Holdings, Inc.",US,10868924
27/12/2023,27/12/2023,Supplier Payment - ExpertNet Subcontractors #17,Supplier Payment,PS-GL,49737.89,0,USD,Wire Transfer,ExpertNet Subcontractors #17,***6086,,PO-202312-PS-GL-0004,FALSE,FALSE,REF-582387,First Continental Bank,***7557,"Globex International Holdings, Inc.",US,10819186.11
27/12/2023,27/12/2023,Client Receipt - ShopSphere Partner #60,Sales Receipt,Retail-NA,0,504208.43,USD,Card Settlement,ShopSphere Partner #60,***2094,INV-202312-Retail-NA-0007,,FALSE,FALSE,REF-913727,First Continental Bank,***2768,"Globex International Holdings, Inc.",US,11323394.54
28/12/2023,28/12/2023,Northshore Power,Rent & Utilities,ALL,13049.17,0,USD,Fedwire,Northshore Power,***6985,,,FALSE,FALSE,REF-928561,First Continental Bank,***2808,"Globex International Holdings, Inc.",US,11310345.37
28/12/2023,28/12/2023,Marketing - Aurelia Media #11,Marketing,ALL,22073.92,0,USD,Wire Transfer,Aurelia Media #11,***6612,,,FALSE,FALSE,REF-708924,First Continental Bank,***6452,"Globex International Holdings, Inc.",US,11288271.45
28/12/2023,28/12/2023,Supplier Payment - NorthRiver Apparel Mfg #33,Supplier Payment,Retail-NA,136491.91,0,USD,Fedwire,NorthRiver Apparel Mfg #33,***9468,,PO-202312-Retail-NA-0002,FALSE,FALSE,REF-308144,First Continental Bank,***4560,"Globex International Holdings, Inc.",US,11151779.54
28/12/2023,28/12/2023,Payroll - GlobalPay Services Ltd,Payroll,ALL,368884.51,0,USD,Fedwire,GlobalPay Services Ltd,***4760,,,FALSE,FALSE,REF-508839,First Continental Bank,***9257,"Globex International Holdings, Inc.",US,10782895.03
28/12/2023,28/12/2023,Client Receipt - Vertex Advisory Client #29,Sales Receipt,PS-GL,0,114409.38,USD,Fedwire Credit,Vertex Advisory Client #29,***8525,INV-202312-PS-GL-0003,,FALSE,FALSE,REF-436777,First Continental Bank,***5747,"Globex International Holdings, Inc.",US,10897304.41
29/12/2023,29/12/2023,Supplier Payment - NorthRiver Apparel Mfg #10,Supplier Payment,Retail-NA,687.79,0,USD,Wire Transfer,NorthRiver Apparel Mfg #10,***2744,,PO-202312-Retail-NA-0004,FALSE,FALSE,REF-167626,First Continental Bank,***1951,"Globex International Holdings, Inc.",US,10896616.62
29/12/2023,29/12/2023,Payroll - GlobalPay Services Ltd,Payroll,ALL,368884.51,0,USD,ACH Debit,GlobalPay Services Ltd,***5123,,,FALSE,FALSE,REF-315707,First Continental Bank,***3899,"Globex International Holdings, Inc.",US,10527732.11
29/12/2023,29/12/2023,Client Receipt - CloudBridge Co. #44,Sales Receipt,SaaS-GL,0,12925.97,USD,Fedwire Credit,CloudBridge Co. #44,***1280,INV-202312-SaaS-GL-0027,,FALSE,FALSE,REF-758707,First Continental Bank,***8562,"Globex International Holdings, Inc.",US,10540658.08
29/12/2023,29/12/2023,Client Receipt - ShopSphere Partner #5,Sales Receipt,Retail-NA,0,148813.56,USD,ACH Credit,ShopSphere Partner #5,***3262,INV-202312-Retail-NA-0009,,FALSE,FALSE,REF-119117,First Continental Bank,***6435,"Globex International Holdings, Inc.",US,10689471.64
29/12/2023,29/12/2023,Client Receipt - Vertex Advisory Client #26,Sales Receipt,PS-GL,0,164254.22,USD,ACH Credit,Vertex Advisory Client #26,***8872,INV-202312-PS-GL-0006,,FALSE,FALSE,REF-783271,First Continental Bank,***3240,"Globex International Holdings, Inc.",US,10853725.86
29/12/2023,29/12/2023,Client Receipt - CloudBridge Co. #1,Sales Receipt,SaaS-GL,0,165262.83,USD,Card Settlement,CloudBridge Co. #1,***7421,INV-202312-SaaS-GL-0005,,FALSE,FALSE,REF-405829,First Continental Bank,***7651,"Globex International Holdings, Inc.",US,11018988.69
30/12/2023,30/12/2023,Supplier Payment - NorthRiver Apparel Mfg #13,Supplier Payment,Retail-NA,88570.53,0,USD,Fedwire,NorthRiver Apparel Mfg #13,***7357,,PO-202312-Retail-NA-0003,FALSE,FALSE,REF-602487,First Continental Bank,***1306,"Globex International Holdings, Inc.",US,10930418.16
30/12/2023,30/12/2023,Interest Earned,Interest Income,ALL,0,12375.96,USD,Fedwire Credit,First Continental Bank,***8463,,,FALSE,FALSE,REF-118147,First Continental Bank,***3899,"Globex International Holdings, Inc.",US,10942794.12
31/12/2023,31/12/2023,Supplier Payment - PackFast Fulfillment #20,Supplier Payment,Retail-NA,81695.83,0,USD,Fedwire,PackFast Fulfillment #20,***1804,,PO-202312-Retail-NA-0011,FALSE,FALSE,REF-900764,First Continental Bank,***5130,"Globex International Holdings, Inc.",US,10861098.29
31/12/2023,31/12/2023,Client Receipt - ShopSphere Partner #79,Sales Receipt,Retail-NA,0,147859.87,USD,Card Settlement,ShopSphere Partner #79,***6323,INV-202312-Retail-NA-0002,,FALSE,FALSE,REF-352056,First Continental Bank,***1528,"Globex International Holdings, Inc.",US,11008958.16
01/01/2024,01/01/2024,Account Maintenance Fee,Bank/Merchant Fees,ALL,2500,0,USD,ACH Debit,First Continental Bank,***3969,,,FALSE,FALSE,REF-604281,First Continental Bank,***9994,"Globex International Holdings, Inc.",US,11006458.16
01/01/2024,01/01/2024,Client Receipt - CloudBridge Co. #50,Sales Receipt,SaaS-GL,0,11391.77,USD,Fedwire Credit,CloudBridge Co. #50,***1564,INV-202401-SaaS-GL-0016,,FALSE,FALSE,REF-971945,First Continental Bank,***8853,"Globex International Holdings, Inc.",US,11017849.93
02/01/2024,02/01/2024,Supplier Payment - PackFast Fulfillment #14,Supplier Payment,Retail-NA,128111.41,0,USD,ACH Debit,PackFast Fulfillment #14,***1629,,PO-202401-Retail-NA-0001,FALSE,FALSE,REF-269391,First Continental Bank,***3357,"Globex International Holdings, Inc.",US,10889738.52
02/01/2024,02/01/2024,Client Receipt - Vertex Advisory Client #55,Sales Receipt,PS-GL,0,18161.72,USD,Card Settlement,Vertex Advisory Client #55,***6374,INV-202401-PS-GL-0009,,FALSE,FALSE,REF-556050,First Continental Bank,***5201,"Globex International Holdings, Inc.",US,10907900.24
02/01/2024,02/01/2024,Client Receipt - ShopSphere Partner #15,Sales Receipt,Retail-NA,0,50951.61,USD,Card Settlement,ShopSphere Partner #15,***6644,INV-202401-Retail-NA-0002,,FALSE,FALSE,REF-628481,First Continental Bank,***3061,"Globex International Holdings, Inc.",US,10958851.85
03/01/2024,03/01/2024,Supplier Payment - HyperCloud Infra #19,Supplier Payment,SaaS-GL,812.06,0,USD,Wire Transfer,HyperCloud Infra #19,***6049,,PO-202401-SaaS-GL-0008,FALSE,FALSE,REF-678055,First Continental Bank,***4099,"Globex International Holdings, Inc.",US,10958039.79
03/01/2024,03/01/2024,Client Receipt - CloudBridge Co. #53,Sales Receipt,SaaS-GL,0,11490.99,USD,ACH Credit,CloudBridge Co. #53,***7795,INV-202401-SaaS-GL-0026,,FALSE,FALSE,REF-999108,First Continental Bank,***1005,"Globex International Holdings, Inc.",US,10969530.78
03/01/2024,03/01/2024,Client Receipt - CloudBridge Co. #78,Sales Receipt,SaaS-GL,0,14579.49,USD,ACH Credit,CloudBridge Co. #78,***3783,INV-202401-SaaS-GL-0003,,FALSE,FALSE,REF-569252,First Continental Bank,***3542,"Globex International Holdings, Inc.",US,10984110.27
03/01/2024,03/01/2024,Client Receipt - CloudBridge Co. #20,Sales Receipt,SaaS-GL,0,20712.54,USD,ACH Credit,CloudBridge Co. #20,***4485,INV-202401-SaaS-GL-0022,,FALSE,FALSE,REF-919089,First Continental Bank,***6033,"Globex International Holdings, Inc.",US,11004822.81
03/01/2024,03/01/2024,Client Receipt - CloudBridge Co. #28,Sales Receipt,SaaS-GL,0,31211.9,USD,Fedwire Credit,CloudBridge Co. #28,***1062,INV-202401-SaaS-GL-0023,,FALSE,FALSE,REF-130232,First Continental Bank,***4970,"Globex International Holdings, Inc.",US,11036034.71
03/01/2024,03/01/2024,Client Receipt - CloudBridge Co. #55,Sales Receipt,SaaS-GL,0,35538.18,USD,Fedwire Credit,CloudBridge Co. #55,***4043,INV-202401-SaaS-GL-0009,,FALSE,FALSE,REF-766424,First Continental Bank,***7131,"Globex International Holdings, Inc.",US,11071572.89
03/01/2024,03/01/2024,Client Receipt - ShopSphere Partner #61,Sales Receipt,Retail-NA,0,55463.38,USD,ACH Credit,ShopSphere Partner #61,***8061,INV-202401-Retail-NA-0011,,FALSE,FALSE,REF-635287,First Continental Bank,***7237,"Globex International Holdings, Inc.",US,11127036.27
04/01/2024,04/01/2024,Supplier Payment - HyperCloud Infra #17,Supplier Payment,SaaS-GL,49109.86,0,USD,Fedwire,HyperCloud Infra #17,***1179,,PO-202401-SaaS-GL-0003,FALSE,FALSE,REF-985627,First Continental Bank,***8409,"Globex International Holdings, Inc.",US,11077926.41
04/01/2024,04/01/2024,Client Receipt - CloudBridge Co. #78,Sales Receipt,SaaS-GL,0,5766.1,USD,Fedwire Credit,CloudBridge Co. #78,***9380,INV-202401-SaaS-GL-0013,,FALSE,FALSE,REF-978627,First Continental Bank,***8894,"Globex International Holdings, Inc.",US,11083692.51
04/01/2024,04/01/2024,Client Receipt - Vertex Advisory Client #38,Sales Receipt,PS-GL,0,22786.98,USD,Fedwire Credit,Vertex Advisory Client #38,***5654,INV-202401-PS-GL-0007,,FALSE,FALSE,REF-722004,First Continental Bank,***7080,"Globex International Holdings, Inc.",US,11106479.49
04/01/2024,04/01/2024,Client Receipt - CloudBridge Co. #74,Sales Receipt,SaaS-GL,0,33308.27,USD,Fedwire Credit,CloudBridge Co. #74,***8030,INV-202401-SaaS-GL-0031,,FALSE,FALSE,REF-782832,First Continental Bank,***2073,"Globex International Holdings, Inc.",US,11139787.76
04/01/2024,04/01/2024,Client Receipt - ShopSphere Partner #68,Sales Receipt,Retail-NA,0,47522.69,USD,ACH Credit,ShopSphere Partner #68,***1130,INV-202401-Retail-NA-0009,,FALSE,FALSE,REF-372041,First Continental Bank,***8228,"Globex International Holdings, Inc.",US,11187310.45
05/01/2024,05/01/2024,Supplier Payment - CodeCraft Contractors #2,Supplier Payment,SaaS-GL,503.34,0,USD,ACH Debit,CodeCraft Contractors #2,***3665,,PO-202401-SaaS-GL-0004,FALSE,FALSE,REF-595856,First Continental Bank,***1413,"Globex International Holdings, Inc.",US,11186807.11
05/01/2024,05/01/2024,Supplier Payment - CodeCraft Contractors #4,Supplier Payment,SaaS-GL,41986.98,0,USD,ACH Debit,CodeCraft Contractors #4,***9136,,PO-202401-SaaS-GL-0005,FALSE,FALSE,REF-903981,First Continental Bank,***5254,"Globex International Holdings, Inc.",US,11144820.13
05/01/2024,05/01/2024,Marketing - Beacon Digital #5,Marketing,ALL,55132.68,0,USD,Fedwire,Beacon Digital #5,***9997,,,FALSE,FALSE,REF-792825,First Continental Bank,***9666,"Globex International Holdings, Inc.",US,11089687.45
05/01/2024,05/01/2024,Client Receipt - ShopSphere Partner #21,Sales Receipt,Retail-NA,0,116978.23,USD,Fedwire Credit,ShopSphere Partner #21,***5026,INV-202401-Retail-NA-0012,,FALSE,FALSE,REF-111967,First Continental Bank,***9914,"Globex International Holdings, Inc.",US,11206665.68
07/01/2024,07/01/2024,Supplier Payment - ExpertNet Subcontractors #8,Supplier Payment,PS-GL,13516.69,0,USD,Wire Transfer,ExpertNet Subcontractors #8,***6123,,PO-202401-PS-GL-0003,FALSE,FALSE,REF-888281,First Continental Bank,***6171,"Globex International Holdings, Inc.",US,11193148.99
09/01/2024,09/01/2024,Client Receipt - CloudBridge Co. #29,Sales Receipt,SaaS-GL,0,398.43,USD,ACH Credit,CloudBridge Co. #29,***8870,INV-202401-SaaS-GL-0028,,FALSE,FALSE,REF-767960,First Continental Bank,***2307,"Globex International Holdings, Inc.",US,11193547.42
10/01/2024,10/01/2024,Supplier Payment - ExpertNet Subcontractors #19,Supplier Payment,PS-GL,17536.32,0,USD,Fedwire,ExpertNet Subcontractors #19,***9469,,PO-202401-PS-GL-0002,FALSE,FALSE,REF-489536,First Continental Bank,***9186,"Globex International Holdings, Inc.",US,11176011.1
10/01/2024,10/01/2024,Client Receipt - CloudBridge Co. #78,Sales Receipt,SaaS-GL,0,5503.92,USD,ACH Credit,CloudBridge Co. #78,***3777,INV-202401-SaaS-GL-0034,,FALSE,FALSE,REF-802736,First Continental Bank,***7338,"Globex International Holdings, Inc.",US,11181515.02
10/01/2024,10/01/2024,Client Receipt - CloudBridge Co. #57,Sales Receipt,SaaS-GL,0,27851.86,USD,Fedwire Credit,CloudBridge Co. #57,***1934,INV-202401-SaaS-GL-0005,,FALSE,FALSE,REF-930270,First Continental Bank,***2649,"Globex International Holdings, Inc.",US,11209366.88
10/01/2024,10/01/2024,Client Receipt - Vertex Advisory Client #21,Sales Receipt,PS-GL,0,65431.52,USD,ACH Credit,Vertex Advisory Client #21,***9040,INV-202401-PS-GL-0002,,FALSE,FALSE,REF-436463,First Continental Bank,***6253,"Globex International Holdings, Inc.",US,11274798.4
11/01/2024,11/01/2024,Supplier Payment - NorthRiver Apparel Mfg #17,Supplier Payment,Retail-NA,9707.38,0,USD,Wire Transfer,NorthRiver Apparel Mfg #17,***7267,,PO-202401-Retail-NA-0005,FALSE,FALSE,REF-183138,First Continental Bank,***1593,"Globex International Holdings, Inc.",US,11265091.02
11/01/2024,11/01/2024,Supplier Payment - ExpertNet Subcontractors #2,Supplier Payment,PS-GL,25817.8,0,USD,Fedwire,ExpertNet Subcontractors #2,***6375,,PO-202401-PS-GL-0008,FALSE,FALSE,REF-548010,First Continental Bank,***2412,"Globex International Holdings, Inc.",US,11239273.22
11/01/2024,11/01/2024,Client Receipt - Vertex Advisory Client #46,Sales Receipt,PS-GL,0,582.66,USD,Card Settlement,Vertex Advisory Client #46,***3181,INV-202401-PS-GL-0012,,FALSE,FALSE,REF-217781,First Continental Bank,***7736,"Globex International Holdings, Inc.",US,11239855.88
11/01/2024,11/01/2024,Client Receipt - CloudBridge Co. #5,Sales Receipt,SaaS-GL,0,5812.65,USD,Fedwire Credit,CloudBridge Co. #5,***4215,INV-202401-SaaS-GL-0032,,FALSE,FALSE,REF-865307,First Continental Bank,***5569,"Globex International Holdings, Inc.",US,11245668.53
11/01/2024,11/01/2024,Client Receipt - CloudBridge Co. #53,Sales Receipt,SaaS-GL,0,16797.35,USD,Card Settlement,CloudBridge Co. #53,***6958,INV-202401-SaaS-GL-0001,,FALSE,FALSE,REF-749148,First Continental Bank,***6930,"Globex International Holdings, Inc.",US,11262465.88
11/01/2024,11/01/2024,Client Receipt - CloudBridge Co. #25,Sales Receipt,SaaS-GL,0,31945.94,USD,Fedwire Credit,CloudBridge Co. #25,***7943,INV-202401-SaaS-GL-0002,,FALSE,FALSE,REF-290753,First Continental Bank,***3761,"Globex International Holdings, Inc.",US,11294411.82
12/01/2024,12/01/2024,Marketing - Aurelia Media #11,Marketing,ALL,205.41,0,USD,Fedwire,Aurelia Media #11,***3764,,,FALSE,FALSE,REF-253175,First Continental Bank,***7454,"Globex International Holdings, Inc.",US,11294206.41
12/01/2024,12/01/2024,Supplier Payment - HyperCloud Infra #10,Supplier Payment,SaaS-GL,10137.21,0,USD,ACH Debit,HyperCloud Infra #10,***9925,,PO-202401-SaaS-GL-0009,FALSE,FALSE,REF-968340,First Continental Bank,***4243,"Globex International Holdings, Inc.",US,11284069.2
12/01/2024,12/01/2024,Supplier Payment - HyperCloud Infra #9,Supplier Payment,SaaS-GL,44345.85,0,USD,Wire Transfer,HyperCloud Infra #9,***6795,,PO-202401-SaaS-GL-0002,FALSE,FALSE,REF-327375,First Continental Bank,***3359,"Globex International Holdings, Inc.",US,11239723.35
12/01/2024,12/01/2024,Intercompany Settlement - Globex APAC Logistics Pte. Ltd.,Intercompany Transfer,ALL,494435,0,USD,Internal Transfer,Globex APAC Logistics Pte. Ltd.,***7715,,,TRUE,TRUE,REF-423532,First Continental Bank,***8495,"Globex International Holdings, Inc.",US,10745288.35
12/01/2024,12/01/2024,Client Receipt - CloudBridge Co. #31,Sales Receipt,SaaS-GL,0,36900.35,USD,Fedwire Credit,CloudBridge Co. #31,***1934,INV-202401-SaaS-GL-0011,,FALSE,FALSE,REF-176237,First Continental Bank,***8379,"Globex International Holdings, Inc.",US,10782188.7
12/01/2024,12/01/2024,Client Receipt - CloudBridge Co. #55,Sales Receipt,SaaS-GL,0,39636.26,USD,Card Settlement,CloudBridge Co. #55,***8485,INV-202401-SaaS-GL-0015,,FALSE,FALSE,REF-213846,First Continental Bank,***8960,"Globex International Holdings, Inc.",US,10821824.96
12/01/2024,12/01/2024,Client Receipt - Vertex Advisory Client #23,Sales Receipt,PS-GL,0,57857.79,USD,Fedwire Credit,Vertex Advisory Client #23,***9700,INV-202401-PS-GL-0006,,FALSE,FALSE,REF-551838,First Continental Bank,***7119,"Globex International Holdings, Inc.",US,10879682.75
12/01/2024,12/01/2024,Client Receipt - Vertex Advisory Client #16,Sales Receipt,PS-GL,0,69255.04,USD,Card Settlement,Vertex Advisory Client #16,***5369,INV-202401-PS-GL-0005,,FALSE,FALSE,REF-808480,First Continental Bank,***4054,"Globex International Holdings, Inc.",US,10948937.79
12/01/2024,12/01/2024,Client Receipt - ShopSphere Partner #41,Sales Receipt,Retail-NA,0,76667.14,USD,Fedwire Credit,ShopSphere Partner #41,***3463,INV-202401-Retail-NA-0007,,FALSE,FALSE,REF-418204,First Continental Bank,***7597,"Globex International Holdings, Inc.",US,11025604.93
12/01/2024,12/01/2024,Intercompany Reimbursement - Globex APAC Logistics Pte. Ltd.,Intercompany Transfer,ALL,0,197774,USD,Internal Transfer,Globex APAC Logistics Pte. Ltd.,***6130,,,TRUE,TRUE,REF-941161,First Continental Bank,***3978,"Globex International Holdings, Inc.",US,11223378.93
13/01/2024,13/01/2024,Client Receipt - CloudBridge Co. #2,Sales Receipt,SaaS-GL,0,29783.46,USD,Card Settlement,CloudBridge Co. #2,***1018,INV-202401-SaaS-GL-0018,,FALSE,FALSE,REF-624901,First Continental Bank,***9572,"Globex International Holdings, Inc.",US,11253162.39
13/01/2024,13/01/2024,Client Receipt - ShopSphere Partner #20,Sales Receipt,Retail-NA,0,35579.94,USD,Card Settlement,ShopSphere Partner #20,***5975,INV-202401-Retail-NA-0004,,FALSE,FALSE,REF-193376,First Continental Bank,***4748,"Globex International Holdings, Inc.",US,11288742.33
13/01/2024,13/01/2024,Client Receipt - ShopSphere Partner #1,Sales Receipt,Retail-NA,0,151763.89,USD,Fedwire Credit,ShopSphere Partner #1,***6520,INV-202401-Retail-NA-0005,,FALSE,FALSE,REF-420159,First Continental Bank,***7695,"Globex International Holdings, Inc.",US,11440506.22
15/01/2024,15/01/2024,Supplier Payment - NorthRiver Apparel Mfg #23,Supplier Payment,Retail-NA,14435.58,0,USD,ACH Debit,NorthRiver Apparel Mfg #23,***6433,,PO-202401-Retail-NA-0006,FALSE,FALSE,REF-996367,First Continental Bank,***7497,"Globex International Holdings, Inc.",US,11426070.64
15/01/2024,15/01/2024,Loan Interest Payment,Loan Interest,ALL,85000,0,USD,Wire Transfer,First Continental Bank - Corporate Lending,***9231,,,FALSE,FALSE,REF-908826,First Continental Bank,***8374,"Globex International Holdings, Inc.",US,11341070.64
15/01/2024,15/01/2024,Loan Principal Repayment,Loan Principal,ALL,500000,0,USD,Wire Transfer,First Continental Bank - Corporate Lending,***2533,,,FALSE,FALSE,REF-175695,First Continental Bank,***3774,"Globex International Holdings, Inc.",US,10841070.64
15/01/2024,15/01/2024,Client Receipt - CloudBridge Co. #71,Sales Receipt,SaaS-GL,0,1285.47,USD,Card Settlement,CloudBridge Co. #71,***9772,INV-202401-SaaS-GL-0012,,FALSE,FALSE,REF-797522,First Continental Bank,***2165,"Globex International Holdings, Inc.",US,10842356.11
15/01/2024,15/01/2024,Client Receipt - CloudBridge Co. #31,Sales Receipt,SaaS-GL,0,5757.07,USD,Fedwire Credit,CloudBridge Co. #31,***4895,INV-202401-SaaS-GL-0014,,FALSE,FALSE,REF-118373,First Continental Bank,***5847,"Globex International Holdings, Inc.",US,10848113.18
15/01/2024,15/01/2024,Client Receipt - Vertex Advisory Client #32,Sales Receipt,PS-GL,0,12624.33,USD,ACH Credit,Vertex Advisory Client #32,***7728,INV-202401-PS-GL-0001,,FALSE,FALSE,REF-698189,First Continental Bank,***5426,"Globex International Holdings, Inc.",US,10860737.51
16/01/2024,16/01/2024,Supplier Payment - ExpertNet Subcontractors #11,Supplier Payment,PS-GL,16854.58,0,USD,Wire Transfer,ExpertNet Subcontractors #11,***9444,,PO-202401-PS-GL-0009,FALSE,FALSE,REF-820247,First Continental Bank,***1260,"Globex International Holdings, Inc.",US,10843882.93
16/01/2024,16/01/2024,Supplier Payment - NorthRiver Apparel Mfg #4,Supplier Payment,Retail-NA,44124.03,0,USD,Fedwire,NorthRiver Apparel Mfg #4,***9454,,PO-202401-Retail-NA-0008,FALSE,FALSE,REF-864033,First Continental Bank,***2906,"Globex International Holdings, Inc.",US,10799758.9
16/01/2024,16/01/2024,Client Receipt - CloudBridge Co. #60,Sales Receipt,SaaS-GL,0,21259.95,USD,Fedwire Credit,CloudBridge Co. #60,***7469,INV-202401-SaaS-GL-0027,,FALSE,FALSE,REF-669262,First Continental Bank,***3987,"Globex International Holdings, Inc.",US,10821018.85
16/01/2024,16/01/2024,Client Receipt - ShopSphere Partner #37,Sales Receipt,Retail-NA,0,66694.29,USD,Fedwire Credit,ShopSphere Partner #37,***5554,INV-202401-Retail-NA-0008,,FALSE,FALSE,REF-554654,First Continental Bank,***6724,"Globex International Holdings, Inc.",US,10887713.14
17/01/2024,17/01/2024,Supplier Payment - HyperCloud Infra #19,Supplier Payment,SaaS-GL,944.73,0,USD,Fedwire,HyperCloud Infra #19,***2026,,PO-202401-SaaS-GL-0010,FALSE,FALSE,REF-748557,First Continental Bank,***2776,"Globex International Holdings, Inc.",US,10886768.41
17/01/2024,17/01/2024,Client Receipt - Vertex Advisory Client #24,Sales Receipt,PS-GL,0,44259.12,USD,Fedwire Credit,Vertex Advisory Client #24,***5836,INV-202401-PS-GL-0010,,FALSE,FALSE,REF-919599,First Continental Bank,***5166,"Globex International Holdings, Inc.",US,10931027.53
18/01/2024,18/01/2024,Merchant Processing Fees,Bank/Merchant Fees,ALL,2574.03,0,USD,Wire Transfer,First Continental Bank,***5940,,,FALSE,FALSE,REF-866198,First Continental Bank,***6564,"Globex International Holdings, Inc.",US,10928453.5
18/01/2024,18/01/2024,Client Receipt - CloudBridge Co. #3,Sales Receipt,SaaS-GL,0,21017.05,USD,Fedwire Credit,CloudBridge Co. #3,***8918,INV-202401-SaaS-GL-0017,,FALSE,FALSE,REF-526918,First Continental Bank,***1427,"Globex International Holdings, Inc.",US,10949470.55
19/01/2024,19/01/2024,Metro Water & Waste,Rent & Utilities,ALL,18410.95,0,USD,ACH Debit,Metro Water & Waste,***4375,,,FALSE,FALSE,REF-279722,First Continental Bank,***6166,"Globex International Holdings, Inc.",US,10931059.6
20/01/2024,20/01/2024,Supplier Payment - NorthRiver Apparel Mfg #21,Supplier Payment,Retail-NA,13965.22,0,USD,Wire Transfer,NorthRiver Apparel Mfg #21,***6885,,PO-202401-Retail-NA-0003,FALSE,FALSE,REF-449754,First Continental Bank,***9879,"Globex International Holdings, Inc.",US,10917094.38
21/01/2024,21/01/2024,VAT/GST Remittance - US IRS,Tax Payment,ALL,135050.93,0,USD,ACH Debit,US IRS,***2033,,,FALSE,FALSE,REF-730477,First Continental Bank,***7920,"Globex International Holdings, Inc.",US,10782043.45
21/01/2024,21/01/2024,Supplier Payment - PackFast Fulfillment #11,Supplier Payment,Retail-NA,161026.83,0,USD,Wire Transfer,PackFast Fulfillment #11,***3135,,PO-202401-Retail-NA-0002,FALSE,FALSE,REF-360460,First Continental Bank,***5968,"Globex International Holdings, Inc.",US,10621016.62
21/01/2024,21/01/2024,Client Receipt - CloudBridge Co. #74,Sales Receipt,SaaS-GL,0,26408.61,USD,Card Settlement,CloudBridge Co. #74,***3373,INV-202401-SaaS-GL-0007,,FALSE,FALSE,REF-293527,First Continental Bank,***8196,"Globex International Holdings, Inc.",US,10647425.23
22/01/2024,22/01/2024,Client Receipt - CloudBridge Co. #24,Sales Receipt,SaaS-GL,0,15817.96,USD,ACH Credit,CloudBridge Co. #24,***3760,INV-202401-SaaS-GL-0010,,FALSE,FALSE,REF-106780,First Continental Bank,***2328,"Globex International Holdings, Inc.",US,10663243.19
23/01/2024,23/01/2024,Supplier Payment - HyperCloud Infra #2,Supplier Payment,SaaS-GL,983.14,0,USD,ACH Debit,HyperCloud Infra #2,***7468,,PO-202401-SaaS-GL-0006,FALSE,FALSE,REF-209795,First Continental Bank,***5635,"Globex International Holdings, Inc.",US,10662260.05
23/01/2024,23/01/2024,Supplier Payment - ExpertNet Subcontractors #9,Supplier Payment,PS-GL,17080.22,0,USD,Fedwire,ExpertNet Subcontractors #9,***4587,,PO-202401-PS-GL-0006,FALSE,FALSE,REF-906067,First Continental Bank,***2859,"Globex International Holdings, Inc.",US,10645179.83
24/01/2024,24/01/2024,Supplier Payment - ExpertNet Subcontractors #5,Supplier Payment,PS-GL,3647.94,0,USD,Fedwire,ExpertNet Subcontractors #5,***9285,,PO-202401-PS-GL-0001,FALSE,FALSE,REF-504849,First Continental Bank,***3267,"Globex International Holdings, Inc.",US,10641531.89
24/01/2024,24/01/2024,Supplier Payment - ExpertNet Subcontractors #15,Supplier Payment,PS-GL,19545.6,0,USD,Fedwire,ExpertNet Subcontractors #15,***2971,,PO-202401-PS-GL-0004,FALSE,FALSE,REF-919611,First Continental Bank,***4392,"Globex International Holdings, Inc.",US,10621986.29
24/01/2024,24/01/2024,Client Receipt - CloudBridge Co. #24,Sales Receipt,SaaS-GL,0,87981.62,USD,Fedwire Credit,CloudBridge Co. #24,***3930,INV-202401-SaaS-GL-0020,,FALSE,FALSE,REF-826334,First Continental Bank,***5240,"Globex International Holdings, Inc.",US,10709967.91
24/01/2024,24/01/2024,Client Receipt - ShopSphere Partner #67,Sales Receipt,Retail-NA,0,220485.04,USD,Card Settlement,ShopSphere Partner #67,***1165,INV-202401-Retail-NA-0010,,FALSE,FALSE,REF-770880,First Continental Bank,***4600,"Globex International Holdings, Inc.",US,10930452.95
25/01/2024,25/01/2024,Supplier Payment - CodeCraft Contractors #3,Supplier Payment,SaaS-GL,1734.65,0,USD,Wire Transfer,CodeCraft Contractors #3,***9425,,PO-202401-SaaS-GL-0001,FALSE,FALSE,REF-124771,First Continental Bank,***4820,"Globex International Holdings, Inc.",US,10928718.3
25/01/2024,25/01/2024,Supplier Payment - CodeCraft Contractors #5,Supplier Payment,SaaS-GL,22800.53,0,USD,ACH Debit,CodeCraft Contractors #5,***1287,,PO-202401-SaaS-GL-0007,FALSE,FALSE,REF-803935,First Continental Bank,***5762,"Globex International Holdings, Inc.",US,10905917.77
25/01/2024,25/01/2024,Supplier Payment - NorthRiver Apparel Mfg #21,Supplier Payment,Retail-NA,87644.55,0,USD,Wire Transfer,NorthRiver Apparel Mfg #21,***6322,,PO-202401-Retail-NA-0004,FALSE,FALSE,REF-446637,First Continental Bank,***5436,"Globex International Holdings, Inc.",US,10818273.22
25/01/2024,25/01/2024,Client Receipt - CloudBridge Co. #75,Sales Receipt,SaaS-GL,0,15553.72,USD,Fedwire Credit,CloudBridge Co. #75,***6327,INV-202401-SaaS-GL-0021,,FALSE,FALSE,REF-602892,First Continental Bank,***2910,"Globex International Holdings, Inc.",US,10833826.94
25/01/2024,25/01/2024,Client Receipt - Vertex Advisory Client #15,Sales Receipt,PS-GL,0,35853.71,USD,Fedwire Credit,Vertex Advisory Client #15,***9988,INV-202401-PS-GL-0004,,FALSE,FALSE,REF-655398,First Continental Bank,***3400,"Globex International Holdings, Inc.",US,10869680.65
25/01/2024,25/01/2024,Client Receipt - CloudBridge Co. #31,Sales Receipt,SaaS-GL,0,66676.44,USD,Card Settlement,CloudBridge Co. #31,***3184,INV-202401-SaaS-GL-0006,,FALSE,FALSE,REF-535676,First Continental Bank,***7764,"Globex International Holdings, Inc.",US,10936357.09
25/01/2024,25/01/2024,Client Receipt - CloudBridge Co. #14,Sales Receipt,SaaS-GL,0,99168.74,USD,ACH Credit,CloudBridge Co. #14,***7213,INV-202401-SaaS-GL-0008,,FALSE,FALSE,REF-737904,First Continental Bank,***4334,"Globex International Holdings, Inc.",US,11035525.83
26/01/2024,26/01/2024,Intercompany Settlement - Globex Consulting UK Ltd.,Intercompany Transfer,ALL,625282,0,USD,Internal Transfer,Globex Consulting UK Ltd.,***2274,,,TRUE,TRUE,REF-129856,First Continental Bank,***1967,"Globex International Holdings, Inc.",US,10410243.83
26/01/2024,26/01/2024,Client Receipt - CloudBridge Co. #23,Sales Receipt,SaaS-GL,0,408.09,USD,Fedwire Credit,CloudBridge Co. #23,***5557,INV-202401-SaaS-GL-0025,,FALSE,FALSE,REF-858972,First Continental Bank,***9814,"Globex International Holdings, Inc.",US,10410651.92
26/01/2024,26/01/2024,Client Receipt - ShopSphere Partner #69,Sales Receipt,Retail-NA,0,6895.27,USD,Card Settlement,ShopSphere Partner #69,***7053,INV-202401-Retail-NA-0001,,FALSE,FALSE,REF-974461,First Continental Bank,***6792,"Globex International Holdings, Inc.",US,10417547.19
26/01/2024,26/01/2024,Client Receipt - Vertex Advisory Client #26,Sales Receipt,PS-GL,0,33932.6,USD,Fedwire Credit,Vertex Advisory Client #26,***8217,INV-202401-PS-GL-0011,,FALSE,FALSE,REF-561088,First Continental Bank,***4364,"Globex International Holdings, Inc.",US,10451479.79
26/01/2024,26/01/2024,Client Receipt - ShopSphere Partner #58,Sales Receipt,Retail-NA,0,50767.63,USD,Fedwire Credit,ShopSphere Partner #58,***4012,INV-202401-Retail-NA-0003,,FALSE,FALSE,REF-267317,First Continental Bank,***3317,"Globex International Holdings, Inc.",US,10502247.42
26/01/2024,26/01/2024,Client Receipt - ShopSphere Partner #58,Sales Receipt,Retail-NA,0,83332.83,USD,Card Settlement,ShopSphere Partner #58,***8845,INV-202401-Retail-NA-0006,,FALSE,FALSE,REF-467144,First Continental Bank,***1287,"Globex International Holdings, Inc.",US,10585580.25
28/01/2024,28/01/2024,Merchant Processing Fees,Bank/Merchant Fees,ALL,4278.24,0,USD,Wire Transfer,First Continental Bank,***3391,,,FALSE,FALSE,REF-548345,First Continental Bank,***2360,"Globex International Holdings, Inc.",US,10581302.01
28/01/2024,28/01/2024,Corporate Tax Estimate,Tax Payment,ALL,98984.86,0,USD,ACH Debit,State of CA FTB,***1037,,,FALSE,FALSE,REF-770352,First Continental Bank,***7592,"Globex International Holdings, Inc.",US,10482317.15
28/01/2024,28/01/2024,Client Receipt - Vertex Advisory Client #35,Sales Receipt,PS-GL,0,102225.07,USD,ACH Credit,Vertex Advisory Client #35,***8037,INV-202401-PS-GL-0003,,FALSE,FALSE,REF-634706,First Continental Bank,***2105,"Globex International Holdings, Inc.",US,10584542.22
29/01/2024,29/01/2024,Supplier Payment - ExpertNet Subcontractors #2,Supplier Payment,PS-GL,18992.87,0,USD,Wire Transfer,ExpertNet Subcontractors #2,***2392,,PO-202401-PS-GL-0005,FALSE,FALSE,REF-790126,First Continental Bank,***8322,"Globex International Holdings, Inc.",US,10565549.35
29/01/2024,29/01/2024,Supplier Payment - ExpertNet Subcontractors #3,Supplier Payment,PS-GL,24606.48,0,USD,Fedwire,ExpertNet Subcontractors #3,***7440,,PO-202401-PS-GL-0007,FALSE,FALSE,REF-647371,First Continental Bank,***8501,"Globex International Holdings, Inc.",US,10540942.87
29/01/2024,29/01/2024,Payroll - GlobalPay Services Ltd,Payroll,ALL,357962.7,0,USD,Fedwire,GlobalPay Services Ltd,***1804,,,FALSE,FALSE,REF-620630,First Continental Bank,***6460,"Globex International Holdings, Inc.",US,10182980.17
29/01/2024,29/01/2024,Client Receipt - CloudBridge Co. #35,Sales Receipt,SaaS-GL,0,10884.09,USD,Card Settlement,CloudBridge Co. #35,***2092,INV-202401-SaaS-GL-0033,,FALSE,FALSE,REF-445090,First Continental Bank,***3061,"Globex International Holdings, Inc.",US,10193864.26
30/01/2024,30/01/2024,Client Receipt - CloudBridge Co. #46,Sales Receipt,SaaS-GL,0,3803.73,USD,Fedwire Credit,CloudBridge Co. #46,***8216,INV-202401-SaaS-GL-0019,,FALSE,FALSE,REF-490038,First Continental Bank,***6624,"Globex International Holdings, Inc.",US,10197667.99
30/01/2024,30/01/2024,Client Receipt - CloudBridge Co. #52,Sales Receipt,SaaS-GL,0,10991.42,USD,Fedwire Credit,CloudBridge Co. #52,***4917,INV-202401-SaaS-GL-0004,,FALSE,FALSE,REF-725688,First Continental Bank,***7722,"Globex International Holdings, Inc.",US,10208659.41
30/01/2024,30/01/2024,Interest Earned,Interest Income,ALL,0,11626.65,USD,ACH Credit,First Continental Bank,***3850,,,FALSE,FALSE,REF-665657,First Continental Bank,***6334,"Globex International Holdings, Inc.",US,10220286.06
30/01/2024,30/01/2024,Client Receipt - CloudBridge Co. #37,Sales Receipt,SaaS-GL,0,14892.45,USD,Fedwire Credit,CloudBridge Co. #37,***3924,INV-202401-SaaS-GL-0029,,FALSE,FALSE,REF-745467,First Continental Bank,***6665,"Globex International Holdings, Inc.",US,10235178.51
30/01/2024,30/01/2024,Client Receipt - Vertex Advisory Client #1,Sales Receipt,PS-GL,0,62357.79,USD,Fedwire Credit,Vertex Advisory Client #1,***3859,INV-202401-PS-GL-0008,,FALSE,FALSE,REF-671419,First Continental Bank,***4303,"Globex International Holdings, Inc.",US,10297536.3
31/01/2024,31/01/2024,Supplier Payment - PackFast Fulfillment #6,Supplier Payment,Retail-NA,70691.07,0,USD,ACH Debit,PackFast Fulfillment #6,***4015,,PO-202401-Retail-NA-0007,FALSE,FALSE,REF-764371,First Continental Bank,***2245,"Globex International Holdings, Inc.",US,10226845.23
31/01/2024,31/01/2024,Client Receipt - CloudBridge Co. #11,Sales Receipt,SaaS-GL,0,2208.18,USD,Card Settlement,CloudBridge Co. #11,***7985,INV-202401-SaaS-GL-0030,,FALSE,FALSE,REF-277375,First Continental Bank,***1932,"Globex International Holdings, Inc.",US,10229053.41
31/01/2024,31/01/2024,Client Receipt - CloudBridge Co. #11,Sales Receipt,SaaS-GL,0,25248.45,USD,Card Settlement,CloudBridge Co. #11,***8537,INV-202401-SaaS-GL-0024,,FALSE,FALSE,REF-829964,First Continental Bank,***4732,"Globex International Holdings, Inc.",US,10254301.86
01/02/2024,01/02/2024,Account Maintenance Fee,Bank/Merchant Fees,ALL,2500,0,USD,Wire Transfer,First Continental Bank,***4965,,,FALSE,FALSE,REF-915968,First Continental Bank,***9861,"Globex International Holdings, Inc.",US,10251801.86
01/02/2024,01/02/2024,Supplier Payment - HyperCloud Infra #9,Supplier Payment,SaaS-GL,7290.69,0,USD,Wire Transfer,HyperCloud Infra #9,***4328,,PO-202402-SaaS-GL-0006,FALSE,FALSE,REF-834458,First Continental Bank,***5169,"Globex International Holdings, Inc.",US,10244511.17
01/02/2024,01/02/2024,Supplier Payment - CodeCraft Contractors #12,Supplier Payment,SaaS-GL,13653.24,0,USD,ACH Debit,CodeCraft Contractors #12,***8254,,PO-202402-SaaS-GL-0005,FALSE,FALSE,REF-682535,First Continental Bank,***9324,"Globex International Holdings, Inc.",US,10230857.93
01/02/2024,01/02/2024,Supplier Payment - HyperCloud Infra #4,Supplier Payment,SaaS-GL,28012.12,0,USD,ACH Debit,HyperCloud Infra #4,***1582,,PO-202402-SaaS-GL-0002,FALSE,FALSE,REF-199800,First Continental Bank,***7697,"Globex International Holdings, Inc.",US,10202845.81
01/02/2024,01/02/2024,Client Receipt - CloudBridge Co. #77,Sales Receipt,SaaS-GL,0,1985.61,USD,Card Settlement,CloudBridge Co. #77,***1208,INV-202402-SaaS-GL-0020,,FALSE,FALSE,REF-567763,First Continental Bank,***4916,"Globex International Holdings, Inc.",US,10204831.42
01/02/2024,01/02/2024,Client Receipt - CloudBridge Co. #79,Sales Receipt,SaaS-GL,0,21432.9,USD,ACH Credit,CloudBridge Co. #79,***1840,INV-202402-SaaS-GL-0005,,FALSE,FALSE,REF-934855,First Continental Bank,***6334,"Globex International Holdings, Inc.",US,10226264.32
01/02/2024,01/02/2024,Client Receipt - ShopSphere Partner #1,Sales Receipt,Retail-NA,0,322432.01,USD,Fedwire Credit,ShopSphere Partner #1,***7168,INV-202402-Retail-NA-0010,,FALSE,FALSE,REF-247040,First Continental Bank,***2706,"Globex International Holdings, Inc.",US,10548696.33
02/02/2024,02/02/2024,Client Receipt - CloudBridge Co. #62,Sales Receipt,SaaS-GL,0,54887.29,USD,ACH Credit,CloudBridge Co. #62,***4091,INV-202402-SaaS-GL-0012,,FALSE,FALSE,REF-927022,First Continental Bank,***7804,"Globex International Holdings, Inc.",US,10603583.62
03/02/2024,03/02/2024,Client Receipt - Card Settlement Batch #14,Sales Receipt,Retail-NA,0,138437.75,USD,ACH Credit,Card Settlement Batch #14,***2760,INV-202402-Retail-NA-0009,,FALSE,FALSE,REF-191173,First Continental Bank,***6712,"Globex International Holdings, Inc.",US,10742021.37
05/02/2024,05/02/2024,Supplier Payment - HyperCloud Infra #9,Supplier Payment,SaaS-GL,5019.74,0,USD,ACH Debit,HyperCloud Infra #9,***1072,,PO-202402-SaaS-GL-0004,FALSE,FALSE,REF-341473,First Continental Bank,***1982,"Globex International Holdings, Inc.",US,10737001.63
05/02/2024,05/02/2024,Supplier Payment - ExpertNet Subcontractors #7,Supplier Payment,PS-GL,7413.81,0,USD,Wire Transfer,ExpertNet Subcontractors #7,***6407,,PO-202402-PS-GL-0006,FALSE,FALSE,REF-379331,First Continental Bank,***6203,"Globex International Holdings, Inc.",US,10729587.82
05/02/2024,05/02/2024,Supplier Payment - CodeCraft Contractors #4,Supplier Payment,SaaS-GL,13292.47,0,USD,Wire Transfer,CodeCraft Contractors #4,***8056,,PO-202402-SaaS-GL-0010,FALSE,FALSE,REF-335708,First Continental Bank,***3937,"Globex International Holdings, Inc.",US,10716295.35
05/02/2024,05/02/2024,Supplier Payment - CodeCraft Contractors #7,Supplier Payment,SaaS-GL,19188.41,0,USD,ACH Debit,CodeCraft Contractors #7,***3540,,PO-202402-SaaS-GL-0001,FALSE,FALSE,REF-557222,First Continental Bank,***3098,"Globex International Holdings, Inc.",US,10697106.94
05/02/2024,05/02/2024,Client Receipt - CloudBridge Co. #16,Sales Receipt,SaaS-GL,0,5429.17,USD,Card Settlement,CloudBridge Co. #16,***9538,INV-202402-SaaS-GL-0006,,FALSE,FALSE,REF-132216,First Continental Bank,***7828,"Globex International Holdings, Inc.",US,10702536.11
06/02/2024,06/02/2024,Supplier Payment - ExpertNet Subcontractors #6,Supplier Payment,PS-GL,4375.04,0,USD,Fedwire,ExpertNet Subcontractors #6,***7484,,PO-202402-PS-GL-0011,FALSE,FALSE,REF-282056,First Continental Bank,***1937,"Globex International Holdings, Inc.",US,10698161.07
06/02/2024,06/02/2024,Merchant Processing Fees,Bank/Merchant Fees,ALL,6191.93,0,USD,ACH Debit,First Continental Bank,***4679,,,FALSE,FALSE,REF-649092,First Continental Bank,***2591,"Globex International Holdings, Inc.",US,10691969.14
06/02/2024,06/02/2024,Supplier Payment - ExpertNet Subcontractors #13,Supplier Payment,PS-GL,11307.28,0,USD,Fedwire,ExpertNet Subcontractors #13,***7145,,PO-202402-PS-GL-0002,FALSE,FALSE,REF-561578,First Continental Bank,***4611,"Globex International Holdings, Inc.",US,10680661.86
06/02/2024,06/02/2024,Client Receipt - Card Settlement Batch #6,Sales Receipt,Retail-NA,0,10346.68,USD,Fedwire Credit,Card Settlement Batch #6,***8219,INV-202402-Retail-NA-0007,,FALSE,FALSE,REF-590033,First Continental Bank,***8171,"Globex International Holdings, Inc.",US,10691008.54
06/02/2024,06/02/2024,Client Receipt - CloudBridge Co. #39,Sales Receipt,SaaS-GL,0,17490.78,USD,ACH Credit,CloudBridge Co. #39,***7805,INV-202402-SaaS-GL-0011,,FALSE,FALSE,REF-692931,First Continental Bank,***8322,"Globex International Holdings, Inc.",US,10708499.32
07/02/2024,07/02/2024,Client Receipt - ShopSphere Partner #60,Sales Receipt,Retail-NA,0,8499.26,USD,ACH Credit,ShopSphere Partner #60,***2608,INV-202402-Retail-NA-0015,,FALSE,FALSE,REF-517100,First Continental Bank,***5618,"Globex International Holdings, Inc.",US,10716998.58
07/02/2024,07/02/2024,Client Receipt - ShopSphere Partner #32,Sales Receipt,Retail-NA,0,13027.88,USD,ACH Credit,ShopSphere Partner #32,***1104,INV-202402-Retail-NA-0014,,FALSE,FALSE,REF-450426,First Continental Bank,***1753,"Globex International Holdings, Inc.",US,10730026.46
07/02/2024,07/02/2024,Client Receipt - ShopSphere Partner #16,Sales Receipt,Retail-NA,0,25992.57,USD,Card Settlement,ShopSphere Partner #16,***2189,INV-202402-Retail-NA-0018,,FALSE,FALSE,REF-620531,First Continental Bank,***2606,"Globex International Holdings, Inc.",US,10756019.03
07/02/2024,07/02/2024,Client Receipt - CloudBridge Co. #25,Sales Receipt,SaaS-GL,0,39090.07,USD,Fedwire Credit,CloudBridge Co. #25,***4177,INV-202402-SaaS-GL-0022,,FALSE,FALSE,REF-923681,First Continental Bank,***4851,"Globex International Holdings, Inc.",US,10795109.1
07/02/2024,07/02/2024,Client Receipt - ShopSphere Partner #62,Sales Receipt,Retail-NA,0,76071.74,USD,Fedwire Credit,ShopSphere Partner #62,***4669,INV-202402-Retail-NA-0012,,FALSE,FALSE,REF-707740,First Continental Bank,***6093,"Globex International Holdings, Inc.",US,10871180.84
08/02/2024,08/02/2024,Supplier Payment - HyperCloud Infra #7,Supplier Payment,SaaS-GL,13108.68,0,USD,Wire Transfer,HyperCloud Infra #7,***8905,,PO-202402-SaaS-GL-0009,FALSE,FALSE,REF-389060,First Continental Bank,***9589,"Globex International Holdings, Inc.",US,10858072.16
08/02/2024,08/02/2024,Supplier Payment - ExpertNet Subcontractors #6,Supplier Payment,PS-GL,24273.57,0,USD,Wire Transfer,ExpertNet Subcontractors #6,***6010,,PO-202402-PS-GL-0004,FALSE,FALSE,REF-930057,First Continental Bank,***2436,"Globex International Holdings, Inc.",US,10833798.59
08/02/2024,08/02/2024,Client Receipt - ShopSphere Partner #7,Sales Receipt,Retail-NA,0,1757.39,USD,Card Settlement,ShopSphere Partner #7,***7287,INV-202402-Retail-NA-0006,,FALSE,FALSE,REF-803777,First Continental Bank,***8604,"Globex International Holdings, Inc.",US,10835555.98
08/02/2024,08/02/2024,Client Receipt - Vertex Advisory Client #19,Sales Receipt,PS-GL,0,63394.66,USD,ACH Credit,Vertex Advisory Client #19,***1270,INV-202402-PS-GL-0007,,FALSE,FALSE,REF-304929,First Continental Bank,***3852,"Globex International Holdings, Inc.",US,10898950.64
09/02/2024,09/02/2024,Client Receipt - CloudBridge Co. #64,Sales Receipt,SaaS-GL,0,10431.42,USD,Card Settlement,CloudBridge Co. #64,***8959,INV-202402-SaaS-GL-0017,,FALSE,FALSE,REF-884968,First Continental Bank,***8129,"Globex International Holdings, Inc.",US,10909382.06
09/02/2024,09/02/2024,Client Receipt - Vertex Advisory Client #13,Sales Receipt,PS-GL,0,95686.66,USD,Fedwire Credit,Vertex Advisory Client #13,***4062,INV-202402-PS-GL-0006,,FALSE,FALSE,REF-472877,First Continental Bank,***3707,"Globex International Holdings, Inc.",US,11005068.72
09/02/2024,09/02/2024,Client Receipt - Vertex Advisory Client #59,Sales Receipt,PS-GL,0,226874.63,USD,ACH Credit,Vertex Advisory Client #59,***5872,INV-202402-PS-GL-0005,,FALSE,FALSE,REF-973340,First Continental Bank,***6500,"Globex International Holdings, Inc.",US,11231943.35
10/02/2024,10/02/2024,Client Receipt - ShopSphere Partner #24,Sales Receipt,Retail-NA,0,50132.15,USD,ACH Credit,ShopSphere Partner #24,***5280,INV-202402-Retail-NA-0008,,FALSE,FALSE,REF-735919,First Continental Bank,***8170,"Globex International Holdings, Inc.",US,11282075.5
11/02/2024,11/02/2024,Supplier Payment - HyperCloud Infra #4,Supplier Payment,SaaS-GL,8611.5,0,USD,Fedwire,HyperCloud Infra #4,***4641,,PO-202402-SaaS-GL-0007,FALSE,FALSE,REF-133798,First Continental Bank,***7031,"Globex International Holdings, Inc.",US,11273464
12/02/2024,12/02/2024,Supplier Payment - NorthRiver Apparel Mfg #30,Supplier Payment,Retail-NA,79733.63,0,USD,ACH Debit,NorthRiver Apparel Mfg #30,***5429,,PO-202402-Retail-NA-0008,FALSE,FALSE,REF-590926,First Continental Bank,***7604,"Globex International Holdings, Inc.",US,11193730.37
12/02/2024,12/02/2024,Supplier Payment - NorthRiver Apparel Mfg #5,Supplier Payment,Retail-NA,148882.51,0,USD,Fedwire,NorthRiver Apparel Mfg #5,***1989,,PO-202402-Retail-NA-0006,FALSE,FALSE,REF-124216,First Continental Bank,***6264,"Globex International Holdings, Inc.",US,11044847.86
12/02/2024,12/02/2024,Intercompany Settlement - Globex Consulting UK Ltd.,Intercompany Transfer,ALL,389714,0,USD,Internal Transfer,Globex Consulting UK Ltd.,***4289,,,TRUE,TRUE,REF-453085,First Continental Bank,***8589,"Globex International Holdings, Inc.",US,10655133.86
12/02/2024,12/02/2024,Client Receipt - CloudBridge Co. #3,Sales Receipt,SaaS-GL,0,45777.81,USD,Card Settlement,CloudBridge Co. #3,***6035,INV-202402-SaaS-GL-0016,,FALSE,FALSE,REF-949983,First Continental Bank,***3427,"Globex International Holdings, Inc.",US,10700911.67
12/02/2024,12/02/2024,Intercompany Reimbursement - Globex Consulting UK Ltd.,Intercompany Transfer,ALL,0,155885.6,USD,Internal Transfer,Globex Consulting UK Ltd.,***8607,,,TRUE,TRUE,REF-171391,First Continental Bank,***4472,"Globex International Holdings, Inc.",US,10856797.27
13/02/2024,13/02/2024,Supplier Payment - PackFast Fulfillment #11,Supplier Payment,Retail-NA,5053.85,0,USD,Fedwire,PackFast Fulfillment #11,***3873,,PO-202402-Retail-NA-0005,FALSE,FALSE,REF-683889,First Continental Bank,***3804,"Globex International Holdings, Inc.",US,10851743.42
13/02/2024,13/02/2024,Supplier Payment - NorthRiver Apparel Mfg #21,Supplier Payment,Retail-NA,14313.75,0,USD,Fedwire,NorthRiver Apparel Mfg #21,***1811,,PO-202402-Retail-NA-0009,FALSE,FALSE,REF-624130,First Continental Bank,***9745,"Globex International Holdings, Inc.",US,10837429.67
13/02/2024,13/02/2024,Supplier Payment - ExpertNet Subcontractors #8,Supplier Payment,PS-GL,15363.61,0,USD,Fedwire,ExpertNet Subcontractors #8,***6588,,PO-202402-PS-GL-0012,FALSE,FALSE,REF-956072,First Continental Bank,***8088,"Globex International Holdings, Inc.",US,10822066.06
13/02/2024,13/02/2024,Client Receipt - Vertex Advisory Client #6,Sales Receipt,PS-GL,0,44472.04,USD,Card Settlement,Vertex Advisory Client #6,***6750,INV-202402-PS-GL-0008,,FALSE,FALSE,REF-539070,First Continental Bank,***5085,"Globex International Holdings, Inc.",US,10866538.1
14/02/2024,14/02/2024,Metro Water & Waste,Rent & Utilities,ALL,3967.03,0,USD,Wire Transfer,Metro Water & Waste,***8463,,,FALSE,FALSE,REF-982586,First Continental Bank,***9568,"Globex International Holdings, Inc.",US,10862571.07
14/02/2024,14/02/2024,Client Receipt - ShopSphere Partner #58,Sales Receipt,Retail-NA,0,20864.22,USD,ACH Credit,ShopSphere Partner #58,***4367,INV-202402-Retail-NA-0011,,FALSE,FALSE,REF-226429,First Continental Bank,***4548,"Globex International Holdings, Inc.",US,10883435.29
14/02/2024,14/02/2024,Client Receipt - CloudBridge Co. #31,Sales Receipt,SaaS-GL,0,34951,USD,Fedwire Credit,CloudBridge Co. #31,***5106,INV-202402-SaaS-GL-0003,,FALSE,FALSE,REF-225178,First Continental Bank,***1481,"Globex International Holdings, Inc.",US,10918386.29
15/02/2024,15/02/2024,Marketing - Beacon Digital #3,Marketing,ALL,6596.44,0,USD,Fedwire,Beacon Digital #3,***6362,,,FALSE,FALSE,REF-876751,First Continental Bank,***5523,"Globex International Holdings, Inc.",US,10911789.85
15/02/2024,15/02/2024,Marketing - Beacon Digital #7,Marketing,ALL,32608.12,0,USD,ACH Debit,Beacon Digital #7,***4498,,,FALSE,FALSE,REF-778222,First Continental Bank,***4461,"Globex International Holdings, Inc.",US,10879181.73
15/02/2024,15/02/2024,Loan Interest Payment,Loan Interest,ALL,85000,0,USD,Wire Transfer,First Continental Bank - Corporate Lending,***6685,,,FALSE,FALSE,REF-750020,First Continental Bank,***4359,"Globex International Holdings, Inc.",US,10794181.73
15/02/2024,15/02/2024,Loan Principal Repayment,Loan Principal,ALL,500000,0,USD,ACH Debit,First Continental Bank - Corporate Lending,***4381,,,FALSE,FALSE,REF-747917,First Continental Bank,***6201,"Globex International Holdings, Inc.",US,10294181.73
16/02/2024,16/02/2024,Client Receipt - CloudBridge Co. #5,Sales Receipt,SaaS-GL,0,16348.66,USD,Card Settlement,CloudBridge Co. #5,***7496,INV-202402-SaaS-GL-0024,,FALSE,FALSE,REF-395086,First Continental Bank,***1171,"Globex International Holdings, Inc.",US,10310530.39
16/02/2024,16/02/2024,Client Receipt - Vertex Advisory Client #56,Sales Receipt,PS-GL,0,63147.55,USD,Fedwire Credit,Vertex Advisory Client #56,***8973,INV-202402-PS-GL-0002,,FALSE,FALSE,REF-596565,First Continental Bank,***2574,"Globex International Holdings, Inc.",US,10373677.94
17/02/2024,17/02/2024,Supplier Payment - HyperCloud Infra #15,Supplier Payment,SaaS-GL,48217.02,0,USD,Fedwire,HyperCloud Infra #15,***5228,,PO-202402-SaaS-GL-0003,FALSE,FALSE,REF-320336,First Continental Bank,***1522,"Globex International Holdings, Inc.",US,10325460.92
17/02/2024,17/02/2024,Client Receipt - ShopSphere Partner #21,Sales Receipt,Retail-NA,0,12003.86,USD,Card Settlement,ShopSphere Partner #21,***5970,INV-202402-Retail-NA-0017,,FALSE,FALSE,REF-241153,First Continental Bank,***7276,"Globex International Holdings, Inc.",US,10337464.78
18/02/2024,18/02/2024,Client Receipt - CloudBridge Co. #24,Sales Receipt,SaaS-GL,0,2079.27,USD,Card Settlement,CloudBridge Co. #24,***1929,INV-202402-SaaS-GL-0023,,FALSE,FALSE,REF-745119,First Continental Bank,***6782,"Globex International Holdings, Inc.",US,10339544.05
19/02/2024,19/02/2024,Client Receipt - CloudBridge Co. #64,Sales Receipt,SaaS-GL,0,1633.01,USD,Fedwire Credit,CloudBridge Co. #64,***4256,INV-202402-SaaS-GL-0008,,FALSE,FALSE,REF-629626,First Continental Bank,***6206,"Globex International Holdings, Inc.",US,10341177.06
19/02/2024,19/02/2024,Client Receipt - ShopSphere Partner #56,Sales Receipt,Retail-NA,0,19895.3,USD,Card Settlement,ShopSphere Partner #56,***6231,INV-202402-Retail-NA-0016,,FALSE,FALSE,REF-670939,First Continental Bank,***2927,"Globex International Holdings, Inc.",US,10361072.36
20/02/2024,20/02/2024,Supplier Payment - ExpertNet Subcontractors #17,Supplier Payment,PS-GL,9667.26,0,USD,ACH Debit,ExpertNet Subcontractors #17,***6825,,PO-202402-PS-GL-0009,FALSE,FALSE,REF-189559,First Continental Bank,***1502,"Globex International Holdings, Inc.",US,10351405.1
20/02/2024,20/02/2024,Client Receipt - CloudBridge Co. #8,Sales Receipt,SaaS-GL,0,6333.92,USD,Card Settlement,CloudBridge Co. #8,***1968,INV-202402-SaaS-GL-0018,,FALSE,FALSE,REF-426655,First Continental Bank,***6575,"Globex International Holdings, Inc.",US,10357739.02
20/02/2024,20/02/2024,Client Receipt - Vertex Advisory Client #41,Sales Receipt,PS-GL,0,34295.35,USD,Card Settlement,Vertex Advisory Client #41,***5423,INV-202402-PS-GL-0001,,FALSE,FALSE,REF-857670,First Continental Bank,***7496,"Globex International Holdings, Inc.",US,10392034.37
20/02/2024,20/02/2024,Client Receipt - CloudBridge Co. #52,Sales Receipt,SaaS-GL,0,37158.85,USD,Card Settlement,CloudBridge Co. #52,***4864,INV-202402-SaaS-GL-0019,,FALSE,FALSE,REF-642341,First Continental Bank,***1993,"Globex International Holdings, Inc.",US,10429193.22
20/02/2024,20/02/2024,Client Receipt - ShopSphere Partner #15,Sales Receipt,Retail-NA,0,48069.42,USD,ACH Credit,ShopSphere Partner #15,***8452,INV-202402-Retail-NA-0013,,FALSE,FALSE,REF-854142,First Continental Bank,***7116,"Globex International Holdings, Inc.",US,10477262.64
21/02/2024,21/02/2024,Client Receipt - CloudBridge Co. #20,Sales Receipt,SaaS-GL,0,7369.69,USD,Card Settlement,CloudBridge Co. #20,***2977,INV-202402-SaaS-GL-0021,,FALSE,FALSE,REF-362760,First Continental Bank,***2976,"Globex International Holdings, Inc.",US,10484632.33
21/02/2024,21/02/2024,Client Receipt - ShopSphere Partner #40,Sales Receipt,Retail-NA,0,54704.6,USD,Fedwire Credit,ShopSphere Partner #40,***9682,INV-202402-Retail-NA-0001,,FALSE,FALSE,REF-446077,First Continental Bank,***9112,"Globex International Holdings, Inc.",US,10539336.93
21/02/2024,21/02/2024,Client Receipt - CloudBridge Co. #23,Sales Receipt,SaaS-GL,0,91028.44,USD,Card Settlement,CloudBridge Co. #23,***3949,INV-202402-SaaS-GL-0015,,FALSE,FALSE,REF-573134,First Continental Bank,***1646,"Globex International Holdings, Inc.",US,10630365.37
21/02/2024,21/02/2024,Client Receipt - ShopSphere Partner #12,Sales Receipt,Retail-NA,0,109270.23,USD,Fedwire Credit,ShopSphere Partner #12,***8605,INV-202402-Retail-NA-0004,,FALSE,FALSE,REF-527838,First Continental Bank,***4208,"Globex International Holdings, Inc.",US,10739635.6
22/02/2024,22/02/2024,Supplier Payment - ExpertNet Subcontractors #1,Supplier Payment,PS-GL,9321.01,0,USD,Wire Transfer,ExpertNet Subcontractors #1,***9368,,PO-202402-PS-GL-0005,FALSE,FALSE,REF-866783,First Continental Bank,***9985,"Globex International Holdings, Inc.",US,10730314.59
22/02/2024,22/02/2024,Supplier Payment - ExpertNet Subcontractors #13,Supplier Payment,PS-GL,20194.12,0,USD,ACH Debit,ExpertNet Subcontractors #13,***2690,,PO-202402-PS-GL-0007,FALSE,FALSE,REF-931304,First Continental Bank,***5009,"Globex International Holdings, Inc.",US,10710120.47
22/02/2024,22/02/2024,Supplier Payment - NorthRiver Apparel Mfg #6,Supplier Payment,Retail-NA,80001.97,0,USD,Wire Transfer,NorthRiver Apparel Mfg #6,***3406,,PO-202402-Retail-NA-0003,FALSE,FALSE,REF-278515,First Continental Bank,***2403,"Globex International Holdings, Inc.",US,10630118.5
22/02/2024,22/02/2024,VAT/GST Remittance - US IRS,Tax Payment,ALL,160108.98,0,USD,Wire Transfer,US IRS,***5133,,,FALSE,FALSE,REF-424664,First Continental Bank,***5791,"Globex International Holdings, Inc.",US,10470009.52
22/02/2024,22/02/2024,Client Receipt - Vertex Advisory Client #7,Sales Receipt,PS-GL,0,52706.39,USD,ACH Credit,Vertex Advisory Client #7,***2326,INV-202402-PS-GL-0003,,FALSE,FALSE,REF-212066,First Continental Bank,***3296,"Globex International Holdings, Inc.",US,10522715.91
22/02/2024,22/02/2024,Client Receipt - Vertex Advisory Client #48,Sales Receipt,PS-GL,0,57321.41,USD,Fedwire Credit,Vertex Advisory Client #48,***1132,INV-202402-PS-GL-0004,,FALSE,FALSE,REF-767021,First Continental Bank,***4583,"Globex International Holdings, Inc.",US,10580037.32
22/02/2024,22/02/2024,Client Receipt - ShopSphere Partner #19,Sales Receipt,Retail-NA,0,73236.78,USD,Fedwire Credit,ShopSphere Partner #19,***8922,INV-202402-Retail-NA-0005,,FALSE,FALSE,REF-679317,First Continental Bank,***7607,"Globex International Holdings, Inc.",US,10653274.1
23/02/2024,23/02/2024,Marketing - Beacon Digital #4,Marketing,ALL,31366.87,0,USD,Fedwire,Beacon Digital #4,***9636,,,FALSE,FALSE,REF-764967,First Continental Bank,***8761,"Globex International Holdings, Inc.",US,10621907.23
23/02/2024,23/02/2024,Client Receipt - CloudBridge Co. #35,Sales Receipt,SaaS-GL,0,6335.91,USD,ACH Credit,CloudBridge Co. #35,***5788,INV-202402-SaaS-GL-0013,,FALSE,FALSE,REF-362727,First Continental Bank,***3038,"Globex International Holdings, Inc.",US,10628243.14
23/02/2024,23/02/2024,Client Receipt - CloudBridge Co. #20,Sales Receipt,SaaS-GL,0,98094.63,USD,Card Settlement,CloudBridge Co. #20,***7815,INV-202402-SaaS-GL-0014,,FALSE,FALSE,REF-216809,First Continental Bank,***2336,"Globex International Holdings, Inc.",US,10726337.77
24/02/2024,24/02/2024,Supplier Payment - NorthRiver Apparel Mfg #9,Supplier Payment,Retail-NA,30543.03,0,USD,Fedwire,NorthRiver Apparel Mfg #9,***1859,,PO-202402-Retail-NA-0004,FALSE,FALSE,REF-203899,First Continental Bank,***8944,"Globex International Holdings, Inc.",US,10695794.74
25/02/2024,25/02/2024,Merchant Processing Fees,Bank/Merchant Fees,ALL,2122.74,0,USD,Wire Transfer,First Continental Bank,***1487,,,FALSE,FALSE,REF-981646,First Continental Bank,***6793,"Globex International Holdings, Inc.",US,10693672
25/02/2024,25/02/2024,Supplier Payment - ExpertNet Subcontractors #4,Supplier Payment,PS-GL,17417.35,0,USD,Fedwire,ExpertNet Subcontractors #4,***2433,,PO-202402-PS-GL-0003,FALSE,FALSE,REF-409290,First Continental Bank,***7700,"Globex International Holdings, Inc.",US,10676254.65
25/02/2024,25/02/2024,Client Receipt - CloudBridge Co. #4,Sales Receipt,SaaS-GL,0,96254.59,USD,Card Settlement,CloudBridge Co. #4,***2440,INV-202402-SaaS-GL-0004,,FALSE,FALSE,REF-157586,First Continental Bank,***8223,"Globex International Holdings, Inc.",US,10772509.24
26/02/2024,26/02/2024,Payroll - GlobalPay Services Ltd,Payroll,ALL,222322.7,0,USD,Wire Transfer,GlobalPay Services Ltd,***6200,,,FALSE,FALSE,REF-773664,First Continental Bank,***2916,"Globex International Holdings, Inc.",US,10550186.54
26/02/2024,26/02/2024,Intercompany Settlement - Globex Consulting UK Ltd.,Intercompany Transfer,ALL,763359,0,USD,Internal Transfer,Globex Consulting UK Ltd.,***5107,,,TRUE,TRUE,REF-589080,First Continental Bank,***2833,"Globex International Holdings, Inc.",US,9786827.54
26/02/2024,26/02/2024,Client Receipt - ShopSphere Partner #68,Sales Receipt,Retail-NA,0,6890.61,USD,Card Settlement,ShopSphere Partner #68,***8681,INV-202402-Retail-NA-0002,,FALSE,FALSE,REF-992991,First Continental Bank,***7097,"Globex International Holdings, Inc.",US,9793718.15
26/02/2024,26/02/2024,Client Receipt - CloudBridge Co. #18,Sales Receipt,SaaS-GL,0,137960.05,USD,Card Settlement,CloudBridge Co. #18,***7316,INV-202402-SaaS-GL-0007,,FALSE,FALSE,REF-976142,First Continental Bank,***3513,"Globex International Holdings, Inc.",US,9931678.2
26/02/2024,26/02/2024,Client Receipt - ShopSphere Partner #42,Sales Receipt,Retail-NA,0,177848.48,USD,ACH Credit,ShopSphere Partner #42,***8232,INV-202402-Retail-NA-0003,,FALSE,FALSE,REF-393712,First Continental Bank,***6560,"Globex International Holdings, Inc.",US,10109526.68
26/02/2024,26/02/2024,Intercompany Reimbursement - Globex Consulting UK Ltd.,Intercompany Transfer,ALL,0,305343.6,USD,Internal Transfer,Globex Consulting UK Ltd.,***3479,,,TRUE,TRUE,REF-289342,First Continental Bank,***3545,"Globex International Holdings, Inc.",US,10414870.28
27/02/2024,27/02/2024,Supplier Payment - ExpertNet Subcontractors #15,Supplier Payment,PS-GL,13557.62,0,USD,Wire Transfer,ExpertNet Subcontractors #15,***5954,,PO-202402-PS-GL-0008,FALSE,FALSE,REF-672792,First Continental Bank,***2080,"Globex International Holdings, Inc.",US,10401312.66
27/02/2024,27/02/2024,Supplier Payment - NorthRiver Apparel Mfg #5,Supplier Payment,Retail-NA,91464.68,0,USD,Wire Transfer,NorthRiver Apparel Mfg #5,***1760,,PO-202402-Retail-NA-0002,FALSE,FALSE,REF-439535,First Continental Bank,***9277,"Globex International Holdings, Inc.",US,10309847.98
28/02/2024,28/02/2024,Alphagrid Utilities,Rent & Utilities,ALL,18100.05,0,USD,ACH Debit,Alphagrid Utilities,***8476,,,FALSE,FALSE,REF-276420,First Continental Bank,***1474,"Globex International Holdings, Inc.",US,10291747.93
28/02/2024,28/02/2024,Supplier Payment - ExpertNet Subcontractors #7,Supplier Payment,PS-GL,53139.05,0,USD,Wire Transfer,ExpertNet Subcontractors #7,***4521,,PO-202402-PS-GL-0001,FALSE,FALSE,REF-572431,First Continental Bank,***8845,"Globex International Holdings, Inc.",US,10238608.88
28/02/2024,28/02/2024,Supplier Payment - CodeCraft Contractors #12,Supplier Payment,SaaS-GL,54112.7,0,USD,ACH Debit,CodeCraft Contractors #12,***4546,,PO-202402-SaaS-GL-0008,FALSE,FALSE,REF-472452,First Continental Bank,***6075,"Globex International Holdings, Inc.",US,10184496.18
28/02/2024,28/02/2024,Supplier Payment - NorthRiver Apparel Mfg #9,Supplier Payment,Retail-NA,116571,0,USD,Wire Transfer,NorthRiver Apparel Mfg #9,***9931,,PO-202402-Retail-NA-0001,FALSE,FALSE,REF-999152,First Continental Bank,***2266,"Globex International Holdings, Inc.",US,10067925.18
28/02/2024,28/02/2024,Client Receipt - CloudBridge Co. #14,Sales Receipt,SaaS-GL,0,13621.73,USD,Card Settlement,CloudBridge Co. #14,***7667,INV-202402-SaaS-GL-0002,,FALSE,FALSE,REF-198415,First Continental Bank,***9558,"Globex International Holdings, Inc.",US,10081546.91
28/02/2024,28/02/2024,Client Receipt - CloudBridge Co. #27,Sales Receipt,SaaS-GL,0,25408.21,USD,ACH Credit,CloudBridge Co. #27,***1757,INV-202402-SaaS-GL-0001,,FALSE,FALSE,REF-906411,First Continental Bank,***6950,"Globex International Holdings, Inc.",US,10106955.12
29/02/2024,29/02/2024,Supplier Payment - ExpertNet Subcontractors #7,Supplier Payment,PS-GL,5339.89,0,USD,ACH Debit,ExpertNet Subcontractors #7,***9083,,PO-202402-PS-GL-0010,FALSE,FALSE,REF-327980,First Continental Bank,***6022,"Globex International Holdings, Inc.",US,10101615.23
29/02/2024,29/02/2024,Supplier Payment - PackFast Fulfillment #16,Supplier Payment,Retail-NA,76650.09,0,USD,Wire Transfer,PackFast Fulfillment #16,***3934,,PO-202402-Retail-NA-0007,FALSE,FALSE,REF-703429,First Continental Bank,***7703,"Globex International Holdings, Inc.",US,10024965.14
29/02/2024,29/02/2024,Payroll - GlobalPay Services Ltd,Payroll,ALL,222322.7,0,USD,Fedwire,GlobalPay Services Ltd,***4382,,,FALSE,FALSE,REF-503500,First Continental Bank,***8905,"Globex International Holdings, Inc.",US,9802642.44
29/02/2024,29/02/2024,Interest Earned,Interest Income,ALL,0,9480.08,USD,ACH Credit,First Continental Bank,***4573,,,FALSE,FALSE,REF-403714,First Continental Bank,***2792,"Globex International Holdings, Inc.",US,9812122.52
29/02/2024,29/02/2024,Client Receipt - CloudBridge Co. #19,Sales Receipt,SaaS-GL,0,15884.93,USD,Card Settlement,CloudBridge Co. #19,***4049,INV-202402-SaaS-GL-0009,,FALSE,FALSE,REF-339098,First Continental Bank,***1826,"Globex International Holdings, Inc.",US,9828007.45
29/02/2024,29/02/2024,Client Receipt - CloudBridge Co. #1,Sales Receipt,SaaS-GL,0,169860.09,USD,ACH Credit,CloudBridge Co. #1,***9972,INV-202402-SaaS-GL-0010,,FALSE,FALSE,REF-269787,First Continental Bank,***4283,"Globex International Holdings, Inc.",US,9997867.54
01/03/2024,01/03/2024,Account Maintenance Fee,Bank/Merchant Fees,ALL,2500,0,USD,ACH Debit,First Continental Bank,***6871,,,FALSE,FALSE,REF-252075,First Continental Bank,***6580,"Globex International Holdings, Inc.",US,9995367.54
01/03/2024,01/03/2024,Supplier Payment - ExpertNet Subcontractors #18,Supplier Payment,PS-GL,45194.95,0,USD,ACH Debit,ExpertNet Subcontractors #18,***4673,,PO-202403-PS-GL-0008,FALSE,FALSE,REF-865963,First Continental Bank,***9173,"Globex International Holdings, Inc.",US,9950172.59
01/03/2024,01/03/2024,Client Receipt - CloudBridge Co. #25,Sales Receipt,SaaS-GL,0,58334.21,USD,ACH Credit,CloudBridge Co. #25,***9309,INV-202403-SaaS-GL-0019,,FALSE,FALSE,REF-762214,First Continental Bank,***8457,"Globex International Holdings, Inc.",US,10008506.8
03/03/2024,03/03/2024,Client Receipt - Vertex Advisory Client #16,Sales Receipt,PS-GL,0,62033.72,USD,Fedwire Credit,Vertex Advisory Client #16,***1035,INV-202403-PS-GL-0009,,FALSE,FALSE,REF-263785,First Continental Bank,***4608,"Globex International Holdings, Inc.",US,10070540.52
04/03/2024,04/03/2024,Supplier Payment - NorthRiver Apparel Mfg #29,Supplier Payment,Retail-NA,8548.58,0,USD,Fedwire,NorthRiver Apparel Mfg #29,***9580,,PO-202403-Retail-NA-0006,FALSE,FALSE,REF-686697,First Continental Bank,***2417,"Globex International Holdings, Inc.",US,10061991.94
04/03/2024,04/03/2024,Marketing - Aurelia Media #2,Marketing,ALL,18086.76,0,USD,Wire Transfer,Aurelia Media #2,***1917,,,FALSE,FALSE,REF-572939,First Continental Bank,***8922,"Globex International Holdings, Inc.",US,10043905.18
04/03/2024,04/03/2024,Marketing - Aurelia Media #4,Marketing,ALL,50521.44,0,USD,Fedwire,Aurelia Media #4,***6497,,,FALSE,FALSE,REF-120381,First Continental Bank,***1245,"Globex International Holdings, Inc.",US,9993383.74
04/03/2024,04/03/2024,Supplier Payment - HyperCloud Infra #15,Supplier Payment,SaaS-GL,88994.79,0,USD,Wire Transfer,HyperCloud Infra #15,***9885,,PO-202403-SaaS-GL-0006,FALSE,FALSE,REF-525950,First Continental Bank,***2230,"Globex International Holdings, Inc.",US,9904388.95
04/03/2024,04/03/2024,Client Receipt - CloudBridge Co. #65,Sales Receipt,SaaS-GL,0,15563.68,USD,Card Settlement,CloudBridge Co. #65,***8052,INV-202403-SaaS-GL-0034,,FALSE,FALSE,REF-258626,First Continental Bank,***2208,"Globex International Holdings, Inc.",US,9919952.63
04/03/2024,04/03/2024,Client Receipt - Vertex Advisory Client #22,Sales Receipt,PS-GL,0,21606.49,USD,Fedwire Credit,Vertex Advisory Client #22,***7085,INV-202403-PS-GL-0001,,FALSE,FALSE,REF-768354,First Continental Bank,***8633,"Globex International Holdings, Inc.",US,9941559.12
04/03/2024,04/03/2024,Client Receipt - CloudBridge Co. #64,Sales Receipt,SaaS-GL,0,55699.55,USD,Fedwire Credit,CloudBridge Co. #64,***5269,INV-202403-SaaS-GL-0004,,FALSE,FALSE,REF-641698,First Continental Bank,***7635,"Globex International Holdings, Inc.",US,9997258.67
04/03/2024,04/03/2024,Client Receipt - ShopSphere Partner #17,Sales Receipt,Retail-NA,0,315338.09,USD,Fedwire Credit,ShopSphere Partner #17,***4326,INV-202403-Retail-NA-0013,,FALSE,FALSE,REF-189175,First Continental Bank,***5859,"Globex International Holdings, Inc.",US,10312596.76
05/03/2024,05/03/2024,Supplier Payment - ExpertNet Subcontractors #10,Supplier Payment,PS-GL,17802.95,0,USD,Wire Transfer,ExpertNet Subcontractors #10,***1833,,PO-202403-PS-GL-0003,FALSE,FALSE,REF-776929,First Continental Bank,***5682,"Globex International Holdings, Inc.",US,10294793.81
05/03/2024,05/03/2024,Supplier Payment - HyperCloud Infra #17,Supplier Payment,SaaS-GL,26663.1,0,USD,Wire Transfer,HyperCloud Infra #17,***8073,,PO-202403-SaaS-GL-0005,FALSE,FALSE,REF-294597,First Continental Bank,***9560,"Globex International Holdings, Inc.",US,10268130.71
05/03/2024,05/03/2024,Supplier Payment - NorthRiver Apparel Mfg #21,Supplier Payment,Retail-NA,38439.12,0,USD,Fedwire,NorthRiver Apparel Mfg #21,***3345,,PO-202403-Retail-NA-0010,FALSE,FALSE,REF-977250,First Continental Bank,***8083,"Globex International Holdings, Inc.",US,10229691.59
05/03/2024,05/03/2024,Supplier Payment - ExpertNet Subcontractors #14,Supplier Payment,PS-GL,54389.24,0,USD,ACH Debit,ExpertNet Subcontractors #14,***1009,,PO-202403-PS-GL-0001,FALSE,FALSE,REF-645219,First Continental Bank,***2651,"Globex International Holdings, Inc.",US,10175302.35
05/03/2024,05/03/2024,Supplier Payment - PackFast Fulfillment #13,Supplier Payment,Retail-NA,154731.44,0,USD,ACH Debit,PackFast Fulfillment #13,***8134,,PO-202403-Retail-NA-0012,FALSE,FALSE,REF-882993,First Continental Bank,***7693,"Globex International Holdings, Inc.",US,10020570.91
05/03/2024,05/03/2024,Client Receipt - CloudBridge Co. #58,Sales Receipt,SaaS-GL,0,41766.91,USD,Fedwire Credit,CloudBridge Co. #58,***3068,INV-202403-SaaS-GL-0029,,FALSE,FALSE,REF-698373,First Continental Bank,***8266,"Globex International Holdings, Inc.",US,10062337.82
05/03/2024,05/03/2024,Client Receipt - Vertex Advisory Client #28,Sales Receipt,PS-GL,0,108780.6,USD,ACH Credit,Vertex Advisory Client #28,***4159,INV-202403-PS-GL-0002,,FALSE,FALSE,REF-194940,First Continental Bank,***1673,"Globex International Holdings, Inc.",US,10171118.42
06/03/2024,06/03/2024,Marketing - Beacon Digital #3,Marketing,ALL,9849.46,0,USD,Wire Transfer,Beacon Digital #3,***9099,,,FALSE,FALSE,REF-206578,First Continental Bank,***8120,"Globex International Holdings, Inc.",US,10161268.96
06/03/2024,06/03/2024,Supplier Payment - ExpertNet Subcontractors #2,Supplier Payment,PS-GL,13249.38,0,USD,ACH Debit,ExpertNet Subcontractors #2,***4254,,PO-202403-PS-GL-0006,FALSE,FALSE,REF-885531,First Continental Bank,***4416,"Globex International Holdings, Inc.",US,10148019.58
06/03/2024,06/03/2024,Supplier Payment - NorthRiver Apparel Mfg #26,Supplier Payment,Retail-NA,133493.16,0,USD,Wire Transfer,NorthRiver Apparel Mfg #26,***9394,,PO-202403-Retail-NA-0003,FALSE,FALSE,REF-772701,First Continental Bank,***2465,"Globex International Holdings, Inc.",US,10014526.42
06/03/2024,06/03/2024,Client Receipt - CloudBridge Co. #29,Sales Receipt,SaaS-GL,0,20357.87,USD,Card Settlement,CloudBridge Co. #29,***5466,INV-202403-SaaS-GL-0030,,FALSE,FALSE,REF-275475,First Continental Bank,***6676,"Globex International Holdings, Inc.",US,10034884.29
06/03/2024,06/03/2024,Client Receipt - ShopSphere Partner #4,Sales Receipt,Retail-NA,0,90199.67,USD,ACH Credit,ShopSphere Partner #4,***9000,INV-202403-Retail-NA-0012,,FALSE,FALSE,REF-847943,First Continental Bank,***5093,"Globex International Holdings, Inc.",US,10125083.96
07/03/2024,07/03/2024,Supplier Payment - ExpertNet Subcontractors #9,Supplier Payment,PS-GL,3962.33,0,USD,Fedwire,ExpertNet Subcontractors #9,***7239,,PO-202403-PS-GL-0009,FALSE,FALSE,REF-947653,First Continental Bank,***8723,"Globex International Holdings, Inc.",US,10121121.63
07/03/2024,07/03/2024,Client Receipt - Vertex Advisory Client #42,Sales Receipt,PS-GL,0,149.85,USD,Card Settlement,Vertex Advisory Client #42,***4477,INV-202403-PS-GL-0011,,FALSE,FALSE,REF-296489,First Continental Bank,***8153,"Globex International Holdings, Inc.",US,10121271.48
07/03/2024,07/03/2024,Client Receipt - CloudBridge Co. #9,Sales Receipt,SaaS-GL,0,10705.28,USD,Fedwire Credit,CloudBridge Co. #9,***4345,INV-202403-SaaS-GL-0035,,FALSE,FALSE,REF-267057,First Continental Bank,***8072,"Globex International Holdings, Inc.",US,10131976.76
08/03/2024,08/03/2024,Supplier Payment - NorthRiver Apparel Mfg #4,Supplier Payment,Retail-NA,105082.91,0,USD,ACH Debit,NorthRiver Apparel Mfg #4,***3785,,PO-202403-Retail-NA-0009,FALSE,FALSE,REF-708018,First Continental Bank,***2015,"Globex International Holdings, Inc.",US,10026893.85
08/03/2024,08/03/2024,Client Receipt - CloudBridge Co. #13,Sales Receipt,SaaS-GL,0,8527.74,USD,ACH Credit,CloudBridge Co. #13,***4445,INV-202403-SaaS-GL-0017,,FALSE,FALSE,REF-317396,First Continental Bank,***2630,"Globex International Holdings, Inc.",US,10035421.59
08/03/2024,08/03/2024,Client Receipt - Vertex Advisory Client #14,Sales Receipt,PS-GL,0,8990.53,USD,Card Settlement,Vertex Advisory Client #14,***7637,INV-202403-PS-GL-0008,,FALSE,FALSE,REF-175716,First Continental Bank,***9712,"Globex International Holdings, Inc.",US,10044412.12
09/03/2024,09/03/2024,Supplier Payment - HyperCloud Infra #18,Supplier Payment,SaaS-GL,12176.42,0,USD,ACH Debit,HyperCloud Infra #18,***4805,,PO-202403-SaaS-GL-0004,FALSE,FALSE,REF-574366,First Continental Bank,***8557,"Globex International Holdings, Inc.",US,10032235.7
10/03/2024,10/03/2024,Client Receipt - Vertex Advisory Client #1,Sales Receipt,PS-GL,0,27544.58,USD,Fedwire Credit,Vertex Advisory Client #1,***2315,INV-202403-PS-GL-0006,,FALSE,FALSE,REF-678988,First Continental Bank,***1490,"Globex International Holdings, Inc.",US,10059780.28
11/03/2024,11/03/2024,Supplier Payment - ExpertNet Subcontractors #8,Supplier Payment,PS-GL,7092.22,0,USD,Fedwire,ExpertNet Subcontractors #8,***2511,,PO-202403-PS-GL-0007,FALSE,FALSE,REF-633592,First Continental Bank,***6568,"Globex International Holdings, Inc.",US,10052688.06
11/03/2024,11/03/2024,Supplier Payment - ExpertNet Subcontractors #7,Supplier Payment,PS-GL,13009.89,0,USD,Fedwire,ExpertNet Subcontractors #7,***9957,,PO-202403-PS-GL-0010,FALSE,FALSE,REF-734037,First Continental Bank,***8447,"Globex International Holdings, Inc.",US,10039678.17
11/03/2024,11/03/2024,Supplier Payment - HyperCloud Infra #10,Supplier Payment,SaaS-GL,20092.65,0,USD,Wire Transfer,HyperCloud Infra #10,***2345,,PO-202403-SaaS-GL-0001,FALSE,FALSE,REF-756532,First Continental Bank,***6612,"Globex International Holdings, Inc.",US,10019585.52
11/03/2024,11/03/2024,Client Receipt - CloudBridge Co. #69,Sales Receipt,SaaS-GL,0,1555.19,USD,Fedwire Credit,CloudBridge Co. #69,***9340,INV-202403-SaaS-GL-0032,,FALSE,FALSE,REF-851812,First Continental Bank,***4626,"Globex International Holdings, Inc.",US,10021140.71
11/03/2024,11/03/2024,Client Receipt - CloudBridge Co. #17,Sales Receipt,SaaS-GL,0,27782.7,USD,Fedwire Credit,CloudBridge Co. #17,***3250,INV-202403-SaaS-GL-0007,,FALSE,FALSE,REF-184117,First Continental Bank,***2725,"Globex International Holdings, Inc.",US,10048923.41
12/03/2024,12/03/2024,Intercompany Settlement - Globex APAC Logistics Pte. Ltd.,Intercompany Transfer,ALL,508462,0,USD,Internal Transfer,Globex APAC Logistics Pte. Ltd.,***3269,,,TRUE,TRUE,REF-643360,First Continental Bank,***1700,"Globex International Holdings, Inc.",US,9540461.41
12/03/2024,12/03/2024,Client Receipt - CloudBridge Co. #29,Sales Receipt,SaaS-GL,0,8804.95,USD,ACH Credit,CloudBridge Co. #29,***4702,INV-202403-SaaS-GL-0008,,FALSE,FALSE,REF-296824,First Continental Bank,***2010,"Globex International Holdings, Inc.",US,9549266.36
12/03/2024,12/03/2024,Client Receipt - CloudBridge Co. #67,Sales Receipt,SaaS-GL,0,33345,USD,Fedwire Credit,CloudBridge Co. #67,***2181,INV-202403-SaaS-GL-0024,,FALSE,FALSE,REF-206496,First Continental Bank,***2395,"Globex International Holdings, Inc.",US,9582611.36
12/03/2024,12/03/2024,Client Receipt - ShopSphere Partner #67,Sales Receipt,Retail-NA,0,160395.53,USD,ACH Credit,ShopSphere Partner #67,***8902,INV-202403-Retail-NA-0006,,FALSE,FALSE,REF-913234,First Continental Bank,***9772,"Globex International Holdings, Inc.",US,9743006.89
12/03/2024,12/03/2024,Intercompany Reimbursement - Globex APAC Logistics Pte. Ltd.,Intercompany Transfer,ALL,0,203384.8,USD,Internal Transfer,Globex APAC Logistics Pte. Ltd.,***7158,,,TRUE,TRUE,REF-733557,First Continental Bank,***3510,"Globex International Holdings, Inc.",US,9946391.69
13/03/2024,13/03/2024,Client Receipt - CloudBridge Co. #27,Sales Receipt,SaaS-GL,0,6907.75,USD,Card Settlement,CloudBridge Co. #27,***4448,INV-202403-SaaS-GL-0010,,FALSE,FALSE,REF-399249,First Continental Bank,***7902,"Globex International Holdings, Inc.",US,9953299.44
14/03/2024,14/03/2024,Merchant Processing Fees,Bank/Merchant Fees,ALL,1511.68,0,USD,ACH Debit,First Continental Bank,***8764,,,FALSE,FALSE,REF-802314,First Continental Bank,***4312,"Globex International Holdings, Inc.",US,9951787.76
14/03/2024,14/03/2024,Client Receipt - ShopSphere Partner #75,Sales Receipt,Retail-NA,0,5393.1,USD,ACH Credit,ShopSphere Partner #75,***8704,INV-202403-Retail-NA-0003,,FALSE,FALSE,REF-234312,First Continental Bank,***1856,"Globex International Holdings, Inc.",US,9957180.86
14/03/2024,14/03/2024,Client Receipt - CloudBridge Co. #48,Sales Receipt,SaaS-GL,0,10604.24,USD,Fedwire Credit,CloudBridge Co. #48,***8776,INV-202403-SaaS-GL-0026,,FALSE,FALSE,REF-771088,First Continental Bank,***2168,"Globex International Holdings, Inc.",US,9967785.1
14/03/2024,14/03/2024,Client Receipt - ShopSphere Partner #63,Sales Receipt,Retail-NA,0,194799.11,USD,Fedwire Credit,ShopSphere Partner #63,***8721,INV-202403-Retail-NA-0005,,FALSE,FALSE,REF-210801,First Continental Bank,***2401,"Globex International Holdings, Inc.",US,10162584.21
15/03/2024,15/03/2024,Supplier Payment - ExpertNet Subcontractors #6,Supplier Payment,PS-GL,20200.01,0,USD,ACH Debit,ExpertNet Subcontractors #6,***9852,,PO-202403-PS-GL-0004,FALSE,FALSE,REF-108380,First Continental Bank,***9929,"Globex International Holdings, Inc.",US,10142384.2
15/03/2024,15/03/2024,Supplier Payment - PackFast Fulfillment #3,Supplier Payment,Retail-NA,38451.42,0,USD,ACH Debit,PackFast Fulfillment #3,***2054,,PO-202403-Retail-NA-0007,FALSE,FALSE,REF-286163,First Continental Bank,***5510,"Globex International Holdings, Inc.",US,10103932.78
15/03/2024,15/03/2024,Loan Interest Payment,Loan Interest,ALL,85000,0,USD,Fedwire,First Continental Bank - Corporate Lending,***4903,,,FALSE,FALSE,REF-850597,First Continental Bank,***8584,"Globex International Holdings, Inc.",US,10018932.78
15/03/2024,15/03/2024,Loan Principal Repayment,Loan Principal,ALL,500000,0,USD,Wire Transfer,First Continental Bank - Corporate Lending,***1138,,,FALSE,FALSE,REF-110761,First Continental Bank,***3891,"Globex International Holdings, Inc.",US,9518932.78
15/03/2024,15/03/2024,Client Receipt - CloudBridge Co. #64,Sales Receipt,SaaS-GL,0,66386.37,USD,Card Settlement,CloudBridge Co. #64,***9761,INV-202403-SaaS-GL-0022,,FALSE,FALSE,REF-417846,First Continental Bank,***1280,"Globex International Holdings, Inc.",US,9585319.15
15/03/2024,15/03/2024,Client Receipt - CloudBridge Co. #40,Sales Receipt,SaaS-GL,0,79388.5,USD,ACH Credit,CloudBridge Co. #40,***6874,INV-202403-SaaS-GL-0028,,FALSE,FALSE,REF-361786,First Continental Bank,***9438,"Globex International Holdings, Inc.",US,9664707.65
16/03/2024,16/03/2024,Metro Water & Waste,Rent & Utilities,ALL,24937.47,0,USD,Wire Transfer,Metro Water & Waste,***5204,,,FALSE,FALSE,REF-995680,First Continental Bank,***5625,"Globex International Holdings, Inc.",US,9639770.18
17/03/2024,17/03/2024,Client Receipt - Vertex Advisory Client #11,Sales Receipt,PS-GL,0,55942.04,USD,Fedwire Credit,Vertex Advisory Client #11,***5741,INV-202403-PS-GL-0010,,FALSE,FALSE,REF-585204,First Continental Bank,***6881,"Globex International Holdings, Inc.",US,9695712.22
18/03/2024,18/03/2024,Supplier Payment - NorthRiver Apparel Mfg #25,Supplier Payment,Retail-NA,30189.96,0,USD,ACH Debit,NorthRiver Apparel Mfg #25,***1071,,PO-202403-Retail-NA-0005,FALSE,FALSE,REF-957604,First Continental Bank,***4201,"Globex International Holdings, Inc.",US,9665522.26
18/03/2024,18/03/2024,Supplier Payment - CodeCraft Contractors #9,Supplier Payment,SaaS-GL,47497.68,0,USD,Wire Transfer,CodeCraft Contractors #9,***2052,,PO-202403-SaaS-GL-0007,FALSE,FALSE,REF-965598,First Continental Bank,***6804,"Globex International Holdings, Inc.",US,9618024.58
18/03/2024,18/03/2024,VAT/GST Remittance - US IRS,Tax Payment,ALL,191184.05,0,USD,ACH Debit,US IRS,***2112,,,FALSE,FALSE,REF-814806,First Continental Bank,***9531,"Globex International Holdings, Inc.",US,9426840.53
18/03/2024,18/03/2024,Client Receipt - CloudBridge Co. #74,Sales Receipt,SaaS-GL,0,5985.25,USD,ACH Credit,CloudBridge Co. #74,***6510,INV-202403-SaaS-GL-0025,,FALSE,FALSE,REF-775051,First Continental Bank,***1583,"Globex International Holdings, Inc.",US,9432825.78
18/03/2024,18/03/2024,Client Receipt - CloudBridge Co. #75,Sales Receipt,SaaS-GL,0,13880.16,USD,Card Settlement,CloudBridge Co. #75,***6182,INV-202403-SaaS-GL-0001,,FALSE,FALSE,REF-158460,First Continental Bank,***4878,"Globex International Holdings, Inc.",US,9446705.94
18/03/2024,18/03/2024,Client Receipt - Card Settlement Batch #16,Sales Receipt,Retail-NA,0,75106.84,USD,Card Settlement,Card Settlement Batch #16,***1297,INV-202403-Retail-NA-0015,,FALSE,FALSE,REF-209806,First Continental Bank,***7767,"Globex International Holdings, Inc.",US,9521812.78
19/03/2024,19/03/2024,Supplier Payment - NorthRiver Apparel Mfg #23,Supplier Payment,Retail-NA,57036.09,0,USD,ACH Debit,NorthRiver Apparel Mfg #23,***7083,,PO-202403-Retail-NA-0008,FALSE,FALSE,REF-747982,First Continental Bank,***9029,"Globex International Holdings, Inc.",US,9464776.69
19/03/2024,19/03/2024,Client Receipt - CloudBridge Co. #53,Sales Receipt,SaaS-GL,0,11263.64,USD,ACH Credit,CloudBridge Co. #53,***5770,INV-202403-SaaS-GL-0023,,FALSE,FALSE,REF-108344,First Continental Bank,***7557,"Globex International Holdings, Inc.",US,9476040.33
19/03/2024,19/03/2024,Client Receipt - Vertex Advisory Client #3,Sales Receipt,PS-GL,0,31588.05,USD,ACH Credit,Vertex Advisory Client #3,***4975,INV-202403-PS-GL-0003,,FALSE,FALSE,REF-870780,First Continental Bank,***9012,"Globex International Holdings, Inc.",US,9507628.38
20/03/2024,20/03/2024,Supplier Payment - CodeCraft Contractors #3,Supplier Payment,SaaS-GL,24768.86,0,USD,Fedwire,CodeCraft Contractors #3,***8079,,PO-202403-SaaS-GL-0008,FALSE,FALSE,REF-769360,First Continental Bank,***1797,"Globex International Holdings, Inc.",US,9482859.52
20/03/2024,20/03/2024,Client Receipt - CloudBridge Co. #44,Sales Receipt,SaaS-GL,0,33439.77,USD,Card Settlement,CloudBridge Co. #44,***9075,INV-202403-SaaS-GL-0021,,FALSE,FALSE,REF-143192,First Continental Bank,***2316,"Globex International Holdings, Inc.",US,9516299.29
20/03/2024,20/03/2024,Client Receipt - ShopSphere Partner #46,Sales Receipt,Retail-NA,0,80363.41,USD,Fedwire Credit,ShopSphere Partner #46,***2978,INV-202403-Retail-NA-0010,,FALSE,FALSE,REF-305025,First Continental Bank,***8867,"Globex International Holdings, Inc.",US,9596662.7
20/03/2024,20/03/2024,Client Receipt - Vertex Advisory Client #38,Sales Receipt,PS-GL,0,259460.87,USD,ACH Credit,Vertex Advisory Client #38,***3236,INV-202403-PS-GL-0004,,FALSE,FALSE,REF-140400,First Continental Bank,***5627,"Globex International Holdings, Inc.",US,9856123.57
21/03/2024,21/03/2024,Client Receipt - CloudBridge Co. #30,Sales Receipt,SaaS-GL,0,2234.36,USD,Card Settlement,CloudBridge Co. #30,***9828,INV-202403-SaaS-GL-0033,,FALSE,FALSE,REF-314067,First Continental Bank,***6515,"Globex International Holdings, Inc.",US,9858357.93
21/03/2024,21/03/2024,Client Receipt - CloudBridge Co. #21,Sales Receipt,SaaS-GL,0,28650.13,USD,ACH Credit,CloudBridge Co. #21,***7217,INV-202403-SaaS-GL-0020,,FALSE,FALSE,REF-890870,First Continental Bank,***4324,"Globex International Holdings, Inc.",US,9887008.06
21/03/2024,21/03/2024,Client Receipt - ShopSphere Partner #56,Sales Receipt,Retail-NA,0,31784.91,USD,Fedwire Credit,ShopSphere Partner #56,***4231,INV-202403-Retail-NA-0002,,FALSE,FALSE,REF-121061,First Continental Bank,***3470,"Globex International Holdings, Inc.",US,9918792.97
22/03/2024,22/03/2024,Supplier Payment - ExpertNet Subcontractors #17,Supplier Payment,PS-GL,8345.55,0,USD,ACH Debit,ExpertNet Subcontractors #17,***2401,,PO-202403-PS-GL-0005,FALSE,FALSE,REF-847062,First Continental Bank,***4812,"Globex International Holdings, Inc.",US,9910447.42
22/03/2024,22/03/2024,Supplier Payment - HyperCloud Infra #13,Supplier Payment,SaaS-GL,10942.72,0,USD,Fedwire,HyperCloud Infra #13,***5226,,PO-202403-SaaS-GL-0002,FALSE,FALSE,REF-401216,First Continental Bank,***2801,"Globex International Holdings, Inc.",US,9899504.7
22/03/2024,22/03/2024,Supplier Payment - ExpertNet Subcontractors #1,Supplier Payment,PS-GL,30637.16,0,USD,ACH Debit,ExpertNet Subcontractors #1,***1794,,PO-202403-PS-GL-0002,FALSE,FALSE,REF-453309,First Continental Bank,***4745,"Globex International Holdings, Inc.",US,9868867.54
22/03/2024,22/03/2024,Client Receipt - CloudBridge Co. #73,Sales Receipt,SaaS-GL,0,16386.7,USD,Card Settlement,CloudBridge Co. #73,***1156,INV-202403-SaaS-GL-0009,,FALSE,FALSE,REF-352037,First Continental Bank,***6777,"Globex International Holdings, Inc.",US,9885254.24
22/03/2024,22/03/2024,Client Receipt - ShopSphere Partner #52,Sales Receipt,Retail-NA,0,24167.54,USD,ACH Credit,ShopSphere Partner #52,***7795,INV-202403-Retail-NA-0009,,FALSE,FALSE,REF-287445,First Continental Bank,***7113,"Globex International Holdings, Inc.",US,9909421.78
23/03/2024,23/03/2024,Client Receipt - CloudBridge Co. #72,Sales Receipt,SaaS-GL,0,53770.94,USD,Fedwire Credit,CloudBridge Co. #72,***5828,INV-202403-SaaS-GL-0018,,FALSE,FALSE,REF-641232,First Continental Bank,***4271,"Globex International Holdings, Inc.",US,9963192.72
23/03/2024,23/03/2024,Client Receipt - Vertex Advisory Client #19,Sales Receipt,PS-GL,0,74626.96,USD,ACH Credit,Vertex Advisory Client #19,***5805,INV-202403-PS-GL-0007,,FALSE,FALSE,REF-266516,First Continental Bank,***2373,"Globex International Holdings, Inc.",US,10037819.68
24/03/2024,24/03/2024,Client Receipt - ShopSphere Partner #78,Sales Receipt,Retail-NA,0,83018.84,USD,Fedwire Credit,ShopSphere Partner #78,***6107,INV-202403-Retail-NA-0011,,FALSE,FALSE,REF-285009,First Continental Bank,***7784,"Globex International Holdings, Inc.",US,10120838.52
25/03/2024,25/03/2024,Client Receipt - CloudBridge Co. #64,Sales Receipt,SaaS-GL,0,7934.17,USD,Fedwire Credit,CloudBridge Co. #64,***2250,INV-202403-SaaS-GL-0003,,FALSE,FALSE,REF-685461,First Continental Bank,***2078,"Globex International Holdings, Inc.",US,10128772.69
25/03/2024,25/03/2024,Client Receipt - CloudBridge Co. #13,Sales Receipt,SaaS-GL,0,13603.34,USD,Fedwire Credit,CloudBridge Co. #13,***6204,INV-202403-SaaS-GL-0027,,FALSE,FALSE,REF-340811,First Continental Bank,***9435,"Globex International Holdings, Inc.",US,10142376.03
25/03/2024,25/03/2024,Client Receipt - ShopSphere Partner #73,Sales Receipt,Retail-NA,0,20513.43,USD,Card Settlement,ShopSphere Partner #73,***5779,INV-202403-Retail-NA-0007,,FALSE,FALSE,REF-500042,First Continental Bank,***3486,"Globex International Holdings, Inc.",US,10162889.46
25/03/2024,25/03/2024,Client Receipt - CloudBridge Co. #71,Sales Receipt,SaaS-GL,0,34037.96,USD,ACH Credit,CloudBridge Co. #71,***5187,INV-202403-SaaS-GL-0012,,FALSE,FALSE,REF-413282,First Continental Bank,***7305,"Globex International Holdings, Inc.",US,10196927.42
25/03/2024,25/03/2024,Client Receipt - ShopSphere Partner #41,Sales Receipt,Retail-NA,0,177697.09,USD,Fedwire Credit,ShopSphere Partner #41,***4335,INV-202403-Retail-NA-0001,,FALSE,FALSE,REF-997498,First Continental Bank,***7933,"Globex International Holdings, Inc.",US,10374624.51
26/03/2024,26/03/2024,Supplier Payment - NorthRiver Apparel Mfg #32,Supplier Payment,Retail-NA,112091.92,0,USD,Fedwire,NorthRiver Apparel Mfg #32,***4401,,PO-202403-Retail-NA-0002,FALSE,FALSE,REF-157243,First Continental Bank,***7142,"Globex International Holdings, Inc.",US,10262532.59
26/03/2024,26/03/2024,Payroll - GlobalPay Services Ltd,Payroll,ALL,495552.02,0,USD,Wire Transfer,GlobalPay Services Ltd,***2740,,,FALSE,FALSE,REF-948892,First Continental Bank,***8527,"Globex International Holdings, Inc.",US,9766980.57
26/03/2024,26/03/2024,Intercompany Settlement - Globex Consulting UK Ltd.,Intercompany Transfer,ALL,895824,0,USD,Internal Transfer,Globex Consulting UK Ltd.,***6028,,,TRUE,TRUE,REF-919173,First Continental Bank,***7612,"Globex International Holdings, Inc.",US,8871156.57
26/03/2024,26/03/2024,Client Receipt - CloudBridge Co. #54,Sales Receipt,SaaS-GL,0,2671.81,USD,ACH Credit,CloudBridge Co. #54,***4851,INV-202403-SaaS-GL-0016,,FALSE,FALSE,REF-304031,First Continental Bank,***1267,"Globex International Holdings, Inc.",US,8873828.38
26/03/2024,26/03/2024,Client Receipt - CloudBridge Co. #22,Sales Receipt,SaaS-GL,0,19373.09,USD,Fedwire Credit,CloudBridge Co. #22,***2139,INV-202403-SaaS-GL-0013,,FALSE,FALSE,REF-971800,First Continental Bank,***8425,"Globex International Holdings, Inc.",US,8893201.47
26/03/2024,26/03/2024,Client Receipt - CloudBridge Co. #51,Sales Receipt,SaaS-GL,0,40026.75,USD,Fedwire Credit,CloudBridge Co. #51,***5097,INV-202403-SaaS-GL-0005,,FALSE,FALSE,REF-557077,First Continental Bank,***1816,"Globex International Holdings, Inc.",US,8933228.22
26/03/2024,26/03/2024,Client Receipt - CloudBridge Co. #34,Sales Receipt,SaaS-GL,0,56230.65,USD,ACH Credit,CloudBridge Co. #34,***7825,INV-202403-SaaS-GL-0031,,FALSE,FALSE,REF-317641,First Continental Bank,***8885,"Globex International Holdings, Inc.",US,8989458.87
27/03/2024,27/03/2024,Supplier Payment - NorthRiver Apparel Mfg #9,Supplier Payment,Retail-NA,14263.82,0,USD,Fedwire,NorthRiver Apparel Mfg #9,***3588,,PO-202403-Retail-NA-0001,FALSE,FALSE,REF-222995,First Continental Bank,***4830,"Globex International Holdings, Inc.",US,8975195.05
27/03/2024,27/03/2024,Client Receipt - ShopSphere Partner #1,Sales Receipt,Retail-NA,0,10106.9,USD,Fedwire Credit,ShopSphere Partner #1,***5883,INV-202403-Retail-NA-0014,,FALSE,FALSE,REF-400135,First Continental Bank,***2834,"Globex International Holdings, Inc.",US,8985301.95
27/03/2024,27/03/2024,Client Receipt - CloudBridge Co. #66,Sales Receipt,SaaS-GL,0,63013.02,USD,Fedwire Credit,CloudBridge Co. #66,***4271,INV-202403-SaaS-GL-0006,,FALSE,FALSE,REF-808227,First Continental Bank,***2741,"Globex International Holdings, Inc.",US,9048314.97
28/03/2024,28/03/2024,Client Receipt - ShopSphere Partner #32,Sales Receipt,Retail-NA,0,35622.6,USD,Card Settlement,ShopSphere Partner #32,***9062,INV-202403-Retail-NA-0004,,FALSE,FALSE,REF-118895,First Continental Bank,***4199,"Globex International Holdings, Inc.",US,9083937.57
28/03/2024,28/03/2024,Client Receipt - CloudBridge Co. #39,Sales Receipt,SaaS-GL,0,49387.29,USD,ACH Credit,CloudBridge Co. #39,***8557,INV-202403-SaaS-GL-0015,,FALSE,FALSE,REF-809583,First Continental Bank,***2853,"Globex International Holdings, Inc.",US,9133324.86
28/03/2024,28/03/2024,Client Receipt - Vertex Advisory Client #33,Sales Receipt,PS-GL,0,62221.9,USD,ACH Credit,Vertex Advisory Client #33,***8179,INV-202403-PS-GL-0005,,FALSE,FALSE,REF-806863,First Continental Bank,***6674,"Globex International Holdings, Inc.",US,9195546.76
29/03/2024,29/03/2024,Supplier Payment - HyperCloud Infra #1,Supplier Payment,SaaS-GL,4135.83,0,USD,ACH Debit,HyperCloud Infra #1,***7547,,PO-202403-SaaS-GL-0003,FALSE,FALSE,REF-239109,First Continental Bank,***2380,"Globex International Holdings, Inc.",US,9191410.93
29/03/2024,29/03/2024,Merchant Processing Fees,Bank/Merchant Fees,ALL,8043.68,0,USD,ACH Debit,First Continental Bank,***9713,,,FALSE,FALSE,REF-438251,First Continental Bank,***8071,"Globex International Holdings, Inc.",US,9183367.25
29/03/2024,29/03/2024,Supplier Payment - NorthRiver Apparel Mfg #22,Supplier Payment,Retail-NA,14254.95,0,USD,ACH Debit,NorthRiver Apparel Mfg #22,***6070,,PO-202403-Retail-NA-0011,FALSE,FALSE,REF-216990,First Continental Bank,***5412,"Globex International Holdings, Inc.",US,9169112.3
29/03/2024,29/03/2024,Client Receipt - Card Settlement Batch #5,Sales Receipt,Retail-NA,0,2559.86,USD,Card Settlement,Card Settlement Batch #5,***9368,INV-202403-Retail-NA-0008,,FALSE,FALSE,REF-422085,First Continental Bank,***9547,"Globex International Holdings, Inc.",US,9171672.16
29/03/2024,29/03/2024,Client Receipt - CloudBridge Co. #31,Sales Receipt,SaaS-GL,0,27787.39,USD,ACH Credit,CloudBridge Co. #31,***9124,INV-202403-SaaS-GL-0002,,FALSE,FALSE,REF-269377,First Continental Bank,***9353,"Globex International Holdings, Inc.",US,9199459.55
29/03/2024,29/03/2024,Client Receipt - CloudBridge Co. #61,Sales Receipt,SaaS-GL,0,56526.02,USD,ACH Credit,CloudBridge Co. #61,***8773,INV-202403-SaaS-GL-0014,,FALSE,FALSE,REF-657684,First Continental Bank,***4238,"Globex International Holdings, Inc.",US,9255985.57
30/03/2024,30/03/2024,Supplier Payment - NorthRiver Apparel Mfg #34,Supplier Payment,Retail-NA,12303.43,0,USD,Wire Transfer,NorthRiver Apparel Mfg #34,***9134,,PO-202403-Retail-NA-0004,FALSE,FALSE,REF-414050,First Continental Bank,***2900,"Globex International Holdings, Inc.",US,9243682.14
30/03/2024,30/03/2024,Interest Earned,Interest Income,ALL,0,7511.07,USD,Fedwire Credit,First Continental Bank,***7261,,,FALSE,FALSE,REF-171421,First Continental Bank,***3698,"Globex International Holdings, Inc.",US,9251193.21
31/03/2024,31/03/2024,Client Receipt - CloudBridge Co. #21,Sales Receipt,SaaS-GL,0,87486.01,USD,Card Settlement,CloudBridge Co. #21,***8067,INV-202403-SaaS-GL-0011,,FALSE,FALSE,REF-795767,First Continental Bank,***1049,"Globex International Holdings, Inc.",US,9338679.22
01/04/2024,01/04/2024,Account Maintenance Fee,Bank/Merchant Fees,ALL,2500,0,USD,Fedwire,First Continental Bank,***1851,,,FALSE,FALSE,REF-711238,First Continental Bank,***3689,"Globex International Holdings, Inc.",US,9336179.22
01/04/2024,01/04/2024,Client Receipt - Vertex Advisory Client #43,Sales Receipt,PS-GL,0,40435.1,USD,Fedwire Credit,Vertex Advisory Client #43,***5584,INV-202404-PS-GL-0004,,FALSE,FALSE,REF-169548,First Continental Bank,***9304,"Globex International Holdings, Inc.",US,9376614.32
01/04/2024,01/04/2024,Client Receipt - ShopSphere Partner #21,Sales Receipt,Retail-NA,0,47472.35,USD,Fedwire Credit,ShopSphere Partner #21,***7723,INV-202404-Retail-NA-0008,,FALSE,FALSE,REF-436482,First Continental Bank,***5810,"Globex International Holdings, Inc.",US,9424086.67
01/04/2024,01/04/2024,Client Receipt - Vertex Advisory Client #21,Sales Receipt,PS-GL,0,82429.29,USD,Card Settlement,Vertex Advisory Client #21,***3426,INV-202404-PS-GL-0006,,FALSE,FALSE,REF-569372,First Continental Bank,***5060,"Globex International Holdings, Inc.",US,9506515.96
02/04/2024,02/04/2024,Client Receipt - CloudBridge Co. #58,Sales Receipt,SaaS-GL,0,16673.16,USD,ACH Credit,CloudBridge Co. #58,***7149,INV-202404-SaaS-GL-0011,,FALSE,FALSE,REF-927470,First Continental Bank,***9975,"Globex International Holdings, Inc.",US,9523189.12
02/04/2024,02/04/2024,Client Receipt - CloudBridge Co. #30,Sales Receipt,SaaS-GL,0,32098.09,USD,Fedwire Credit,CloudBridge Co. #30,***6634,INV-202404-SaaS-GL-0015,,FALSE,FALSE,REF-372610,First Continental Bank,***3870,"Globex International Holdings, Inc.",US,9555287.21
03/04/2024,03/04/2024,Supplier Payment - ExpertNet Subcontractors #5,Supplier Payment,PS-GL,4412.59,0,USD,Wire Transfer,ExpertNet Subcontractors #5,***6679,,PO-202404-PS-GL-0001,FALSE,FALSE,REF-324299,First Continental Bank,***4596,"Globex International Holdings, Inc.",US,9550874.62
03/04/2024,03/04/2024,Supplier Payment - ExpertNet Subcontractors #6,Supplier Payment,PS-GL,23921.28,0,USD,Wire Transfer,ExpertNet Subcontractors #6,***7111,,PO-202404-PS-GL-0005,FALSE,FALSE,REF-853220,First Continental Bank,***3418,"Globex International Holdings, Inc.",US,9526953.34
03/04/2024,03/04/2024,Client Receipt - CloudBridge Co. #65,Sales Receipt,SaaS-GL,0,23348.49,USD,Card Settlement,CloudBridge Co. #65,***3739,INV-202404-SaaS-GL-0004,,FALSE,FALSE,REF-391652,First Continental Bank,***4104,"Globex International Holdings, Inc.",US,9550301.83
03/04/2024,03/04/2024,Client Receipt - ShopSphere Partner #40,Sales Receipt,Retail-NA,0,198024.89,USD,ACH Credit,ShopSphere Partner #40,***6925,INV-202404-Retail-NA-0013,,FALSE,FALSE,REF-578504,First Continental Bank,***6469,"Globex International Holdings, Inc.",US,9748326.72
05/04/2024,05/04/2024,Supplier Payment - ExpertNet Subcontractors #9,Supplier Payment,PS-GL,57838.12,0,USD,Wire Transfer,ExpertNet Subcontractors #9,***9676,,PO-202404-PS-GL-0011,FALSE,FALSE,REF-118537,First Continental Bank,***9104,"Globex International Holdings, Inc.",US,9690488.6
06/04/2024,06/04/2024,Client Receipt - CloudBridge Co. #77,Sales Receipt,SaaS-GL,0,10776.72,USD,Fedwire Credit,CloudBridge Co. #77,***7086,INV-202404-SaaS-GL-0005,,FALSE,FALSE,REF-314323,First Continental Bank,***6337,"Globex International Holdings, Inc.",US,9701265.32
06/04/2024,06/04/2024,Client Receipt - CloudBridge Co. #13,Sales Receipt,SaaS-GL,0,57904.87,USD,Card Settlement,CloudBridge Co. #13,***6790,INV-202404-SaaS-GL-0017,,FALSE,FALSE,REF-545629,First Continental Bank,***2842,"Globex International Holdings, Inc.",US,9759170.19
07/04/2024,07/04/2024,Supplier Payment - HyperCloud Infra #3,Supplier Payment,SaaS-GL,8995.08,0,USD,ACH Debit,HyperCloud Infra #3,***2484,,PO-202404-SaaS-GL-0009,FALSE,FALSE,REF-815491,First Continental Bank,***2663,"Globex International Holdings, Inc.",US,9750175.11
08/04/2024,08/04/2024,Supplier Payment - CodeCraft Contractors #4,Supplier Payment,SaaS-GL,43259.88,0,USD,Fedwire,CodeCraft Contractors #4,***1773,,PO-202404-SaaS-GL-0008,FALSE,FALSE,REF-867593,First Continental Bank,***9186,"Globex International Holdings, Inc.",US,9706915.23
08/04/2024,08/04/2024,Client Receipt - CloudBridge Co. #75,Sales Receipt,SaaS-GL,0,10395.88,USD,Fedwire Credit,CloudBridge Co. #75,***4106,INV-202404-SaaS-GL-0018,,FALSE,FALSE,REF-853875,First Continental Bank,***6373,"Globex International Holdings, Inc.",US,9717311.11
08/04/2024,08/04/2024,Client Receipt - CloudBridge Co. #28,Sales Receipt,SaaS-GL,0,83374.76,USD,Fedwire Credit,CloudBridge Co. #28,***5297,INV-202404-SaaS-GL-0021,,FALSE,FALSE,REF-764464,First Continental Bank,***9757,"Globex International Holdings, Inc.",US,9800685.87
08/04/2024,08/04/2024,Client Receipt - ShopSphere Partner #55,Sales Receipt,Retail-NA,0,204295.63,USD,Fedwire Credit,ShopSphere Partner #55,***8186,INV-202404-Retail-NA-0003,,FALSE,FALSE,REF-261906,First Continental Bank,***1557,"Globex International Holdings, Inc.",US,10004981.5
09/04/2024,09/04/2024,Supplier Payment - HyperCloud Infra #14,Supplier Payment,SaaS-GL,604.05,0,USD,Wire Transfer,HyperCloud Infra #14,***7906,,PO-202404-SaaS-GL-0003,FALSE,FALSE,REF-531866,First Continental Bank,***1732,"Globex International Holdings, Inc.",US,10004377.45
09/04/2024,09/04/2024,Supplier Payment - NorthRiver Apparel Mfg #17,Supplier Payment,Retail-NA,6376.55,0,USD,Wire Transfer,NorthRiver Apparel Mfg #17,***3293,,PO-202404-Retail-NA-0008,FALSE,FALSE,REF-335188,First Continental Bank,***3575,"Globex International Holdings, Inc.",US,9998000.9
09/04/2024,09/04/2024,Supplier Payment - ExpertNet Subcontractors #6,Supplier Payment,PS-GL,19876.42,0,USD,Wire Transfer,ExpertNet Subcontractors #6,***1438,,PO-202404-PS-GL-0008,FALSE,FALSE,REF-779519,First Continental Bank,***6897,"Globex International Holdings, Inc.",US,9978124.48
10/04/2024,10/04/2024,Supplier Payment - ExpertNet Subcontractors #4,Supplier Payment,PS-GL,4952.07,0,USD,Wire Transfer,ExpertNet Subcontractors #4,***8201,,PO-202404-PS-GL-0010,FALSE,FALSE,REF-347120,First Continental Bank,***9037,"Globex International Holdings, Inc.",US,9973172.41
10/04/2024,10/04/2024,Supplier Payment - HyperCloud Infra #3,Supplier Payment,SaaS-GL,22796.35,0,USD,ACH Debit,HyperCloud Infra #3,***2732,,PO-202404-SaaS-GL-0007,FALSE,FALSE,REF-252796,First Continental Bank,***2577,"Globex International Holdings, Inc.",US,9950376.06
10/04/2024,10/04/2024,Supplier Payment - PackFast Fulfillment #17,Supplier Payment,Retail-NA,82587.89,0,USD,Fedwire,PackFast Fulfillment #17,***9760,,PO-202404-Retail-NA-0005,FALSE,FALSE,REF-312474,First Continental Bank,***5628,"Globex International Holdings, Inc.",US,9867788.17
10/04/2024,10/04/2024,Supplier Payment - NorthRiver Apparel Mfg #8,Supplier Payment,Retail-NA,159911.92,0,USD,ACH Debit,NorthRiver Apparel Mfg #8,***3582,,PO-202404-Retail-NA-0006,FALSE,FALSE,REF-241884,First Continental Bank,***2596,"Globex International Holdings, Inc.",US,9707876.25
10/04/2024,10/04/2024,Client Receipt - Card Settlement Batch #6,Sales Receipt,Retail-NA,0,44501.04,USD,ACH Credit,Card Settlement Batch #6,***6409,INV-202404-Retail-NA-0009,,FALSE,FALSE,REF-487738,First Continental Bank,***7173,"Globex International Holdings, Inc.",US,9752377.29
10/04/2024,10/04/2024,Client Receipt - ShopSphere Partner #66,Sales Receipt,Retail-NA,0,62591.61,USD,Card Settlement,ShopSphere Partner #66,***7390,INV-202404-Retail-NA-0006,,FALSE,FALSE,REF-536273,First Continental Bank,***2817,"Globex International Holdings, Inc.",US,9814968.9
10/04/2024,10/04/2024,Client Receipt - CloudBridge Co. #73,Sales Receipt,SaaS-GL,0,137817.49,USD,Fedwire Credit,CloudBridge Co. #73,***4300,INV-202404-SaaS-GL-0001,,FALSE,FALSE,REF-923541,First Continental Bank,***4057,"Globex International Holdings, Inc.",US,9952786.39
11/04/2024,11/04/2024,Supplier Payment - NorthRiver Apparel Mfg #34,Supplier Payment,Retail-NA,61321.61,0,USD,ACH Debit,NorthRiver Apparel Mfg #34,***7342,,PO-202404-Retail-NA-0003,FALSE,FALSE,REF-592745,First Continental Bank,***4020,"Globex International Holdings, Inc.",US,9891464.78
11/04/2024,11/04/2024,Client Receipt - CloudBridge Co. #19,Sales Receipt,SaaS-GL,0,98323.36,USD,Card Settlement,CloudBridge Co. #19,***2123,INV-202404-SaaS-GL-0002,,FALSE,FALSE,REF-809964,First Continental Bank,***4512,"Globex International Holdings, Inc.",US,9989788.14
12/04/2024,12/04/2024,Intercompany Settlement - Globex Retail NA LLC,Intercompany Transfer,ALL,235611,0,USD,Internal Transfer,Globex Retail NA LLC,***5433,,,TRUE,TRUE,REF-340326,First Continental Bank,***8005,"Globex International Holdings, Inc.",US,9754177.14
12/04/2024,12/04/2024,Client Receipt - Vertex Advisory Client #16,Sales Receipt,PS-GL,0,6772.59,USD,Card Settlement,Vertex Advisory Client #16,***4745,INV-202404-PS-GL-0003,,FALSE,FALSE,REF-782452,First Continental Bank,***7217,"Globex International Holdings, Inc.",US,9760949.73
12/04/2024,12/04/2024,Client Receipt - CloudBridge Co. #29,Sales Receipt,SaaS-GL,0,16865.96,USD,ACH Credit,CloudBridge Co. #29,***7104,INV-202404-SaaS-GL-0010,,FALSE,FALSE,REF-887053,First Continental Bank,***3788,"Globex International Holdings, Inc.",US,9777815.69
12/04/2024,12/04/2024,Client Receipt - ShopSphere Partner #46,Sales Receipt,Retail-NA,0,45955.08,USD,Card Settlement,ShopSphere Partner #46,***8531,INV-202404-Retail-NA-0002,,FALSE,FALSE,REF-191936,First Continental Bank,***4325,"Globex International Holdings, Inc.",US,9823770.77
12/04/2024,12/04/2024,Client Receipt - CloudBridge Co. #11,Sales Receipt,SaaS-GL,0,62990.78,USD,Card Settlement,CloudBridge Co. #11,***3017,INV-202404-SaaS-GL-0006,,FALSE,FALSE,REF-407165,First Continental Bank,***5757,"Globex International Holdings, Inc.",US,9886761.55
12/04/2024,12/04/2024,Client Receipt - CloudBridge Co. #57,Sales Receipt,SaaS-GL,0,162645.62,USD,Card Settlement,CloudBridge Co. #57,***1733,INV-202404-SaaS-GL-0013,,FALSE,FALSE,REF-595024,First Continental Bank,***8980,"Globex International Holdings, Inc.",US,10049407.17
13/04/2024,13/04/2024,Supplier Payment - NorthRiver Apparel Mfg #11,Supplier Payment,Retail-NA,3372.1,0,USD,Wire Transfer,NorthRiver Apparel Mfg #11,***4351,,PO-202404-Retail-NA-0004,FALSE,FALSE,REF-209958,First Continental Bank,***5629,"Globex International Holdings, Inc.",US,10046035.07
13/04/2024,13/04/2024,Client Receipt - CloudBridge Co. #68,Sales Receipt,SaaS-GL,0,11938.79,USD,Card Settlement,CloudBridge Co. #68,***5401,INV-202404-SaaS-GL-0016,,FALSE,FALSE,REF-562717,First Continental Bank,***5462,"Globex International Holdings, Inc.",US,10057973.86
13/04/2024,13/04/2024,Client Receipt - CloudBridge Co. #15,Sales Receipt,SaaS-GL,0,17857.95,USD,Card Settlement,CloudBridge Co. #15,***3251,INV-202404-SaaS-GL-0023,,FALSE,FALSE,REF-980860,First Continental Bank,***5932,"Globex International Holdings, Inc.",US,10075831.81
14/04/2024,14/04/2024,Client Receipt - CloudBridge Co. #5,Sales Receipt,SaaS-GL,0,69940.5,USD,Fedwire Credit,CloudBridge Co. #5,***9156,INV-202404-SaaS-GL-0022,,FALSE,FALSE,REF-672377,First Continental Bank,***8030,"Globex International Holdings, Inc.",US,10145772.31
15/04/2024,15/04/2024,Supplier Payment - ExpertNet Subcontractors #6,Supplier Payment,PS-GL,8797.58,0,USD,Wire Transfer,ExpertNet Subcontractors #6,***2659,,PO-202404-PS-GL-0002,FALSE,FALSE,REF-127963,First Continental Bank,***7447,"Globex International Holdings, Inc.",US,10136974.73
15/04/2024,15/04/2024,Supplier Payment - HyperCloud Infra #3,Supplier Payment,SaaS-GL,26673.83,0,USD,Wire Transfer,HyperCloud Infra #3,***1158,,PO-202404-SaaS-GL-0005,FALSE,FALSE,REF-499395,First Continental Bank,***5701,"Globex International Holdings, Inc.",US,10110300.9
15/04/2024,15/04/2024,Supplier Payment - CodeCraft Contractors #6,Supplier Payment,SaaS-GL,28233.99,0,USD,ACH Debit,CodeCraft Contractors #6,***4916,,PO-202404-SaaS-GL-0002,FALSE,FALSE,REF-228497,First Continental Bank,***7631,"Globex International Holdings, Inc.",US,10082066.91
15/04/2024,15/04/2024,Loan Interest Payment,Loan Interest,ALL,85000,0,USD,ACH Debit,First Continental Bank - Corporate Lending,***1532,,,FALSE,FALSE,REF-301598,First Continental Bank,***2160,"Globex International Holdings, Inc.",US,9997066.91
15/04/2024,15/04/2024,Supplier Payment - PackFast Fulfillment #3,Supplier Payment,Retail-NA,119060.9,0,USD,ACH Debit,PackFast Fulfillment #3,***5489,,PO-202404-Retail-NA-0007,FALSE,FALSE,REF-936041,First Continental Bank,***5929,"Globex International Holdings, Inc.",US,9878006.01
15/04/2024,15/04/2024,Loan Principal Repayment,Loan Principal,ALL,500000,0,USD,Wire Transfer,First Continental Bank - Corporate Lending,***4772,,,FALSE,FALSE,REF-687714,First Continental Bank,***1291,"Globex International Holdings, Inc.",US,9378006.01
15/04/2024,15/04/2024,Client Receipt - ShopSphere Partner #8,Sales Receipt,Retail-NA,0,55269.73,USD,Fedwire Credit,ShopSphere Partner #8,***3587,INV-202404-Retail-NA-0010,,FALSE,FALSE,REF-996933,First Continental Bank,***6857,"Globex International Holdings, Inc.",US,9433275.74
16/04/2024,16/04/2024,Supplier Payment - ExpertNet Subcontractors #8,Supplier Payment,PS-GL,2559.7,0,USD,ACH Debit,ExpertNet Subcontractors #8,***8185,,PO-202404-PS-GL-0006,FALSE,FALSE,REF-893299,First Continental Bank,***3132,"Globex International Holdings, Inc.",US,9430716.04
16/04/2024,16/04/2024,Client Receipt - ShopSphere Partner #65,Sales Receipt,Retail-NA,0,6981.72,USD,Fedwire Credit,ShopSphere Partner #65,***4180,INV-202404-Retail-NA-0015,,FALSE,FALSE,REF-668002,First Continental Bank,***5998,"Globex International Holdings, Inc.",US,9437697.76
16/04/2024,16/04/2024,Client Receipt - ShopSphere Partner #62,Sales Receipt,Retail-NA,0,101755.58,USD,Card Settlement,ShopSphere Partner #62,***7387,INV-202404-Retail-NA-0005,,FALSE,FALSE,REF-127978,First Continental Bank,***1663,"Globex International Holdings, Inc.",US,9539453.34
17/04/2024,17/04/2024,Supplier Payment - ExpertNet Subcontractors #9,Supplier Payment,PS-GL,9719.57,0,USD,Wire Transfer,ExpertNet Subcontractors #9,***8825,,PO-202404-PS-GL-0009,FALSE,FALSE,REF-109297,First Continental Bank,***9793,"Globex International Holdings, Inc.",US,9529733.77
17/04/2024,17/04/2024,Supplier Payment - HyperCloud Infra #7,Supplier Payment,SaaS-GL,36409.05,0,USD,Wire Transfer,HyperCloud Infra #7,***8455,,PO-202404-SaaS-GL-0010,FALSE,FALSE,REF-901006,First Continental Bank,***7750,"Globex International Holdings, Inc.",US,9493324.72
17/04/2024,17/04/2024,Marketing - Aurelia Media #4,Marketing,ALL,41114.99,0,USD,Fedwire,Aurelia Media #4,***4294,,,FALSE,FALSE,REF-199434,First Continental Bank,***7477,"Globex International Holdings, Inc.",US,9452209.73
17/04/2024,17/04/2024,Client Receipt - CloudBridge Co. #66,Sales Receipt,SaaS-GL,0,9329.93,USD,ACH Credit,CloudBridge Co. #66,***4163,INV-202404-SaaS-GL-0007,,FALSE,FALSE,REF-408115,First Continental Bank,***3433,"Globex International Holdings, Inc.",US,9461539.66
17/04/2024,17/04/2024,Client Receipt - Vertex Advisory Client #36,Sales Receipt,PS-GL,0,43155.93,USD,Card Settlement,Vertex Advisory Client #36,***2161,INV-202404-PS-GL-0005,,FALSE,FALSE,REF-951981,First Continental Bank,***9634,"Globex International Holdings, Inc.",US,9504695.59
17/04/2024,17/04/2024,Client Receipt - ShopSphere Partner #39,Sales Receipt,Retail-NA,0,79927.23,USD,ACH Credit,ShopSphere Partner #39,***9713,INV-202404-Retail-NA-0004,,FALSE,FALSE,REF-147088,First Continental Bank,***9047,"Globex International Holdings, Inc.",US,9584622.82
18/04/2024,18/04/2024,Northshore Power,Rent & Utilities,ALL,26388.44,0,USD,Fedwire,Northshore Power,***3999,,,FALSE,FALSE,REF-652286,First Continental Bank,***8819,"Globex International Holdings, Inc.",US,9558234.38
18/04/2024,18/04/2024,Marketing - Beacon Digital #4,Marketing,ALL,39024.39,0,USD,Wire Transfer,Beacon Digital #4,***6317,,,FALSE,FALSE,REF-811751,First Continental Bank,***2515,"Globex International Holdings, Inc.",US,9519209.99
18/04/2024,18/04/2024,Client Receipt - ShopSphere Partner #72,Sales Receipt,Retail-NA,0,116576.75,USD,Fedwire Credit,ShopSphere Partner #72,***1344,INV-202404-Retail-NA-0001,,FALSE,FALSE,REF-993962,First Continental Bank,***5388,"Globex International Holdings, Inc.",US,9635786.74
18/04/2024,18/04/2024,Client Receipt - ShopSphere Partner #35,Sales Receipt,Retail-NA,0,117209.4,USD,Fedwire Credit,ShopSphere Partner #35,***2653,INV-202404-Retail-NA-0007,,FALSE,FALSE,REF-358087,First Continental Bank,***6087,"Globex International Holdings, Inc.",US,9752996.14
18/04/2024,18/04/2024,Client Receipt - Vertex Advisory Client #3,Sales Receipt,PS-GL,0,218313.33,USD,Card Settlement,Vertex Advisory Client #3,***5508,INV-202404-PS-GL-0008,,FALSE,FALSE,REF-788787,First Continental Bank,***9047,"Globex International Holdings, Inc.",US,9971309.47
20/04/2024,20/04/2024,Supplier Payment - CodeCraft Contractors #8,Supplier Payment,SaaS-GL,24770.17,0,USD,Wire Transfer,CodeCraft Contractors #8,***6949,,PO-202404-SaaS-GL-0001,FALSE,FALSE,REF-320888,First Continental Bank,***2642,"Globex International Holdings, Inc.",US,9946539.3
20/04/2024,20/04/2024,Supplier Payment - NorthRiver Apparel Mfg #12,Supplier Payment,Retail-NA,282259.65,0,USD,ACH Debit,NorthRiver Apparel Mfg #12,***7757,,PO-202404-Retail-NA-0002,FALSE,FALSE,REF-486576,First Continental Bank,***7426,"Globex International Holdings, Inc.",US,9664279.65
21/04/2024,21/04/2024,Supplier Payment - NorthRiver Apparel Mfg #27,Supplier Payment,Retail-NA,41832.33,0,USD,ACH Debit,NorthRiver Apparel Mfg #27,***3977,,PO-202404-Retail-NA-0001,FALSE,FALSE,REF-444170,First Continental Bank,***5053,"Globex International Holdings, Inc.",US,9622447.32
22/04/2024,22/04/2024,Supplier Payment - CodeCraft Contractors #5,Supplier Payment,SaaS-GL,39790.75,0,USD,ACH Debit,CodeCraft Contractors #5,***4753,,PO-202404-SaaS-GL-0004,FALSE,FALSE,REF-486010,First Continental Bank,***3779,"Globex International Holdings, Inc.",US,9582656.57
22/04/2024,22/04/2024,VAT/GST Remittance - US IRS,Tax Payment,ALL,198197.14,0,USD,SWIFT MT103,US IRS,***5946,,,FALSE,FALSE,REF-661963,First Continental Bank,***2135,"Globex International Holdings, Inc.",US,9384459.43
22/04/2024,22/04/2024,Client Receipt - ShopSphere Partner #34,Sales Receipt,Retail-NA,0,14921.86,USD,Card Settlement,ShopSphere Partner #34,***7772,INV-202404-Retail-NA-0012,,FALSE,FALSE,REF-104102,First Continental Bank,***8170,"Globex International Holdings, Inc.",US,9399381.29
23/04/2024,23/04/2024,Supplier Payment - ExpertNet Subcontractors #1,Supplier Payment,PS-GL,10018.76,0,USD,ACH Debit,ExpertNet Subcontractors #1,***7723,,PO-202404-PS-GL-0003,FALSE,FALSE,REF-398499,First Continental Bank,***1777,"Globex International Holdings, Inc.",US,9389362.53
23/04/2024,23/04/2024,Supplier Payment - ExpertNet Subcontractors #17,Supplier Payment,PS-GL,19989.14,0,USD,Fedwire,ExpertNet Subcontractors #17,***8426,,PO-202404-PS-GL-0004,FALSE,FALSE,REF-292335,First Continental Bank,***5795,"Globex International Holdings, Inc.",US,9369373.39
23/04/2024,23/04/2024,Client Receipt - Vertex Advisory Client #17,Sales Receipt,PS-GL,0,50689.55,USD,Card Settlement,Vertex Advisory Client #17,***9152,INV-202404-PS-GL-0007,,FALSE,FALSE,REF-910675,First Continental Bank,***5291,"Globex International Holdings, Inc.",US,9420062.94
23/04/2024,23/04/2024,Client Receipt - ShopSphere Partner #51,Sales Receipt,Retail-NA,0,127051.63,USD,ACH Credit,ShopSphere Partner #51,***8339,INV-202404-Retail-NA-0011,,FALSE,FALSE,REF-362481,First Continental Bank,***2766,"Globex International Holdings, Inc.",US,9547114.57
24/04/2024,24/04/2024,Supplier Payment - ExpertNet Subcontractors #2,Supplier Payment,PS-GL,3958.48,0,USD,Wire Transfer,ExpertNet Subcontractors #2,***2779,,PO-202404-PS-GL-0012,FALSE,FALSE,REF-654049,First Continental Bank,***8668,"Globex International Holdings, Inc.",US,9543156.09
24/04/2024,24/04/2024,Merchant Processing Fees,Bank/Merchant Fees,ALL,9409.31,0,USD,Wire Transfer,First Continental Bank,***5488,,,FALSE,FALSE,REF-691987,First Continental Bank,***1576,"Globex International Holdings, Inc.",US,9533746.78
24/04/2024,24/04/2024,Client Receipt - CloudBridge Co. #19,Sales Receipt,SaaS-GL,0,7361.32,USD,Card Settlement,CloudBridge Co. #19,***9899,INV-202404-SaaS-GL-0008,,FALSE,FALSE,REF-235235,First Continental Bank,***3652,"Globex International Holdings, Inc.",US,9541108.1
24/04/2024,24/04/2024,Client Receipt - CloudBridge Co. #36,Sales Receipt,SaaS-GL,0,52797.87,USD,Fedwire Credit,CloudBridge Co. #36,***5136,INV-202404-SaaS-GL-0003,,FALSE,FALSE,REF-193332,First Continental Bank,***3667,"Globex International Holdings, Inc.",US,9593905.97
24/04/2024,24/04/2024,Client Receipt - Vertex Advisory Client #2,Sales Receipt,PS-GL,0,126069.54,USD,ACH Credit,Vertex Advisory Client #2,***2824,INV-202404-PS-GL-0001,,FALSE,FALSE,REF-720517,First Continental Bank,***6478,"Globex International Holdings, Inc.",US,9719975.51
25/04/2024,25/04/2024,Supplier Payment - HyperCloud Infra #4,Supplier Payment,SaaS-GL,16121.63,0,USD,ACH Debit,HyperCloud Infra #4,***4726,,PO-202404-SaaS-GL-0006,FALSE,FALSE,REF-198778,First Continental Bank,***2088,"Globex International Holdings, Inc.",US,9703853.88
26/04/2024,26/04/2024,Intercompany Settlement - Globex Retail NA LLC,Intercompany Transfer,ALL,358341,0,USD,Internal Transfer,Globex Retail NA LLC,***2243,,,TRUE,TRUE,REF-908600,First Continental Bank,***7394,"Globex International Holdings, Inc.",US,9345512.88
26/04/2024,26/04/2024,Client Receipt - CloudBridge Co. #51,Sales Receipt,SaaS-GL,0,133676.51,USD,Card Settlement,CloudBridge Co. #51,***4902,INV-202404-SaaS-GL-0009,,FALSE,FALSE,REF-797701,First Continental Bank,***6629,"Globex International Holdings, Inc.",US,9479189.39
27/04/2024,27/04/2024,Payroll - GlobalPay Services Ltd,Payroll,ALL,263442.27,0,USD,ACH Debit,GlobalPay Services Ltd,***9150,,,FALSE,FALSE,REF-773235,First Continental Bank,***3804,"Globex International Holdings, Inc.",US,9215747.12
27/04/2024,27/04/2024,Client Receipt - Vertex Advisory Client #5,Sales Receipt,PS-GL,0,182603.71,USD,Fedwire Credit,Vertex Advisory Client #5,***9931,INV-202404-PS-GL-0002,,FALSE,FALSE,REF-699847,First Continental Bank,***4549,"Globex International Holdings, Inc.",US,9398350.83
28/04/2024,28/04/2024,Corporate Tax Estimate,Tax Payment,ALL,141277.17,0,USD,Fedwire,State of CA FTB,***8841,,,FALSE,FALSE,REF-918433,First Continental Bank,***1874,"Globex International Holdings, Inc.",US,9257073.66
28/04/2024,28/04/2024,Payroll - GlobalPay Services Ltd,Payroll,ALL,263442.27,0,USD,Fedwire,GlobalPay Services Ltd,***6012,,,FALSE,FALSE,REF-290028,First Continental Bank,***2657,"Globex International Holdings, Inc.",US,8993631.39
28/04/2024,28/04/2024,Client Receipt - CloudBridge Co. #25,Sales Receipt,SaaS-GL,0,9447.1,USD,Fedwire Credit,CloudBridge Co. #25,***7214,INV-202404-SaaS-GL-0014,,FALSE,FALSE,REF-355629,First Continental Bank,***5062,"Globex International Holdings, Inc.",US,9003078.49
28/04/2024,28/04/2024,Client Receipt - CloudBridge Co. #64,Sales Receipt,SaaS-GL,0,15265.39,USD,Fedwire Credit,CloudBridge Co. #64,***7780,INV-202404-SaaS-GL-0012,,FALSE,FALSE,REF-147966,First Continental Bank,***9995,"Globex International Holdings, Inc.",US,9018343.88
29/04/2024,29/04/2024,Supplier Payment - ExpertNet Subcontractors #2,Supplier Payment,PS-GL,59097,0,USD,Fedwire,ExpertNet Subcontractors #2,***3370,,PO-202404-PS-GL-0007,FALSE,FALSE,REF-282892,First Continental Bank,***9566,"Globex International Holdings, Inc.",US,8959246.88
29/04/2024,29/04/2024,Client Receipt - CloudBridge Co. #54,Sales Receipt,SaaS-GL,0,22223.36,USD,Card Settlement,CloudBridge Co. #54,***7166,INV-202404-SaaS-GL-0020,,FALSE,FALSE,REF-744874,First Continental Bank,***4007,"Globex International Holdings, Inc.",US,8981470.24
29/04/2024,29/04/2024,Client Receipt - ShopSphere Partner #70,Sales Receipt,Retail-NA,0,153325.41,USD,Fedwire Credit,ShopSphere Partner #70,***7850,INV-202404-Retail-NA-0014,,FALSE,FALSE,REF-658602,First Continental Bank,***2481,"Globex International Holdings, Inc.",US,9134795.65
30/04/2024,30/04/2024,Merchant Processing Fees,Bank/Merchant Fees,ALL,292.12,0,USD,ACH Debit,First Continental Bank,***1217,,,FALSE,FALSE,REF-678920,First Continental Bank,***1191,"Globex International Holdings, Inc.",US,9134503.53
30/04/2024,30/04/2024,Interest Earned,Interest Income,ALL,0,10702.01,USD,Card Settlement,First Continental Bank,***9541,,,FALSE,FALSE,REF-539313,First Continental Bank,***7110,"Globex International Holdings, Inc.",US,9145205.54
30/04/2024,30/04/2024,Client Receipt - CloudBridge Co. #43,Sales Receipt,SaaS-GL,0,62649.66,USD,ACH Credit,CloudBridge Co. #43,***2102,INV-202404-SaaS-GL-0019,,FALSE,FALSE,REF-600433,First Continental Bank,***9266,"Globex International Holdings, Inc.",US,9207855.2
01/05/2024,01/05/2024,Account Maintenance Fee,Bank/Merchant Fees,ALL,2500,0,USD,ACH Debit,First Continental Bank,***3205,,,FALSE,FALSE,REF-355177,First Continental Bank,***2505,"Globex International Holdings, Inc.",US,9205355.2
01/05/2024,01/05/2024,Supplier Payment - ExpertNet Subcontractors #10,Supplier Payment,PS-GL,11793.25,0,USD,Fedwire,ExpertNet Subcontractors #10,***9987,,PO-202405-PS-GL-0002,FALSE,FALSE,REF-259639,First Continental Bank,***9456,"Globex International Holdings, Inc.",US,9193561.95
01/05/2024,01/05/2024,Client Receipt - CloudBridge Co. #46,Sales Receipt,SaaS-GL,0,7333.84,USD,Fedwire Credit,CloudBridge Co. #46,***3724,INV-202405-SaaS-GL-0001,,FALSE,FALSE,REF-969241,First Continental Bank,***3824,"Globex International Holdings, Inc.",US,9200895.79
01/05/2024,01/05/2024,Client Receipt - Vertex Advisory Client #42,Sales Receipt,PS-GL,0,9144.36,USD,ACH Credit,Vertex Advisory Client #42,***1393,INV-202405-PS-GL-0007,,FALSE,FALSE,REF-713309,First Continental Bank,***2635,"Globex International Holdings, Inc.",US,9210040.15
01/05/2024,01/05/2024,Client Receipt - Vertex Advisory Client #45,Sales Receipt,PS-GL,0,38793.22,USD,Fedwire Credit,Vertex Advisory Client #45,***3237,INV-202405-PS-GL-0008,,FALSE,FALSE,REF-191777,First Continental Bank,***8487,"Globex International Holdings, Inc.",US,9248833.37
01/05/2024,01/05/2024,Client Receipt - ShopSphere Partner #16,Sales Receipt,Retail-NA,0,105515.21,USD,Fedwire Credit,ShopSphere Partner #16,***2306,INV-202405-Retail-NA-0007,,FALSE,FALSE,REF-462524,First Continental Bank,***3294,"Globex International Holdings, Inc.",US,9354348.58
01/05/2024,01/05/2024,Client Receipt - Vertex Advisory Client #24,Sales Receipt,PS-GL,0,148000.93,USD,Card Settlement,Vertex Advisory Client #24,***8079,INV-202405-PS-GL-0001,,FALSE,FALSE,REF-787988,First Continental Bank,***5510,"Globex International Holdings, Inc.",US,9502349.51
01/05/2024,01/05/2024,Client Receipt - Vertex Advisory Client #57,Sales Receipt,PS-GL,0,195902.81,USD,Card Settlement,Vertex Advisory Client #57,***4140,INV-202405-PS-GL-0009,,FALSE,FALSE,REF-401247,First Continental Bank,***8034,"Globex International Holdings, Inc.",US,9698252.32
02/05/2024,02/05/2024,Supplier Payment - CodeCraft Contractors #12,Supplier Payment,SaaS-GL,8029.57,0,USD,Wire Transfer,CodeCraft Contractors #12,***2162,,PO-202405-SaaS-GL-0006,FALSE,FALSE,REF-810148,First Continental Bank,***2907,"Globex International Holdings, Inc.",US,9690222.75
02/05/2024,02/05/2024,Supplier Payment - ExpertNet Subcontractors #18,Supplier Payment,PS-GL,21949.93,0,USD,Fedwire,ExpertNet Subcontractors #18,***7358,,PO-202405-PS-GL-0001,FALSE,FALSE,REF-157679,First Continental Bank,***8050,"Globex International Holdings, Inc.",US,9668272.82
02/05/2024,02/05/2024,Client Receipt - CloudBridge Co. #62,Sales Receipt,SaaS-GL,0,58128.53,USD,Card Settlement,CloudBridge Co. #62,***5178,INV-202405-SaaS-GL-0011,,FALSE,FALSE,REF-302941,First Continental Bank,***9944,"Globex International Holdings, Inc.",US,9726401.35
03/05/2024,03/05/2024,Supplier Payment - CodeCraft Contractors #12,Supplier Payment,SaaS-GL,993.01,0,USD,ACH Debit,CodeCraft Contractors #12,***1508,,PO-202405-SaaS-GL-0005,FALSE,FALSE,REF-124829,First Continental Bank,***1652,"Globex International Holdings, Inc.",US,9725408.34
03/05/2024,03/05/2024,Client Receipt - CloudBridge Co. #67,Sales Receipt,SaaS-GL,0,10108.39,USD,Card Settlement,CloudBridge Co. #67,***2851,INV-202405-SaaS-GL-0028,,FALSE,FALSE,REF-175316,First Continental Bank,***5219,"Globex International Holdings, Inc.",US,9735516.73
03/05/2024,03/05/2024,Client Receipt - ShopSphere Partner #2,Sales Receipt,Retail-NA,0,80654.82,USD,ACH Credit,ShopSphere Partner #2,***4122,INV-202405-Retail-NA-0017,,FALSE,FALSE,REF-963101,First Continental Bank,***2871,"Globex International Holdings, Inc.",US,9816171.55
04/05/2024,04/05/2024,Supplier Payment - PackFast Fulfillment #10,Supplier Payment,Retail-NA,5190.39,0,USD,Wire Transfer,PackFast Fulfillment #10,***8183,,PO-202405-Retail-NA-0012,FALSE,FALSE,REF-264055,First Continental Bank,***1877,"Globex International Holdings, Inc.",US,9810981.16
04/05/2024,04/05/2024,Client Receipt - CloudBridge Co. #31,Sales Receipt,SaaS-GL,0,16393.88,USD,Card Settlement,CloudBridge Co. #31,***8077,INV-202405-SaaS-GL-0030,,FALSE,FALSE,REF-752404,First Continental Bank,***3144,"Globex International Holdings, Inc.",US,9827375.04
05/05/2024,05/05/2024,Supplier Payment - PackFast Fulfillment #17,Supplier Payment,Retail-NA,111382.8,0,USD,Wire Transfer,PackFast Fulfillment #17,***5231,,PO-202405-Retail-NA-0002,FALSE,FALSE,REF-205102,First Continental Bank,***8902,"Globex International Holdings, Inc.",US,9715992.24
05/05/2024,05/05/2024,Client Receipt - ShopSphere Partner #24,Sales Receipt,Retail-NA,0,5981.68,USD,ACH Credit,ShopSphere Partner #24,***1764,INV-202405-Retail-NA-0002,,FALSE,FALSE,REF-143360,First Continental Bank,***7948,"Globex International Holdings, Inc.",US,9721973.92
06/05/2024,06/05/2024,Client Receipt - CloudBridge Co. #1,Sales Receipt,SaaS-GL,0,23631.92,USD,ACH Credit,CloudBridge Co. #1,***8477,INV-202405-SaaS-GL-0014,,FALSE,FALSE,REF-238385,First Continental Bank,***2014,"Globex International Holdings, Inc.",US,9745605.84
07/05/2024,07/05/2024,Supplier Payment - ExpertNet Subcontractors #15,Supplier Payment,PS-GL,33510.12,0,USD,Wire Transfer,ExpertNet Subcontractors #15,***3286,,PO-202405-PS-GL-0010,FALSE,FALSE,REF-182865,First Continental Bank,***6957,"Globex International Holdings, Inc.",US,9712095.72
07/05/2024,07/05/2024,Supplier Payment - NorthRiver Apparel Mfg #18,Supplier Payment,Retail-NA,191200.98,0,USD,Wire Transfer,NorthRiver Apparel Mfg #18,***6049,,PO-202405-Retail-NA-0005,FALSE,FALSE,REF-715166,First Continental Bank,***2666,"Globex International Holdings, Inc.",US,9520894.74
07/05/2024,07/05/2024,Client Receipt - CloudBridge Co. #58,Sales Receipt,SaaS-GL,0,218.68,USD,Card Settlement,CloudBridge Co. #58,***1250,INV-202405-SaaS-GL-0004,,FALSE,FALSE,REF-621359,First Continental Bank,***2262,"Globex International Holdings, Inc.",US,9521113.42
07/05/2024,07/05/2024,Client Receipt - CloudBridge Co. #70,Sales Receipt,SaaS-GL,0,81551.39,USD,Card Settlement,CloudBridge Co. #70,***3938,INV-202405-SaaS-GL-0027,,FALSE,FALSE,REF-255087,First Continental Bank,***4101,"Globex International Holdings, Inc.",US,9602664.81
07/05/2024,07/05/2024,Client Receipt - CloudBridge Co. #16,Sales Receipt,SaaS-GL,0,81554.16,USD,Fedwire Credit,CloudBridge Co. #16,***5319,INV-202405-SaaS-GL-0031,,FALSE,FALSE,REF-991018,First Continental Bank,***9608,"Globex International Holdings, Inc.",US,9684218.97
08/05/2024,08/05/2024,Marketing - Aurelia Media #5,Marketing,ALL,6538.91,0,USD,Wire Transfer,Aurelia Media #5,***4683,,,FALSE,FALSE,REF-668473,First Continental Bank,***1038,"Globex International Holdings, Inc.",US,9677680.06
08/05/2024,08/05/2024,Supplier Payment - ExpertNet Subcontractors #14,Supplier Payment,PS-GL,16610.55,0,USD,Fedwire,ExpertNet Subcontractors #14,***7547,,PO-202405-PS-GL-0012,FALSE,FALSE,REF-130218,First Continental Bank,***5946,"Globex International Holdings, Inc.",US,9661069.51
08/05/2024,08/05/2024,Client Receipt - CloudBridge Co. #9,Sales Receipt,SaaS-GL,0,24621.09,USD,Fedwire Credit,CloudBridge Co. #9,***9980,INV-202405-SaaS-GL-0017,,FALSE,FALSE,REF-751332,First Continental Bank,***7417,"Globex International Holdings, Inc.",US,9685690.6
08/05/2024,08/05/2024,Client Receipt - Card Settlement Batch #24,Sales Receipt,Retail-NA,0,105918.95,USD,Fedwire Credit,Card Settlement Batch #24,***7391,INV-202405-Retail-NA-0011,,FALSE,FALSE,REF-417459,First Continental Bank,***8401,"Globex International Holdings, Inc.",US,9791609.55
08/05/2024,08/05/2024,Client Receipt - ShopSphere Partner #13,Sales Receipt,Retail-NA,0,183223.15,USD,Fedwire Credit,ShopSphere Partner #13,***8984,INV-202405-Retail-NA-0015,,FALSE,FALSE,REF-630063,First Continental Bank,***6486,"Globex International Holdings, Inc.",US,9974832.7
09/05/2024,09/05/2024,Client Receipt - CloudBridge Co. #20,Sales Receipt,SaaS-GL,0,24774.57,USD,Card Settlement,CloudBridge Co. #20,***7307,INV-202405-SaaS-GL-0010,,FALSE,FALSE,REF-877117,First Continental Bank,***7383,"Globex International Holdings, Inc.",US,9999607.27
09/05/2024,09/05/2024,Client Receipt - Vertex Advisory Client #23,Sales Receipt,PS-GL,0,31565.03,USD,ACH Credit,Vertex Advisory Client #23,***3873,INV-202405-PS-GL-0005,,FALSE,FALSE,REF-928186,First Continental Bank,***6410,"Globex International Holdings, Inc.",US,10031172.3
09/05/2024,09/05/2024,Client Receipt - CloudBridge Co. #43,Sales Receipt,SaaS-GL,0,42487.97,USD,Card Settlement,CloudBridge Co. #43,***2908,INV-202405-SaaS-GL-0025,,FALSE,FALSE,REF-239753,First Continental Bank,***2153,"Globex International Holdings, Inc.",US,10073660.27
09/05/2024,09/05/2024,Client Receipt - ShopSphere Partner #73,Sales Receipt,Retail-NA,0,170076.61,USD,Card Settlement,ShopSphere Partner #73,***4416,INV-202405-Retail-NA-0018,,FALSE,FALSE,REF-838101,First Continental Bank,***8945,"Globex International Holdings, Inc.",US,10243736.88
10/05/2024,10/05/2024,Client Receipt - CloudBridge Co. #40,Sales Receipt,SaaS-GL,0,28052.27,USD,ACH Credit,CloudBridge Co. #40,***8538,INV-202405-SaaS-GL-0026,,FALSE,FALSE,REF-795976,First Continental Bank,***7263,"Globex International Holdings, Inc.",US,10271789.15
10/05/2024,10/05/2024,Client Receipt - Vertex Advisory Client #57,Sales Receipt,PS-GL,0,72171.11,USD,ACH Credit,Vertex Advisory Client #57,***2292,INV-202405-PS-GL-0004,,FALSE,FALSE,REF-487542,First Continental Bank,***6319,"Globex International Holdings, Inc.",US,10343960.26
11/05/2024,11/05/2024,Client Receipt - ShopSphere Partner #68,Sales Receipt,Retail-NA,0,58556.83,USD,Card Settlement,ShopSphere Partner #68,***4551,INV-202405-Retail-NA-0014,,FALSE,FALSE,REF-466593,First Continental Bank,***1009,"Globex International Holdings, Inc.",US,10402517.09
11/05/2024,11/05/2024,Client Receipt - ShopSphere Partner #53,Sales Receipt,Retail-NA,0,58828.89,USD,Fedwire Credit,ShopSphere Partner #53,***7778,INV-202405-Retail-NA-0013,,FALSE,FALSE,REF-137766,First Continental Bank,***5286,"Globex International Holdings, Inc.",US,10461345.98
12/05/2024,12/05/2024,Supplier Payment - HyperCloud Infra #7,Supplier Payment,SaaS-GL,10367.48,0,USD,Fedwire,HyperCloud Infra #7,***2197,,PO-202405-SaaS-GL-0002,FALSE,FALSE,REF-263367,First Continental Bank,***7445,"Globex International Holdings, Inc.",US,10450978.5
12/05/2024,12/05/2024,Intercompany Settlement - Globex Retail NA LLC,Intercompany Transfer,ALL,325943,0,USD,Internal Transfer,Globex Retail NA LLC,***7289,,,TRUE,TRUE,REF-430691,First Continental Bank,***1740,"Globex International Holdings, Inc.",US,10125035.5
13/05/2024,13/05/2024,Merchant Processing Fees,Bank/Merchant Fees,ALL,5451.42,0,USD,Fedwire,First Continental Bank,***9010,,,FALSE,FALSE,REF-463368,First Continental Bank,***1786,"Globex International Holdings, Inc.",US,10119584.08
13/05/2024,13/05/2024,Supplier Payment - ExpertNet Subcontractors #11,Supplier Payment,PS-GL,6010.93,0,USD,Wire Transfer,ExpertNet Subcontractors #11,***9336,,PO-202405-PS-GL-0006,FALSE,FALSE,REF-883128,First Continental Bank,***5606,"Globex International Holdings, Inc.",US,10113573.15
13/05/2024,13/05/2024,Supplier Payment - ExpertNet Subcontractors #17,Supplier Payment,PS-GL,8562.29,0,USD,Wire Transfer,ExpertNet Subcontractors #17,***2613,,PO-202405-PS-GL-0007,FALSE,FALSE,REF-989345,First Continental Bank,***7621,"Globex International Holdings, Inc.",US,10105010.86
13/05/2024,13/05/2024,Client Receipt - CloudBridge Co. #79,Sales Receipt,SaaS-GL,0,16040.23,USD,ACH Credit,CloudBridge Co. #79,***4101,INV-202405-SaaS-GL-0023,,FALSE,FALSE,REF-612989,First Continental Bank,***4407,"Globex International Holdings, Inc.",US,10121051.09
14/05/2024,14/05/2024,Skyline Internet Services,Rent & Utilities,ALL,21187.56,0,USD,Fedwire,Skyline Internet Services,***9787,,,FALSE,FALSE,REF-470407,First Continental Bank,***2740,"Globex International Holdings, Inc.",US,10099863.53
14/05/2024,14/05/2024,Supplier Payment - ExpertNet Subcontractors #18,Supplier Payment,PS-GL,24289.29,0,USD,ACH Debit,ExpertNet Subcontractors #18,***1947,,PO-202405-PS-GL-0005,FALSE,FALSE,REF-453345,First Continental Bank,***5329,"Globex International Holdings, Inc.",US,10075574.24
14/05/2024,14/05/2024,Supplier Payment - HyperCloud Infra #19,Supplier Payment,SaaS-GL,45556.17,0,USD,Fedwire,HyperCloud Infra #19,***5716,,PO-202405-SaaS-GL-0009,FALSE,FALSE,REF-467825,First Continental Bank,***2623,"Globex International Holdings, Inc.",US,10030018.07
14/05/2024,14/05/2024,Client Receipt - CloudBridge Co. #63,Sales Receipt,SaaS-GL,0,2936.47,USD,Fedwire Credit,CloudBridge Co. #63,***7792,INV-202405-SaaS-GL-0012,,FALSE,FALSE,REF-976527,First Continental Bank,***7554,"Globex International Holdings, Inc.",US,10032954.54
14/05/2024,14/05/2024,Client Receipt - CloudBridge Co. #11,Sales Receipt,SaaS-GL,0,30012.12,USD,ACH Credit,CloudBridge Co. #11,***1232,INV-202405-SaaS-GL-0015,,FALSE,FALSE,REF-994444,First Continental Bank,***6755,"Globex International Holdings, Inc.",US,10062966.66
15/05/2024,15/05/2024,Supplier Payment - ExpertNet Subcontractors #15,Supplier Payment,PS-GL,33523.21,0,USD,Wire Transfer,ExpertNet Subcontractors #15,***2420,,PO-202405-PS-GL-0008,FALSE,FALSE,REF-923424,First Continental Bank,***2767,"Globex International Holdings, Inc.",US,10029443.45
15/05/2024,15/05/2024,Supplier Payment - NorthRiver Apparel Mfg #26,Supplier Payment,Retail-NA,56405.92,0,USD,ACH Debit,NorthRiver Apparel Mfg #26,***2780,,PO-202405-Retail-NA-0004,FALSE,FALSE,REF-398653,First Continental Bank,***6335,"Globex International Holdings, Inc.",US,9973037.53
15/05/2024,15/05/2024,Loan Interest Payment,Loan Interest,ALL,85000,0,USD,Fedwire,First Continental Bank - Corporate Lending,***9015,,,FALSE,FALSE,REF-571869,First Continental Bank,***8157,"Globex International Holdings, Inc.",US,9888037.53
15/05/2024,15/05/2024,Loan Principal Repayment,Loan Principal,ALL,500000,0,USD,ACH Debit,First Continental Bank - Corporate Lending,***9052,,,FALSE,FALSE,REF-268248,First Continental Bank,***8079,"Globex International Holdings, Inc.",US,9388037.53
15/05/2024,15/05/2024,Client Receipt - ShopSphere Partner #55,Sales Receipt,Retail-NA,0,48992.81,USD,ACH Credit,ShopSphere Partner #55,***2923,INV-202405-Retail-NA-0003,,FALSE,FALSE,REF-182890,First Continental Bank,***1475,"Globex International Holdings, Inc.",US,9437030.34
16/05/2024,16/05/2024,Supplier Payment - NorthRiver Apparel Mfg #24,Supplier Payment,Retail-NA,27701.83,0,USD,ACH Debit,NorthRiver Apparel Mfg #24,***3737,,PO-202405-Retail-NA-0008,FALSE,FALSE,REF-360660,First Continental Bank,***9006,"Globex International Holdings, Inc.",US,9409328.51
16/05/2024,16/05/2024,Supplier Payment - PackFast Fulfillment #18,Supplier Payment,Retail-NA,89193.05,0,USD,Fedwire,PackFast Fulfillment #18,***8219,,PO-202405-Retail-NA-0010,FALSE,FALSE,REF-922528,First Continental Bank,***8535,"Globex International Holdings, Inc.",US,9320135.46
16/05/2024,16/05/2024,Client Receipt - Card Settlement Batch #4,Sales Receipt,Retail-NA,0,68832.75,USD,Fedwire Credit,Card Settlement Batch #4,***7223,INV-202405-Retail-NA-0004,,FALSE,FALSE,REF-148946,First Continental Bank,***8302,"Globex International Holdings, Inc.",US,9388968.21
16/05/2024,16/05/2024,Client Receipt - Vertex Advisory Client #51,Sales Receipt,PS-GL,0,150028.39,USD,Card Settlement,Vertex Advisory Client #51,***7700,INV-202405-PS-GL-0002,,FALSE,FALSE,REF-972334,First Continental Bank,***9462,"Globex International Holdings, Inc.",US,9538996.6
17/05/2024,17/05/2024,Supplier Payment - HyperCloud Infra #14,Supplier Payment,SaaS-GL,16684.4,0,USD,Wire Transfer,HyperCloud Infra #14,***4807,,PO-202405-SaaS-GL-0007,FALSE,FALSE,REF-905416,First Continental Bank,***2612,"Globex International Holdings, Inc.",US,9522312.2
17/05/2024,17/05/2024,Supplier Payment - NorthRiver Apparel Mfg #34,Supplier Payment,Retail-NA,20285.55,0,USD,ACH Debit,NorthRiver Apparel Mfg #34,***1972,,PO-202405-Retail-NA-0003,FALSE,FALSE,REF-323518,First Continental Bank,***2027,"Globex International Holdings, Inc.",US,9502026.65
17/05/2024,17/05/2024,Client Receipt - CloudBridge Co. #11,Sales Receipt,SaaS-GL,0,4595.08,USD,Fedwire Credit,CloudBridge Co. #11,***6941,INV-202405-SaaS-GL-0009,,FALSE,FALSE,REF-180005,First Continental Bank,***8992,"Globex International Holdings, Inc.",US,9506621.73
17/05/2024,17/05/2024,Client Receipt - ShopSphere Partner #47,Sales Receipt,Retail-NA,0,108951.43,USD,Fedwire Credit,ShopSphere Partner #47,***2674,INV-202405-Retail-NA-0012,,FALSE,FALSE,REF-472732,First Continental Bank,***5263,"Globex International Holdings, Inc.",US,9615573.16
18/05/2024,18/05/2024,Supplier Payment - HyperCloud Infra #13,Supplier Payment,SaaS-GL,27914.28,0,USD,ACH Debit,HyperCloud Infra #13,***7903,,PO-202405-SaaS-GL-0004,FALSE,FALSE,REF-164147,First Continental Bank,***2212,"Globex International Holdings, Inc.",US,9587658.88
18/05/2024,18/05/2024,Client Receipt - CloudBridge Co. #48,Sales Receipt,SaaS-GL,0,20158.68,USD,Fedwire Credit,CloudBridge Co. #48,***6576,INV-202405-SaaS-GL-0018,,FALSE,FALSE,REF-604370,First Continental Bank,***3717,"Globex International Holdings, Inc.",US,9607817.56
19/05/2024,19/05/2024,Client Receipt - CloudBridge Co. #23,Sales Receipt,SaaS-GL,0,23076.87,USD,Fedwire Credit,CloudBridge Co. #23,***3907,INV-202405-SaaS-GL-0008,,FALSE,FALSE,REF-188687,First Continental Bank,***3906,"Globex International Holdings, Inc.",US,9630894.43
20/05/2024,20/05/2024,Merchant Processing Fees,Bank/Merchant Fees,ALL,4597.34,0,USD,Fedwire,First Continental Bank,***1558,,,FALSE,FALSE,REF-453918,First Continental Bank,***3332,"Globex International Holdings, Inc.",US,9626297.09
20/05/2024,20/05/2024,Metro Water & Waste,Rent & Utilities,ALL,6185.62,0,USD,ACH Debit,Metro Water & Waste,***8205,,,FALSE,FALSE,REF-145566,First Continental Bank,***2927,"Globex International Holdings, Inc.",US,9620111.47
20/05/2024,20/05/2024,Supplier Payment - PackFast Fulfillment #8,Supplier Payment,Retail-NA,9644.76,0,USD,Fedwire,PackFast Fulfillment #8,***2326,,PO-202405-Retail-NA-0011,FALSE,FALSE,REF-736302,First Continental Bank,***6479,"Globex International Holdings, Inc.",US,9610466.71
20/05/2024,20/05/2024,Supplier Payment - CodeCraft Contractors #9,Supplier Payment,SaaS-GL,13991.4,0,USD,Fedwire,CodeCraft Contractors #9,***3015,,PO-202405-SaaS-GL-0001,FALSE,FALSE,REF-975603,First Continental Bank,***8419,"Globex International Holdings, Inc.",US,9596475.31
20/05/2024,20/05/2024,Supplier Payment - NorthRiver Apparel Mfg #15,Supplier Payment,Retail-NA,34150.09,0,USD,ACH Debit,NorthRiver Apparel Mfg #15,***1404,,PO-202405-Retail-NA-0001,FALSE,FALSE,REF-419306,First Continental Bank,***1722,"Globex International Holdings, Inc.",US,9562325.22
20/05/2024,20/05/2024,Supplier Payment - NorthRiver Apparel Mfg #23,Supplier Payment,Retail-NA,56517.17,0,USD,Wire Transfer,NorthRiver Apparel Mfg #23,***1987,,PO-202405-Retail-NA-0009,FALSE,FALSE,REF-887550,First Continental Bank,***3610,"Globex International Holdings, Inc.",US,9505808.05
20/05/2024,20/05/2024,Client Receipt - ShopSphere Partner #37,Sales Receipt,Retail-NA,0,51168.33,USD,Card Settlement,ShopSphere Partner #37,***7024,INV-202405-Retail-NA-0006,,FALSE,FALSE,REF-222813,First Continental Bank,***7845,"Globex International Holdings, Inc.",US,9556976.38
21/05/2024,21/05/2024,Supplier Payment - ExpertNet Subcontractors #5,Supplier Payment,PS-GL,24816.51,0,USD,Fedwire,ExpertNet Subcontractors #5,***8143,,PO-202405-PS-GL-0011,FALSE,FALSE,REF-182142,First Continental Bank,***4832,"Globex International Holdings, Inc.",US,9532159.87
21/05/2024,21/05/2024,Client Receipt - Card Settlement Batch #2,Sales Receipt,Retail-NA,0,92266.93,USD,ACH Credit,Card Settlement Batch #2,***2295,INV-202405-Retail-NA-0005,,FALSE,FALSE,REF-438854,First Continental Bank,***5137,"Globex International Holdings, Inc.",US,9624426.8
22/05/2024,22/05/2024,Supplier Payment - CodeCraft Contractors #11,Supplier Payment,SaaS-GL,16288.09,0,USD,Fedwire,CodeCraft Contractors #11,***8970,,PO-202405-SaaS-GL-0008,FALSE,FALSE,REF-965422,First Continental Bank,***1512,"Globex International Holdings, Inc.",US,9608138.71
22/05/2024,22/05/2024,Marketing - Aurelia Media #9,Marketing,ALL,34370.73,0,USD,Fedwire,Aurelia Media #9,***9714,,,FALSE,FALSE,REF-457503,First Continental Bank,***4541,"Globex International Holdings, Inc.",US,9573767.98
22/05/2024,22/05/2024,VAT/GST Remittance - US IRS,Tax Payment,ALL,189505.45,0,USD,Fedwire,US IRS,***4662,,,FALSE,FALSE,REF-237289,First Continental Bank,***1492,"Globex International Holdings, Inc.",US,9384262.53
22/05/2024,22/05/2024,Client Receipt - CloudBridge Co. #42,Sales Receipt,SaaS-GL,0,1633.88,USD,Fedwire Credit,CloudBridge Co. #42,***2619,INV-202405-SaaS-GL-0003,,FALSE,FALSE,REF-834773,First Continental Bank,***9381,"Globex International Holdings, Inc.",US,9385896.41
22/05/2024,22/05/2024,Client Receipt - ShopSphere Partner #76,Sales Receipt,Retail-NA,0,1827.06,USD,Card Settlement,ShopSphere Partner #76,***7788,INV-202405-Retail-NA-0009,,FALSE,FALSE,REF-406053,First Continental Bank,***8492,"Globex International Holdings, Inc.",US,9387723.47
22/05/2024,22/05/2024,Client Receipt - ShopSphere Partner #9,Sales Receipt,Retail-NA,0,9952.01,USD,ACH Credit,ShopSphere Partner #9,***1354,INV-202405-Retail-NA-0016,,FALSE,FALSE,REF-720921,First Continental Bank,***2028,"Globex International Holdings, Inc.",US,9397675.48
22/05/2024,22/05/2024,Client Receipt - CloudBridge Co. #76,Sales Receipt,SaaS-GL,0,65363.83,USD,ACH Credit,CloudBridge Co. #76,***5570,INV-202405-SaaS-GL-0020,,FALSE,FALSE,REF-257866,First Continental Bank,***8699,"Globex International Holdings, Inc.",US,9463039.31
23/05/2024,23/05/2024,Client Receipt - CloudBridge Co. #57,Sales Receipt,SaaS-GL,0,128495.83,USD,ACH Credit,CloudBridge Co. #57,***4945,INV-202405-SaaS-GL-0002,,FALSE,FALSE,REF-212409,First Continental Bank,***3834,"Globex International Holdings, Inc.",US,9591535.14
25/05/2024,25/05/2024,Supplier Payment - ExpertNet Subcontractors #3,Supplier Payment,PS-GL,41163.88,0,USD,Fedwire,ExpertNet Subcontractors #3,***5518,,PO-202405-PS-GL-0004,FALSE,FALSE,REF-540100,First Continental Bank,***1490,"Globex International Holdings, Inc.",US,9550371.26
25/05/2024,25/05/2024,Client Receipt - CloudBridge Co. #35,Sales Receipt,SaaS-GL,0,56784.6,USD,Fedwire Credit,CloudBridge Co. #35,***4784,INV-202405-SaaS-GL-0005,,FALSE,FALSE,REF-838069,First Continental Bank,***1688,"Globex International Holdings, Inc.",US,9607155.86
26/05/2024,26/05/2024,Marketing - Beacon Digital #8,Marketing,ALL,44968.94,0,USD,ACH Debit,Beacon Digital #8,***2392,,,FALSE,FALSE,REF-448428,First Continental Bank,***9363,"Globex International Holdings, Inc.",US,9562186.92
26/05/2024,26/05/2024,Intercompany Settlement - Globex APAC Logistics Pte. Ltd.,Intercompany Transfer,ALL,863887,0,USD,Internal Transfer,Globex APAC Logistics Pte. Ltd.,***9267,,,TRUE,TRUE,REF-642370,First Continental Bank,***3431,"Globex International Holdings, Inc.",US,8698299.92
27/05/2024,27/05/2024,Supplier Payment - PackFast Fulfillment #1,Supplier Payment,Retail-NA,116997.48,0,USD,ACH Debit,PackFast Fulfillment #1,***9519,,PO-202405-Retail-NA-0006,FALSE,FALSE,REF-422923,First Continental Bank,***8546,"Globex International Holdings, Inc.",US,8581302.44
27/05/2024,27/05/2024,Client Receipt - CloudBridge Co. #70,Sales Receipt,SaaS-GL,0,28715.24,USD,ACH Credit,CloudBridge Co. #70,***8829,INV-202405-SaaS-GL-0016,,FALSE,FALSE,REF-202827,First Continental Bank,***3704,"Globex International Holdings, Inc.",US,8610017.68
27/05/2024,27/05/2024,Client Receipt - CloudBridge Co. #9,Sales Receipt,SaaS-GL,0,47783.76,USD,ACH Credit,CloudBridge Co. #9,***3128,INV-202405-SaaS-GL-0022,,FALSE,FALSE,REF-930480,First Continental Bank,***9597,"Globex International Holdings, Inc.",US,8657801.44
27/05/2024,27/05/2024,Client Receipt - CloudBridge Co. #44,Sales Receipt,SaaS-GL,0,59973.54,USD,Card Settlement,CloudBridge Co. #44,***3063,INV-202405-SaaS-GL-0013,,FALSE,FALSE,REF-274492,First Continental Bank,***7422,"Globex International Holdings, Inc.",US,8717774.98
28/05/2024,28/05/2024,Payroll - GlobalPay Services Ltd,Payroll,ALL,271351.75,0,USD,Wire Transfer,GlobalPay Services Ltd,***3349,,,FALSE,FALSE,REF-744681,First Continental Bank,***7653,"Globex International Holdings, Inc.",US,8446423.23
28/05/2024,28/05/2024,Client Receipt - CloudBridge Co. #4,Sales Receipt,SaaS-GL,0,10610.43,USD,Fedwire Credit,CloudBridge Co. #4,***8022,INV-202405-SaaS-GL-0007,,FALSE,FALSE,REF-432067,First Continental Bank,***4721,"Globex International Holdings, Inc.",US,8457033.66
28/05/2024,28/05/2024,Client Receipt - ShopSphere Partner #55,Sales Receipt,Retail-NA,0,20188.51,USD,Fedwire Credit,ShopSphere Partner #55,***1775,INV-202405-Retail-NA-0008,,FALSE,FALSE,REF-268479,First Continental Bank,***7254,"Globex International Holdings, Inc.",US,8477222.17
28/05/2024,28/05/2024,Client Receipt - CloudBridge Co. #52,Sales Receipt,SaaS-GL,0,28811.65,USD,Card Settlement,CloudBridge Co. #52,***8561,INV-202405-SaaS-GL-0006,,FALSE,FALSE,REF-686969,First Continental Bank,***6624,"Globex International Holdings, Inc.",US,8506033.82
28/05/2024,28/05/2024,Client Receipt - CloudBridge Co. #63,Sales Receipt,SaaS-GL,0,122864.01,USD,ACH Credit,CloudBridge Co. #63,***7349,INV-202405-SaaS-GL-0024,,FALSE,FALSE,REF-737780,First Continental Bank,***8887,"Globex International Holdings, Inc.",US,8628897.83
29/05/2024,29/05/2024,Supplier Payment - HyperCloud Infra #17,Supplier Payment,SaaS-GL,29086.99,0,USD,Wire Transfer,HyperCloud Infra #17,***9933,,PO-202405-SaaS-GL-0003,FALSE,FALSE,REF-257614,First Continental Bank,***6631,"Globex International Holdings, Inc.",US,8599810.84
29/05/2024,29/05/2024,Supplier Payment - NorthRiver Apparel Mfg #34,Supplier Payment,Retail-NA,75889.08,0,USD,ACH Debit,NorthRiver Apparel Mfg #34,***6651,,PO-202405-Retail-NA-0007,FALSE,FALSE,REF-963328,First Continental Bank,***7365,"Globex International Holdings, Inc.",US,8523921.76
29/05/2024,29/05/2024,Payroll - GlobalPay Services Ltd,Payroll,ALL,271351.75,0,USD,ACH Debit,GlobalPay Services Ltd,***5168,,,FALSE,FALSE,REF-364055,First Continental Bank,***5752,"Globex International Holdings, Inc.",US,8252570.01
29/05/2024,29/05/2024,Client Receipt - ShopSphere Partner #4,Sales Receipt,Retail-NA,0,241249.68,USD,Fedwire Credit,ShopSphere Partner #4,***3525,INV-202405-Retail-NA-0010,,FALSE,FALSE,REF-223743,First Continental Bank,***7384,"Globex International Holdings, Inc.",US,8493819.69
30/05/2024,30/05/2024,Supplier Payment - HyperCloud Infra #8,Supplier Payment,SaaS-GL,91126.13,0,USD,Wire Transfer,HyperCloud Infra #8,***7469,,PO-202405-SaaS-GL-0010,FALSE,FALSE,REF-132431,First Continental Bank,***8281,"Globex International Holdings, Inc.",US,8402693.56
30/05/2024,30/05/2024,Interest Earned,Interest Income,ALL,0,9705.79,USD,Fedwire Credit,First Continental Bank,***2135,,,FALSE,FALSE,REF-576420,First Continental Bank,***8718,"Globex International Holdings, Inc.",US,8412399.35
30/05/2024,30/05/2024,Client Receipt - ShopSphere Partner #37,Sales Receipt,Retail-NA,0,32467.26,USD,Card Settlement,ShopSphere Partner #37,***3149,INV-202405-Retail-NA-0001,,FALSE,FALSE,REF-734918,First Continental Bank,***4345,"Globex International Holdings, Inc.",US,8444866.61
30/05/2024,30/05/2024,Client Receipt - CloudBridge Co. #32,Sales Receipt,SaaS-GL,0,37958.67,USD,ACH Credit,CloudBridge Co. #32,***3090,INV-202405-SaaS-GL-0032,,FALSE,FALSE,REF-233591,First Continental Bank,***9695,"Globex International Holdings, Inc.",US,8482825.28
30/05/2024,30/05/2024,Client Receipt - CloudBridge Co. #4,Sales Receipt,SaaS-GL,0,57284.51,USD,ACH Credit,CloudBridge Co. #4,***7675,INV-202405-SaaS-GL-0021,,FALSE,FALSE,REF-113532,First Continental Bank,***7712,"Globex International Holdings, Inc.",US,8540109.79
31/05/2024,31/05/2024,Supplier Payment - ExpertNet Subcontractors #3,Supplier Payment,PS-GL,3910.09,0,USD,ACH Debit,ExpertNet Subcontractors #3,***1450,,PO-202405-PS-GL-0003,FALSE,FALSE,REF-180161,First Continental Bank,***8197,"Globex International Holdings, Inc.",US,8536199.7
31/05/2024,31/05/2024,Supplier Payment - ExpertNet Subcontractors #15,Supplier Payment,PS-GL,10257.7,0,USD,ACH Debit,ExpertNet Subcontractors #15,***2711,,PO-202405-PS-GL-0009,FALSE,FALSE,REF-356309,First Continental Bank,***9272,"Globex International Holdings, Inc.",US,8525942
31/05/2024,31/05/2024,Client Receipt - Vertex Advisory Client #53,Sales Receipt,PS-GL,0,7212.63,USD,Fedwire Credit,Vertex Advisory Client #53,***4237,INV-202405-PS-GL-0003,,FALSE,FALSE,REF-859901,First Continental Bank,***6750,"Globex International Holdings, Inc.",US,8533154.63
31/05/2024,31/05/2024,Client Receipt - CloudBridge Co. #57,Sales Receipt,SaaS-GL,0,11147.19,USD,Card Settlement,CloudBridge Co. #57,***9340,INV-202405-SaaS-GL-0019,,FALSE,FALSE,REF-632649,First Continental Bank,***5701,"Globex International Holdings, Inc.",US,8544301.82
31/05/2024,31/05/2024,Client Receipt - CloudBridge Co. #49,Sales Receipt,SaaS-GL,0,28885.46,USD,Card Settlement,CloudBridge Co. #49,***4817,INV-202405-SaaS-GL-0029,,FALSE,FALSE,REF-885152,First Continental Bank,***6171,"Globex International Holdings, Inc.",US,8573187.28
31/05/2024,31/05/2024,Client Receipt - Vertex Advisory Client #15,Sales Receipt,PS-GL,0,135174.02,USD,Card Settlement,Vertex Advisory Client #15,***6078,INV-202405-PS-GL-0006,,FALSE,FALSE,REF-534046,First Continental Bank,***7281,"Globex International Holdings, Inc.",US,8708361.3
01/06/2024,01/06/2024,Account Maintenance Fee,Bank/Merchant Fees,ALL,2500,0,USD,ACH Debit,First Continental Bank,***3052,,,FALSE,FALSE,REF-817020,First Continental Bank,***7635,"Globex International Holdings, Inc.",US,8705861.3
01/06/2024,01/06/2024,Client Receipt - Vertex Advisory Client #38,Sales Receipt,PS-GL,0,68798.31,USD,Fedwire Credit,Vertex Advisory Client #38,***9544,INV-202406-PS-GL-0001,,FALSE,FALSE,REF-515211,First Continental Bank,***2336,"Globex International Holdings, Inc.",US,8774659.61
01/06/2024,01/06/2024,Client Receipt - Vertex Advisory Client #1,Sales Receipt,PS-GL,0,175904.65,USD,Card Settlement,Vertex Advisory Client #1,***3982,INV-202406-PS-GL-0008,,FALSE,FALSE,REF-264005,First Continental Bank,***3311,"Globex International Holdings, Inc.",US,8950564.26
02/06/2024,02/06/2024,Supplier Payment - CodeCraft Contractors #9,Supplier Payment,SaaS-GL,18559.7,0,USD,Fedwire,CodeCraft Contractors #9,***7926,,PO-202406-SaaS-GL-0005,FALSE,FALSE,REF-978418,First Continental Bank,***4906,"Globex International Holdings, Inc.",US,8932004.56
02/06/2024,02/06/2024,Supplier Payment - ExpertNet Subcontractors #9,Supplier Payment,PS-GL,25632.95,0,USD,ACH Debit,ExpertNet Subcontractors #9,***6474,,PO-202406-PS-GL-0001,FALSE,FALSE,REF-970781,First Continental Bank,***2089,"Globex International Holdings, Inc.",US,8906371.61
02/06/2024,02/06/2024,Supplier Payment - ExpertNet Subcontractors #3,Supplier Payment,PS-GL,34263.6,0,USD,Wire Transfer,ExpertNet Subcontractors #3,***8849,,PO-202406-PS-GL-0008,FALSE,FALSE,REF-442267,First Continental Bank,***7339,"Globex International Holdings, Inc.",US,8872108.01
03/06/2024,03/06/2024,Client Receipt - CloudBridge Co. #50,Sales Receipt,SaaS-GL,0,37232.52,USD,ACH Credit,CloudBridge Co. #50,***6408,INV-202406-SaaS-GL-0029,,FALSE,FALSE,REF-667677,First Continental Bank,***5009,"Globex International Holdings, Inc.",US,8909340.53
04/06/2024,04/06/2024,Supplier Payment - ExpertNet Subcontractors #16,Supplier Payment,PS-GL,2202.59,0,USD,ACH Debit,ExpertNet Subcontractors #16,***9279,,PO-202406-PS-GL-0006,FALSE,FALSE,REF-741896,First Continental Bank,***8724,"Globex International Holdings, Inc.",US,8907137.94
04/06/2024,04/06/2024,Client Receipt - CloudBridge Co. #7,Sales Receipt,SaaS-GL,0,69310.51,USD,Card Settlement,CloudBridge Co. #7,***4895,INV-202406-SaaS-GL-0016,,FALSE,FALSE,REF-330949,First Continental Bank,***4779,"Globex International Holdings, Inc.",US,8976448.45
05/06/2024,05/06/2024,Supplier Payment - ExpertNet Subcontractors #11,Supplier Payment,PS-GL,30401.9,0,USD,ACH Debit,ExpertNet Subcontractors #11,***4860,,PO-202406-PS-GL-0004,FALSE,FALSE,REF-836128,First Continental Bank,***8886,"Globex International Holdings, Inc.",US,8946046.55
05/06/2024,05/06/2024,Supplier Payment - NorthRiver Apparel Mfg #27,Supplier Payment,Retail-NA,33537.85,0,USD,ACH Debit,NorthRiver Apparel Mfg #27,***7313,,PO-202406-Retail-NA-0004,FALSE,FALSE,REF-987744,First Continental Bank,***6904,"Globex International Holdings, Inc.",US,8912508.7
05/06/2024,05/06/2024,Client Receipt - CloudBridge Co. #46,Sales Receipt,SaaS-GL,0,39664.81,USD,Fedwire Credit,CloudBridge Co. #46,***2294,INV-202406-SaaS-GL-0027,,FALSE,FALSE,REF-506198,First Continental Bank,***2366,"Globex International Holdings, Inc.",US,8952173.51
05/06/2024,05/06/2024,Client Receipt - Vertex Advisory Client #4,Sales Receipt,PS-GL,0,51916.36,USD,Card Settlement,Vertex Advisory Client #4,***5437,INV-202406-PS-GL-0002,,FALSE,FALSE,REF-280871,First Continental Bank,***5967,"Globex International Holdings, Inc.",US,9004089.87
06/06/2024,06/06/2024,Supplier Payment - PackFast Fulfillment #7,Supplier Payment,Retail-NA,2228.55,0,USD,ACH Debit,PackFast Fulfillment #7,***2612,,PO-202406-Retail-NA-0008,FALSE,FALSE,REF-979280,First Continental Bank,***8443,"Globex International Holdings, Inc.",US,9001861.32
06/06/2024,06/06/2024,Supplier Payment - ExpertNet Subcontractors #17,Supplier Payment,PS-GL,13510.61,0,USD,Fedwire,ExpertNet Subcontractors #17,***7997,,PO-202406-PS-GL-0007,FALSE,FALSE,REF-133195,First Continental Bank,***9844,"Globex International Holdings, Inc.",US,8988350.71
06/06/2024,06/06/2024,Supplier Payment - CodeCraft Contractors #7,Supplier Payment,SaaS-GL,24128.59,0,USD,Wire Transfer,CodeCraft Contractors #7,***6863,,PO-202406-SaaS-GL-0006,FALSE,FALSE,REF-592125,First Continental Bank,***1751,"Globex International Holdings, Inc.",US,8964222.12
06/06/2024,06/06/2024,Client Receipt - CloudBridge Co. #29,Sales Receipt,SaaS-GL,0,11710.4,USD,ACH Credit,CloudBridge Co. #29,***4154,INV-202406-SaaS-GL-0014,,FALSE,FALSE,REF-497190,First Continental Bank,***2377,"Globex International Holdings, Inc.",US,8975932.52
07/06/2024,07/06/2024,Supplier Payment - NorthRiver Apparel Mfg #8,Supplier Payment,Retail-NA,34719.93,0,USD,ACH Debit,NorthRiver Apparel Mfg #8,***6393,,PO-202406-Retail-NA-0011,FALSE,FALSE,REF-670197,First Continental Bank,***2562,"Globex International Holdings, Inc.",US,8941212.59
07/06/2024,07/06/2024,Supplier Payment - CodeCraft Contractors #10,Supplier Payment,SaaS-GL,47327.84,0,USD,Fedwire,CodeCraft Contractors #10,***9021,,PO-202406-SaaS-GL-0007,FALSE,FALSE,REF-442643,First Continental Bank,***1394,"Globex International Holdings, Inc.",US,8893884.75
07/06/2024,07/06/2024,Client Receipt - CloudBridge Co. #62,Sales Receipt,SaaS-GL,0,2251.98,USD,Fedwire Credit,CloudBridge Co. #62,***9557,INV-202406-SaaS-GL-0028,,FALSE,FALSE,REF-819827,First Continental Bank,***5764,"Globex International Holdings, Inc.",US,8896136.73
07/06/2024,07/06/2024,Client Receipt - CloudBridge Co. #30,Sales Receipt,SaaS-GL,0,31219.05,USD,Fedwire Credit,CloudBridge Co. #30,***5602,INV-202406-SaaS-GL-0009,,FALSE,FALSE,REF-324468,First Continental Bank,***5003,"Globex International Holdings, Inc.",US,8927355.78
07/06/2024,07/06/2024,Client Receipt - ShopSphere Partner #14,Sales Receipt,Retail-NA,0,31909.92,USD,Fedwire Credit,ShopSphere Partner #14,***2610,INV-202406-Retail-NA-0011,,FALSE,FALSE,REF-299177,First Continental Bank,***2004,"Globex International Holdings, Inc.",US,8959265.7
07/06/2024,07/06/2024,Client Receipt - ShopSphere Partner #14,Sales Receipt,Retail-NA,0,49457.12,USD,ACH Credit,ShopSphere Partner #14,***8710,INV-202406-Retail-NA-0009,,FALSE,FALSE,REF-688463,First Continental Bank,***3660,"Globex International Holdings, Inc.",US,9008722.82
08/06/2024,08/06/2024,Client Receipt - CloudBridge Co. #45,Sales Receipt,SaaS-GL,0,889.16,USD,Fedwire Credit,CloudBridge Co. #45,***1837,INV-202406-SaaS-GL-0026,,FALSE,FALSE,REF-835413,First Continental Bank,***3582,"Globex International Holdings, Inc.",US,9009611.98
09/06/2024,09/06/2024,Supplier Payment - NorthRiver Apparel Mfg #26,Supplier Payment,Retail-NA,193255.27,0,USD,Fedwire,NorthRiver Apparel Mfg #26,***3672,,PO-202406-Retail-NA-0010,FALSE,FALSE,REF-193810,First Continental Bank,***4587,"Globex International Holdings, Inc.",US,8816356.71
09/06/2024,09/06/2024,Client Receipt - Vertex Advisory Client #13,Sales Receipt,PS-GL,0,143656.78,USD,Card Settlement,Vertex Advisory Client #13,***6685,INV-202406-PS-GL-0010,,FALSE,FALSE,REF-868157,First Continental Bank,***3974,"Globex International Holdings, Inc.",US,8960013.49
10/06/2024,10/06/2024,Supplier Payment - ExpertNet Subcontractors #19,Supplier Payment,PS-GL,105780.88,0,USD,Wire Transfer,ExpertNet Subcontractors #19,***3623,,PO-202406-PS-GL-0003,FALSE,FALSE,REF-403344,First Continental Bank,***3401,"Globex International Holdings, Inc.",US,8854232.61
10/06/2024,10/06/2024,Client Receipt - Vertex Advisory Client #18,Sales Receipt,PS-GL,0,7712.74,USD,ACH Credit,Vertex Advisory Client #18,***7078,INV-202406-PS-GL-0005,,FALSE,FALSE,REF-722985,First Continental Bank,***8662,"Globex International Holdings, Inc.",US,8861945.35
10/06/2024,10/06/2024,Client Receipt - CloudBridge Co. #44,Sales Receipt,SaaS-GL,0,13272.96,USD,Card Settlement,CloudBridge Co. #44,***8274,INV-202406-SaaS-GL-0017,,FALSE,FALSE,REF-341265,First Continental Bank,***5122,"Globex International Holdings, Inc.",US,8875218.31
10/06/2024,10/06/2024,Client Receipt - ShopSphere Partner #74,Sales Receipt,Retail-NA,0,136615.4,USD,Fedwire Credit,ShopSphere Partner #74,***7904,INV-202406-Retail-NA-0004,,FALSE,FALSE,REF-815340,First Continental Bank,***4225,"Globex International Holdings, Inc.",US,9011833.71
11/06/2024,11/06/2024,Supplier Payment - CodeCraft Contractors #3,Supplier Payment,SaaS-GL,35051.32,0,USD,ACH Debit,CodeCraft Contractors #3,***5675,,PO-202406-SaaS-GL-0003,FALSE,FALSE,REF-757016,First Continental Bank,***8439,"Globex International Holdings, Inc.",US,8976782.39
11/06/2024,11/06/2024,Client Receipt - CloudBridge Co. #33,Sales Receipt,SaaS-GL,0,2875.63,USD,Card Settlement,CloudBridge Co. #33,***2851,INV-202406-SaaS-GL-0019,,FALSE,FALSE,REF-132409,First Continental Bank,***3400,"Globex International Holdings, Inc.",US,8979658.02
11/06/2024,11/06/2024,Client Receipt - Card Settlement Batch #11,Sales Receipt,Retail-NA,0,21797.14,USD,Fedwire Credit,Card Settlement Batch #11,***2108,INV-202406-Retail-NA-0002,,FALSE,FALSE,REF-665660,First Continental Bank,***8635,"Globex International Holdings, Inc.",US,9001455.16
11/06/2024,11/06/2024,Client Receipt - Vertex Advisory Client #11,Sales Receipt,PS-GL,0,27814.65,USD,Card Settlement,Vertex Advisory Client #11,***7164,INV-202406-PS-GL-0007,,FALSE,FALSE,REF-771774,First Continental Bank,***6615,"Globex International Holdings, Inc.",US,9029269.81
11/06/2024,11/06/2024,Client Receipt - Vertex Advisory Client #58,Sales Receipt,PS-GL,0,104049.24,USD,Card Settlement,Vertex Advisory Client #58,***6970,INV-202406-PS-GL-0012,,FALSE,FALSE,REF-561106,First Continental Bank,***7118,"Globex International Holdings, Inc.",US,9133319.05
12/06/2024,12/06/2024,Intercompany Settlement - Globex Retail NA LLC,Intercompany Transfer,ALL,285076,0,USD,Internal Transfer,Globex Retail NA LLC,***1086,,,TRUE,TRUE,REF-652228,First Continental Bank,***6436,"Globex International Holdings, Inc.",US,8848243.05
12/06/2024,12/06/2024,Client Receipt - CloudBridge Co. #56,Sales Receipt,SaaS-GL,0,26428.51,USD,ACH Credit,CloudBridge Co. #56,***5329,INV-202406-SaaS-GL-0004,,FALSE,FALSE,REF-205737,First Continental Bank,***1767,"Globex International Holdings, Inc.",US,8874671.56
12/06/2024,12/06/2024,Client Receipt - CloudBridge Co. #18,Sales Receipt,SaaS-GL,0,47879.97,USD,ACH Credit,CloudBridge Co. #18,***3611,INV-202406-SaaS-GL-0008,,FALSE,FALSE,REF-325066,First Continental Bank,***5483,"Globex International Holdings, Inc.",US,8922551.53
12/06/2024,12/06/2024,Client Receipt - CloudBridge Co. #54,Sales Receipt,SaaS-GL,0,61271.6,USD,Fedwire Credit,CloudBridge Co. #54,***3410,INV-202406-SaaS-GL-0023,,FALSE,FALSE,REF-976658,First Continental Bank,***5496,"Globex International Holdings, Inc.",US,8983823.13
13/06/2024,13/06/2024,Supplier Payment - HyperCloud Infra #15,Supplier Payment,SaaS-GL,35887.7,0,USD,ACH Debit,HyperCloud Infra #15,***3046,,PO-202406-SaaS-GL-0010,FALSE,FALSE,REF-400300,First Continental Bank,***7329,"Globex International Holdings, Inc.",US,8947935.43
14/06/2024,14/06/2024,Supplier Payment - NorthRiver Apparel Mfg #24,Supplier Payment,Retail-NA,69924.63,0,USD,Fedwire,NorthRiver Apparel Mfg #24,***5527,,PO-202406-Retail-NA-0003,FALSE,FALSE,REF-264845,First Continental Bank,***5568,"Globex International Holdings, Inc.",US,8878010.8
14/06/2024,14/06/2024,Client Receipt - Vertex Advisory Client #50,Sales Receipt,PS-GL,0,50541.43,USD,ACH Credit,Vertex Advisory Client #50,***4980,INV-202406-PS-GL-0006,,FALSE,FALSE,REF-688658,First Continental Bank,***3773,"Globex International Holdings, Inc.",US,8928552.23
14/06/2024,14/06/2024,Client Receipt - ShopSphere Partner #52,Sales Receipt,Retail-NA,0,80330.57,USD,ACH Credit,ShopSphere Partner #52,***8861,INV-202406-Retail-NA-0007,,FALSE,FALSE,REF-794594,First Continental Bank,***3592,"Globex International Holdings, Inc.",US,9008882.8
15/06/2024,15/06/2024,Loan Interest Payment,Loan Interest,ALL,85000,0,USD,ACH Debit,First Continental Bank - Corporate Lending,***7104,,,FALSE,FALSE,REF-365831,First Continental Bank,***9933,"Globex International Holdings, Inc.",US,8923882.8
15/06/2024,15/06/2024,Loan Principal Repayment,Loan Principal,ALL,500000,0,USD,Fedwire,First Continental Bank - Corporate Lending,***1875,,,FALSE,FALSE,REF-793953,First Continental Bank,***5323,"Globex International Holdings, Inc.",US,8423882.8
16/06/2024,16/06/2024,Supplier Payment - ExpertNet Subcontractors #19,Supplier Payment,PS-GL,19721.1,0,USD,Fedwire,ExpertNet Subcontractors #19,***7858,,PO-202406-PS-GL-0002,FALSE,FALSE,REF-965911,First Continental Bank,***7591,"Globex International Holdings, Inc.",US,8404161.7
17/06/2024,17/06/2024,Merchant Processing Fees,Bank/Merchant Fees,ALL,532.95,0,USD,Wire Transfer,First Continental Bank,***7568,,,FALSE,FALSE,REF-294921,First Continental Bank,***6615,"Globex International Holdings, Inc.",US,8403628.75
17/06/2024,17/06/2024,Supplier Payment - HyperCloud Infra #8,Supplier Payment,SaaS-GL,18272.68,0,USD,Wire Transfer,HyperCloud Infra #8,***5297,,PO-202406-SaaS-GL-0001,FALSE,FALSE,REF-538366,First Continental Bank,***2686,"Globex International Holdings, Inc.",US,8385356.07
17/06/2024,17/06/2024,Metro Water & Waste,Rent & Utilities,ALL,26068.68,0,USD,Wire Transfer,Metro Water & Waste,***4818,,,FALSE,FALSE,REF-437198,First Continental Bank,***7430,"Globex International Holdings, Inc.",US,8359287.39
17/06/2024,17/06/2024,Client Receipt - CloudBridge Co. #52,Sales Receipt,SaaS-GL,0,39728.21,USD,Card Settlement,CloudBridge Co. #52,***8546,INV-202406-SaaS-GL-0022,,FALSE,FALSE,REF-585880,First Continental Bank,***4551,"Globex International Holdings, Inc.",US,8399015.6
17/06/2024,17/06/2024,Client Receipt - CloudBridge Co. #3,Sales Receipt,SaaS-GL,0,60499.74,USD,ACH Credit,CloudBridge Co. #3,***1297,INV-202406-SaaS-GL-0010,,FALSE,FALSE,REF-896188,First Continental Bank,***3717,"Globex International Holdings, Inc.",US,8459515.34
17/06/2024,17/06/2024,Client Receipt - CloudBridge Co. #10,Sales Receipt,SaaS-GL,0,234414.92,USD,ACH Credit,CloudBridge Co. #10,***8449,INV-202406-SaaS-GL-0003,,FALSE,FALSE,REF-482549,First Continental Bank,***5550,"Globex International Holdings, Inc.",US,8693930.26
18/06/2024,18/06/2024,Supplier Payment - ExpertNet Subcontractors #16,Supplier Payment,PS-GL,2363.45,0,USD,Wire Transfer,ExpertNet Subcontractors #16,***1416,,PO-202406-PS-GL-0005,FALSE,FALSE,REF-547319,First Continental Bank,***7965,"Globex International Holdings, Inc.",US,8691566.81
18/06/2024,18/06/2024,Supplier Payment - CodeCraft Contractors #12,Supplier Payment,SaaS-GL,38223.82,0,USD,Wire Transfer,CodeCraft Contractors #12,***8665,,PO-202406-SaaS-GL-0009,FALSE,FALSE,REF-287527,First Continental Bank,***4318,"Globex International Holdings, Inc.",US,8653342.99
18/06/2024,18/06/2024,Supplier Payment - NorthRiver Apparel Mfg #25,Supplier Payment,Retail-NA,83700.03,0,USD,Wire Transfer,NorthRiver Apparel Mfg #25,***5094,,PO-202406-Retail-NA-0007,FALSE,FALSE,REF-536120,First Continental Bank,***3878,"Globex International Holdings, Inc.",US,8569642.96
18/06/2024,18/06/2024,Client Receipt - CloudBridge Co. #13,Sales Receipt,SaaS-GL,0,20722.31,USD,Card Settlement,CloudBridge Co. #13,***7361,INV-202406-SaaS-GL-0001,,FALSE,FALSE,REF-377582,First Continental Bank,***7096,"Globex International Holdings, Inc.",US,8590365.27
18/06/2024,18/06/2024,Client Receipt - ShopSphere Partner #52,Sales Receipt,Retail-NA,0,29138.44,USD,ACH Credit,ShopSphere Partner #52,***4057,INV-202406-Retail-NA-0014,,FALSE,FALSE,REF-781161,First Continental Bank,***4260,"Globex International Holdings, Inc.",US,8619503.71
18/06/2024,18/06/2024,Client Receipt - Vertex Advisory Client #19,Sales Receipt,PS-GL,0,37903.73,USD,Fedwire Credit,Vertex Advisory Client #19,***4809,INV-202406-PS-GL-0003,,FALSE,FALSE,REF-617149,First Continental Bank,***4850,"Globex International Holdings, Inc.",US,8657407.44
18/06/2024,18/06/2024,Client Receipt - CloudBridge Co. #13,Sales Receipt,SaaS-GL,0,109933.43,USD,Card Settlement,CloudBridge Co. #13,***6847,INV-202406-SaaS-GL-0007,,FALSE,FALSE,REF-783062,First Continental Bank,***3664,"Globex International Holdings, Inc.",US,8767340.87
19/06/2024,19/06/2024,Supplier Payment - HyperCloud Infra #17,Supplier Payment,SaaS-GL,8311.27,0,USD,Wire Transfer,HyperCloud Infra #17,***4843,,PO-202406-SaaS-GL-0002,FALSE,FALSE,REF-188334,First Continental Bank,***8634,"Globex International Holdings, Inc.",US,8759029.6
19/06/2024,19/06/2024,VAT/GST Remittance - US IRS,Tax Payment,ALL,204693.08,0,USD,Wire Transfer,US IRS,***4672,,,FALSE,FALSE,REF-897498,First Continental Bank,***9855,"Globex International Holdings, Inc.",US,8554336.52
19/06/2024,19/06/2024,Client Receipt - CloudBridge Co. #27,Sales Receipt,SaaS-GL,0,8171.44,USD,ACH Credit,CloudBridge Co. #27,***3803,INV-202406-SaaS-GL-0025,,FALSE,FALSE,REF-267458,First Continental Bank,***3283,"Globex International Holdings, Inc.",US,8562507.96
19/06/2024,19/06/2024,Client Receipt - CloudBridge Co. #21,Sales Receipt,SaaS-GL,0,22192.09,USD,Fedwire Credit,CloudBridge Co. #21,***3593,INV-202406-SaaS-GL-0012,,FALSE,FALSE,REF-335618,First Continental Bank,***4113,"Globex International Holdings, Inc.",US,8584700.05
19/06/2024,19/06/2024,Client Receipt - ShopSphere Partner #77,Sales Receipt,Retail-NA,0,97788,USD,ACH Credit,ShopSphere Partner #77,***8567,INV-202406-Retail-NA-0006,,FALSE,FALSE,REF-294731,First Continental Bank,***3246,"Globex International Holdings, Inc.",US,8682488.05
20/06/2024,20/06/2024,Client Receipt - Vertex Advisory Client #57,Sales Receipt,PS-GL,0,2519.76,USD,ACH Credit,Vertex Advisory Client #57,***2502,INV-202406-PS-GL-0009,,FALSE,FALSE,REF-857226,First Continental Bank,***7108,"Globex International Holdings, Inc.",US,8685007.81
20/06/2024,20/06/2024,Client Receipt - CloudBridge Co. #12,Sales Receipt,SaaS-GL,0,15565.84,USD,ACH Credit,CloudBridge Co. #12,***2055,INV-202406-SaaS-GL-0030,,FALSE,FALSE,REF-796267,First Continental Bank,***4997,"Globex International Holdings, Inc.",US,8700573.65
20/06/2024,20/06/2024,Client Receipt - CloudBridge Co. #71,Sales Receipt,SaaS-GL,0,17430.51,USD,Fedwire Credit,CloudBridge Co. #71,***3376,INV-202406-SaaS-GL-0024,,FALSE,FALSE,REF-677031,First Continental Bank,***5938,"Globex International Holdings, Inc.",US,8718004.16
20/06/2024,20/06/2024,Client Receipt - Card Settlement Batch #11,Sales Receipt,Retail-NA,0,60750.66,USD,ACH Credit,Card Settlement Batch #11,***7199,INV-202406-Retail-NA-0012,,FALSE,FALSE,REF-244489,First Continental Bank,***1493,"Globex International Holdings, Inc.",US,8778754.82
21/06/2024,21/06/2024,Supplier Payment - NorthRiver Apparel Mfg #33,Supplier Payment,Retail-NA,57772,0,USD,Wire Transfer,NorthRiver Apparel Mfg #33,***4868,,PO-202406-Retail-NA-0002,FALSE,FALSE,REF-675124,First Continental Bank,***1618,"Globex International Holdings, Inc.",US,8720982.82
21/06/2024,21/06/2024,Client Receipt - CloudBridge Co. #47,Sales Receipt,SaaS-GL,0,13016.4,USD,ACH Credit,CloudBridge Co. #47,***3814,INV-202406-SaaS-GL-0006,,FALSE,FALSE,REF-693779,First Continental Bank,***9473,"Globex International Holdings, Inc.",US,8733999.22
23/06/2024,23/06/2024,Supplier Payment - ExpertNet Subcontractors #5,Supplier Payment,PS-GL,2520.67,0,USD,Wire Transfer,ExpertNet Subcontractors #5,***7515,,PO-202406-PS-GL-0009,FALSE,FALSE,REF-653624,First Continental Bank,***6120,"Globex International Holdings, Inc.",US,8731478.55
23/06/2024,23/06/2024,Supplier Payment - NorthRiver Apparel Mfg #21,Supplier Payment,Retail-NA,22196.46,0,USD,Fedwire,NorthRiver Apparel Mfg #21,***3728,,PO-202406-Retail-NA-0001,FALSE,FALSE,REF-639946,First Continental Bank,***8569,"Globex International Holdings, Inc.",US,8709282.09
23/06/2024,23/06/2024,Client Receipt - CloudBridge Co. #8,Sales Receipt,SaaS-GL,0,85355.68,USD,ACH Credit,CloudBridge Co. #8,***6911,INV-202406-SaaS-GL-0005,,FALSE,FALSE,REF-945787,First Continental Bank,***5200,"Globex International Holdings, Inc.",US,8794637.77
24/06/2024,24/06/2024,Merchant Processing Fees,Bank/Merchant Fees,ALL,9619.71,0,USD,Fedwire,First Continental Bank,***6131,,,FALSE,FALSE,REF-679368,First Continental Bank,***2555,"Globex International Holdings, Inc.",US,8785018.06
24/06/2024,24/06/2024,Marketing - Beacon Digital #5,Marketing,ALL,17526.57,0,USD,Fedwire,Beacon Digital #5,***3611,,,FALSE,FALSE,REF-938197,First Continental Bank,***6872,"Globex International Holdings, Inc.",US,8767491.49
24/06/2024,24/06/2024,Client Receipt - CloudBridge Co. #57,Sales Receipt,SaaS-GL,0,399.86,USD,Fedwire Credit,CloudBridge Co. #57,***2325,INV-202406-SaaS-GL-0021,,FALSE,FALSE,REF-314989,First Continental Bank,***5118,"Globex International Holdings, Inc.",US,8767891.35
24/06/2024,24/06/2024,Client Receipt - ShopSphere Partner #47,Sales Receipt,Retail-NA,0,106740.52,USD,Card Settlement,ShopSphere Partner #47,***6857,INV-202406-Retail-NA-0001,,FALSE,FALSE,REF-781190,First Continental Bank,***7023,"Globex International Holdings, Inc.",US,8874631.87
24/06/2024,24/06/2024,Client Receipt - ShopSphere Partner #13,Sales Receipt,Retail-NA,0,163305.64,USD,Fedwire Credit,ShopSphere Partner #13,***7605,INV-202406-Retail-NA-0010,,FALSE,FALSE,REF-522300,First Continental Bank,***2781,"Globex International Holdings, Inc.",US,9037937.51
25/06/2024,25/06/2024,Marketing - Aurelia Media #10,Marketing,ALL,38048.91,0,USD,Fedwire,Aurelia Media #10,***9351,,,FALSE,FALSE,REF-653625,First Continental Bank,***7907,"Globex International Holdings, Inc.",US,8999888.6
25/06/2024,25/06/2024,Client Receipt - CloudBridge Co. #27,Sales Receipt,SaaS-GL,0,33689.53,USD,ACH Credit,CloudBridge Co. #27,***4158,INV-202406-SaaS-GL-0002,,FALSE,FALSE,REF-895895,First Continental Bank,***2945,"Globex International Holdings, Inc.",US,9033578.13
25/06/2024,25/06/2024,Client Receipt - Vertex Advisory Client #29,Sales Receipt,PS-GL,0,64998.38,USD,ACH Credit,Vertex Advisory Client #29,***9266,INV-202406-PS-GL-0011,,FALSE,FALSE,REF-924705,First Continental Bank,***2639,"Globex International Holdings, Inc.",US,9098576.51
26/06/2024,26/06/2024,Intercompany Settlement - Globex APAC Logistics Pte. Ltd.,Intercompany Transfer,ALL,486448,0,USD,Internal Transfer,Globex APAC Logistics Pte. Ltd.,***4816,,,TRUE,TRUE,REF-997022,First Continental Bank,***4448,"Globex International Holdings, Inc.",US,8612128.51
26/06/2024,26/06/2024,Client Receipt - CloudBridge Co. #74,Sales Receipt,SaaS-GL,0,72409.64,USD,Fedwire Credit,CloudBridge Co. #74,***5300,INV-202406-SaaS-GL-0015,,FALSE,FALSE,REF-368671,First Continental Bank,***7365,"Globex International Holdings, Inc.",US,8684538.15
26/06/2024,26/06/2024,Client Receipt - Card Settlement Batch #6,Sales Receipt,Retail-NA,0,142276.67,USD,Card Settlement,Card Settlement Batch #6,***9395,INV-202406-Retail-NA-0005,,FALSE,FALSE,REF-829956,First Continental Bank,***4439,"Globex International Holdings, Inc.",US,8826814.82
26/06/2024,26/06/2024,Client Receipt - ShopSphere Partner #42,Sales Receipt,Retail-NA,0,170350.06,USD,Fedwire Credit,ShopSphere Partner #42,***7763,INV-202406-Retail-NA-0013,,FALSE,FALSE,REF-183501,First Continental Bank,***6531,"Globex International Holdings, Inc.",US,8997164.88
26/06/2024,26/06/2024,Client Receipt - ShopSphere Partner #48,Sales Receipt,Retail-NA,0,237464.93,USD,ACH Credit,ShopSphere Partner #48,***3117,INV-202406-Retail-NA-0003,,FALSE,FALSE,REF-778179,First Continental Bank,***1944,"Globex International Holdings, Inc.",US,9234629.81
27/06/2024,27/06/2024,Supplier Payment - PackFast Fulfillment #19,Supplier Payment,Retail-NA,1338.46,0,USD,ACH Debit,PackFast Fulfillment #19,***1569,,PO-202406-Retail-NA-0005,FALSE,FALSE,REF-174358,First Continental Bank,***4327,"Globex International Holdings, Inc.",US,9233291.35
27/06/2024,27/06/2024,Supplier Payment - CodeCraft Contractors #4,Supplier Payment,SaaS-GL,16013.82,0,USD,Fedwire,CodeCraft Contractors #4,***7106,,PO-202406-SaaS-GL-0008,FALSE,FALSE,REF-191208,First Continental Bank,***4961,"Globex International Holdings, Inc.",US,9217277.53
27/06/2024,27/06/2024,Supplier Payment - PackFast Fulfillment #15,Supplier Payment,Retail-NA,117113.1,0,USD,Fedwire,PackFast Fulfillment #15,***1484,,PO-202406-Retail-NA-0006,FALSE,FALSE,REF-313881,First Continental Bank,***6611,"Globex International Holdings, Inc.",US,9100164.43
27/06/2024,27/06/2024,Supplier Payment - NorthRiver Apparel Mfg #16,Supplier Payment,Retail-NA,178772.82,0,USD,ACH Debit,NorthRiver Apparel Mfg #16,***1508,,PO-202406-Retail-NA-0009,FALSE,FALSE,REF-777690,First Continental Bank,***7261,"Globex International Holdings, Inc.",US,8921391.61
27/06/2024,27/06/2024,Client Receipt - CloudBridge Co. #76,Sales Receipt,SaaS-GL,0,13920.85,USD,Fedwire Credit,CloudBridge Co. #76,***9991,INV-202406-SaaS-GL-0013,,FALSE,FALSE,REF-457240,First Continental Bank,***3833,"Globex International Holdings, Inc.",US,8935312.46
27/06/2024,27/06/2024,Client Receipt - CloudBridge Co. #20,Sales Receipt,SaaS-GL,0,32351.74,USD,Fedwire Credit,CloudBridge Co. #20,***1534,INV-202406-SaaS-GL-0018,,FALSE,FALSE,REF-527445,First Continental Bank,***4313,"Globex International Holdings, Inc.",US,8967664.2
27/06/2024,27/06/2024,Client Receipt - CloudBridge Co. #1,Sales Receipt,SaaS-GL,0,48236.63,USD,ACH Credit,CloudBridge Co. #1,***9121,INV-202406-SaaS-GL-0020,,FALSE,FALSE,REF-904871,First Continental Bank,***2472,"Globex International Holdings, Inc.",US,9015900.83
27/06/2024,27/06/2024,Client Receipt - Vertex Advisory Client #24,Sales Receipt,PS-GL,0,52176.47,USD,ACH Credit,Vertex Advisory Client #24,***3303,INV-202406-PS-GL-0004,,FALSE,FALSE,REF-935731,First Continental Bank,***5631,"Globex International Holdings, Inc.",US,9068077.3
28/06/2024,28/06/2024,Supplier Payment - HyperCloud Infra #4,Supplier Payment,SaaS-GL,18260.78,0,USD,Wire Transfer,HyperCloud Infra #4,***7451,,PO-202406-SaaS-GL-0004,FALSE,FALSE,REF-564587,First Continental Bank,***4178,"Globex International Holdings, Inc.",US,9049816.52
28/06/2024,28/06/2024,Marketing - Beacon Digital #2,Marketing,ALL,26747.77,0,USD,Wire Transfer,Beacon Digital #2,***6313,,,FALSE,FALSE,REF-777891,First Continental Bank,***6858,"Globex International Holdings, Inc.",US,9023068.75
28/06/2024,28/06/2024,Payroll - GlobalPay Services Ltd,Payroll,ALL,275923.84,0,USD,ACH Debit,GlobalPay Services Ltd,***7750,,,FALSE,FALSE,REF-543744,First Continental Bank,***1201,"Globex International Holdings, Inc.",US,8747144.91
28/06/2024,28/06/2024,Client Receipt - CloudBridge Co. #17,Sales Receipt,SaaS-GL,0,9942.82,USD,Card Settlement,CloudBridge Co. #17,***7846,INV-202406-SaaS-GL-0011,,FALSE,FALSE,REF-638020,First Continental Bank,***4950,"Globex International Holdings, Inc.",US,8757087.73
29/06/2024,29/06/2024,Alphagrid Utilities,Rent & Utilities,ALL,1010.56,0,USD,Wire Transfer,Alphagrid Utilities,***3523,,,FALSE,FALSE,REF-804452,First Continental Bank,***7676,"Globex International Holdings, Inc.",US,8756077.17
30/06/2024,30/06/2024,Payroll - GlobalPay Services Ltd,Payroll,ALL,275923.84,0,USD,ACH Debit,GlobalPay Services Ltd,***6197,,,FALSE,FALSE,REF-226331,First Continental Bank,***6621,"Globex International Holdings, Inc.",US,8480153.33
30/06/2024,30/06/2024,Interest Earned,Interest Income,ALL,0,9724.56,USD,ACH Credit,First Continental Bank,***2293,,,FALSE,FALSE,REF-684505,First Continental Bank,***9208,"Globex International Holdings, Inc.",US,8489877.89
30/06/2024,30/06/2024,Client Receipt - ShopSphere Partner #77,Sales Receipt,Retail-NA,0,116727.84,USD,Fedwire Credit,ShopSphere Partner #77,***7498,INV-202406-Retail-NA-0008,,FALSE,FALSE,REF-937270,First Continental Bank,***3402,"Globex International Holdings, Inc.",US,8606605.73
01/07/2024,01/07/2024,Account Maintenance Fee,Bank/Merchant Fees,ALL,2500,0,USD,Wire Transfer,First Continental Bank,***7317,,,FALSE,FALSE,REF-303151,First Continental Bank,***1332,"Globex International Holdings, Inc.",US,8604105.73
01/07/2024,01/07/2024,Supplier Payment - ExpertNet Subcontractors #2,Supplier Payment,PS-GL,2669.94,0,USD,Fedwire,ExpertNet Subcontractors #2,***1499,,PO-202407-PS-GL-0007,FALSE,FALSE,REF-667917,First Continental Bank,***1630,"Globex International Holdings, Inc.",US,8601435.79
01/07/2024,01/07/2024,Supplier Payment - ExpertNet Subcontractors #4,Supplier Payment,PS-GL,60584.79,0,USD,Fedwire,ExpertNet Subcontractors #4,***1861,,PO-202407-PS-GL-0011,FALSE,FALSE,REF-663107,First Continental Bank,***1543,"Globex International Holdings, Inc.",US,8540851
01/07/2024,01/07/2024,Client Receipt - CloudBridge Co. #64,Sales Receipt,SaaS-GL,0,4703.31,USD,Card Settlement,CloudBridge Co. #64,***5958,INV-202407-SaaS-GL-0018,,FALSE,FALSE,REF-652123,First Continental Bank,***3675,"Globex International Holdings, Inc.",US,8545554.31
01/07/2024,01/07/2024,Client Receipt - CloudBridge Co. #12,Sales Receipt,SaaS-GL,0,151570.17,USD,Fedwire Credit,CloudBridge Co. #12,***2473,INV-202407-SaaS-GL-0012,,FALSE,FALSE,REF-135350,First Continental Bank,***2500,"Globex International Holdings, Inc.",US,8697124.48
02/07/2024,02/07/2024,Supplier Payment - CodeCraft Contractors #7,Supplier Payment,SaaS-GL,54660.67,0,USD,ACH Debit,CodeCraft Contractors #7,***8660,,PO-202407-SaaS-GL-0001,FALSE,FALSE,REF-421433,First Continental Bank,***4993,"Globex International Holdings, Inc.",US,8642463.81
02/07/2024,02/07/2024,Supplier Payment - NorthRiver Apparel Mfg #30,Supplier Payment,Retail-NA,91748.03,0,USD,Fedwire,NorthRiver Apparel Mfg #30,***4809,,PO-202407-Retail-NA-0007,FALSE,FALSE,REF-266614,First Continental Bank,***7222,"Globex International Holdings, Inc.",US,8550715.78
02/07/2024,02/07/2024,Client Receipt - ShopSphere Partner #3,Sales Receipt,Retail-NA,0,21669.1,USD,Fedwire Credit,ShopSphere Partner #3,***5744,INV-202407-Retail-NA-0012,,FALSE,FALSE,REF-321333,First Continental Bank,***4613,"Globex International Holdings, Inc.",US,8572384.88
03/07/2024,03/07/2024,Supplier Payment - PackFast Fulfillment #1,Supplier Payment,Retail-NA,74333.81,0,USD,Fedwire,PackFast Fulfillment #1,***9051,,PO-202407-Retail-NA-0006,FALSE,FALSE,REF-969439,First Continental Bank,***4168,"Globex International Holdings, Inc.",US,8498051.07
03/07/2024,03/07/2024,Supplier Payment - NorthRiver Apparel Mfg #13,Supplier Payment,Retail-NA,205453.47,0,USD,Wire Transfer,NorthRiver Apparel Mfg #13,***5664,,PO-202407-Retail-NA-0003,FALSE,FALSE,REF-372313,First Continental Bank,***8086,"Globex International Holdings, Inc.",US,8292597.6
03/07/2024,03/07/2024,Client Receipt - Card Settlement Batch #8,Sales Receipt,Retail-NA,0,11017.91,USD,Card Settlement,Card Settlement Batch #8,***9526,INV-202407-Retail-NA-0005,,FALSE,FALSE,REF-995910,First Continental Bank,***7988,"Globex International Holdings, Inc.",US,8303615.51
03/07/2024,03/07/2024,Client Receipt - ShopSphere Partner #63,Sales Receipt,Retail-NA,0,33268.62,USD,Fedwire Credit,ShopSphere Partner #63,***2353,INV-202407-Retail-NA-0017,,FALSE,FALSE,REF-630606,First Continental Bank,***2164,"Globex International Holdings, Inc.",US,8336884.13
03/07/2024,03/07/2024,Client Receipt - CloudBridge Co. #5,Sales Receipt,SaaS-GL,0,61859.65,USD,Card Settlement,CloudBridge Co. #5,***5290,INV-202407-SaaS-GL-0005,,FALSE,FALSE,REF-558199,First Continental Bank,***8427,"Globex International Holdings, Inc.",US,8398743.78
04/07/2024,04/07/2024,Supplier Payment - ExpertNet Subcontractors #1,Supplier Payment,PS-GL,2174.63,0,USD,Fedwire,ExpertNet Subcontractors #1,***1255,,PO-202407-PS-GL-0008,FALSE,FALSE,REF-615812,First Continental Bank,***8902,"Globex International Holdings, Inc.",US,8396569.15
04/07/2024,04/07/2024,Supplier Payment - CodeCraft Contractors #7,Supplier Payment,SaaS-GL,4028.52,0,USD,ACH Debit,CodeCraft Contractors #7,***7590,,PO-202407-SaaS-GL-0002,FALSE,FALSE,REF-813942,First Continental Bank,***1835,"Globex International Holdings, Inc.",US,8392540.63
04/07/2024,04/07/2024,Supplier Payment - ExpertNet Subcontractors #16,Supplier Payment,PS-GL,15433.05,0,USD,Wire Transfer,ExpertNet Subcontractors #16,***3422,,PO-202407-PS-GL-0003,FALSE,FALSE,REF-286279,First Continental Bank,***4142,"Globex International Holdings, Inc.",US,8377107.58
04/07/2024,04/07/2024,Client Receipt - ShopSphere Partner #75,Sales Receipt,Retail-NA,0,43795.32,USD,Fedwire Credit,ShopSphere Partner #75,***8170,INV-202407-Retail-NA-0004,,FALSE,FALSE,REF-932005,First Continental Bank,***4850,"Globex International Holdings, Inc.",US,8420902.9
04/07/2024,04/07/2024,Client Receipt - CloudBridge Co. #54,Sales Receipt,SaaS-GL,0,105531.78,USD,Fedwire Credit,CloudBridge Co. #54,***5334,INV-202407-SaaS-GL-0003,,FALSE,FALSE,REF-192635,First Continental Bank,***9641,"Globex International Holdings, Inc.",US,8526434.68
04/07/2024,04/07/2024,Client Receipt - ShopSphere Partner #68,Sales Receipt,Retail-NA,0,105552.4,USD,Card Settlement,ShopSphere Partner #68,***6901,INV-202407-Retail-NA-0009,,FALSE,FALSE,REF-563768,First Continental Bank,***8529,"Globex International Holdings, Inc.",US,8631987.08
05/07/2024,05/07/2024,Supplier Payment - ExpertNet Subcontractors #17,Supplier Payment,PS-GL,22830.31,0,USD,Fedwire,ExpertNet Subcontractors #17,***9893,,PO-202407-PS-GL-0012,FALSE,FALSE,REF-314777,First Continental Bank,***5686,"Globex International Holdings, Inc.",US,8609156.77
05/07/2024,05/07/2024,Client Receipt - CloudBridge Co. #51,Sales Receipt,SaaS-GL,0,51793.62,USD,Fedwire Credit,CloudBridge Co. #51,***6614,INV-202407-SaaS-GL-0007,,FALSE,FALSE,REF-152747,First Continental Bank,***8348,"Globex International Holdings, Inc.",US,8660950.39
05/07/2024,05/07/2024,Client Receipt - ShopSphere Partner #42,Sales Receipt,Retail-NA,0,55259.63,USD,Fedwire Credit,ShopSphere Partner #42,***5654,INV-202407-Retail-NA-0007,,FALSE,FALSE,REF-476887,First Continental Bank,***6657,"Globex International Holdings, Inc.",US,8716210.02
08/07/2024,08/07/2024,Skyline Internet Services,Rent & Utilities,ALL,25513.26,0,USD,Wire Transfer,Skyline Internet Services,***3690,,,FALSE,FALSE,REF-641748,First Continental Bank,***2858,"Globex International Holdings, Inc.",US,8690696.76
08/07/2024,08/07/2024,Client Receipt - Vertex Advisory Client #24,Sales Receipt,PS-GL,0,1446.42,USD,Fedwire Credit,Vertex Advisory Client #24,***8987,INV-202407-PS-GL-0012,,FALSE,FALSE,REF-519136,First Continental Bank,***2785,"Globex International Holdings, Inc.",US,8692143.18
09/07/2024,09/07/2024,Supplier Payment - ExpertNet Subcontractors #16,Supplier Payment,PS-GL,16430.37,0,USD,Wire Transfer,ExpertNet Subcontractors #16,***6904,,PO-202407-PS-GL-0005,FALSE,FALSE,REF-494804,First Continental Bank,***7185,"Globex International Holdings, Inc.",US,8675712.81
10/07/2024,10/07/2024,Supplier Payment - HyperCloud Infra #17,Supplier Payment,SaaS-GL,4617.79,0,USD,ACH Debit,HyperCloud Infra #17,***6841,,PO-202407-SaaS-GL-0008,FALSE,FALSE,REF-997664,First Continental Bank,***8578,"Globex International Holdings, Inc.",US,8671095.02
10/07/2024,10/07/2024,Marketing - Beacon Digital #9,Marketing,ALL,15843.7,0,USD,ACH Debit,Beacon Digital #9,***3347,,,FALSE,FALSE,REF-535945,First Continental Bank,***4804,"Globex International Holdings, Inc.",US,8655251.32
10/07/2024,10/07/2024,Supplier Payment - HyperCloud Infra #3,Supplier Payment,SaaS-GL,25124.97,0,USD,ACH Debit,HyperCloud Infra #3,***2293,,PO-202407-SaaS-GL-0006,FALSE,FALSE,REF-326217,First Continental Bank,***3700,"Globex International Holdings, Inc.",US,8630126.35
10/07/2024,10/07/2024,Supplier Payment - CodeCraft Contractors #9,Supplier Payment,SaaS-GL,33732.95,0,USD,Wire Transfer,CodeCraft Contractors #9,***7837,,PO-202407-SaaS-GL-0007,FALSE,FALSE,REF-665872,First Continental Bank,***6828,"Globex International Holdings, Inc.",US,8596393.4
10/07/2024,10/07/2024,Client Receipt - CloudBridge Co. #19,Sales Receipt,SaaS-GL,0,10249.26,USD,ACH Credit,CloudBridge Co. #19,***9686,INV-202407-SaaS-GL-0021,,FALSE,FALSE,REF-545883,First Continental Bank,***6857,"Globex International Holdings, Inc.",US,8606642.66
10/07/2024,10/07/2024,Client Receipt - CloudBridge Co. #28,Sales Receipt,SaaS-GL,0,28776.24,USD,ACH Credit,CloudBridge Co. #28,***5241,INV-202407-SaaS-GL-0016,,FALSE,FALSE,REF-652189,First Continental Bank,***7063,"Globex International Holdings, Inc.",US,8635418.9
10/07/2024,10/07/2024,Client Receipt - CloudBridge Co. #18,Sales Receipt,SaaS-GL,0,55844.16,USD,ACH Credit,CloudBridge Co. #18,***2723,INV-202407-SaaS-GL-0009,,FALSE,FALSE,REF-471903,First Continental Bank,***6709,"Globex International Holdings, Inc.",US,8691263.06
10/07/2024,10/07/2024,Client Receipt - ShopSphere Partner #47,Sales Receipt,Retail-NA,0,113376.12,USD,ACH Credit,ShopSphere Partner #47,***6056,INV-202407-Retail-NA-0011,,FALSE,FALSE,REF-328076,First Continental Bank,***4109,"Globex International Holdings, Inc.",US,8804639.18
10/07/2024,10/07/2024,Client Receipt - CloudBridge Co. #56,Sales Receipt,SaaS-GL,0,162919.13,USD,Card Settlement,CloudBridge Co. #56,***6073,INV-202407-SaaS-GL-0020,,FALSE,FALSE,REF-356279,First Continental Bank,***6980,"Globex International Holdings, Inc.",US,8967558.31
11/07/2024,11/07/2024,Supplier Payment - ExpertNet Subcontractors #17,Supplier Payment,PS-GL,9288.36,0,USD,ACH Debit,ExpertNet Subcontractors #17,***9996,,PO-202407-PS-GL-0002,FALSE,FALSE,REF-922526,First Continental Bank,***5047,"Globex International Holdings, Inc.",US,8958269.95
11/07/2024,11/07/2024,Marketing - Aurelia Media #10,Marketing,ALL,15618.34,0,USD,Fedwire,Aurelia Media #10,***2237,,,FALSE,FALSE,REF-236823,First Continental Bank,***3543,"Globex International Holdings, Inc.",US,8942651.61
11/07/2024,11/07/2024,Supplier Payment - ExpertNet Subcontractors #14,Supplier Payment,PS-GL,29603.11,0,USD,ACH Debit,ExpertNet Subcontractors #14,***8583,,PO-202407-PS-GL-0006,FALSE,FALSE,REF-352379,First Continental Bank,***5558,"Globex International Holdings, Inc.",US,8913048.5
11/07/2024,11/07/2024,Client Receipt - Vertex Advisory Client #43,Sales Receipt,PS-GL,0,49642.51,USD,ACH Credit,Vertex Advisory Client #43,***5771,INV-202407-PS-GL-0007,,FALSE,FALSE,REF-759880,First Continental Bank,***9628,"Globex International Holdings, Inc.",US,8962691.01
11/07/2024,11/07/2024,Client Receipt - Vertex Advisory Client #56,Sales Receipt,PS-GL,0,135080.36,USD,Card Settlement,Vertex Advisory Client #56,***7828,INV-202407-PS-GL-0009,,FALSE,FALSE,REF-582532,First Continental Bank,***6611,"Globex International Holdings, Inc.",US,9097771.37
12/07/2024,12/07/2024,Intercompany Settlement - Globex Consulting UK Ltd.,Intercompany Transfer,ALL,256934,0,USD,Internal Transfer,Globex Consulting UK Ltd.,***1014,,,TRUE,TRUE,REF-105198,First Continental Bank,***7065,"Globex International Holdings, Inc.",US,8840837.37
12/07/2024,12/07/2024,Client Receipt - Card Settlement Batch #10,Sales Receipt,Retail-NA,0,81792.89,USD,Fedwire Credit,Card Settlement Batch #10,***1961,INV-202407-Retail-NA-0006,,FALSE,FALSE,REF-661271,First Continental Bank,***7737,"Globex International Holdings, Inc.",US,8922630.26
14/07/2024,14/07/2024,Supplier Payment - HyperCloud Infra #12,Supplier Payment,SaaS-GL,226.94,0,USD,Fedwire,HyperCloud Infra #12,***6137,,PO-202407-SaaS-GL-0011,FALSE,FALSE,REF-369528,First Continental Bank,***9843,"Globex International Holdings, Inc.",US,8922403.32
14/07/2024,14/07/2024,Client Receipt - CloudBridge Co. #28,Sales Receipt,SaaS-GL,0,9237.83,USD,ACH Credit,CloudBridge Co. #28,***3715,INV-202407-SaaS-GL-0014,,FALSE,FALSE,REF-710116,First Continental Bank,***9460,"Globex International Holdings, Inc.",US,8931641.15
15/07/2024,15/07/2024,Supplier Payment - CodeCraft Contractors #8,Supplier Payment,SaaS-GL,584.85,0,USD,Wire Transfer,CodeCraft Contractors #8,***5842,,PO-202407-SaaS-GL-0010,FALSE,FALSE,REF-164973,First Continental Bank,***4221,"Globex International Holdings, Inc.",US,8931056.3
15/07/2024,15/07/2024,Merchant Processing Fees,Bank/Merchant Fees,ALL,6377.97,0,USD,Wire Transfer,First Continental Bank,***9091,,,FALSE,FALSE,REF-561315,First Continental Bank,***9471,"Globex International Holdings, Inc.",US,8924678.33
15/07/2024,15/07/2024,Loan Interest Payment,Loan Interest,ALL,85000,0,USD,Wire Transfer,First Continental Bank - Corporate Lending,***1104,,,FALSE,FALSE,REF-146923,First Continental Bank,***6444,"Globex International Holdings, Inc.",US,8839678.33
15/07/2024,15/07/2024,Loan Principal Repayment,Loan Principal,ALL,500000,0,USD,ACH Debit,First Continental Bank - Corporate Lending,***9181,,,FALSE,FALSE,REF-366754,First Continental Bank,***8346,"Globex International Holdings, Inc.",US,8339678.33
15/07/2024,15/07/2024,Client Receipt - ShopSphere Partner #24,Sales Receipt,Retail-NA,0,11934.01,USD,Card Settlement,ShopSphere Partner #24,***3748,INV-202407-Retail-NA-0014,,FALSE,FALSE,REF-474854,First Continental Bank,***7009,"Globex International Holdings, Inc.",US,8351612.34
15/07/2024,15/07/2024,Client Receipt - ShopSphere Partner #75,Sales Receipt,Retail-NA,0,66190.9,USD,ACH Credit,ShopSphere Partner #75,***3795,INV-202407-Retail-NA-0013,,FALSE,FALSE,REF-778325,First Continental Bank,***5618,"Globex International Holdings, Inc.",US,8417803.24
17/07/2024,17/07/2024,Supplier Payment - ExpertNet Subcontractors #8,Supplier Payment,PS-GL,22353.42,0,USD,Wire Transfer,ExpertNet Subcontractors #8,***2167,,PO-202407-PS-GL-0010,FALSE,FALSE,REF-647766,First Continental Bank,***4305,"Globex International Holdings, Inc.",US,8395449.82
17/07/2024,17/07/2024,Client Receipt - CloudBridge Co. #31,Sales Receipt,SaaS-GL,0,10151.47,USD,Card Settlement,CloudBridge Co. #31,***8145,INV-202407-SaaS-GL-0019,,FALSE,FALSE,REF-404472,First Continental Bank,***5844,"Globex International Holdings, Inc.",US,8405601.29
17/07/2024,17/07/2024,Client Receipt - CloudBridge Co. #24,Sales Receipt,SaaS-GL,0,20874.42,USD,ACH Credit,CloudBridge Co. #24,***4758,INV-202407-SaaS-GL-0011,,FALSE,FALSE,REF-432975,First Continental Bank,***7641,"Globex International Holdings, Inc.",US,8426475.71
17/07/2024,17/07/2024,Client Receipt - CloudBridge Co. #72,Sales Receipt,SaaS-GL,0,28335.27,USD,Card Settlement,CloudBridge Co. #72,***2124,INV-202407-SaaS-GL-0008,,FALSE,FALSE,REF-515310,First Continental Bank,***6879,"Globex International Holdings, Inc.",US,8454810.98
17/07/2024,17/07/2024,Client Receipt - Vertex Advisory Client #23,Sales Receipt,PS-GL,0,37444.22,USD,Fedwire Credit,Vertex Advisory Client #23,***3055,INV-202407-PS-GL-0008,,FALSE,FALSE,REF-164772,First Continental Bank,***3890,"Globex International Holdings, Inc.",US,8492255.2
17/07/2024,17/07/2024,Client Receipt - CloudBridge Co. #23,Sales Receipt,SaaS-GL,0,41308.63,USD,Card Settlement,CloudBridge Co. #23,***9714,INV-202407-SaaS-GL-0010,,FALSE,FALSE,REF-155559,First Continental Bank,***2528,"Globex International Holdings, Inc.",US,8533563.83
18/07/2024,18/07/2024,Supplier Payment - PackFast Fulfillment #5,Supplier Payment,Retail-NA,220044.2,0,USD,Wire Transfer,PackFast Fulfillment #5,***8966,,PO-202407-Retail-NA-0005,FALSE,FALSE,REF-229123,First Continental Bank,***3217,"Globex International Holdings, Inc.",US,8313519.63
18/07/2024,18/07/2024,Client Receipt - CloudBridge Co. #26,Sales Receipt,SaaS-GL,0,19622.57,USD,Fedwire Credit,CloudBridge Co. #26,***2293,INV-202407-SaaS-GL-0015,,FALSE,FALSE,REF-467154,First Continental Bank,***7422,"Globex International Holdings, Inc.",US,8333142.2
18/07/2024,18/07/2024,Client Receipt - ShopSphere Partner #35,Sales Receipt,Retail-NA,0,205614.33,USD,Card Settlement,ShopSphere Partner #35,***1739,INV-202407-Retail-NA-0001,,FALSE,FALSE,REF-955940,First Continental Bank,***9396,"Globex International Holdings, Inc.",US,8538756.53
19/07/2024,19/07/2024,Supplier Payment - ExpertNet Subcontractors #10,Supplier Payment,PS-GL,1458.57,0,USD,Fedwire,ExpertNet Subcontractors #10,***8646,,PO-202407-PS-GL-0004,FALSE,FALSE,REF-369644,First Continental Bank,***7621,"Globex International Holdings, Inc.",US,8537297.96
19/07/2024,19/07/2024,VAT/GST Remittance - US IRS,Tax Payment,ALL,190338.16,0,USD,SWIFT MT103,US IRS,***1836,,,FALSE,FALSE,REF-336822,First Continental Bank,***4980,"Globex International Holdings, Inc.",US,8346959.8
19/07/2024,19/07/2024,Client Receipt - Vertex Advisory Client #32,Sales Receipt,PS-GL,0,8569.37,USD,ACH Credit,Vertex Advisory Client #32,***4909,INV-202407-PS-GL-0002,,FALSE,FALSE,REF-807598,First Continental Bank,***6256,"Globex International Holdings, Inc.",US,8355529.17
19/07/2024,19/07/2024,Client Receipt - Vertex Advisory Client #12,Sales Receipt,PS-GL,0,216334.74,USD,Card Settlement,Vertex Advisory Client #12,***4355,INV-202407-PS-GL-0004,,FALSE,FALSE,REF-360227,First Continental Bank,***9505,"Globex International Holdings, Inc.",US,8571863.91
20/07/2024,20/07/2024,Supplier Payment - ExpertNet Subcontractors #1,Supplier Payment,PS-GL,20714.6,0,USD,Wire Transfer,ExpertNet Subcontractors #1,***1196,,PO-202407-PS-GL-0001,FALSE,FALSE,REF-180973,First Continental Bank,***4163,"Globex International Holdings, Inc.",US,8551149.31
21/07/2024,21/07/2024,Supplier Payment - HyperCloud Infra #9,Supplier Payment,SaaS-GL,1646.92,0,USD,ACH Debit,HyperCloud Infra #9,***6124,,PO-202407-SaaS-GL-0012,FALSE,FALSE,REF-196503,First Continental Bank,***7763,"Globex International Holdings, Inc.",US,8549502.39
21/07/2024,21/07/2024,Supplier Payment - CodeCraft Contractors #5,Supplier Payment,SaaS-GL,29974.16,0,USD,ACH Debit,CodeCraft Contractors #5,***3993,,PO-202407-SaaS-GL-0003,FALSE,FALSE,REF-768625,First Continental Bank,***1033,"Globex International Holdings, Inc.",US,8519528.23
22/07/2024,22/07/2024,Supplier Payment - HyperCloud Infra #17,Supplier Payment,SaaS-GL,21743.03,0,USD,ACH Debit,HyperCloud Infra #17,***5619,,PO-202407-SaaS-GL-0004,FALSE,FALSE,REF-601289,First Continental Bank,***9216,"Globex International Holdings, Inc.",US,8497785.2
22/07/2024,22/07/2024,Supplier Payment - NorthRiver Apparel Mfg #21,Supplier Payment,Retail-NA,28425.43,0,USD,Wire Transfer,NorthRiver Apparel Mfg #21,***9607,,PO-202407-Retail-NA-0002,FALSE,FALSE,REF-658916,First Continental Bank,***9541,"Globex International Holdings, Inc.",US,8469359.77
22/07/2024,22/07/2024,Supplier Payment - PackFast Fulfillment #9,Supplier Payment,Retail-NA,87576.63,0,USD,Fedwire,PackFast Fulfillment #9,***2595,,PO-202407-Retail-NA-0004,FALSE,FALSE,REF-647753,First Continental Bank,***7573,"Globex International Holdings, Inc.",US,8381783.14
22/07/2024,22/07/2024,Client Receipt - ShopSphere Partner #17,Sales Receipt,Retail-NA,0,24214.05,USD,ACH Credit,ShopSphere Partner #17,***1584,INV-202407-Retail-NA-0008,,FALSE,FALSE,REF-376170,First Continental Bank,***4723,"Globex International Holdings, Inc.",US,8405997.19
22/07/2024,22/07/2024,Client Receipt - Vertex Advisory Client #13,Sales Receipt,PS-GL,0,45520.06,USD,Card Settlement,Vertex Advisory Client #13,***6860,INV-202407-PS-GL-0006,,FALSE,FALSE,REF-563131,First Continental Bank,***2039,"Globex International Holdings, Inc.",US,8451517.25
22/07/2024,22/07/2024,Client Receipt - CloudBridge Co. #42,Sales Receipt,SaaS-GL,0,182655.72,USD,ACH Credit,CloudBridge Co. #42,***5587,INV-202407-SaaS-GL-0004,,FALSE,FALSE,REF-225968,First Continental Bank,***1858,"Globex International Holdings, Inc.",US,8634172.97
23/07/2024,23/07/2024,Supplier Payment - ExpertNet Subcontractors #12,Supplier Payment,PS-GL,21599.56,0,USD,Fedwire,ExpertNet Subcontractors #12,***5835,,PO-202407-PS-GL-0009,FALSE,FALSE,REF-399771,First Continental Bank,***9577,"Globex International Holdings, Inc.",US,8612573.41
23/07/2024,23/07/2024,Client Receipt - Vertex Advisory Client #24,Sales Receipt,PS-GL,0,12944.46,USD,Card Settlement,Vertex Advisory Client #24,***5392,INV-202407-PS-GL-0005,,FALSE,FALSE,REF-907271,First Continental Bank,***6298,"Globex International Holdings, Inc.",US,8625517.87
23/07/2024,23/07/2024,Client Receipt - Vertex Advisory Client #57,Sales Receipt,PS-GL,0,34964.13,USD,Fedwire Credit,Vertex Advisory Client #57,***4039,INV-202407-PS-GL-0010,,FALSE,FALSE,REF-952126,First Continental Bank,***2403,"Globex International Holdings, Inc.",US,8660482
23/07/2024,23/07/2024,Client Receipt - CloudBridge Co. #21,Sales Receipt,SaaS-GL,0,46905.6,USD,Fedwire Credit,CloudBridge Co. #21,***4111,INV-202407-SaaS-GL-0017,,FALSE,FALSE,REF-848549,First Continental Bank,***7015,"Globex International Holdings, Inc.",US,8707387.6
23/07/2024,23/07/2024,Client Receipt - Vertex Advisory Client #5,Sales Receipt,PS-GL,0,64137.12,USD,Fedwire Credit,Vertex Advisory Client #5,***3350,INV-202407-PS-GL-0003,,FALSE,FALSE,REF-735682,First Continental Bank,***3959,"Globex International Holdings, Inc.",US,8771524.72
24/07/2024,24/07/2024,Marketing - Aurelia Media #4,Marketing,ALL,48339.46,0,USD,Wire Transfer,Aurelia Media #4,***5652,,,FALSE,FALSE,REF-732468,First Continental Bank,***5692,"Globex International Holdings, Inc.",US,8723185.26
24/07/2024,24/07/2024,Client Receipt - ShopSphere Partner #29,Sales Receipt,Retail-NA,0,72273.93,USD,ACH Credit,ShopSphere Partner #29,***3670,INV-202407-Retail-NA-0010,,FALSE,FALSE,REF-296172,First Continental Bank,***8842,"Globex International Holdings, Inc.",US,8795459.19
24/07/2024,24/07/2024,Client Receipt - ShopSphere Partner #26,Sales Receipt,Retail-NA,0,173078.28,USD,Card Settlement,ShopSphere Partner #26,***4411,INV-202407-Retail-NA-0002,,FALSE,FALSE,REF-372297,First Continental Bank,***3655,"Globex International Holdings, Inc.",US,8968537.47
25/07/2024,25/07/2024,Supplier Payment - HyperCloud Infra #4,Supplier Payment,SaaS-GL,66940.58,0,USD,Fedwire,HyperCloud Infra #4,***5142,,PO-202407-SaaS-GL-0009,FALSE,FALSE,REF-258182,First Continental Bank,***8312,"Globex International Holdings, Inc.",US,8901596.89
26/07/2024,26/07/2024,Payroll - GlobalPay Services Ltd,Payroll,ALL,260591.09,0,USD,Wire Transfer,GlobalPay Services Ltd,***9881,,,FALSE,FALSE,REF-457182,First Continental Bank,***4260,"Globex International Holdings, Inc.",US,8641005.8
26/07/2024,26/07/2024,Intercompany Settlement - Globex Consulting UK Ltd.,Intercompany Transfer,ALL,572655,0,USD,Internal Transfer,Globex Consulting UK Ltd.,***1933,,,TRUE,TRUE,REF-636452,First Continental Bank,***7677,"Globex International Holdings, Inc.",US,8068350.8
26/07/2024,26/07/2024,Client Receipt - CloudBridge Co. #1,Sales Receipt,SaaS-GL,0,37322.42,USD,Fedwire Credit,CloudBridge Co. #1,***9858,INV-202407-SaaS-GL-0001,,FALSE,FALSE,REF-651076,First Continental Bank,***8897,"Globex International Holdings, Inc.",US,8105673.22
26/07/2024,26/07/2024,Client Receipt - Card Settlement Batch #23,Sales Receipt,Retail-NA,0,58145,USD,ACH Credit,Card Settlement Batch #23,***6384,INV-202407-Retail-NA-0016,,FALSE,FALSE,REF-499877,First Continental Bank,***2208,"Globex International Holdings, Inc.",US,8163818.22
26/07/2024,26/07/2024,Client Receipt - Vertex Advisory Client #8,Sales Receipt,PS-GL,0,89102.79,USD,ACH Credit,Vertex Advisory Client #8,***7362,INV-202407-PS-GL-0001,,FALSE,FALSE,REF-811388,First Continental Bank,***5024,"Globex International Holdings, Inc.",US,8252921.01
26/07/2024,26/07/2024,Intercompany Reimbursement - Globex Consulting UK Ltd.,Intercompany Transfer,ALL,0,229062,USD,Internal Transfer,Globex Consulting UK Ltd.,***3884,,,TRUE,TRUE,REF-684156,First Continental Bank,***4095,"Globex International Holdings, Inc.",US,8481983.01
27/07/2024,27/07/2024,Payroll - GlobalPay Services Ltd,Payroll,ALL,260591.09,0,USD,Fedwire,GlobalPay Services Ltd,***7273,,,FALSE,FALSE,REF-921967,First Continental Bank,***2832,"Globex International Holdings, Inc.",US,8221391.92
27/07/2024,27/07/2024,Client Receipt - CloudBridge Co. #8,Sales Receipt,SaaS-GL,0,42168.8,USD,Fedwire Credit,CloudBridge Co. #8,***6931,INV-202407-SaaS-GL-0006,,FALSE,FALSE,REF-627787,First Continental Bank,***4402,"Globex International Holdings, Inc.",US,8263560.72
28/07/2024,28/07/2024,Merchant Processing Fees,Bank/Merchant Fees,ALL,3432.14,0,USD,Wire Transfer,First Continental Bank,***3672,,,FALSE,FALSE,REF-841464,First Continental Bank,***9412,"Globex International Holdings, Inc.",US,8260128.58
28/07/2024,28/07/2024,Corporate Tax Estimate,Tax Payment,ALL,141604.67,0,USD,ACH Debit,State of NY DoF,***7472,,,FALSE,FALSE,REF-872829,First Continental Bank,***6481,"Globex International Holdings, Inc.",US,8118523.91
28/07/2024,28/07/2024,Client Receipt - ShopSphere Partner #30,Sales Receipt,Retail-NA,0,201845.24,USD,Card Settlement,ShopSphere Partner #30,***6005,INV-202407-Retail-NA-0003,,FALSE,FALSE,REF-837240,First Continental Bank,***4015,"Globex International Holdings, Inc.",US,8320369.15
29/07/2024,29/07/2024,Supplier Payment - NorthRiver Apparel Mfg #22,Supplier Payment,Retail-NA,8111.48,0,USD,ACH Debit,NorthRiver Apparel Mfg #22,***5560,,PO-202407-Retail-NA-0001,FALSE,FALSE,REF-495581,First Continental Bank,***5315,"Globex International Holdings, Inc.",US,8312257.67
29/07/2024,29/07/2024,Client Receipt - CloudBridge Co. #10,Sales Receipt,SaaS-GL,0,36847.83,USD,ACH Credit,CloudBridge Co. #10,***7556,INV-202407-SaaS-GL-0013,,FALSE,FALSE,REF-988570,First Continental Bank,***8738,"Globex International Holdings, Inc.",US,8349105.5
30/07/2024,30/07/2024,Interest Earned,Interest Income,ALL,0,10627.73,USD,Card Settlement,First Continental Bank,***1169,,,FALSE,FALSE,REF-702162,First Continental Bank,***9462,"Globex International Holdings, Inc.",US,8359733.23
30/07/2024,30/07/2024,Client Receipt - CloudBridge Co. #18,Sales Receipt,SaaS-GL,0,17025.68,USD,Fedwire Credit,CloudBridge Co. #18,***7364,INV-202407-SaaS-GL-0002,,FALSE,FALSE,REF-417181,First Continental Bank,***4606,"Globex International Holdings, Inc.",US,8376758.91
31/07/2024,31/07/2024,Supplier Payment - HyperCloud Infra #9,Supplier Payment,SaaS-GL,4373.4,0,USD,ACH Debit,HyperCloud Infra #9,***4713,,PO-202407-SaaS-GL-0005,FALSE,FALSE,REF-303642,First Continental Bank,***1579,"Globex International Holdings, Inc.",US,8372385.51
31/07/2024,31/07/2024,Supplier Payment - PackFast Fulfillment #21,Supplier Payment,Retail-NA,41029.9,0,USD,Wire Transfer,PackFast Fulfillment #21,***4339,,PO-202407-Retail-NA-0008,FALSE,FALSE,REF-389191,First Continental Bank,***3646,"Globex International Holdings, Inc.",US,8331355.61
31/07/2024,31/07/2024,Client Receipt - Vertex Advisory Client #12,Sales Receipt,PS-GL,0,55282.86,USD,Card Settlement,Vertex Advisory Client #12,***2235,INV-202407-PS-GL-0011,,FALSE,FALSE,REF-858881,First Continental Bank,***2767,"Globex International Holdings, Inc.",US,8386638.47
31/07/2024,31/07/2024,Client Receipt - Card Settlement Batch #24,Sales Receipt,Retail-NA,0,96832.18,USD,Fedwire Credit,Card Settlement Batch #24,***8602,INV-202407-Retail-NA-0015,,FALSE,FALSE,REF-168276,First Continental Bank,***2478,"Globex International Holdings, Inc.",US,8483470.65
01/08/2024,01/08/2024,Account Maintenance Fee,Bank/Merchant Fees,ALL,2500,0,USD,Fedwire,First Continental Bank,***6351,,,FALSE,FALSE,REF-716219,First Continental Bank,***8219,"Globex International Holdings, Inc.",US,8480970.65
01/08/2024,01/08/2024,Supplier Payment - CodeCraft Contractors #2,Supplier Payment,SaaS-GL,10026.54,0,USD,ACH Debit,CodeCraft Contractors #2,***9393,,PO-202408-SaaS-GL-0010,FALSE,FALSE,REF-923438,First Continental Bank,***2687,"Globex International Holdings, Inc.",US,8470944.11
01/08/2024,01/08/2024,Client Receipt - Vertex Advisory Client #11,Sales Receipt,PS-GL,0,213.91,USD,Fedwire Credit,Vertex Advisory Client #11,***8756,INV-202408-PS-GL-0008,,FALSE,FALSE,REF-689192,First Continental Bank,***8509,"Globex International Holdings, Inc.",US,8471158.02
02/08/2024,02/08/2024,Client Receipt - ShopSphere Partner #46,Sales Receipt,Retail-NA,0,11172,USD,Fedwire Credit,ShopSphere Partner #46,***3503,INV-202408-Retail-NA-0010,,FALSE,FALSE,REF-284199,First Continental Bank,***3253,"Globex International Holdings, Inc.",US,8482330.02
02/08/2024,02/08/2024,Client Receipt - CloudBridge Co. #39,Sales Receipt,SaaS-GL,0,21545.69,USD,Fedwire Credit,CloudBridge Co. #39,***8352,INV-202408-SaaS-GL-0007,,FALSE,FALSE,REF-129841,First Continental Bank,***1162,"Globex International Holdings, Inc.",US,8503875.71
02/08/2024,02/08/2024,Client Receipt - CloudBridge Co. #68,Sales Receipt,SaaS-GL,0,63312.26,USD,Fedwire Credit,CloudBridge Co. #68,***9630,INV-202408-SaaS-GL-0014,,FALSE,FALSE,REF-517521,First Continental Bank,***5807,"Globex International Holdings, Inc.",US,8567187.97
05/08/2024,05/08/2024,Client Receipt - CloudBridge Co. #2,Sales Receipt,SaaS-GL,0,31023.9,USD,Fedwire Credit,CloudBridge Co. #2,***1706,INV-202408-SaaS-GL-0001,,FALSE,FALSE,REF-215546,First Continental Bank,***6391,"Globex International Holdings, Inc.",US,8598211.87
06/08/2024,06/08/2024,Supplier Payment - ExpertNet Subcontractors #5,Supplier Payment,PS-GL,63519.03,0,USD,ACH Debit,ExpertNet Subcontractors #5,***4933,,PO-202408-PS-GL-0001,FALSE,FALSE,REF-306632,First Continental Bank,***5426,"Globex International Holdings, Inc.",US,8534692.84
06/08/2024,06/08/2024,Client Receipt - CloudBridge Co. #79,Sales Receipt,SaaS-GL,0,72599.43,USD,Fedwire Credit,CloudBridge Co. #79,***7907,INV-202408-SaaS-GL-0008,,FALSE,FALSE,REF-206319,First Continental Bank,***3264,"Globex International Holdings, Inc.",US,8607292.27
07/08/2024,07/08/2024,Client Receipt - CloudBridge Co. #24,Sales Receipt,SaaS-GL,0,6109.88,USD,Fedwire Credit,CloudBridge Co. #24,***7923,INV-202408-SaaS-GL-0018,,FALSE,FALSE,REF-716644,First Continental Bank,***2577,"Globex International Holdings, Inc.",US,8613402.15
07/08/2024,07/08/2024,Client Receipt - CloudBridge Co. #42,Sales Receipt,SaaS-GL,0,7113.72,USD,ACH Credit,CloudBridge Co. #42,***5071,INV-202408-SaaS-GL-0016,,FALSE,FALSE,REF-938950,First Continental Bank,***8711,"Globex International Holdings, Inc.",US,8620515.87
07/08/2024,07/08/2024,Client Receipt - CloudBridge Co. #26,Sales Receipt,SaaS-GL,0,9259.63,USD,Card Settlement,CloudBridge Co. #26,***3750,INV-202408-SaaS-GL-0013,,FALSE,FALSE,REF-204581,First Continental Bank,***1706,"Globex International Holdings, Inc.",US,8629775.5
08/08/2024,08/08/2024,Client Receipt - CloudBridge Co. #60,Sales Receipt,SaaS-GL,0,6315.52,USD,Fedwire Credit,CloudBridge Co. #60,***8794,INV-202408-SaaS-GL-0006,,FALSE,FALSE,REF-317408,First Continental Bank,***9082,"Globex International Holdings, Inc.",US,8636091.02
08/08/2024,08/08/2024,Client Receipt - CloudBridge Co. #60,Sales Receipt,SaaS-GL,0,18477.13,USD,ACH Credit,CloudBridge Co. #60,***6196,INV-202408-SaaS-GL-0002,,FALSE,FALSE,REF-415024,First Continental Bank,***7408,"Globex International Holdings, Inc.",US,8654568.15
08/08/2024,08/08/2024,Client Receipt - Vertex Advisory Client #3,Sales Receipt,PS-GL,0,50122.55,USD,Fedwire Credit,Vertex Advisory Client #3,***8240,INV-202408-PS-GL-0007,,FALSE,FALSE,REF-161556,First Continental Bank,***6336,"Globex International Holdings, Inc.",US,8704690.7
08/08/2024,08/08/2024,Client Receipt - Vertex Advisory Client #44,Sales Receipt,PS-GL,0,125204.47,USD,Fedwire Credit,Vertex Advisory Client #44,***3522,INV-202408-PS-GL-0001,,FALSE,FALSE,REF-641368,First Continental Bank,***8804,"Globex International Holdings, Inc.",US,8829895.17
08/08/2024,08/08/2024,Client Receipt - Vertex Advisory Client #25,Sales Receipt,PS-GL,0,169941.05,USD,Fedwire Credit,Vertex Advisory Client #25,***1771,INV-202408-PS-GL-0005,,FALSE,FALSE,REF-811340,First Continental Bank,***6275,"Globex International Holdings, Inc.",US,8999836.22
09/08/2024,09/08/2024,Client Receipt - Vertex Advisory Client #30,Sales Receipt,PS-GL,0,4560.02,USD,Fedwire Credit,Vertex Advisory Client #30,***2806,INV-202408-PS-GL-0009,,FALSE,FALSE,REF-259178,First Continental Bank,***6986,"Globex International Holdings, Inc.",US,9004396.24
09/08/2024,09/08/2024,Client Receipt - CloudBridge Co. #47,Sales Receipt,SaaS-GL,0,43223.57,USD,Card Settlement,CloudBridge Co. #47,***3845,INV-202408-SaaS-GL-0028,,FALSE,FALSE,REF-271255,First Continental Bank,***4150,"Globex International Holdings, Inc.",US,9047619.81
10/08/2024,10/08/2024,Merchant Processing Fees,Bank/Merchant Fees,ALL,4097.56,0,USD,ACH Debit,First Continental Bank,***2794,,,FALSE,FALSE,REF-899988,First Continental Bank,***4265,"Globex International Holdings, Inc.",US,9043522.25
11/08/2024,11/08/2024,Client Receipt - Vertex Advisory Client #36,Sales Receipt,PS-GL,0,162924.8,USD,Fedwire Credit,Vertex Advisory Client #36,***6872,INV-202408-PS-GL-0004,,FALSE,FALSE,REF-736090,First Continental Bank,***3595,"Globex International Holdings, Inc.",US,9206447.05
11/08/2024,11/08/2024,Client Receipt - CloudBridge Co. #13,Sales Receipt,SaaS-GL,0,188020.14,USD,Card Settlement,CloudBridge Co. #13,***6147,INV-202408-SaaS-GL-0027,,FALSE,FALSE,REF-767730,First Continental Bank,***5999,"Globex International Holdings, Inc.",US,9394467.19
12/08/2024,12/08/2024,Supplier Payment - CodeCraft Contractors #7,Supplier Payment,SaaS-GL,67587.18,0,USD,ACH Debit,CodeCraft Contractors #7,***4807,,PO-202408-SaaS-GL-0002,FALSE,FALSE,REF-664155,First Continental Bank,***9378,"Globex International Holdings, Inc.",US,9326880.01
12/08/2024,12/08/2024,Supplier Payment - NorthRiver Apparel Mfg #20,Supplier Payment,Retail-NA,108471.72,0,USD,Fedwire,NorthRiver Apparel Mfg #20,***9346,,PO-202408-Retail-NA-0006,FALSE,FALSE,REF-970905,First Continental Bank,***4000,"Globex International Holdings, Inc.",US,9218408.29
12/08/2024,12/08/2024,Intercompany Settlement - Globex APAC Logistics Pte. Ltd.,Intercompany Transfer,ALL,632247,0,USD,Internal Transfer,Globex APAC Logistics Pte. Ltd.,***4153,,,TRUE,TRUE,REF-820498,First Continental Bank,***5838,"Globex International Holdings, Inc.",US,8586161.29
12/08/2024,12/08/2024,Client Receipt - CloudBridge Co. #45,Sales Receipt,SaaS-GL,0,21618.49,USD,Card Settlement,CloudBridge Co. #45,***1802,INV-202408-SaaS-GL-0025,,FALSE,FALSE,REF-236972,First Continental Bank,***1800,"Globex International Holdings, Inc.",US,8607779.78
12/08/2024,12/08/2024,Client Receipt - Vertex Advisory Client #9,Sales Receipt,PS-GL,0,75834.9,USD,ACH Credit,Vertex Advisory Client #9,***5698,INV-202408-PS-GL-0006,,FALSE,FALSE,REF-619540,First Continental Bank,***1585,"Globex International Holdings, Inc.",US,8683614.68
13/08/2024,13/08/2024,Supplier Payment - NorthRiver Apparel Mfg #1,Supplier Payment,Retail-NA,7904.72,0,USD,Wire Transfer,NorthRiver Apparel Mfg #1,***9684,,PO-202408-Retail-NA-0001,FALSE,FALSE,REF-472446,First Continental Bank,***3069,"Globex International Holdings, Inc.",US,8675709.96
13/08/2024,13/08/2024,Northshore Power,Rent & Utilities,ALL,11828.05,0,USD,Fedwire,Northshore Power,***8958,,,FALSE,FALSE,REF-779011,First Continental Bank,***1629,"Globex International Holdings, Inc.",US,8663881.91
13/08/2024,13/08/2024,Supplier Payment - ExpertNet Subcontractors #1,Supplier Payment,PS-GL,11896.37,0,USD,Fedwire,ExpertNet Subcontractors #1,***4269,,PO-202408-PS-GL-0005,FALSE,FALSE,REF-810161,First Continental Bank,***4643,"Globex International Holdings, Inc.",US,8651985.54
13/08/2024,13/08/2024,Supplier Payment - CodeCraft Contractors #6,Supplier Payment,SaaS-GL,13695.1,0,USD,ACH Debit,CodeCraft Contractors #6,***2469,,PO-202408-SaaS-GL-0004,FALSE,FALSE,REF-741636,First Continental Bank,***2472,"Globex International Holdings, Inc.",US,8638290.44
13/08/2024,13/08/2024,Supplier Payment - PackFast Fulfillment #16,Supplier Payment,Retail-NA,16452.28,0,USD,Fedwire,PackFast Fulfillment #16,***3885,,PO-202408-Retail-NA-0007,FALSE,FALSE,REF-878441,First Continental Bank,***6419,"Globex International Holdings, Inc.",US,8621838.16
14/08/2024,14/08/2024,Metro Water & Waste,Rent & Utilities,ALL,13079.34,0,USD,Wire Transfer,Metro Water & Waste,***2868,,,FALSE,FALSE,REF-567292,First Continental Bank,***5140,"Globex International Holdings, Inc.",US,8608758.82
14/08/2024,14/08/2024,Supplier Payment - ExpertNet Subcontractors #5,Supplier Payment,PS-GL,22742.99,0,USD,Fedwire,ExpertNet Subcontractors #5,***5197,,PO-202408-PS-GL-0006,FALSE,FALSE,REF-722584,First Continental Bank,***8386,"Globex International Holdings, Inc.",US,8586015.83
14/08/2024,14/08/2024,Client Receipt - CloudBridge Co. #11,Sales Receipt,SaaS-GL,0,13551.26,USD,Card Settlement,CloudBridge Co. #11,***2711,INV-202408-SaaS-GL-0024,,FALSE,FALSE,REF-481160,First Continental Bank,***3537,"Globex International Holdings, Inc.",US,8599567.09
14/08/2024,14/08/2024,Client Receipt - CloudBridge Co. #57,Sales Receipt,SaaS-GL,0,27926.79,USD,ACH Credit,CloudBridge Co. #57,***6632,INV-202408-SaaS-GL-0026,,FALSE,FALSE,REF-136194,First Continental Bank,***1292,"Globex International Holdings, Inc.",US,8627493.88
15/08/2024,15/08/2024,Loan Interest Payment,Loan Interest,ALL,85000,0,USD,ACH Debit,First Continental Bank - Corporate Lending,***3695,,,FALSE,FALSE,REF-752490,First Continental Bank,***8202,"Globex International Holdings, Inc.",US,8542493.88
15/08/2024,15/08/2024,Loan Principal Repayment,Loan Principal,ALL,500000,0,USD,ACH Debit,First Continental Bank - Corporate Lending,***8757,,,FALSE,FALSE,REF-183761,First Continental Bank,***4551,"Globex International Holdings, Inc.",US,8042493.88
15/08/2024,15/08/2024,Client Receipt - ShopSphere Partner #17,Sales Receipt,Retail-NA,0,3238.34,USD,Card Settlement,ShopSphere Partner #17,***2147,INV-202408-Retail-NA-0007,,FALSE,FALSE,REF-217442,First Continental Bank,***5646,"Globex International Holdings, Inc.",US,8045732.22
15/08/2024,15/08/2024,Client Receipt - ShopSphere Partner #67,Sales Receipt,Retail-NA,0,120784.31,USD,Fedwire Credit,ShopSphere Partner #67,***6858,INV-202408-Retail-NA-0008,,FALSE,FALSE,REF-531801,First Continental Bank,***7093,"Globex International Holdings, Inc.",US,8166516.53
16/08/2024,16/08/2024,Supplier Payment - CodeCraft Contractors #6,Supplier Payment,SaaS-GL,19850.78,0,USD,Fedwire,CodeCraft Contractors #6,***7277,,PO-202408-SaaS-GL-0009,FALSE,FALSE,REF-946500,First Continental Bank,***7170,"Globex International Holdings, Inc.",US,8146665.75
16/08/2024,16/08/2024,Supplier Payment - ExpertNet Subcontractors #19,Supplier Payment,PS-GL,26501.76,0,USD,Wire Transfer,ExpertNet Subcontractors #19,***4731,,PO-202408-PS-GL-0003,FALSE,FALSE,REF-327682,First Continental Bank,***6672,"Globex International Holdings, Inc.",US,8120163.99
16/08/2024,16/08/2024,Supplier Payment - ExpertNet Subcontractors #7,Supplier Payment,PS-GL,63388.69,0,USD,Wire Transfer,ExpertNet Subcontractors #7,***8785,,PO-202408-PS-GL-0007,FALSE,FALSE,REF-653813,First Continental Bank,***4108,"Globex International Holdings, Inc.",US,8056775.3
16/08/2024,16/08/2024,Client Receipt - ShopSphere Partner #13,Sales Receipt,Retail-NA,0,10107.98,USD,ACH Credit,ShopSphere Partner #13,***1952,INV-202408-Retail-NA-0009,,FALSE,FALSE,REF-585221,First Continental Bank,***8927,"Globex International Holdings, Inc.",US,8066883.28
18/08/2024,18/08/2024,Client Receipt - Card Settlement Batch #13,Sales Receipt,Retail-NA,0,307540.09,USD,Fedwire Credit,Card Settlement Batch #13,***1406,INV-202408-Retail-NA-0001,,FALSE,FALSE,REF-870784,First Continental Bank,***6176,"Globex International Holdings, Inc.",US,8374423.37
19/08/2024,19/08/2024,Supplier Payment - PackFast Fulfillment #16,Supplier Payment,Retail-NA,78543.08,0,USD,ACH Debit,PackFast Fulfillment #16,***8526,,PO-202408-Retail-NA-0004,FALSE,FALSE,REF-675358,First Continental Bank,***1635,"Globex International Holdings, Inc.",US,8295880.29
19/08/2024,19/08/2024,Client Receipt - CloudBridge Co. #47,Sales Receipt,SaaS-GL,0,12575.75,USD,Card Settlement,CloudBridge Co. #47,***8114,INV-202408-SaaS-GL-0009,,FALSE,FALSE,REF-118991,First Continental Bank,***4762,"Globex International Holdings, Inc.",US,8308456.04
20/08/2024,20/08/2024,Supplier Payment - ExpertNet Subcontractors #17,Supplier Payment,PS-GL,3709.88,0,USD,Wire Transfer,ExpertNet Subcontractors #17,***6884,,PO-202408-PS-GL-0002,FALSE,FALSE,REF-630560,First Continental Bank,***6324,"Globex International Holdings, Inc.",US,8304746.16
20/08/2024,20/08/2024,Supplier Payment - HyperCloud Infra #10,Supplier Payment,SaaS-GL,8718.37,0,USD,Fedwire,HyperCloud Infra #10,***6809,,PO-202408-SaaS-GL-0001,FALSE,FALSE,REF-330842,First Continental Bank,***2341,"Globex International Holdings, Inc.",US,8296027.79
20/08/2024,20/08/2024,Marketing - Beacon Digital #7,Marketing,ALL,26931.74,0,USD,Wire Transfer,Beacon Digital #7,***7427,,,FALSE,FALSE,REF-912859,First Continental Bank,***9448,"Globex International Holdings, Inc.",US,8269096.05
20/08/2024,20/08/2024,Client Receipt - ShopSphere Partner #77,Sales Receipt,Retail-NA,0,3393.27,USD,Card Settlement,ShopSphere Partner #77,***5619,INV-202408-Retail-NA-0005,,FALSE,FALSE,REF-946466,First Continental Bank,***6638,"Globex International Holdings, Inc.",US,8272489.32
20/08/2024,20/08/2024,Client Receipt - CloudBridge Co. #5,Sales Receipt,SaaS-GL,0,3771.34,USD,ACH Credit,CloudBridge Co. #5,***3551,INV-202408-SaaS-GL-0019,,FALSE,FALSE,REF-502312,First Continental Bank,***9813,"Globex International Holdings, Inc.",US,8276260.66
20/08/2024,20/08/2024,Client Receipt - CloudBridge Co. #74,Sales Receipt,SaaS-GL,0,17493.6,USD,ACH Credit,CloudBridge Co. #74,***9824,INV-202408-SaaS-GL-0003,,FALSE,FALSE,REF-264276,First Continental Bank,***6896,"Globex International Holdings, Inc.",US,8293754.26
20/08/2024,20/08/2024,Client Receipt - ShopSphere Partner #68,Sales Receipt,Retail-NA,0,31375.65,USD,Card Settlement,ShopSphere Partner #68,***5886,INV-202408-Retail-NA-0003,,FALSE,FALSE,REF-194320,First Continental Bank,***6769,"Globex International Holdings, Inc.",US,8325129.91
20/08/2024,20/08/2024,Client Receipt - Vertex Advisory Client #10,Sales Receipt,PS-GL,0,73013.75,USD,ACH Credit,Vertex Advisory Client #10,***8665,INV-202408-PS-GL-0003,,FALSE,FALSE,REF-954452,First Continental Bank,***7968,"Globex International Holdings, Inc.",US,8398143.66
20/08/2024,20/08/2024,Client Receipt - Card Settlement Batch #8,Sales Receipt,Retail-NA,0,81967.32,USD,Fedwire Credit,Card Settlement Batch #8,***4963,INV-202408-Retail-NA-0006,,FALSE,FALSE,REF-634941,First Continental Bank,***1347,"Globex International Holdings, Inc.",US,8480110.98
20/08/2024,20/08/2024,Client Receipt - CloudBridge Co. #15,Sales Receipt,SaaS-GL,0,84744.9,USD,Card Settlement,CloudBridge Co. #15,***6692,INV-202408-SaaS-GL-0010,,FALSE,FALSE,REF-181529,First Continental Bank,***2039,"Globex International Holdings, Inc.",US,8564855.88
20/08/2024,20/08/2024,Client Receipt - CloudBridge Co. #9,Sales Receipt,SaaS-GL,0,100081.64,USD,Card Settlement,CloudBridge Co. #9,***3312,INV-202408-SaaS-GL-0012,,FALSE,FALSE,REF-168410,First Continental Bank,***1672,"Globex International Holdings, Inc.",US,8664937.52
21/08/2024,21/08/2024,Supplier Payment - ExpertNet Subcontractors #11,Supplier Payment,PS-GL,14114.52,0,USD,ACH Debit,ExpertNet Subcontractors #11,***4271,,PO-202408-PS-GL-0004,FALSE,FALSE,REF-594988,First Continental Bank,***1901,"Globex International Holdings, Inc.",US,8650823
21/08/2024,21/08/2024,Supplier Payment - PackFast Fulfillment #15,Supplier Payment,Retail-NA,31363.59,0,USD,Wire Transfer,PackFast Fulfillment #15,***7989,,PO-202408-Retail-NA-0002,FALSE,FALSE,REF-375035,First Continental Bank,***2727,"Globex International Holdings, Inc.",US,8619459.41
21/08/2024,21/08/2024,VAT/GST Remittance - US IRS,Tax Payment,ALL,191653.27,0,USD,SWIFT MT103,US IRS,***7698,,,FALSE,FALSE,REF-951161,First Continental Bank,***6941,"Globex International Holdings, Inc.",US,8427806.14
21/08/2024,21/08/2024,Client Receipt - CloudBridge Co. #69,Sales Receipt,SaaS-GL,0,23063.6,USD,Card Settlement,CloudBridge Co. #69,***9040,INV-202408-SaaS-GL-0023,,FALSE,FALSE,REF-179496,First Continental Bank,***6109,"Globex International Holdings, Inc.",US,8450869.74
21/08/2024,21/08/2024,Client Receipt - CloudBridge Co. #13,Sales Receipt,SaaS-GL,0,54994.37,USD,Fedwire Credit,CloudBridge Co. #13,***8561,INV-202408-SaaS-GL-0004,,FALSE,FALSE,REF-459859,First Continental Bank,***9194,"Globex International Holdings, Inc.",US,8505864.11
22/08/2024,22/08/2024,Supplier Payment - CodeCraft Contractors #5,Supplier Payment,SaaS-GL,12234.2,0,USD,Fedwire,CodeCraft Contractors #5,***2012,,PO-202408-SaaS-GL-0006,FALSE,FALSE,REF-798527,First Continental Bank,***4909,"Globex International Holdings, Inc.",US,8493629.91
22/08/2024,22/08/2024,Marketing - Beacon Digital #9,Marketing,ALL,49718.69,0,USD,Wire Transfer,Beacon Digital #9,***1106,,,FALSE,FALSE,REF-244311,First Continental Bank,***4219,"Globex International Holdings, Inc.",US,8443911.22
22/08/2024,22/08/2024,Client Receipt - CloudBridge Co. #47,Sales Receipt,SaaS-GL,0,17218.43,USD,Fedwire Credit,CloudBridge Co. #47,***2892,INV-202408-SaaS-GL-0015,,FALSE,FALSE,REF-722214,First Continental Bank,***2078,"Globex International Holdings, Inc.",US,8461129.65
22/08/2024,22/08/2024,Client Receipt - CloudBridge Co. #28,Sales Receipt,SaaS-GL,0,47179.96,USD,Card Settlement,CloudBridge Co. #28,***3329,INV-202408-SaaS-GL-0017,,FALSE,FALSE,REF-724491,First Continental Bank,***7937,"Globex International Holdings, Inc.",US,8508309.61
23/08/2024,23/08/2024,Supplier Payment - HyperCloud Infra #4,Supplier Payment,SaaS-GL,11944.89,0,USD,Wire Transfer,HyperCloud Infra #4,***7256,,PO-202408-SaaS-GL-0003,FALSE,FALSE,REF-309296,First Continental Bank,***1020,"Globex International Holdings, Inc.",US,8496364.72
23/08/2024,23/08/2024,Supplier Payment - NorthRiver Apparel Mfg #34,Supplier Payment,Retail-NA,233009.89,0,USD,Wire Transfer,NorthRiver Apparel Mfg #34,***5683,,PO-202408-Retail-NA-0008,FALSE,FALSE,REF-346220,First Continental Bank,***9218,"Globex International Holdings, Inc.",US,8263354.83
23/08/2024,23/08/2024,Client Receipt - CloudBridge Co. #25,Sales Receipt,SaaS-GL,0,29411.07,USD,Card Settlement,CloudBridge Co. #25,***9380,INV-202408-SaaS-GL-0021,,FALSE,FALSE,REF-885686,First Continental Bank,***3098,"Globex International Holdings, Inc.",US,8292765.9
24/08/2024,24/08/2024,Merchant Processing Fees,Bank/Merchant Fees,ALL,5055.13,0,USD,Fedwire,First Continental Bank,***7105,,,FALSE,FALSE,REF-891473,First Continental Bank,***6110,"Globex International Holdings, Inc.",US,8287710.77
25/08/2024,25/08/2024,Client Receipt - Vertex Advisory Client #31,Sales Receipt,PS-GL,0,51130.14,USD,Card Settlement,Vertex Advisory Client #31,***8769,INV-202408-PS-GL-0002,,FALSE,FALSE,REF-289634,First Continental Bank,***7430,"Globex International Holdings, Inc.",US,8338840.91
26/08/2024,26/08/2024,Supplier Payment - CodeCraft Contractors #9,Supplier Payment,SaaS-GL,13851.89,0,USD,Fedwire,CodeCraft Contractors #9,***6819,,PO-202408-SaaS-GL-0008,FALSE,FALSE,REF-157744,First Continental Bank,***3732,"Globex International Holdings, Inc.",US,8324989.02
26/08/2024,26/08/2024,Supplier Payment - PackFast Fulfillment #19,Supplier Payment,Retail-NA,77552.17,0,USD,Wire Transfer,PackFast Fulfillment #19,***8229,,PO-202408-Retail-NA-0009,FALSE,FALSE,REF-499506,First Continental Bank,***6217,"Globex International Holdings, Inc.",US,8247436.85
26/08/2024,26/08/2024,Intercompany Settlement - Globex APAC Logistics Pte. Ltd.,Intercompany Transfer,ALL,800053,0,USD,Internal Transfer,Globex APAC Logistics Pte. Ltd.,***8323,,,TRUE,TRUE,REF-785466,First Continental Bank,***5858,"Globex International Holdings, Inc.",US,7447383.85
26/08/2024,26/08/2024,Client Receipt - CloudBridge Co. #9,Sales Receipt,SaaS-GL,0,46393.51,USD,Fedwire Credit,CloudBridge Co. #9,***4847,INV-202408-SaaS-GL-0020,,FALSE,FALSE,REF-185249,First Continental Bank,***2146,"Globex International Holdings, Inc.",US,7493777.36
26/08/2024,26/08/2024,Client Receipt - ShopSphere Partner #3,Sales Receipt,Retail-NA,0,617559.32,USD,ACH Credit,ShopSphere Partner #3,***5365,INV-202408-Retail-NA-0004,,FALSE,FALSE,REF-827682,First Continental Bank,***7247,"Globex International Holdings, Inc.",US,8111336.68
27/08/2024,27/08/2024,Supplier Payment - PackFast Fulfillment #7,Supplier Payment,Retail-NA,142516.2,0,USD,Fedwire,PackFast Fulfillment #7,***7633,,PO-202408-Retail-NA-0005,FALSE,FALSE,REF-513813,First Continental Bank,***3787,"Globex International Holdings, Inc.",US,7968820.48
27/08/2024,27/08/2024,Client Receipt - CloudBridge Co. #45,Sales Receipt,SaaS-GL,0,21514.25,USD,Fedwire Credit,CloudBridge Co. #45,***9879,INV-202408-SaaS-GL-0011,,FALSE,FALSE,REF-767664,First Continental Bank,***5485,"Globex International Holdings, Inc.",US,7990334.73
28/08/2024,28/08/2024,Supplier Payment - ExpertNet Subcontractors #9,Supplier Payment,PS-GL,8010.44,0,USD,Wire Transfer,ExpertNet Subcontractors #9,***4139,,PO-202408-PS-GL-0008,FALSE,FALSE,REF-916175,First Continental Bank,***5840,"Globex International Holdings, Inc.",US,7982324.29
28/08/2024,28/08/2024,Client Receipt - CloudBridge Co. #43,Sales Receipt,SaaS-GL,0,27616.8,USD,ACH Credit,CloudBridge Co. #43,***9354,INV-202408-SaaS-GL-0022,,FALSE,FALSE,REF-220609,First Continental Bank,***7680,"Globex International Holdings, Inc.",US,8009941.09
28/08/2024,28/08/2024,Client Receipt - CloudBridge Co. #34,Sales Receipt,SaaS-GL,0,53261.76,USD,Card Settlement,CloudBridge Co. #34,***1243,INV-202408-SaaS-GL-0005,,FALSE,FALSE,REF-265479,First Continental Bank,***9147,"Globex International Holdings, Inc.",US,8063202.85
29/08/2024,29/08/2024,Supplier Payment - CodeCraft Contractors #11,Supplier Payment,SaaS-GL,61843.24,0,USD,Wire Transfer,CodeCraft Contractors #11,***3895,,PO-202408-SaaS-GL-0005,FALSE,FALSE,REF-913996,First Continental Bank,***5250,"Globex International Holdings, Inc.",US,8001359.61
29/08/2024,29/08/2024,Client Receipt - ShopSphere Partner #15,Sales Receipt,Retail-NA,0,119928.64,USD,ACH Credit,ShopSphere Partner #15,***6032,INV-202408-Retail-NA-0002,,FALSE,FALSE,REF-866709,First Continental Bank,***5138,"Globex International Holdings, Inc.",US,8121288.25
30/08/2024,30/08/2024,Supplier Payment - CodeCraft Contractors #3,Supplier Payment,SaaS-GL,15519.86,0,USD,Wire Transfer,CodeCraft Contractors #3,***8992,,PO-202408-SaaS-GL-0007,FALSE,FALSE,REF-811063,First Continental Bank,***6653,"Globex International Holdings, Inc.",US,8105768.39
30/08/2024,30/08/2024,Payroll - GlobalPay Services Ltd,Payroll,ALL,247519.22,0,USD,ACH Debit,GlobalPay Services Ltd,***6617,,,FALSE,FALSE,REF-705446,First Continental Bank,***3343,"Globex International Holdings, Inc.",US,7858249.17
30/08/2024,30/08/2024,Payroll - GlobalPay Services Ltd,Payroll,ALL,247519.22,0,USD,Wire Transfer,GlobalPay Services Ltd,***7308,,,FALSE,FALSE,REF-913970,First Continental Bank,***7890,"Globex International Holdings, Inc.",US,7610729.95
30/08/2024,30/08/2024,Interest Earned,Interest Income,ALL,0,11257.73,USD,Fedwire Credit,First Continental Bank,***7999,,,FALSE,FALSE,REF-948063,First Continental Bank,***9343,"Globex International Holdings, Inc.",US,7621987.68
31/08/2024,31/08/2024,Supplier Payment - PackFast Fulfillment #3,Supplier Payment,Retail-NA,23073.15,0,USD,ACH Debit,PackFast Fulfillment #3,***4572,,PO-202408-Retail-NA-0003,FALSE,FALSE,REF-217929,First Continental Bank,***6721,"Globex International Holdings, Inc.",US,7598914.53
01/09/2024,01/09/2024,Account Maintenance Fee,Bank/Merchant Fees,ALL,2500,0,USD,Wire Transfer,First Continental Bank,***4314,,,FALSE,FALSE,REF-438324,First Continental Bank,***5108,"Globex International Holdings, Inc.",US,7596414.53
01/09/2024,01/09/2024,Metro Water & Waste,Rent & Utilities,ALL,26358.63,0,USD,Wire Transfer,Metro Water & Waste,***9859,,,FALSE,FALSE,REF-653199,First Continental Bank,***4617,"Globex International Holdings, Inc.",US,7570055.9
01/09/2024,01/09/2024,Supplier Payment - PackFast Fulfillment #20,Supplier Payment,Retail-NA,128839.18,0,USD,Wire Transfer,PackFast Fulfillment #20,***2325,,PO-202409-Retail-NA-0004,FALSE,FALSE,REF-152995,First Continental Bank,***2851,"Globex International Holdings, Inc.",US,7441216.72
01/09/2024,01/09/2024,Client Receipt - CloudBridge Co. #46,Sales Receipt,SaaS-GL,0,36987.21,USD,Fedwire Credit,CloudBridge Co. #46,***5911,INV-202409-SaaS-GL-0015,,FALSE,FALSE,REF-541529,First Continental Bank,***8846,"Globex International Holdings, Inc.",US,7478203.93
02/09/2024,02/09/2024,Supplier Payment - ExpertNet Subcontractors #19,Supplier Payment,PS-GL,7816.46,0,USD,Wire Transfer,ExpertNet Subcontractors #19,***9136,,PO-202409-PS-GL-0001,FALSE,FALSE,REF-226824,First Continental Bank,***9157,"Globex International Holdings, Inc.",US,7470387.47
02/09/2024,02/09/2024,Client Receipt - CloudBridge Co. #31,Sales Receipt,SaaS-GL,0,2582.32,USD,ACH Credit,CloudBridge Co. #31,***3143,INV-202409-SaaS-GL-0022,,FALSE,FALSE,REF-350718,First Continental Bank,***3150,"Globex International Holdings, Inc.",US,7472969.79
02/09/2024,02/09/2024,Client Receipt - ShopSphere Partner #7,Sales Receipt,Retail-NA,0,214119.97,USD,Card Settlement,ShopSphere Partner #7,***4043,INV-202409-Retail-NA-0002,,FALSE,FALSE,REF-375015,First Continental Bank,***1499,"Globex International Holdings, Inc.",US,7687089.76
03/09/2024,03/09/2024,Supplier Payment - ExpertNet Subcontractors #17,Supplier Payment,PS-GL,15867.71,0,USD,ACH Debit,ExpertNet Subcontractors #17,***4642,,PO-202409-PS-GL-0005,FALSE,FALSE,REF-269377,First Continental Bank,***6298,"Globex International Holdings, Inc.",US,7671222.05
03/09/2024,03/09/2024,Client Receipt - ShopSphere Partner #16,Sales Receipt,Retail-NA,0,1624.99,USD,Card Settlement,ShopSphere Partner #16,***6042,INV-202409-Retail-NA-0006,,FALSE,FALSE,REF-553049,First Continental Bank,***9221,"Globex International Holdings, Inc.",US,7672847.04
04/09/2024,04/09/2024,Client Receipt - CloudBridge Co. #79,Sales Receipt,SaaS-GL,0,17492.98,USD,Fedwire Credit,CloudBridge Co. #79,***8198,INV-202409-SaaS-GL-0014,,FALSE,FALSE,REF-331718,First Continental Bank,***7793,"Globex International Holdings, Inc.",US,7690340.02
04/09/2024,04/09/2024,Client Receipt - CloudBridge Co. #60,Sales Receipt,SaaS-GL,0,112400.32,USD,Fedwire Credit,CloudBridge Co. #60,***8808,INV-202409-SaaS-GL-0003,,FALSE,FALSE,REF-104576,First Continental Bank,***1879,"Globex International Holdings, Inc.",US,7802740.34
05/09/2024,05/09/2024,Client Receipt - CloudBridge Co. #64,Sales Receipt,SaaS-GL,0,39398.72,USD,Card Settlement,CloudBridge Co. #64,***6610,INV-202409-SaaS-GL-0019,,FALSE,FALSE,REF-957584,First Continental Bank,***9829,"Globex International Holdings, Inc.",US,7842139.06
05/09/2024,05/09/2024,Client Receipt - CloudBridge Co. #59,Sales Receipt,SaaS-GL,0,83158.43,USD,Fedwire Credit,CloudBridge Co. #59,***8613,INV-202409-SaaS-GL-0001,,FALSE,FALSE,REF-960070,First Continental Bank,***1899,"Globex International Holdings, Inc.",US,7925297.49
05/09/2024,05/09/2024,Client Receipt - ShopSphere Partner #6,Sales Receipt,Retail-NA,0,280162.74,USD,Fedwire Credit,ShopSphere Partner #6,***5788,INV-202409-Retail-NA-0009,,FALSE,FALSE,REF-414534,First Continental Bank,***3046,"Globex International Holdings, Inc.",US,8205460.23
06/09/2024,06/09/2024,Merchant Processing Fees,Bank/Merchant Fees,ALL,8622.8,0,USD,Wire Transfer,First Continental Bank,***8900,,,FALSE,FALSE,REF-425288,First Continental Bank,***8874,"Globex International Holdings, Inc.",US,8196837.43
06/09/2024,06/09/2024,Client Receipt - CloudBridge Co. #19,Sales Receipt,SaaS-GL,0,1566.43,USD,ACH Credit,CloudBridge Co. #19,***2836,INV-202409-SaaS-GL-0028,,FALSE,FALSE,REF-684443,First Continental Bank,***4203,"Globex International Holdings, Inc.",US,8198403.86
06/09/2024,06/09/2024,Client Receipt - ShopSphere Partner #44,Sales Receipt,Retail-NA,0,17676.25,USD,Fedwire Credit,ShopSphere Partner #44,***7794,INV-202409-Retail-NA-0008,,FALSE,FALSE,REF-900214,First Continental Bank,***5170,"Globex International Holdings, Inc.",US,8216080.11
07/09/2024,07/09/2024,Supplier Payment - CodeCraft Contractors #8,Supplier Payment,SaaS-GL,4212.21,0,USD,Fedwire,CodeCraft Contractors #8,***7487,,PO-202409-SaaS-GL-0008,FALSE,FALSE,REF-839573,First Continental Bank,***1078,"Globex International Holdings, Inc.",US,8211867.9
07/09/2024,07/09/2024,Supplier Payment - ExpertNet Subcontractors #18,Supplier Payment,PS-GL,23938.21,0,USD,Fedwire,ExpertNet Subcontractors #18,***4970,,PO-202409-PS-GL-0007,FALSE,FALSE,REF-867512,First Continental Bank,***5629,"Globex International Holdings, Inc.",US,8187929.69
08/09/2024,08/09/2024,Client Receipt - CloudBridge Co. #78,Sales Receipt,SaaS-GL,0,20471.05,USD,Fedwire Credit,CloudBridge Co. #78,***5394,INV-202409-SaaS-GL-0011,,FALSE,FALSE,REF-761546,First Continental Bank,***2510,"Globex International Holdings, Inc.",US,8208400.74
09/09/2024,09/09/2024,Supplier Payment - ExpertNet Subcontractors #18,Supplier Payment,PS-GL,4441.23,0,USD,Wire Transfer,ExpertNet Subcontractors #18,***2617,,PO-202409-PS-GL-0003,FALSE,FALSE,REF-905648,First Continental Bank,***8372,"Globex International Holdings, Inc.",US,8203959.51
09/09/2024,09/09/2024,Client Receipt - CloudBridge Co. #44,Sales Receipt,SaaS-GL,0,6573.77,USD,ACH Credit,CloudBridge Co. #44,***9461,INV-202409-SaaS-GL-0009,,FALSE,FALSE,REF-435229,First Continental Bank,***2789,"Globex International Holdings, Inc.",US,8210533.28
09/09/2024,09/09/2024,Client Receipt - CloudBridge Co. #11,Sales Receipt,SaaS-GL,0,21305.29,USD,Card Settlement,CloudBridge Co. #11,***3846,INV-202409-SaaS-GL-0008,,FALSE,FALSE,REF-300046,First Continental Bank,***1879,"Globex International Holdings, Inc.",US,8231838.57
09/09/2024,09/09/2024,Client Receipt - CloudBridge Co. #20,Sales Receipt,SaaS-GL,0,49999.47,USD,Card Settlement,CloudBridge Co. #20,***7297,INV-202409-SaaS-GL-0020,,FALSE,FALSE,REF-162987,First Continental Bank,***7241,"Globex International Holdings, Inc.",US,8281838.04
09/09/2024,09/09/2024,Client Receipt - CloudBridge Co. #67,Sales Receipt,SaaS-GL,0,73040.73,USD,Fedwire Credit,CloudBridge Co. #67,***3499,INV-202409-SaaS-GL-0017,,FALSE,FALSE,REF-252772,First Continental Bank,***1343,"Globex International Holdings, Inc.",US,8354878.77
10/09/2024,10/09/2024,Supplier Payment - HyperCloud Infra #19,Supplier Payment,SaaS-GL,3152.46,0,USD,ACH Debit,HyperCloud Infra #19,***5289,,PO-202409-SaaS-GL-0007,FALSE,FALSE,REF-519193,First Continental Bank,***1327,"Globex International Holdings, Inc.",US,8351726.31
10/09/2024,10/09/2024,Supplier Payment - CodeCraft Contractors #6,Supplier Payment,SaaS-GL,22519.3,0,USD,Fedwire,CodeCraft Contractors #6,***5794,,PO-202409-SaaS-GL-0003,FALSE,FALSE,REF-342452,First Continental Bank,***4085,"Globex International Holdings, Inc.",US,8329207.01
10/09/2024,10/09/2024,Supplier Payment - NorthRiver Apparel Mfg #8,Supplier Payment,Retail-NA,30208.68,0,USD,ACH Debit,NorthRiver Apparel Mfg #8,***1185,,PO-202409-Retail-NA-0006,FALSE,FALSE,REF-234084,First Continental Bank,***1843,"Globex International Holdings, Inc.",US,8298998.33
10/09/2024,10/09/2024,Supplier Payment - CodeCraft Contractors #4,Supplier Payment,SaaS-GL,32080.75,0,USD,Wire Transfer,CodeCraft Contractors #4,***8757,,PO-202409-SaaS-GL-0004,FALSE,FALSE,REF-786441,First Continental Bank,***6837,"Globex International Holdings, Inc.",US,8266917.58
10/09/2024,10/09/2024,Client Receipt - CloudBridge Co. #51,Sales Receipt,SaaS-GL,0,20967.86,USD,Fedwire Credit,CloudBridge Co. #51,***9267,INV-202409-SaaS-GL-0018,,FALSE,FALSE,REF-744367,First Continental Bank,***9187,"Globex International Holdings, Inc.",US,8287885.44
10/09/2024,10/09/2024,Client Receipt - CloudBridge Co. #32,Sales Receipt,SaaS-GL,0,32356.94,USD,Fedwire Credit,CloudBridge Co. #32,***8535,INV-202409-SaaS-GL-0025,,FALSE,FALSE,REF-113031,First Continental Bank,***3022,"Globex International Holdings, Inc.",US,8320242.38
10/09/2024,10/09/2024,Client Receipt - CloudBridge Co. #18,Sales Receipt,SaaS-GL,0,59756.64,USD,Card Settlement,CloudBridge Co. #18,***5238,INV-202409-SaaS-GL-0023,,FALSE,FALSE,REF-121093,First Continental Bank,***5902,"Globex International Holdings, Inc.",US,8379999.02
10/09/2024,10/09/2024,Client Receipt - ShopSphere Partner #28,Sales Receipt,Retail-NA,0,200300.82,USD,ACH Credit,ShopSphere Partner #28,***4777,INV-202409-Retail-NA-0012,,FALSE,FALSE,REF-948923,First Continental Bank,***8577,"Globex International Holdings, Inc.",US,8580299.84
11/09/2024,11/09/2024,Supplier Payment - ExpertNet Subcontractors #11,Supplier Payment,PS-GL,6535.17,0,USD,Fedwire,ExpertNet Subcontractors #11,***9999,,PO-202409-PS-GL-0002,FALSE,FALSE,REF-476115,First Continental Bank,***6590,"Globex International Holdings, Inc.",US,8573764.67
11/09/2024,11/09/2024,Supplier Payment - ExpertNet Subcontractors #1,Supplier Payment,PS-GL,12545.81,0,USD,Wire Transfer,ExpertNet Subcontractors #1,***8739,,PO-202409-PS-GL-0004,FALSE,FALSE,REF-581008,First Continental Bank,***4540,"Globex International Holdings, Inc.",US,8561218.86
11/09/2024,11/09/2024,Supplier Payment - PackFast Fulfillment #9,Supplier Payment,Retail-NA,49008.33,0,USD,Fedwire,PackFast Fulfillment #9,***8949,,PO-202409-Retail-NA-0008,FALSE,FALSE,REF-974837,First Continental Bank,***2301,"Globex International Holdings, Inc.",US,8512210.53
11/09/2024,11/09/2024,Client Receipt - CloudBridge Co. #12,Sales Receipt,SaaS-GL,0,55906.26,USD,Fedwire Credit,CloudBridge Co. #12,***6665,INV-202409-SaaS-GL-0021,,FALSE,FALSE,REF-295070,First Continental Bank,***8070,"Globex International Holdings, Inc.",US,8568116.79
11/09/2024,11/09/2024,Client Receipt - ShopSphere Partner #61,Sales Receipt,Retail-NA,0,101940.88,USD,Fedwire Credit,ShopSphere Partner #61,***3757,INV-202409-Retail-NA-0004,,FALSE,FALSE,REF-137736,First Continental Bank,***4823,"Globex International Holdings, Inc.",US,8670057.67
12/09/2024,12/09/2024,Supplier Payment - CodeCraft Contractors #11,Supplier Payment,SaaS-GL,20146.04,0,USD,ACH Debit,CodeCraft Contractors #11,***1576,,PO-202409-SaaS-GL-0006,FALSE,FALSE,REF-200635,First Continental Bank,***8167,"Globex International Holdings, Inc.",US,8649911.63
12/09/2024,12/09/2024,Intercompany Settlement - Globex Consulting UK Ltd.,Intercompany Transfer,ALL,590893,0,USD,Internal Transfer,Globex Consulting UK Ltd.,***9989,,,TRUE,TRUE,REF-288420,First Continental Bank,***5913,"Globex International Holdings, Inc.",US,8059018.63
12/09/2024,12/09/2024,Client Receipt - CloudBridge Co. #77,Sales Receipt,SaaS-GL,0,22945.71,USD,Card Settlement,CloudBridge Co. #77,***1683,INV-202409-SaaS-GL-0005,,FALSE,FALSE,REF-209324,First Continental Bank,***6005,"Globex International Holdings, Inc.",US,8081964.34
12/09/2024,12/09/2024,Client Receipt - Vertex Advisory Client #23,Sales Receipt,PS-GL,0,53130.07,USD,ACH Credit,Vertex Advisory Client #23,***7978,INV-202409-PS-GL-0004,,FALSE,FALSE,REF-500296,First Continental Bank,***5028,"Globex International Holdings, Inc.",US,8135094.41
12/09/2024,12/09/2024,Intercompany Reimbursement - Globex Consulting UK Ltd.,Intercompany Transfer,ALL,0,236357.2,USD,Internal Transfer,Globex Consulting UK Ltd.,***3297,,,TRUE,TRUE,REF-469293,First Continental Bank,***4863,"Globex International Holdings, Inc.",US,8371451.61
13/09/2024,13/09/2024,Supplier Payment - ExpertNet Subcontractors #6,Supplier Payment,PS-GL,8145.83,0,USD,ACH Debit,ExpertNet Subcontractors #6,***2580,,PO-202409-PS-GL-0008,FALSE,FALSE,REF-728538,First Continental Bank,***5273,"Globex International Holdings, Inc.",US,8363305.78
13/09/2024,13/09/2024,Supplier Payment - PackFast Fulfillment #2,Supplier Payment,Retail-NA,57518.25,0,USD,ACH Debit,PackFast Fulfillment #2,***2502,,PO-202409-Retail-NA-0005,FALSE,FALSE,REF-318267,First Continental Bank,***3695,"Globex International Holdings, Inc.",US,8305787.53
13/09/2024,13/09/2024,Client Receipt - CloudBridge Co. #23,Sales Receipt,SaaS-GL,0,162949.52,USD,ACH Credit,CloudBridge Co. #23,***3006,INV-202409-SaaS-GL-0016,,FALSE,FALSE,REF-391933,First Continental Bank,***2432,"Globex International Holdings, Inc.",US,8468737.05
14/09/2024,14/09/2024,Supplier Payment - HyperCloud Infra #11,Supplier Payment,SaaS-GL,10575.68,0,USD,Wire Transfer,HyperCloud Infra #11,***1171,,PO-202409-SaaS-GL-0002,FALSE,FALSE,REF-538552,First Continental Bank,***3661,"Globex International Holdings, Inc.",US,8458161.37
15/09/2024,15/09/2024,Supplier Payment - PackFast Fulfillment #20,Supplier Payment,Retail-NA,6011.82,0,USD,Wire Transfer,PackFast Fulfillment #20,***4427,,PO-202409-Retail-NA-0003,FALSE,FALSE,REF-446473,First Continental Bank,***5388,"Globex International Holdings, Inc.",US,8452149.55
15/09/2024,15/09/2024,Supplier Payment - HyperCloud Infra #5,Supplier Payment,SaaS-GL,22414.73,0,USD,Wire Transfer,HyperCloud Infra #5,***5877,,PO-202409-SaaS-GL-0010,FALSE,FALSE,REF-680027,First Continental Bank,***9992,"Globex International Holdings, Inc.",US,8429734.82
15/09/2024,15/09/2024,Loan Interest Payment,Loan Interest,ALL,85000,0,USD,Fedwire,First Continental Bank - Corporate Lending,***3178,,,FALSE,FALSE,REF-128462,First Continental Bank,***9193,"Globex International Holdings, Inc.",US,8344734.82
15/09/2024,15/09/2024,Loan Principal Repayment,Loan Principal,ALL,500000,0,USD,Fedwire,First Continental Bank - Corporate Lending,***7223,,,FALSE,FALSE,REF-848862,First Continental Bank,***2437,"Globex International Holdings, Inc.",US,7844734.82
16/09/2024,16/09/2024,Client Receipt - CloudBridge Co. #27,Sales Receipt,SaaS-GL,0,991.02,USD,Fedwire Credit,CloudBridge Co. #27,***1137,INV-202409-SaaS-GL-0013,,FALSE,FALSE,REF-411207,First Continental Bank,***2902,"Globex International Holdings, Inc.",US,7845725.84
16/09/2024,16/09/2024,Client Receipt - CloudBridge Co. #55,Sales Receipt,SaaS-GL,0,2622.37,USD,Card Settlement,CloudBridge Co. #55,***9279,INV-202409-SaaS-GL-0006,,FALSE,FALSE,REF-406244,First Continental Bank,***4532,"Globex International Holdings, Inc.",US,7848348.21
16/09/2024,16/09/2024,Client Receipt - CloudBridge Co. #72,Sales Receipt,SaaS-GL,0,3702.67,USD,Card Settlement,CloudBridge Co. #72,***2058,INV-202409-SaaS-GL-0012,,FALSE,FALSE,REF-406984,First Continental Bank,***4597,"Globex International Holdings, Inc.",US,7852050.88
16/09/2024,16/09/2024,Client Receipt - CloudBridge Co. #74,Sales Receipt,SaaS-GL,0,15140.05,USD,Card Settlement,CloudBridge Co. #74,***1971,INV-202409-SaaS-GL-0010,,FALSE,FALSE,REF-747145,First Continental Bank,***7670,"Globex International Holdings, Inc.",US,7867190.93
16/09/2024,16/09/2024,Client Receipt - Vertex Advisory Client #59,Sales Receipt,PS-GL,0,23989.1,USD,Fedwire Credit,Vertex Advisory Client #59,***4937,INV-202409-PS-GL-0001,,FALSE,FALSE,REF-563208,First Continental Bank,***2743,"Globex International Holdings, Inc.",US,7891180.03
16/09/2024,16/09/2024,Client Receipt - ShopSphere Partner #7,Sales Receipt,Retail-NA,0,24437.43,USD,Card Settlement,ShopSphere Partner #7,***4432,INV-202409-Retail-NA-0010,,FALSE,FALSE,REF-746969,First Continental Bank,***9746,"Globex International Holdings, Inc.",US,7915617.46
17/09/2024,17/09/2024,Marketing - Beacon Digital #1,Marketing,ALL,18032.3,0,USD,Wire Transfer,Beacon Digital #1,***4224,,,FALSE,FALSE,REF-650768,First Continental Bank,***7905,"Globex International Holdings, Inc.",US,7897585.16
18/09/2024,18/09/2024,Supplier Payment - ExpertNet Subcontractors #7,Supplier Payment,PS-GL,19896.77,0,USD,ACH Debit,ExpertNet Subcontractors #7,***7525,,PO-202409-PS-GL-0009,FALSE,FALSE,REF-273892,First Continental Bank,***4104,"Globex International Holdings, Inc.",US,7877688.39
18/09/2024,18/09/2024,Supplier Payment - ExpertNet Subcontractors #2,Supplier Payment,PS-GL,34963.33,0,USD,Wire Transfer,ExpertNet Subcontractors #2,***1561,,PO-202409-PS-GL-0012,FALSE,FALSE,REF-828322,First Continental Bank,***8933,"Globex International Holdings, Inc.",US,7842725.06
18/09/2024,18/09/2024,Supplier Payment - NorthRiver Apparel Mfg #7,Supplier Payment,Retail-NA,101853.19,0,USD,Wire Transfer,NorthRiver Apparel Mfg #7,***2299,,PO-202409-Retail-NA-0011,FALSE,FALSE,REF-268458,First Continental Bank,***2760,"Globex International Holdings, Inc.",US,7740871.87
18/09/2024,18/09/2024,Client Receipt - CloudBridge Co. #28,Sales Receipt,SaaS-GL,0,45113.1,USD,Fedwire Credit,CloudBridge Co. #28,***6604,INV-202409-SaaS-GL-0002,,FALSE,FALSE,REF-207802,First Continental Bank,***1867,"Globex International Holdings, Inc.",US,7785984.97
18/09/2024,18/09/2024,Client Receipt - Vertex Advisory Client #54,Sales Receipt,PS-GL,0,139849.14,USD,ACH Credit,Vertex Advisory Client #54,***1992,INV-202409-PS-GL-0007,,FALSE,FALSE,REF-416962,First Continental Bank,***1857,"Globex International Holdings, Inc.",US,7925834.11
18/09/2024,18/09/2024,Client Receipt - Vertex Advisory Client #3,Sales Receipt,PS-GL,0,176956.8,USD,Fedwire Credit,Vertex Advisory Client #3,***1555,INV-202409-PS-GL-0002,,FALSE,FALSE,REF-502064,First Continental Bank,***1668,"Globex International Holdings, Inc.",US,8102790.91
19/09/2024,19/09/2024,Supplier Payment - HyperCloud Infra #15,Supplier Payment,SaaS-GL,25009.21,0,USD,Wire Transfer,HyperCloud Infra #15,***1018,,PO-202409-SaaS-GL-0005,FALSE,FALSE,REF-454364,First Continental Bank,***4213,"Globex International Holdings, Inc.",US,8077781.7
19/09/2024,19/09/2024,Supplier Payment - PackFast Fulfillment #5,Supplier Payment,Retail-NA,83754.54,0,USD,Fedwire,PackFast Fulfillment #5,***3410,,PO-202409-Retail-NA-0009,FALSE,FALSE,REF-530380,First Continental Bank,***7920,"Globex International Holdings, Inc.",US,7994027.16
19/09/2024,19/09/2024,VAT/GST Remittance - US IRS,Tax Payment,ALL,202806.52,0,USD,Fedwire,US IRS,***6510,,,FALSE,FALSE,REF-908961,First Continental Bank,***1577,"Globex International Holdings, Inc.",US,7791220.64
19/09/2024,19/09/2024,Client Receipt - Vertex Advisory Client #13,Sales Receipt,PS-GL,0,185083.9,USD,Card Settlement,Vertex Advisory Client #13,***9672,INV-202409-PS-GL-0006,,FALSE,FALSE,REF-862580,First Continental Bank,***6520,"Globex International Holdings, Inc.",US,7976304.54
19/09/2024,19/09/2024,Client Receipt - ShopSphere Partner #48,Sales Receipt,Retail-NA,0,243982.59,USD,Card Settlement,ShopSphere Partner #48,***1418,INV-202409-Retail-NA-0011,,FALSE,FALSE,REF-448964,First Continental Bank,***8379,"Globex International Holdings, Inc.",US,8220287.13
20/09/2024,20/09/2024,Merchant Processing Fees,Bank/Merchant Fees,ALL,893.32,0,USD,ACH Debit,First Continental Bank,***7458,,,FALSE,FALSE,REF-308303,First Continental Bank,***7838,"Globex International Holdings, Inc.",US,8219393.81
20/09/2024,20/09/2024,Client Receipt - CloudBridge Co. #59,Sales Receipt,SaaS-GL,0,74651.38,USD,Card Settlement,CloudBridge Co. #59,***8654,INV-202409-SaaS-GL-0024,,FALSE,FALSE,REF-314455,First Continental Bank,***2006,"Globex International Holdings, Inc.",US,8294045.19
21/09/2024,21/09/2024,Supplier Payment - PackFast Fulfillment #21,Supplier Payment,Retail-NA,27125.17,0,USD,Wire Transfer,PackFast Fulfillment #21,***4725,,PO-202409-Retail-NA-0002,FALSE,FALSE,REF-671422,First Continental Bank,***1551,"Globex International Holdings, Inc.",US,8266920.02
21/09/2024,21/09/2024,Client Receipt - CloudBridge Co. #47,Sales Receipt,SaaS-GL,0,10137.88,USD,Fedwire Credit,CloudBridge Co. #47,***9694,INV-202409-SaaS-GL-0026,,FALSE,FALSE,REF-193996,First Continental Bank,***6787,"Globex International Holdings, Inc.",US,8277057.9
22/09/2024,22/09/2024,Supplier Payment - ExpertNet Subcontractors #11,Supplier Payment,PS-GL,18838.92,0,USD,Wire Transfer,ExpertNet Subcontractors #11,***4935,,PO-202409-PS-GL-0006,FALSE,FALSE,REF-562555,First Continental Bank,***2773,"Globex International Holdings, Inc.",US,8258218.98
22/09/2024,22/09/2024,Marketing - Aurelia Media #10,Marketing,ALL,65428.85,0,USD,ACH Debit,Aurelia Media #10,***7721,,,FALSE,FALSE,REF-236196,First Continental Bank,***4020,"Globex International Holdings, Inc.",US,8192790.13
22/09/2024,22/09/2024,Supplier Payment - NorthRiver Apparel Mfg #24,Supplier Payment,Retail-NA,205864.84,0,USD,Fedwire,NorthRiver Apparel Mfg #24,***7492,,PO-202409-Retail-NA-0001,FALSE,FALSE,REF-846301,First Continental Bank,***6158,"Globex International Holdings, Inc.",US,7986925.29
23/09/2024,23/09/2024,Supplier Payment - NorthRiver Apparel Mfg #19,Supplier Payment,Retail-NA,2046.76,0,USD,Fedwire,NorthRiver Apparel Mfg #19,***3687,,PO-202409-Retail-NA-0007,FALSE,FALSE,REF-302725,First Continental Bank,***1688,"Globex International Holdings, Inc.",US,7984878.53
23/09/2024,23/09/2024,Client Receipt - CloudBridge Co. #50,Sales Receipt,SaaS-GL,0,8285.06,USD,Fedwire Credit,CloudBridge Co. #50,***6182,INV-202409-SaaS-GL-0007,,FALSE,FALSE,REF-261810,First Continental Bank,***9439,"Globex International Holdings, Inc.",US,7993163.59
23/09/2024,23/09/2024,Client Receipt - CloudBridge Co. #53,Sales Receipt,SaaS-GL,0,122165.97,USD,Card Settlement,CloudBridge Co. #53,***7944,INV-202409-SaaS-GL-0027,,FALSE,FALSE,REF-694746,First Continental Bank,***3943,"Globex International Holdings, Inc.",US,8115329.56
23/09/2024,23/09/2024,Client Receipt - ShopSphere Partner #21,Sales Receipt,Retail-NA,0,140020.37,USD,Fedwire Credit,ShopSphere Partner #21,***1341,INV-202409-Retail-NA-0007,,FALSE,FALSE,REF-523948,First Continental Bank,***5308,"Globex International Holdings, Inc.",US,8255349.93
24/09/2024,24/09/2024,Client Receipt - ShopSphere Partner #4,Sales Receipt,Retail-NA,0,20477.45,USD,ACH Credit,ShopSphere Partner #4,***7195,INV-202409-Retail-NA-0005,,FALSE,FALSE,REF-894592,First Continental Bank,***2257,"Globex International Holdings, Inc.",US,8275827.38
24/09/2024,24/09/2024,Client Receipt - ShopSphere Partner #14,Sales Receipt,Retail-NA,0,41043.78,USD,Fedwire Credit,ShopSphere Partner #14,***9255,INV-202409-Retail-NA-0001,,FALSE,FALSE,REF-392980,First Continental Bank,***1138,"Globex International Holdings, Inc.",US,8316871.16
25/09/2024,25/09/2024,Supplier Payment - CodeCraft Contractors #12,Supplier Payment,SaaS-GL,33797.73,0,USD,ACH Debit,CodeCraft Contractors #12,***8064,,PO-202409-SaaS-GL-0009,FALSE,FALSE,REF-719061,First Continental Bank,***2465,"Globex International Holdings, Inc.",US,8283073.43
25/09/2024,25/09/2024,Supplier Payment - CodeCraft Contractors #3,Supplier Payment,SaaS-GL,73746.67,0,USD,Wire Transfer,CodeCraft Contractors #3,***7323,,PO-202409-SaaS-GL-0001,FALSE,FALSE,REF-906303,First Continental Bank,***3156,"Globex International Holdings, Inc.",US,8209326.76
25/09/2024,25/09/2024,Client Receipt - Vertex Advisory Client #29,Sales Receipt,PS-GL,0,3560.05,USD,ACH Credit,Vertex Advisory Client #29,***3211,INV-202409-PS-GL-0005,,FALSE,FALSE,REF-118281,First Continental Bank,***9408,"Globex International Holdings, Inc.",US,8212886.81
26/09/2024,26/09/2024,Supplier Payment - ExpertNet Subcontractors #1,Supplier Payment,PS-GL,16273.44,0,USD,Fedwire,ExpertNet Subcontractors #1,***5462,,PO-202409-PS-GL-0010,FALSE,FALSE,REF-262683,First Continental Bank,***3065,"Globex International Holdings, Inc.",US,8196613.37
26/09/2024,26/09/2024,Intercompany Settlement - Globex APAC Logistics Pte. Ltd.,Intercompany Transfer,ALL,319950,0,USD,Internal Transfer,Globex APAC Logistics Pte. Ltd.,***4065,,,TRUE,TRUE,REF-639159,First Continental Bank,***6923,"Globex International Holdings, Inc.",US,7876663.37
26/09/2024,26/09/2024,Client Receipt - Vertex Advisory Client #48,Sales Receipt,PS-GL,0,48950.01,USD,Fedwire Credit,Vertex Advisory Client #48,***4328,INV-202409-PS-GL-0003,,FALSE,FALSE,REF-821472,First Continental Bank,***8763,"Globex International Holdings, Inc.",US,7925613.38
26/09/2024,26/09/2024,Client Receipt - Vertex Advisory Client #56,Sales Receipt,PS-GL,0,118949.97,USD,Fedwire Credit,Vertex Advisory Client #56,***6561,INV-202409-PS-GL-0008,,FALSE,FALSE,REF-674664,First Continental Bank,***7591,"Globex International Holdings, Inc.",US,8044563.35
27/09/2024,27/09/2024,Supplier Payment - NorthRiver Apparel Mfg #27,Supplier Payment,Retail-NA,64492.19,0,USD,ACH Debit,NorthRiver Apparel Mfg #27,***8005,,PO-202409-Retail-NA-0010,FALSE,FALSE,REF-833073,First Continental Bank,***4252,"Globex International Holdings, Inc.",US,7980071.16
27/09/2024,27/09/2024,Client Receipt - CloudBridge Co. #43,Sales Receipt,SaaS-GL,0,23034.41,USD,Card Settlement,CloudBridge Co. #43,***2146,INV-202409-SaaS-GL-0004,,FALSE,FALSE,REF-244857,First Continental Bank,***9338,"Globex International Holdings, Inc.",US,8003105.57
27/09/2024,27/09/2024,Client Receipt - ShopSphere Partner #25,Sales Receipt,Retail-NA,0,90072.64,USD,Card Settlement,ShopSphere Partner #25,***6115,INV-202409-Retail-NA-0003,,FALSE,FALSE,REF-978682,First Continental Bank,***9000,"Globex International Holdings, Inc.",US,8093178.21
28/09/2024,28/09/2024,Supplier Payment - ExpertNet Subcontractors #3,Supplier Payment,PS-GL,55877.83,0,USD,Fedwire,ExpertNet Subcontractors #3,***2694,,PO-202409-PS-GL-0011,FALSE,FALSE,REF-460135,First Continental Bank,***2979,"Globex International Holdings, Inc.",US,8037300.38
30/09/2024,30/09/2024,Payroll - GlobalPay Services Ltd,Payroll,ALL,517434.08,0,USD,Fedwire,GlobalPay Services Ltd,***7983,,,FALSE,FALSE,REF-146859,First Continental Bank,***9145,"Globex International Holdings, Inc.",US,7519866.3
30/09/2024,30/09/2024,Interest Earned,Interest Income,ALL,0,11953.34,USD,Fedwire Credit,First Continental Bank,***4720,,,FALSE,FALSE,REF-234960,First Continental Bank,***9643,"Globex International Holdings, Inc.",US,7531819.64
01/10/2024,01/10/2024,Account Maintenance Fee,Bank/Merchant Fees,ALL,2500,0,USD,Wire Transfer,First Continental Bank,***9460,,,FALSE,FALSE,REF-161181,First Continental Bank,***1822,"Globex International Holdings, Inc.",US,7529319.64
01/10/2024,01/10/2024,Marketing - Beacon Digital #6,Marketing,ALL,4185.48,0,USD,ACH Debit,Beacon Digital #6,***9109,,,FALSE,FALSE,REF-834985,First Continental Bank,***2039,"Globex International Holdings, Inc.",US,7525134.16
01/10/2024,01/10/2024,Supplier Payment - HyperCloud Infra #18,Supplier Payment,SaaS-GL,10241.02,0,USD,ACH Debit,HyperCloud Infra #18,***9876,,PO-202410-SaaS-GL-0002,FALSE,FALSE,REF-372841,First Continental Bank,***3451,"Globex International Holdings, Inc.",US,7514893.14
01/10/2024,01/10/2024,Client Receipt - CloudBridge Co. #65,Sales Receipt,SaaS-GL,0,26855.55,USD,ACH Credit,CloudBridge Co. #65,***7951,INV-202410-SaaS-GL-0027,,FALSE,FALSE,REF-995048,First Continental Bank,***8118,"Globex International Holdings, Inc.",US,7541748.69
01/10/2024,01/10/2024,Client Receipt - CloudBridge Co. #15,Sales Receipt,SaaS-GL,0,59675.78,USD,ACH Credit,CloudBridge Co. #15,***5639,INV-202410-SaaS-GL-0011,,FALSE,FALSE,REF-353326,First Continental Bank,***6877,"Globex International Holdings, Inc.",US,7601424.47
02/10/2024,02/10/2024,Supplier Payment - CodeCraft Contractors #2,Supplier Payment,SaaS-GL,4995.61,0,USD,Wire Transfer,CodeCraft Contractors #2,***7593,,PO-202410-SaaS-GL-0004,FALSE,FALSE,REF-379244,First Continental Bank,***1763,"Globex International Holdings, Inc.",US,7596428.86
02/10/2024,02/10/2024,Client Receipt - CloudBridge Co. #75,Sales Receipt,SaaS-GL,0,32311.21,USD,Card Settlement,CloudBridge Co. #75,***1050,INV-202410-SaaS-GL-0024,,FALSE,FALSE,REF-145503,First Continental Bank,***4719,"Globex International Holdings, Inc.",US,7628740.07
03/10/2024,03/10/2024,Supplier Payment - ExpertNet Subcontractors #13,Supplier Payment,PS-GL,143.68,0,USD,Wire Transfer,ExpertNet Subcontractors #13,***4300,,PO-202410-PS-GL-0001,FALSE,FALSE,REF-427289,First Continental Bank,***7477,"Globex International Holdings, Inc.",US,7628596.39
03/10/2024,03/10/2024,Supplier Payment - CodeCraft Contractors #11,Supplier Payment,SaaS-GL,27763.95,0,USD,ACH Debit,CodeCraft Contractors #11,***7675,,PO-202410-SaaS-GL-0005,FALSE,FALSE,REF-447750,First Continental Bank,***4463,"Globex International Holdings, Inc.",US,7600832.44
03/10/2024,03/10/2024,Client Receipt - CloudBridge Co. #28,Sales Receipt,SaaS-GL,0,8222.21,USD,ACH Credit,CloudBridge Co. #28,***9860,INV-202410-SaaS-GL-0015,,FALSE,FALSE,REF-199307,First Continental Bank,***1608,"Globex International Holdings, Inc.",US,7609054.65
03/10/2024,03/10/2024,Client Receipt - CloudBridge Co. #38,Sales Receipt,SaaS-GL,0,10362.78,USD,Fedwire Credit,CloudBridge Co. #38,***9828,INV-202410-SaaS-GL-0005,,FALSE,FALSE,REF-558200,First Continental Bank,***1928,"Globex International Holdings, Inc.",US,7619417.43
03/10/2024,03/10/2024,Client Receipt - CloudBridge Co. #24,Sales Receipt,SaaS-GL,0,65697.68,USD,Fedwire Credit,CloudBridge Co. #24,***2419,INV-202410-SaaS-GL-0014,,FALSE,FALSE,REF-987844,First Continental Bank,***8155,"Globex International Holdings, Inc.",US,7685115.11
03/10/2024,03/10/2024,Client Receipt - CloudBridge Co. #24,Sales Receipt,SaaS-GL,0,97981.53,USD,Fedwire Credit,CloudBridge Co. #24,***1056,INV-202410-SaaS-GL-0004,,FALSE,FALSE,REF-809240,First Continental Bank,***5788,"Globex International Holdings, Inc.",US,7783096.64
03/10/2024,03/10/2024,Client Receipt - CloudBridge Co. #48,Sales Receipt,SaaS-GL,0,120997.01,USD,ACH Credit,CloudBridge Co. #48,***2904,INV-202410-SaaS-GL-0022,,FALSE,FALSE,REF-300276,First Continental Bank,***5476,"Globex International Holdings, Inc.",US,7904093.65
04/10/2024,04/10/2024,Supplier Payment - PackFast Fulfillment #3,Supplier Payment,Retail-NA,15748.59,0,USD,Fedwire,PackFast Fulfillment #3,***2014,,PO-202410-Retail-NA-0007,FALSE,FALSE,REF-571059,First Continental Bank,***5480,"Globex International Holdings, Inc.",US,7888345.06
04/10/2024,04/10/2024,Client Receipt - Vertex Advisory Client #55,Sales Receipt,PS-GL,0,9860.9,USD,Fedwire Credit,Vertex Advisory Client #55,***3889,INV-202410-PS-GL-0002,,FALSE,FALSE,REF-977629,First Continental Bank,***7539,"Globex International Holdings, Inc.",US,7898205.96
04/10/2024,04/10/2024,Client Receipt - ShopSphere Partner #3,Sales Receipt,Retail-NA,0,129222.57,USD,Fedwire Credit,ShopSphere Partner #3,***9398,INV-202410-Retail-NA-0003,,FALSE,FALSE,REF-563695,First Continental Bank,***3618,"Globex International Holdings, Inc.",US,8027428.53
07/10/2024,07/10/2024,Supplier Payment - PackFast Fulfillment #17,Supplier Payment,Retail-NA,211382.73,0,USD,Fedwire,PackFast Fulfillment #17,***1934,,PO-202410-Retail-NA-0002,FALSE,FALSE,REF-419950,First Continental Bank,***7501,"Globex International Holdings, Inc.",US,7816045.8
07/10/2024,07/10/2024,Client Receipt - ShopSphere Partner #53,Sales Receipt,Retail-NA,0,43462.8,USD,ACH Credit,ShopSphere Partner #53,***5613,INV-202410-Retail-NA-0010,,FALSE,FALSE,REF-149213,First Continental Bank,***3384,"Globex International Holdings, Inc.",US,7859508.6
07/10/2024,07/10/2024,Client Receipt - CloudBridge Co. #71,Sales Receipt,SaaS-GL,0,57808.01,USD,Fedwire Credit,CloudBridge Co. #71,***1104,INV-202410-SaaS-GL-0020,,FALSE,FALSE,REF-361013,First Continental Bank,***2806,"Globex International Holdings, Inc.",US,7917316.61
08/10/2024,08/10/2024,Supplier Payment - HyperCloud Infra #8,Supplier Payment,SaaS-GL,1744.62,0,USD,Wire Transfer,HyperCloud Infra #8,***3095,,PO-202410-SaaS-GL-0012,FALSE,FALSE,REF-417458,First Continental Bank,***8934,"Globex International Holdings, Inc.",US,7915571.99
08/10/2024,08/10/2024,Supplier Payment - CodeCraft Contractors #11,Supplier Payment,SaaS-GL,7704.23,0,USD,ACH Debit,CodeCraft Contractors #11,***7465,,PO-202410-SaaS-GL-0003,FALSE,FALSE,REF-937733,First Continental Bank,***7118,"Globex International Holdings, Inc.",US,7907867.76
08/10/2024,08/10/2024,Northshore Power,Rent & Utilities,ALL,28856.78,0,USD,Wire Transfer,Northshore Power,***9399,,,FALSE,FALSE,REF-124491,First Continental Bank,***4306,"Globex International Holdings, Inc.",US,7879010.98
08/10/2024,08/10/2024,Client Receipt - Card Settlement Batch #9,Sales Receipt,Retail-NA,0,22905.92,USD,ACH Credit,Card Settlement Batch #9,***2919,INV-202410-Retail-NA-0004,,FALSE,FALSE,REF-559942,First Continental Bank,***6832,"Globex International Holdings, Inc.",US,7901916.9
08/10/2024,08/10/2024,Client Receipt - ShopSphere Partner #79,Sales Receipt,Retail-NA,0,120966.96,USD,ACH Credit,ShopSphere Partner #79,***7636,INV-202410-Retail-NA-0011,,FALSE,FALSE,REF-228377,First Continental Bank,***3406,"Globex International Holdings, Inc.",US,8022883.86
09/10/2024,09/10/2024,Client Receipt - CloudBridge Co. #38,Sales Receipt,SaaS-GL,0,24647.43,USD,ACH Credit,CloudBridge Co. #38,***2327,INV-202410-SaaS-GL-0017,,FALSE,FALSE,REF-148303,First Continental Bank,***4849,"Globex International Holdings, Inc.",US,8047531.29
10/10/2024,10/10/2024,Supplier Payment - ExpertNet Subcontractors #2,Supplier Payment,PS-GL,10588.1,0,USD,ACH Debit,ExpertNet Subcontractors #2,***4474,,PO-202410-PS-GL-0007,FALSE,FALSE,REF-259048,First Continental Bank,***4286,"Globex International Holdings, Inc.",US,8036943.19
10/10/2024,10/10/2024,Supplier Payment - ExpertNet Subcontractors #5,Supplier Payment,PS-GL,25909.66,0,USD,ACH Debit,ExpertNet Subcontractors #5,***7368,,PO-202410-PS-GL-0004,FALSE,FALSE,REF-259422,First Continental Bank,***6733,"Globex International Holdings, Inc.",US,8011033.53
10/10/2024,10/10/2024,Marketing - Aurelia Media #2,Marketing,ALL,60276.48,0,USD,Fedwire,Aurelia Media #2,***9125,,,FALSE,FALSE,REF-191022,First Continental Bank,***7994,"Globex International Holdings, Inc.",US,7950757.05
10/10/2024,10/10/2024,Supplier Payment - PackFast Fulfillment #19,Supplier Payment,Retail-NA,164557.33,0,USD,ACH Debit,PackFast Fulfillment #19,***4917,,PO-202410-Retail-NA-0001,FALSE,FALSE,REF-726662,First Continental Bank,***2091,"Globex International Holdings, Inc.",US,7786199.72
10/10/2024,10/10/2024,Client Receipt - CloudBridge Co. #45,Sales Receipt,SaaS-GL,0,3567.89,USD,Card Settlement,CloudBridge Co. #45,***6872,INV-202410-SaaS-GL-0008,,FALSE,FALSE,REF-123709,First Continental Bank,***3806,"Globex International Holdings, Inc.",US,7789767.61
10/10/2024,10/10/2024,Client Receipt - CloudBridge Co. #16,Sales Receipt,SaaS-GL,0,7084.79,USD,Card Settlement,CloudBridge Co. #16,***1834,INV-202410-SaaS-GL-0029,,FALSE,FALSE,REF-650778,First Continental Bank,***3868,"Globex International Holdings, Inc.",US,7796852.4
10/10/2024,10/10/2024,Client Receipt - Vertex Advisory Client #11,Sales Receipt,PS-GL,0,54366.11,USD,Card Settlement,Vertex Advisory Client #11,***2460,INV-202410-PS-GL-0010,,FALSE,FALSE,REF-694203,First Continental Bank,***7921,"Globex International Holdings, Inc.",US,7851218.51
11/10/2024,11/10/2024,Supplier Payment - CodeCraft Contractors #9,Supplier Payment,SaaS-GL,49039.47,0,USD,Wire Transfer,CodeCraft Contractors #9,***6021,,PO-202410-SaaS-GL-0006,FALSE,FALSE,REF-117288,First Continental Bank,***6135,"Globex International Holdings, Inc.",US,7802179.04
11/10/2024,11/10/2024,Client Receipt - ShopSphere Partner #10,Sales Receipt,Retail-NA,0,5976.87,USD,ACH Credit,ShopSphere Partner #10,***3517,INV-202410-Retail-NA-0014,,FALSE,FALSE,REF-227029,First Continental Bank,***6850,"Globex International Holdings, Inc.",US,7808155.91
11/10/2024,11/10/2024,Client Receipt - ShopSphere Partner #8,Sales Receipt,Retail-NA,0,39515.77,USD,ACH Credit,ShopSphere Partner #8,***6383,INV-202410-Retail-NA-0013,,FALSE,FALSE,REF-348353,First Continental Bank,***6087,"Globex International Holdings, Inc.",US,7847671.68
11/10/2024,11/10/2024,Client Receipt - ShopSphere Partner #31,Sales Receipt,Retail-NA,0,68758.07,USD,ACH Credit,ShopSphere Partner #31,***6688,INV-202410-Retail-NA-0009,,FALSE,FALSE,REF-595424,First Continental Bank,***1818,"Globex International Holdings, Inc.",US,7916429.75
12/10/2024,12/10/2024,Intercompany Settlement - Globex Retail NA LLC,Intercompany Transfer,ALL,848971,0,USD,Internal Transfer,Globex Retail NA LLC,***3979,,,TRUE,TRUE,REF-538307,First Continental Bank,***8082,"Globex International Holdings, Inc.",US,7067458.75
12/10/2024,12/10/2024,Intercompany Reimbursement - Globex Retail NA LLC,Intercompany Transfer,ALL,0,339588.4,USD,Internal Transfer,Globex Retail NA LLC,***3999,,,TRUE,TRUE,REF-899910,First Continental Bank,***7928,"Globex International Holdings, Inc.",US,7407047.15
13/10/2024,13/10/2024,Client Receipt - ShopSphere Partner #40,Sales Receipt,Retail-NA,0,211546.04,USD,ACH Credit,ShopSphere Partner #40,***2851,INV-202410-Retail-NA-0012,,FALSE,FALSE,REF-914515,First Continental Bank,***7633,"Globex International Holdings, Inc.",US,7618593.19
14/10/2024,14/10/2024,Client Receipt - ShopSphere Partner #41,Sales Receipt,Retail-NA,0,42948.89,USD,Card Settlement,ShopSphere Partner #41,***5926,INV-202410-Retail-NA-0001,,FALSE,FALSE,REF-222814,First Continental Bank,***6412,"Globex International Holdings, Inc.",US,7661542.08
14/10/2024,14/10/2024,Client Receipt - CloudBridge Co. #7,Sales Receipt,SaaS-GL,0,95812.01,USD,Fedwire Credit,CloudBridge Co. #7,***7858,INV-202410-SaaS-GL-0025,,FALSE,FALSE,REF-577623,First Continental Bank,***6747,"Globex International Holdings, Inc.",US,7757354.09
14/10/2024,14/10/2024,Client Receipt - ShopSphere Partner #66,Sales Receipt,Retail-NA,0,213865.53,USD,Fedwire Credit,ShopSphere Partner #66,***5413,INV-202410-Retail-NA-0006,,FALSE,FALSE,REF-483362,First Continental Bank,***8887,"Globex International Holdings, Inc.",US,7971219.62
15/10/2024,15/10/2024,Supplier Payment - ExpertNet Subcontractors #4,Supplier Payment,PS-GL,27451.06,0,USD,ACH Debit,ExpertNet Subcontractors #4,***9831,,PO-202410-PS-GL-0008,FALSE,FALSE,REF-386312,First Continental Bank,***1820,"Globex International Holdings, Inc.",US,7943768.56
15/10/2024,15/10/2024,Loan Interest Payment,Loan Interest,ALL,85000,0,USD,ACH Debit,First Continental Bank - Corporate Lending,***6769,,,FALSE,FALSE,REF-766099,First Continental Bank,***7744,"Globex International Holdings, Inc.",US,7858768.56
15/10/2024,15/10/2024,Loan Principal Repayment,Loan Principal,ALL,500000,0,USD,Fedwire,First Continental Bank - Corporate Lending,***1422,,,FALSE,FALSE,REF-787611,First Continental Bank,***3853,"Globex International Holdings, Inc.",US,7358768.56
15/10/2024,15/10/2024,Client Receipt - CloudBridge Co. #66,Sales Receipt,SaaS-GL,0,5830.06,USD,ACH Credit,CloudBridge Co. #66,***2272,INV-202410-SaaS-GL-0007,,FALSE,FALSE,REF-517865,First Continental Bank,***6744,"Globex International Holdings, Inc.",US,7364598.62
15/10/2024,15/10/2024,Client Receipt - CloudBridge Co. #62,Sales Receipt,SaaS-GL,0,67460.3,USD,Fedwire Credit,CloudBridge Co. #62,***6437,INV-202410-SaaS-GL-0002,,FALSE,FALSE,REF-181344,First Continental Bank,***1883,"Globex International Holdings, Inc.",US,7432058.92
15/10/2024,15/10/2024,Client Receipt - Vertex Advisory Client #44,Sales Receipt,PS-GL,0,95161.48,USD,Fedwire Credit,Vertex Advisory Client #44,***6779,INV-202410-PS-GL-0001,,FALSE,FALSE,REF-247937,First Continental Bank,***2692,"Globex International Holdings, Inc.",US,7527220.4
15/10/2024,15/10/2024,Client Receipt - CloudBridge Co. #54,Sales Receipt,SaaS-GL,0,132950,USD,Card Settlement,CloudBridge Co. #54,***9308,INV-202410-SaaS-GL-0018,,FALSE,FALSE,REF-994652,First Continental Bank,***1863,"Globex International Holdings, Inc.",US,7660170.4
15/10/2024,15/10/2024,Client Receipt - ShopSphere Partner #63,Sales Receipt,Retail-NA,0,147532.08,USD,ACH Credit,ShopSphere Partner #63,***7243,INV-202410-Retail-NA-0008,,FALSE,FALSE,REF-308898,First Continental Bank,***6920,"Globex International Holdings, Inc.",US,7807702.48
16/10/2024,16/10/2024,Merchant Processing Fees,Bank/Merchant Fees,ALL,1434.66,0,USD,ACH Debit,First Continental Bank,***9518,,,FALSE,FALSE,REF-887765,First Continental Bank,***7589,"Globex International Holdings, Inc.",US,7806267.82
16/10/2024,16/10/2024,Client Receipt - Vertex Advisory Client #44,Sales Receipt,PS-GL,0,66882.77,USD,Fedwire Credit,Vertex Advisory Client #44,***6496,INV-202410-PS-GL-0008,,FALSE,FALSE,REF-607552,First Continental Bank,***1932,"Globex International Holdings, Inc.",US,7873150.59
17/10/2024,17/10/2024,Supplier Payment - ExpertNet Subcontractors #1,Supplier Payment,PS-GL,18253.56,0,USD,ACH Debit,ExpertNet Subcontractors #1,***5166,,PO-202410-PS-GL-0003,FALSE,FALSE,REF-722092,First Continental Bank,***5872,"Globex International Holdings, Inc.",US,7854897.03
17/10/2024,17/10/2024,Supplier Payment - PackFast Fulfillment #1,Supplier Payment,Retail-NA,27009.51,0,USD,ACH Debit,PackFast Fulfillment #1,***5442,,PO-202410-Retail-NA-0009,FALSE,FALSE,REF-647056,First Continental Bank,***1672,"Globex International Holdings, Inc.",US,7827887.52
17/10/2024,17/10/2024,Client Receipt - CloudBridge Co. #8,Sales Receipt,SaaS-GL,0,1912.21,USD,Card Settlement,CloudBridge Co. #8,***6107,INV-202410-SaaS-GL-0019,,FALSE,FALSE,REF-853952,First Continental Bank,***7673,"Globex International Holdings, Inc.",US,7829799.73
17/10/2024,17/10/2024,Client Receipt - CloudBridge Co. #70,Sales Receipt,SaaS-GL,0,8992.95,USD,Card Settlement,CloudBridge Co. #70,***8518,INV-202410-SaaS-GL-0016,,FALSE,FALSE,REF-677991,First Continental Bank,***3221,"Globex International Holdings, Inc.",US,7838792.68
17/10/2024,17/10/2024,Client Receipt - CloudBridge Co. #13,Sales Receipt,SaaS-GL,0,22729.06,USD,Card Settlement,CloudBridge Co. #13,***3531,INV-202410-SaaS-GL-0009,,FALSE,FALSE,REF-758861,First Continental Bank,***2689,"Globex International Holdings, Inc.",US,7861521.74
17/10/2024,17/10/2024,Client Receipt - Card Settlement Batch #6,Sales Receipt,Retail-NA,0,417655.94,USD,ACH Credit,Card Settlement Batch #6,***4588,INV-202410-Retail-NA-0007,,FALSE,FALSE,REF-262300,First Continental Bank,***4483,"Globex International Holdings, Inc.",US,8279177.68
18/10/2024,18/10/2024,Supplier Payment - PackFast Fulfillment #10,Supplier Payment,Retail-NA,14762.21,0,USD,Fedwire,PackFast Fulfillment #10,***6865,,PO-202410-Retail-NA-0004,FALSE,FALSE,REF-760405,First Continental Bank,***4731,"Globex International Holdings, Inc.",US,8264415.47
18/10/2024,18/10/2024,Client Receipt - Vertex Advisory Client #5,Sales Receipt,PS-GL,0,47992.56,USD,Card Settlement,Vertex Advisory Client #5,***7936,INV-202410-PS-GL-0004,,FALSE,FALSE,REF-494512,First Continental Bank,***6085,"Globex International Holdings, Inc.",US,8312408.03
19/10/2024,19/10/2024,Supplier Payment - PackFast Fulfillment #9,Supplier Payment,Retail-NA,116736.7,0,USD,Wire Transfer,PackFast Fulfillment #9,***4994,,PO-202410-Retail-NA-0008,FALSE,FALSE,REF-777701,First Continental Bank,***6535,"Globex International Holdings, Inc.",US,8195671.33
19/10/2024,19/10/2024,VAT/GST Remittance - US IRS,Tax Payment,ALL,216126.31,0,USD,ACH Debit,US IRS,***5996,,,FALSE,FALSE,REF-471809,First Continental Bank,***6859,"Globex International Holdings, Inc.",US,7979545.02
19/10/2024,19/10/2024,Client Receipt - CloudBridge Co. #21,Sales Receipt,SaaS-GL,0,9680.13,USD,ACH Credit,CloudBridge Co. #21,***5569,INV-202410-SaaS-GL-0028,,FALSE,FALSE,REF-456965,First Continental Bank,***1074,"Globex International Holdings, Inc.",US,7989225.15
19/10/2024,19/10/2024,Client Receipt - CloudBridge Co. #33,Sales Receipt,SaaS-GL,0,37867.11,USD,Fedwire Credit,CloudBridge Co. #33,***8054,INV-202410-SaaS-GL-0013,,FALSE,FALSE,REF-111673,First Continental Bank,***4421,"Globex International Holdings, Inc.",US,8027092.26
19/10/2024,19/10/2024,Client Receipt - CloudBridge Co. #27,Sales Receipt,SaaS-GL,0,75065.19,USD,ACH Credit,CloudBridge Co. #27,***8006,INV-202410-SaaS-GL-0012,,FALSE,FALSE,REF-134346,First Continental Bank,***3246,"Globex International Holdings, Inc.",US,8102157.45
20/10/2024,20/10/2024,Supplier Payment - HyperCloud Infra #17,Supplier Payment,SaaS-GL,54119.77,0,USD,ACH Debit,HyperCloud Infra #17,***5065,,PO-202410-SaaS-GL-0001,FALSE,FALSE,REF-991295,First Continental Bank,***1858,"Globex International Holdings, Inc.",US,8048037.68
20/10/2024,20/10/2024,Client Receipt - CloudBridge Co. #61,Sales Receipt,SaaS-GL,0,17269.13,USD,Card Settlement,CloudBridge Co. #61,***8914,INV-202410-SaaS-GL-0021,,FALSE,FALSE,REF-306204,First Continental Bank,***8456,"Globex International Holdings, Inc.",US,8065306.81
21/10/2024,21/10/2024,Merchant Processing Fees,Bank/Merchant Fees,ALL,8926.8,0,USD,Wire Transfer,First Continental Bank,***6254,,,FALSE,FALSE,REF-247861,First Continental Bank,***2596,"Globex International Holdings, Inc.",US,8056380.01
21/10/2024,21/10/2024,Supplier Payment - PackFast Fulfillment #8,Supplier Payment,Retail-NA,144225.67,0,USD,ACH Debit,PackFast Fulfillment #8,***9817,,PO-202410-Retail-NA-0005,FALSE,FALSE,REF-765383,First Continental Bank,***1542,"Globex International Holdings, Inc.",US,7912154.34
21/10/2024,21/10/2024,Client Receipt - CloudBridge Co. #3,Sales Receipt,SaaS-GL,0,3913.66,USD,Fedwire Credit,CloudBridge Co. #3,***6682,INV-202410-SaaS-GL-0010,,FALSE,FALSE,REF-235641,First Continental Bank,***1281,"Globex International Holdings, Inc.",US,7916068
21/10/2024,21/10/2024,Client Receipt - ShopSphere Partner #30,Sales Receipt,Retail-NA,0,10835.02,USD,Card Settlement,ShopSphere Partner #30,***4935,INV-202410-Retail-NA-0005,,FALSE,FALSE,REF-871584,First Continental Bank,***2512,"Globex International Holdings, Inc.",US,7926903.02
21/10/2024,21/10/2024,Client Receipt - Vertex Advisory Client #51,Sales Receipt,PS-GL,0,210558.15,USD,Card Settlement,Vertex Advisory Client #51,***4907,INV-202410-PS-GL-0009,,FALSE,FALSE,REF-992937,First Continental Bank,***9490,"Globex International Holdings, Inc.",US,8137461.17
22/10/2024,22/10/2024,Supplier Payment - PackFast Fulfillment #2,Supplier Payment,Retail-NA,41282.25,0,USD,Wire Transfer,PackFast Fulfillment #2,***6797,,PO-202410-Retail-NA-0003,FALSE,FALSE,REF-942083,First Continental Bank,***9182,"Globex International Holdings, Inc.",US,8096178.92
22/10/2024,22/10/2024,Client Receipt - CloudBridge Co. #26,Sales Receipt,SaaS-GL,0,55496.95,USD,Fedwire Credit,CloudBridge Co. #26,***9255,INV-202410-SaaS-GL-0023,,FALSE,FALSE,REF-418842,First Continental Bank,***9321,"Globex International Holdings, Inc.",US,8151675.87
23/10/2024,23/10/2024,Client Receipt - Vertex Advisory Client #28,Sales Receipt,PS-GL,0,54859.2,USD,ACH Credit,Vertex Advisory Client #28,***6213,INV-202410-PS-GL-0006,,FALSE,FALSE,REF-339237,First Continental Bank,***6030,"Globex International Holdings, Inc.",US,8206535.07
23/10/2024,23/10/2024,Client Receipt - Vertex Advisory Client #30,Sales Receipt,PS-GL,0,80995.69,USD,Fedwire Credit,Vertex Advisory Client #30,***7475,INV-202410-PS-GL-0003,,FALSE,FALSE,REF-365159,First Continental Bank,***1962,"Globex International Holdings, Inc.",US,8287530.76
24/10/2024,24/10/2024,Client Receipt - Vertex Advisory Client #7,Sales Receipt,PS-GL,0,35484.08,USD,ACH Credit,Vertex Advisory Client #7,***6353,INV-202410-PS-GL-0007,,FALSE,FALSE,REF-434419,First Continental Bank,***4035,"Globex International Holdings, Inc.",US,8323014.84
25/10/2024,25/10/2024,Supplier Payment - CodeCraft Contractors #11,Supplier Payment,SaaS-GL,8533.17,0,USD,ACH Debit,CodeCraft Contractors #11,***3801,,PO-202410-SaaS-GL-0009,FALSE,FALSE,REF-680004,First Continental Bank,***4626,"Globex International Holdings, Inc.",US,8314481.67
25/10/2024,25/10/2024,Client Receipt - CloudBridge Co. #75,Sales Receipt,SaaS-GL,0,14943.83,USD,Fedwire Credit,CloudBridge Co. #75,***4354,INV-202410-SaaS-GL-0003,,FALSE,FALSE,REF-396328,First Continental Bank,***6964,"Globex International Holdings, Inc.",US,8329425.5
26/10/2024,26/10/2024,Supplier Payment - HyperCloud Infra #3,Supplier Payment,SaaS-GL,28861.37,0,USD,ACH Debit,HyperCloud Infra #3,***2925,,PO-202410-SaaS-GL-0011,FALSE,FALSE,REF-958984,First Continental Bank,***6023,"Globex International Holdings, Inc.",US,8300564.13
26/10/2024,26/10/2024,Supplier Payment - ExpertNet Subcontractors #1,Supplier Payment,PS-GL,47161.44,0,USD,ACH Debit,ExpertNet Subcontractors #1,***7822,,PO-202410-PS-GL-0002,FALSE,FALSE,REF-812849,First Continental Bank,***5573,"Globex International Holdings, Inc.",US,8253402.69
26/10/2024,26/10/2024,Supplier Payment - ExpertNet Subcontractors #3,Supplier Payment,PS-GL,60991.57,0,USD,Fedwire,ExpertNet Subcontractors #3,***6001,,PO-202410-PS-GL-0006,FALSE,FALSE,REF-682800,First Continental Bank,***9311,"Globex International Holdings, Inc.",US,8192411.12
26/10/2024,26/10/2024,Intercompany Settlement - Globex APAC Logistics Pte. Ltd.,Intercompany Transfer,ALL,336723,0,USD,Internal Transfer,Globex APAC Logistics Pte. Ltd.,***1059,,,TRUE,TRUE,REF-483069,First Continental Bank,***9220,"Globex International Holdings, Inc.",US,7855688.12
28/10/2024,28/10/2024,Supplier Payment - HyperCloud Infra #5,Supplier Payment,SaaS-GL,1634.94,0,USD,Fedwire,HyperCloud Infra #5,***2589,,PO-202410-SaaS-GL-0008,FALSE,FALSE,REF-215405,First Continental Bank,***6567,"Globex International Holdings, Inc.",US,7854053.18
28/10/2024,28/10/2024,Corporate Tax Estimate,Tax Payment,ALL,162376.47,0,USD,Fedwire,State of NY DoF,***8195,,,FALSE,FALSE,REF-331451,First Continental Bank,***1326,"Globex International Holdings, Inc.",US,7691676.71
28/10/2024,28/10/2024,Client Receipt - CloudBridge Co. #63,Sales Receipt,SaaS-GL,0,79999.04,USD,ACH Credit,CloudBridge Co. #63,***9029,INV-202410-SaaS-GL-0026,,FALSE,FALSE,REF-886133,First Continental Bank,***4699,"Globex International Holdings, Inc.",US,7771675.75
28/10/2024,28/10/2024,Client Receipt - CloudBridge Co. #31,Sales Receipt,SaaS-GL,0,84187.47,USD,Fedwire Credit,CloudBridge Co. #31,***8408,INV-202410-SaaS-GL-0001,,FALSE,FALSE,REF-697638,First Continental Bank,***8329,"Globex International Holdings, Inc.",US,7855863.22
29/10/2024,29/10/2024,Supplier Payment - HyperCloud Infra #9,Supplier Payment,SaaS-GL,3019.51,0,USD,ACH Debit,HyperCloud Infra #9,***7348,,PO-202410-SaaS-GL-0010,FALSE,FALSE,REF-794809,First Continental Bank,***4260,"Globex International Holdings, Inc.",US,7852843.71
29/10/2024,29/10/2024,Supplier Payment - PackFast Fulfillment #6,Supplier Payment,Retail-NA,96690.26,0,USD,Wire Transfer,PackFast Fulfillment #6,***3844,,PO-202410-Retail-NA-0006,FALSE,FALSE,REF-882446,First Continental Bank,***3446,"Globex International Holdings, Inc.",US,7756153.45
29/10/2024,29/10/2024,Payroll - GlobalPay Services Ltd,Payroll,ALL,574200.15,0,USD,Fedwire,GlobalPay Services Ltd,***9384,,,FALSE,FALSE,REF-812548,First Continental Bank,***9958,"Globex International Holdings, Inc.",US,7181953.3
29/10/2024,29/10/2024,Client Receipt - CloudBridge Co. #27,Sales Receipt,SaaS-GL,0,8952.95,USD,ACH Credit,CloudBridge Co. #27,***9206,INV-202410-SaaS-GL-0006,,FALSE,FALSE,REF-612683,First Continental Bank,***5592,"Globex International Holdings, Inc.",US,7190906.25
29/10/2024,29/10/2024,Client Receipt - Vertex Advisory Client #2,Sales Receipt,PS-GL,0,169355.01,USD,ACH Credit,Vertex Advisory Client #2,***9019,INV-202410-PS-GL-0005,,FALSE,FALSE,REF-320596,First Continental Bank,***1569,"Globex International Holdings, Inc.",US,7360261.26
30/10/2024,30/10/2024,Marketing - Aurelia Media #6,Marketing,ALL,24474.01,0,USD,Fedwire,Aurelia Media #6,***7054,,,FALSE,FALSE,REF-100718,First Continental Bank,***2733,"Globex International Holdings, Inc.",US,7335787.25
30/10/2024,30/10/2024,Supplier Payment - HyperCloud Infra #9,Supplier Payment,SaaS-GL,74762.6,0,USD,Fedwire,HyperCloud Infra #9,***3276,,PO-202410-SaaS-GL-0007,FALSE,FALSE,REF-190839,First Continental Bank,***8005,"Globex International Holdings, Inc.",US,7261024.65
30/10/2024,30/10/2024,Interest Earned,Interest Income,ALL,0,9295.61,USD,ACH Credit,First Continental Bank,***8073,,,FALSE,FALSE,REF-853838,First Continental Bank,***8932,"Globex International Holdings, Inc.",US,7270320.26
31/10/2024,31/10/2024,Supplier Payment - ExpertNet Subcontractors #8,Supplier Payment,PS-GL,57155.71,0,USD,Wire Transfer,ExpertNet Subcontractors #8,***4053,,PO-202410-PS-GL-0005,FALSE,FALSE,REF-528874,First Continental Bank,***1466,"Globex International Holdings, Inc.",US,7213164.55
31/10/2024,31/10/2024,Client Receipt - ShopSphere Partner #53,Sales Receipt,Retail-NA,0,38253.44,USD,Card Settlement,ShopSphere Partner #53,***6984,INV-202410-Retail-NA-0002,,FALSE,FALSE,REF-626715,First Continental Bank,***3771,"Globex International Holdings, Inc.",US,7251417.99
01/11/2024,01/11/2024,Account Maintenance Fee,Bank/Merchant Fees,ALL,2500,0,USD,Fedwire,First Continental Bank,***4264,,,FALSE,FALSE,REF-336154,First Continental Bank,***9092,"Globex International Holdings, Inc.",US,7248917.99
01/11/2024,01/11/2024,Supplier Payment - HyperCloud Infra #3,Supplier Payment,SaaS-GL,10895.44,0,USD,ACH Debit,HyperCloud Infra #3,***7654,,PO-202411-SaaS-GL-0001,FALSE,FALSE,REF-324811,First Continental Bank,***9410,"Globex International Holdings, Inc.",US,7238022.55
01/11/2024,01/11/2024,Client Receipt - CloudBridge Co. #69,Sales Receipt,SaaS-GL,0,10468.94,USD,Card Settlement,CloudBridge Co. #69,***4398,INV-202411-SaaS-GL-0010,,FALSE,FALSE,REF-360847,First Continental Bank,***1897,"Globex International Holdings, Inc.",US,7248491.49
01/11/2024,01/11/2024,Client Receipt - ShopSphere Partner #64,Sales Receipt,Retail-NA,0,179028.42,USD,ACH Credit,ShopSphere Partner #64,***4638,INV-202411-Retail-NA-0013,,FALSE,FALSE,REF-176943,First Continental Bank,***6220,"Globex International Holdings, Inc.",US,7427519.91
02/11/2024,02/11/2024,Client Receipt - CloudBridge Co. #19,Sales Receipt,SaaS-GL,0,36590.34,USD,ACH Credit,CloudBridge Co. #19,***3352,INV-202411-SaaS-GL-0007,,FALSE,FALSE,REF-791142,First Continental Bank,***8553,"Globex International Holdings, Inc.",US,7464110.25
03/11/2024,03/11/2024,Client Receipt - ShopSphere Partner #23,Sales Receipt,Retail-NA,0,54067.01,USD,ACH Credit,ShopSphere Partner #23,***8705,INV-202411-Retail-NA-0002,,FALSE,FALSE,REF-812681,First Continental Bank,***2749,"Globex International Holdings, Inc.",US,7518177.26
04/11/2024,04/11/2024,Client Receipt - Vertex Advisory Client #47,Sales Receipt,PS-GL,0,40450.98,USD,ACH Credit,Vertex Advisory Client #47,***1661,INV-202411-PS-GL-0002,,FALSE,FALSE,REF-252377,First Continental Bank,***2143,"Globex International Holdings, Inc.",US,7558628.24
04/11/2024,04/11/2024,Client Receipt - CloudBridge Co. #52,Sales Receipt,SaaS-GL,0,57328.57,USD,Card Settlement,CloudBridge Co. #52,***5948,INV-202411-SaaS-GL-0018,,FALSE,FALSE,REF-573090,First Continental Bank,***3466,"Globex International Holdings, Inc.",US,7615956.81
04/11/2024,04/11/2024,Client Receipt - CloudBridge Co. #73,Sales Receipt,SaaS-GL,0,63436.08,USD,ACH Credit,CloudBridge Co. #73,***9869,INV-202411-SaaS-GL-0009,,FALSE,FALSE,REF-953636,First Continental Bank,***1192,"Globex International Holdings, Inc.",US,7679392.89
04/11/2024,04/11/2024,Client Receipt - CloudBridge Co. #52,Sales Receipt,SaaS-GL,0,116460.79,USD,ACH Credit,CloudBridge Co. #52,***5038,INV-202411-SaaS-GL-0001,,FALSE,FALSE,REF-424043,First Continental Bank,***4386,"Globex International Holdings, Inc.",US,7795853.68
04/11/2024,04/11/2024,Client Receipt - CloudBridge Co. #55,Sales Receipt,SaaS-GL,0,124278.27,USD,Card Settlement,CloudBridge Co. #55,***1127,INV-202411-SaaS-GL-0016,,FALSE,FALSE,REF-153373,First Continental Bank,***9447,"Globex International Holdings, Inc.",US,7920131.95
05/11/2024,05/11/2024,Client Receipt - Vertex Advisory Client #9,Sales Receipt,PS-GL,0,102872.45,USD,Card Settlement,Vertex Advisory Client #9,***1607,INV-202411-PS-GL-0005,,FALSE,FALSE,REF-226881,First Continental Bank,***7792,"Globex International Holdings, Inc.",US,8023004.4
06/11/2024,06/11/2024,Marketing - Beacon Digital #2,Marketing,ALL,16761.34,0,USD,Wire Transfer,Beacon Digital #2,***1651,,,FALSE,FALSE,REF-679941,First Continental Bank,***9276,"Globex International Holdings, Inc.",US,8006243.06
06/11/2024,06/11/2024,Supplier Payment - ExpertNet Subcontractors #6,Supplier Payment,PS-GL,23922.77,0,USD,Fedwire,ExpertNet Subcontractors #6,***2303,,PO-202411-PS-GL-0001,FALSE,FALSE,REF-631480,First Continental Bank,***6059,"Globex International Holdings, Inc.",US,7982320.29
06/11/2024,06/11/2024,Client Receipt - CloudBridge Co. #5,Sales Receipt,SaaS-GL,0,13647.04,USD,ACH Credit,CloudBridge Co. #5,***9810,INV-202411-SaaS-GL-0020,,FALSE,FALSE,REF-965180,First Continental Bank,***1007,"Globex International Holdings, Inc.",US,7995967.33
06/11/2024,06/11/2024,Client Receipt - CloudBridge Co. #34,Sales Receipt,SaaS-GL,0,59416.46,USD,ACH Credit,CloudBridge Co. #34,***8909,INV-202411-SaaS-GL-0005,,FALSE,FALSE,REF-618163,First Continental Bank,***5737,"Globex International Holdings, Inc.",US,8055383.79
06/11/2024,06/11/2024,Client Receipt - ShopSphere Partner #41,Sales Receipt,Retail-NA,0,100024.35,USD,Card Settlement,ShopSphere Partner #41,***5243,INV-202411-Retail-NA-0007,,FALSE,FALSE,REF-597199,First Continental Bank,***8046,"Globex International Holdings, Inc.",US,8155408.14
06/11/2024,06/11/2024,Client Receipt - ShopSphere Partner #35,Sales Receipt,Retail-NA,0,164192.09,USD,Card Settlement,ShopSphere Partner #35,***7868,INV-202411-Retail-NA-0006,,FALSE,FALSE,REF-291348,First Continental Bank,***9411,"Globex International Holdings, Inc.",US,8319600.23
06/11/2024,06/11/2024,Client Receipt - ShopSphere Partner #41,Sales Receipt,Retail-NA,0,362717.55,USD,Card Settlement,ShopSphere Partner #41,***8877,INV-202411-Retail-NA-0001,,FALSE,FALSE,REF-525751,First Continental Bank,***1240,"Globex International Holdings, Inc.",US,8682317.78
07/11/2024,07/11/2024,Client Receipt - CloudBridge Co. #4,Sales Receipt,SaaS-GL,0,35325.39,USD,ACH Credit,CloudBridge Co. #4,***3343,INV-202411-SaaS-GL-0002,,FALSE,FALSE,REF-150515,First Continental Bank,***1139,"Globex International Holdings, Inc.",US,8717643.17
07/11/2024,07/11/2024,Client Receipt - ShopSphere Partner #43,Sales Receipt,Retail-NA,0,37250.59,USD,Card Settlement,ShopSphere Partner #43,***4024,INV-202411-Retail-NA-0011,,FALSE,FALSE,REF-868607,First Continental Bank,***8424,"Globex International Holdings, Inc.",US,8754893.76
07/11/2024,07/11/2024,Client Receipt - CloudBridge Co. #33,Sales Receipt,SaaS-GL,0,46573.94,USD,ACH Credit,CloudBridge Co. #33,***1602,INV-202411-SaaS-GL-0013,,FALSE,FALSE,REF-995262,First Continental Bank,***1229,"Globex International Holdings, Inc.",US,8801467.7
07/11/2024,07/11/2024,Client Receipt - ShopSphere Partner #8,Sales Receipt,Retail-NA,0,142998.05,USD,Fedwire Credit,ShopSphere Partner #8,***5380,INV-202411-Retail-NA-0009,,FALSE,FALSE,REF-896922,First Continental Bank,***2817,"Globex International Holdings, Inc.",US,8944465.75
08/11/2024,08/11/2024,Client Receipt - CloudBridge Co. #61,Sales Receipt,SaaS-GL,0,36048,USD,Fedwire Credit,CloudBridge Co. #61,***5471,INV-202411-SaaS-GL-0021,,FALSE,FALSE,REF-303971,First Continental Bank,***8730,"Globex International Holdings, Inc.",US,8980513.75
08/11/2024,08/11/2024,Client Receipt - CloudBridge Co. #66,Sales Receipt,SaaS-GL,0,68500.74,USD,Fedwire Credit,CloudBridge Co. #66,***7170,INV-202411-SaaS-GL-0017,,FALSE,FALSE,REF-849585,First Continental Bank,***9076,"Globex International Holdings, Inc.",US,9049014.49
08/11/2024,08/11/2024,Client Receipt - CloudBridge Co. #28,Sales Receipt,SaaS-GL,0,77621.22,USD,ACH Credit,CloudBridge Co. #28,***8484,INV-202411-SaaS-GL-0006,,FALSE,FALSE,REF-842310,First Continental Bank,***3084,"Globex International Holdings, Inc.",US,9126635.71
08/11/2024,08/11/2024,Client Receipt - Vertex Advisory Client #16,Sales Receipt,PS-GL,0,193265.38,USD,ACH Credit,Vertex Advisory Client #16,***7094,INV-202411-PS-GL-0006,,FALSE,FALSE,REF-862221,First Continental Bank,***3191,"Globex International Holdings, Inc.",US,9319901.09
08/11/2024,08/11/2024,Client Receipt - Vertex Advisory Client #46,Sales Receipt,PS-GL,0,211001.21,USD,Card Settlement,Vertex Advisory Client #46,***1973,INV-202411-PS-GL-0003,,FALSE,FALSE,REF-172869,First Continental Bank,***6862,"Globex International Holdings, Inc.",US,9530902.3
09/11/2024,09/11/2024,Supplier Payment - HyperCloud Infra #4,Supplier Payment,SaaS-GL,33316.49,0,USD,Fedwire,HyperCloud Infra #4,***1683,,PO-202411-SaaS-GL-0009,FALSE,FALSE,REF-188692,First Continental Bank,***1236,"Globex International Holdings, Inc.",US,9497585.81
10/11/2024,10/11/2024,Client Receipt - ShopSphere Partner #73,Sales Receipt,Retail-NA,0,11028.98,USD,ACH Credit,ShopSphere Partner #73,***5020,INV-202411-Retail-NA-0003,,FALSE,FALSE,REF-269316,First Continental Bank,***1380,"Globex International Holdings, Inc.",US,9508614.79
11/11/2024,11/11/2024,Merchant Processing Fees,Bank/Merchant Fees,ALL,4420.72,0,USD,Wire Transfer,First Continental Bank,***6052,,,FALSE,FALSE,REF-648894,First Continental Bank,***5677,"Globex International Holdings, Inc.",US,9504194.07
11/11/2024,11/11/2024,Supplier Payment - HyperCloud Infra #4,Supplier Payment,SaaS-GL,17866.9,0,USD,Wire Transfer,HyperCloud Infra #4,***3289,,PO-202411-SaaS-GL-0007,FALSE,FALSE,REF-846093,First Continental Bank,***2285,"Globex International Holdings, Inc.",US,9486327.17
12/11/2024,12/11/2024,Supplier Payment - NorthRiver Apparel Mfg #12,Supplier Payment,Retail-NA,116883.72,0,USD,ACH Debit,NorthRiver Apparel Mfg #12,***2833,,PO-202411-Retail-NA-0009,FALSE,FALSE,REF-793490,First Continental Bank,***5950,"Globex International Holdings, Inc.",US,9369443.45
12/11/2024,12/11/2024,Intercompany Settlement - Globex APAC Logistics Pte. Ltd.,Intercompany Transfer,ALL,422568,0,USD,Internal Transfer,Globex APAC Logistics Pte. Ltd.,***3544,,,TRUE,TRUE,REF-751631,First Continental Bank,***1184,"Globex International Holdings, Inc.",US,8946875.45
12/11/2024,12/11/2024,Client Receipt - Vertex Advisory Client #27,Sales Receipt,PS-GL,0,15028.41,USD,ACH Credit,Vertex Advisory Client #27,***6865,INV-202411-PS-GL-0004,,FALSE,FALSE,REF-176961,First Continental Bank,***1762,"Globex International Holdings, Inc.",US,8961903.86
12/11/2024,12/11/2024,Client Receipt - Vertex Advisory Client #22,Sales Receipt,PS-GL,0,323318,USD,ACH Credit,Vertex Advisory Client #22,***8756,INV-202411-PS-GL-0001,,FALSE,FALSE,REF-749115,First Continental Bank,***7856,"Globex International Holdings, Inc.",US,9285221.86
13/11/2024,13/11/2024,Supplier Payment - NorthRiver Apparel Mfg #3,Supplier Payment,Retail-NA,6219.02,0,USD,Wire Transfer,NorthRiver Apparel Mfg #3,***5297,,PO-202411-Retail-NA-0003,FALSE,FALSE,REF-834798,First Continental Bank,***1650,"Globex International Holdings, Inc.",US,9279002.84
13/11/2024,13/11/2024,Supplier Payment - HyperCloud Infra #6,Supplier Payment,SaaS-GL,27789.34,0,USD,Fedwire,HyperCloud Infra #6,***2824,,PO-202411-SaaS-GL-0005,FALSE,FALSE,REF-434698,First Continental Bank,***1800,"Globex International Holdings, Inc.",US,9251213.5
13/11/2024,13/11/2024,Client Receipt - CloudBridge Co. #8,Sales Receipt,SaaS-GL,0,64257.56,USD,Card Settlement,CloudBridge Co. #8,***8000,INV-202411-SaaS-GL-0022,,FALSE,FALSE,REF-677998,First Continental Bank,***5856,"Globex International Holdings, Inc.",US,9315471.06
13/11/2024,13/11/2024,Client Receipt - CloudBridge Co. #55,Sales Receipt,SaaS-GL,0,66257.18,USD,Fedwire Credit,CloudBridge Co. #55,***4769,INV-202411-SaaS-GL-0012,,FALSE,FALSE,REF-108645,First Continental Bank,***6339,"Globex International Holdings, Inc.",US,9381728.24
14/11/2024,14/11/2024,Supplier Payment - HyperCloud Infra #4,Supplier Payment,SaaS-GL,2434.21,0,USD,Wire Transfer,HyperCloud Infra #4,***1316,,PO-202411-SaaS-GL-0002,FALSE,FALSE,REF-169681,First Continental Bank,***8113,"Globex International Holdings, Inc.",US,9379294.03
14/11/2024,14/11/2024,Supplier Payment - HyperCloud Infra #6,Supplier Payment,SaaS-GL,5223.12,0,USD,ACH Debit,HyperCloud Infra #6,***3211,,PO-202411-SaaS-GL-0004,FALSE,FALSE,REF-802523,First Continental Bank,***9605,"Globex International Holdings, Inc.",US,9374070.91
14/11/2024,14/11/2024,Supplier Payment - PackFast Fulfillment #6,Supplier Payment,Retail-NA,28740.95,0,USD,Fedwire,PackFast Fulfillment #6,***3496,,PO-202411-Retail-NA-0002,FALSE,FALSE,REF-629534,First Continental Bank,***5445,"Globex International Holdings, Inc.",US,9345329.96
14/11/2024,14/11/2024,Supplier Payment - ExpertNet Subcontractors #1,Supplier Payment,PS-GL,68684.72,0,USD,Wire Transfer,ExpertNet Subcontractors #1,***1121,,PO-202411-PS-GL-0004,FALSE,FALSE,REF-600814,First Continental Bank,***5305,"Globex International Holdings, Inc.",US,9276645.24
14/11/2024,14/11/2024,Supplier Payment - NorthRiver Apparel Mfg #7,Supplier Payment,Retail-NA,99726.37,0,USD,Fedwire,NorthRiver Apparel Mfg #7,***5802,,PO-202411-Retail-NA-0005,FALSE,FALSE,REF-993865,First Continental Bank,***8601,"Globex International Holdings, Inc.",US,9176918.87
15/11/2024,15/11/2024,Loan Interest Payment,Loan Interest,ALL,85000,0,USD,Wire Transfer,First Continental Bank - Corporate Lending,***8923,,,FALSE,FALSE,REF-182195,First Continental Bank,***5460,"Globex International Holdings, Inc.",US,9091918.87
15/11/2024,15/11/2024,Loan Principal Repayment,Loan Principal,ALL,500000,0,USD,ACH Debit,First Continental Bank - Corporate Lending,***5198,,,FALSE,FALSE,REF-752793,First Continental Bank,***3517,"Globex International Holdings, Inc.",US,8591918.87
15/11/2024,15/11/2024,Client Receipt - CloudBridge Co. #39,Sales Receipt,SaaS-GL,0,13021.62,USD,Fedwire Credit,CloudBridge Co. #39,***1175,INV-202411-SaaS-GL-0004,,FALSE,FALSE,REF-442631,First Continental Bank,***5864,"Globex International Holdings, Inc.",US,8604940.49
15/11/2024,15/11/2024,Client Receipt - CloudBridge Co. #27,Sales Receipt,SaaS-GL,0,25606.18,USD,ACH Credit,CloudBridge Co. #27,***5100,INV-202411-SaaS-GL-0025,,FALSE,FALSE,REF-969004,First Continental Bank,***7383,"Globex International Holdings, Inc.",US,8630546.67
15/11/2024,15/11/2024,Client Receipt - ShopSphere Partner #40,Sales Receipt,Retail-NA,0,51125.24,USD,ACH Credit,ShopSphere Partner #40,***5255,INV-202411-Retail-NA-0014,,FALSE,FALSE,REF-560421,First Continental Bank,***5071,"Globex International Holdings, Inc.",US,8681671.91
16/11/2024,16/11/2024,Client Receipt - CloudBridge Co. #40,Sales Receipt,SaaS-GL,0,39110.16,USD,Fedwire Credit,CloudBridge Co. #40,***8991,INV-202411-SaaS-GL-0011,,FALSE,FALSE,REF-821762,First Continental Bank,***6013,"Globex International Holdings, Inc.",US,8720782.07
18/11/2024,18/11/2024,Supplier Payment - CodeCraft Contractors #2,Supplier Payment,SaaS-GL,82228.03,0,USD,ACH Debit,CodeCraft Contractors #2,***8794,,PO-202411-SaaS-GL-0003,FALSE,FALSE,REF-229383,First Continental Bank,***1780,"Globex International Holdings, Inc.",US,8638554.04
18/11/2024,18/11/2024,Client Receipt - Vertex Advisory Client #32,Sales Receipt,PS-GL,0,10843.6,USD,Fedwire Credit,Vertex Advisory Client #32,***6806,INV-202411-PS-GL-0009,,FALSE,FALSE,REF-396365,First Continental Bank,***3715,"Globex International Holdings, Inc.",US,8649397.64
18/11/2024,18/11/2024,Client Receipt - CloudBridge Co. #29,Sales Receipt,SaaS-GL,0,65680.38,USD,Fedwire Credit,CloudBridge Co. #29,***2392,INV-202411-SaaS-GL-0014,,FALSE,FALSE,REF-104283,First Continental Bank,***1783,"Globex International Holdings, Inc.",US,8715078.02
19/11/2024,19/11/2024,Supplier Payment - HyperCloud Infra #1,Supplier Payment,SaaS-GL,5570.75,0,USD,Wire Transfer,HyperCloud Infra #1,***9101,,PO-202411-SaaS-GL-0006,FALSE,FALSE,REF-593017,First Continental Bank,***8718,"Globex International Holdings, Inc.",US,8709507.27
19/11/2024,19/11/2024,Supplier Payment - NorthRiver Apparel Mfg #1,Supplier Payment,Retail-NA,36035.41,0,USD,ACH Debit,NorthRiver Apparel Mfg #1,***5520,,PO-202411-Retail-NA-0001,FALSE,FALSE,REF-948549,First Continental Bank,***9794,"Globex International Holdings, Inc.",US,8673471.86
19/11/2024,19/11/2024,Supplier Payment - ExpertNet Subcontractors #1,Supplier Payment,PS-GL,59757.39,0,USD,Fedwire,ExpertNet Subcontractors #1,***2902,,PO-202411-PS-GL-0005,FALSE,FALSE,REF-136148,First Continental Bank,***8778,"Globex International Holdings, Inc.",US,8613714.47
19/11/2024,19/11/2024,Supplier Payment - PackFast Fulfillment #21,Supplier Payment,Retail-NA,90988.21,0,USD,Fedwire,PackFast Fulfillment #21,***1054,,PO-202411-Retail-NA-0008,FALSE,FALSE,REF-417413,First Continental Bank,***8115,"Globex International Holdings, Inc.",US,8522726.26
20/11/2024,20/11/2024,Supplier Payment - ExpertNet Subcontractors #6,Supplier Payment,PS-GL,15132.59,0,USD,Wire Transfer,ExpertNet Subcontractors #6,***5896,,PO-202411-PS-GL-0002,FALSE,FALSE,REF-714435,First Continental Bank,***9891,"Globex International Holdings, Inc.",US,8507593.67
20/11/2024,20/11/2024,Metro Water & Waste,Rent & Utilities,ALL,32664.19,0,USD,Wire Transfer,Metro Water & Waste,***9006,,,FALSE,FALSE,REF-206909,First Continental Bank,***1389,"Globex International Holdings, Inc.",US,8474929.48
20/11/2024,20/11/2024,VAT/GST Remittance - US IRS,Tax Payment,ALL,232997,0,USD,Fedwire,US IRS,***9002,,,FALSE,FALSE,REF-316828,First Continental Bank,***5072,"Globex International Holdings, Inc.",US,8241932.48
20/11/2024,20/11/2024,Client Receipt - CloudBridge Co. #46,Sales Receipt,SaaS-GL,0,130765.23,USD,Fedwire Credit,CloudBridge Co. #46,***2533,INV-202411-SaaS-GL-0023,,FALSE,FALSE,REF-362962,First Continental Bank,***9330,"Globex International Holdings, Inc.",US,8372697.71
21/11/2024,21/11/2024,Client Receipt - CloudBridge Co. #51,Sales Receipt,SaaS-GL,0,69889.39,USD,ACH Credit,CloudBridge Co. #51,***1757,INV-202411-SaaS-GL-0019,,FALSE,FALSE,REF-889055,First Continental Bank,***9409,"Globex International Holdings, Inc.",US,8442587.1
22/11/2024,22/11/2024,Supplier Payment - ExpertNet Subcontractors #1,Supplier Payment,PS-GL,4289.22,0,USD,Wire Transfer,ExpertNet Subcontractors #1,***1683,,PO-202411-PS-GL-0008,FALSE,FALSE,REF-119968,First Continental Bank,***1518,"Globex International Holdings, Inc.",US,8438297.88
22/11/2024,22/11/2024,Merchant Processing Fees,Bank/Merchant Fees,ALL,7541.13,0,USD,ACH Debit,First Continental Bank,***8270,,,FALSE,FALSE,REF-816726,First Continental Bank,***9920,"Globex International Holdings, Inc.",US,8430756.75
22/11/2024,22/11/2024,Supplier Payment - ExpertNet Subcontractors #14,Supplier Payment,PS-GL,28749.83,0,USD,ACH Debit,ExpertNet Subcontractors #14,***7769,,PO-202411-PS-GL-0003,FALSE,FALSE,REF-583958,First Continental Bank,***1774,"Globex International Holdings, Inc.",US,8402006.92
22/11/2024,22/11/2024,Client Receipt - ShopSphere Partner #45,Sales Receipt,Retail-NA,0,320.58,USD,Card Settlement,ShopSphere Partner #45,***1262,INV-202411-Retail-NA-0008,,FALSE,FALSE,REF-472406,First Continental Bank,***2309,"Globex International Holdings, Inc.",US,8402327.5
22/11/2024,22/11/2024,Client Receipt - CloudBridge Co. #3,Sales Receipt,SaaS-GL,0,22880.39,USD,Fedwire Credit,CloudBridge Co. #3,***3951,INV-202411-SaaS-GL-0024,,FALSE,FALSE,REF-961071,First Continental Bank,***4445,"Globex International Holdings, Inc.",US,8425207.89
23/11/2024,23/11/2024,Supplier Payment - ExpertNet Subcontractors #11,Supplier Payment,PS-GL,71528.94,0,USD,Fedwire,ExpertNet Subcontractors #11,***5612,,PO-202411-PS-GL-0006,FALSE,FALSE,REF-100525,First Continental Bank,***6006,"Globex International Holdings, Inc.",US,8353678.95
24/11/2024,24/11/2024,Client Receipt - Card Settlement Batch #23,Sales Receipt,Retail-NA,0,14253.09,USD,Card Settlement,Card Settlement Batch #23,***9947,INV-202411-Retail-NA-0012,,FALSE,FALSE,REF-538780,First Continental Bank,***5040,"Globex International Holdings, Inc.",US,8367932.04
25/11/2024,25/11/2024,Client Receipt - Card Settlement Batch #24,Sales Receipt,Retail-NA,0,34955.06,USD,Card Settlement,Card Settlement Batch #24,***3573,INV-202411-Retail-NA-0015,,FALSE,FALSE,REF-714706,First Continental Bank,***3474,"Globex International Holdings, Inc.",US,8402887.1
25/11/2024,25/11/2024,Client Receipt - CloudBridge Co. #29,Sales Receipt,SaaS-GL,0,43173.29,USD,ACH Credit,CloudBridge Co. #29,***4450,INV-202411-SaaS-GL-0015,,FALSE,FALSE,REF-832447,First Continental Bank,***3593,"Globex International Holdings, Inc.",US,8446060.39
26/11/2024,26/11/2024,Supplier Payment - PackFast Fulfillment #2,Supplier Payment,Retail-NA,102605.5,0,USD,ACH Debit,PackFast Fulfillment #2,***6717,,PO-202411-Retail-NA-0006,FALSE,FALSE,REF-621931,First Continental Bank,***6308,"Globex International Holdings, Inc.",US,8343454.89
26/11/2024,26/11/2024,Supplier Payment - HyperCloud Infra #1,Supplier Payment,SaaS-GL,124244.2,0,USD,Wire Transfer,HyperCloud Infra #1,***2528,,PO-202411-SaaS-GL-0008,FALSE,FALSE,REF-885050,First Continental Bank,***3556,"Globex International Holdings, Inc.",US,8219210.69
26/11/2024,26/11/2024,Supplier Payment - NorthRiver Apparel Mfg #33,Supplier Payment,Retail-NA,231756.27,0,USD,ACH Debit,NorthRiver Apparel Mfg #33,***5763,,PO-202411-Retail-NA-0007,FALSE,FALSE,REF-760334,First Continental Bank,***4184,"Globex International Holdings, Inc.",US,7987454.42
26/11/2024,26/11/2024,Intercompany Settlement - Globex Consulting UK Ltd.,Intercompany Transfer,ALL,835514,0,USD,Internal Transfer,Globex Consulting UK Ltd.,***8895,,,TRUE,TRUE,REF-198062,First Continental Bank,***1047,"Globex International Holdings, Inc.",US,7151940.42
26/11/2024,26/11/2024,Client Receipt - Vertex Advisory Client #50,Sales Receipt,PS-GL,0,29484.44,USD,Card Settlement,Vertex Advisory Client #50,***9015,INV-202411-PS-GL-0007,,FALSE,FALSE,REF-724287,First Continental Bank,***1981,"Globex International Holdings, Inc.",US,7181424.86
27/11/2024,27/11/2024,Client Receipt - Vertex Advisory Client #5,Sales Receipt,PS-GL,0,11821.83,USD,Fedwire Credit,Vertex Advisory Client #5,***6470,INV-202411-PS-GL-0008,,FALSE,FALSE,REF-537652,First Continental Bank,***3485,"Globex International Holdings, Inc.",US,7193246.69
27/11/2024,27/11/2024,Client Receipt - ShopSphere Partner #76,Sales Receipt,Retail-NA,0,148272.76,USD,ACH Credit,ShopSphere Partner #76,***3110,INV-202411-Retail-NA-0005,,FALSE,FALSE,REF-607657,First Continental Bank,***3348,"Globex International Holdings, Inc.",US,7341519.45
27/11/2024,27/11/2024,Client Receipt - Card Settlement Batch #14,Sales Receipt,Retail-NA,0,158499.19,USD,Fedwire Credit,Card Settlement Batch #14,***2114,INV-202411-Retail-NA-0010,,FALSE,FALSE,REF-662214,First Continental Bank,***2532,"Globex International Holdings, Inc.",US,7500018.64
27/11/2024,27/11/2024,Client Receipt - ShopSphere Partner #23,Sales Receipt,Retail-NA,0,261091.93,USD,ACH Credit,ShopSphere Partner #23,***5148,INV-202411-Retail-NA-0004,,FALSE,FALSE,REF-761398,First Continental Bank,***7082,"Globex International Holdings, Inc.",US,7761110.57
28/11/2024,28/11/2024,Supplier Payment - ExpertNet Subcontractors #18,Supplier Payment,PS-GL,9360.43,0,USD,Fedwire,ExpertNet Subcontractors #18,***7350,,PO-202411-PS-GL-0007,FALSE,FALSE,REF-664507,First Continental Bank,***3163,"Globex International Holdings, Inc.",US,7751750.14
28/11/2024,28/11/2024,Marketing - Beacon Digital #7,Marketing,ALL,86145.14,0,USD,Fedwire,Beacon Digital #7,***2428,,,FALSE,FALSE,REF-280601,First Continental Bank,***6019,"Globex International Holdings, Inc.",US,7665605
28/11/2024,28/11/2024,Supplier Payment - PackFast Fulfillment #4,Supplier Payment,Retail-NA,232948.24,0,USD,Wire Transfer,PackFast Fulfillment #4,***6716,,PO-202411-Retail-NA-0004,FALSE,FALSE,REF-764916,First Continental Bank,***3774,"Globex International Holdings, Inc.",US,7432656.76
29/11/2024,29/11/2024,Payroll - GlobalPay Services Ltd,Payroll,ALL,329784.31,0,USD,Wire Transfer,GlobalPay Services Ltd,***5233,,,FALSE,FALSE,REF-489680,First Continental Bank,***3592,"Globex International Holdings, Inc.",US,7102872.45
29/11/2024,29/11/2024,Client Receipt - CloudBridge Co. #72,Sales Receipt,SaaS-GL,0,44559.06,USD,Fedwire Credit,CloudBridge Co. #72,***3862,INV-202411-SaaS-GL-0008,,FALSE,FALSE,REF-848686,First Continental Bank,***9905,"Globex International Holdings, Inc.",US,7147431.51
29/11/2024,29/11/2024,Client Receipt - CloudBridge Co. #29,Sales Receipt,SaaS-GL,0,76233.24,USD,Card Settlement,CloudBridge Co. #29,***5978,INV-202411-SaaS-GL-0003,,FALSE,FALSE,REF-814888,First Continental Bank,***6986,"Globex International Holdings, Inc.",US,7223664.75
30/11/2024,30/11/2024,Payroll - GlobalPay Services Ltd,Payroll,ALL,329784.31,0,USD,Fedwire,GlobalPay Services Ltd,***1673,,,FALSE,FALSE,REF-414966,First Continental Bank,***5283,"Globex International Holdings, Inc.",US,6893880.44
30/11/2024,30/11/2024,Interest Earned,Interest Income,ALL,0,11237.78,USD,Fedwire Credit,First Continental Bank,***4253,,,FALSE,FALSE,REF-353804,First Continental Bank,***6680,"Globex International Holdings, Inc.",US,6905118.22
01/12/2024,01/12/2024,Account Maintenance Fee,Bank/Merchant Fees,ALL,2500,0,USD,ACH Debit,First Continental Bank,***4523,,,FALSE,FALSE,REF-626283,First Continental Bank,***7747,"Globex International Holdings, Inc.",US,6902618.22
01/12/2024,01/12/2024,Supplier Payment - HyperCloud Infra #1,Supplier Payment,SaaS-GL,23751.94,0,USD,Fedwire,HyperCloud Infra #1,***9222,,PO-202412-SaaS-GL-0003,FALSE,FALSE,REF-357378,First Continental Bank,***5920,"Globex International Holdings, Inc.",US,6878866.28
01/12/2024,01/12/2024,Client Receipt - CloudBridge Co. #36,Sales Receipt,SaaS-GL,0,39870.29,USD,Fedwire Credit,CloudBridge Co. #36,***9082,INV-202412-SaaS-GL-0012,,FALSE,FALSE,REF-295302,First Continental Bank,***2785,"Globex International Holdings, Inc.",US,6918736.57
02/12/2024,02/12/2024,Merchant Processing Fees,Bank/Merchant Fees,ALL,4605,0,USD,Wire Transfer,First Continental Bank,***2135,,,FALSE,FALSE,REF-892714,First Continental Bank,***9919,"Globex International Holdings, Inc.",US,6914131.57
02/12/2024,02/12/2024,Client Receipt - CloudBridge Co. #49,Sales Receipt,SaaS-GL,0,56061.12,USD,Fedwire Credit,CloudBridge Co. #49,***5939,INV-202412-SaaS-GL-0013,,FALSE,FALSE,REF-292845,First Continental Bank,***2909,"Globex International Holdings, Inc.",US,6970192.69
03/12/2024,03/12/2024,Supplier Payment - HyperCloud Infra #5,Supplier Payment,SaaS-GL,10888.08,0,USD,Fedwire,HyperCloud Infra #5,***1343,,PO-202412-SaaS-GL-0008,FALSE,FALSE,REF-793543,First Continental Bank,***5666,"Globex International Holdings, Inc.",US,6959304.61
03/12/2024,03/12/2024,Client Receipt - Vertex Advisory Client #51,Sales Receipt,PS-GL,0,106749.65,USD,ACH Credit,Vertex Advisory Client #51,***7244,INV-202412-PS-GL-0008,,FALSE,FALSE,REF-182841,First Continental Bank,***9464,"Globex International Holdings, Inc.",US,7066054.26
04/12/2024,04/12/2024,Supplier Payment - CodeCraft Contractors #12,Supplier Payment,SaaS-GL,10365.27,0,USD,Fedwire,CodeCraft Contractors #12,***3668,,PO-202412-SaaS-GL-0002,FALSE,FALSE,REF-735521,First Continental Bank,***8887,"Globex International Holdings, Inc.",US,7055688.99
04/12/2024,04/12/2024,Client Receipt - CloudBridge Co. #8,Sales Receipt,SaaS-GL,0,5159.29,USD,Card Settlement,CloudBridge Co. #8,***6551,INV-202412-SaaS-GL-0008,,FALSE,FALSE,REF-110186,First Continental Bank,***7072,"Globex International Holdings, Inc.",US,7060848.28
05/12/2024,05/12/2024,Merchant Processing Fees,Bank/Merchant Fees,ALL,8986.85,0,USD,Fedwire,First Continental Bank,***5845,,,FALSE,FALSE,REF-509598,First Continental Bank,***9804,"Globex International Holdings, Inc.",US,7051861.43
05/12/2024,05/12/2024,Supplier Payment - PackFast Fulfillment #3,Supplier Payment,Retail-NA,12790.29,0,USD,Fedwire,PackFast Fulfillment #3,***6796,,PO-202412-Retail-NA-0008,FALSE,FALSE,REF-352801,First Continental Bank,***8749,"Globex International Holdings, Inc.",US,7039071.14
05/12/2024,05/12/2024,Supplier Payment - HyperCloud Infra #4,Supplier Payment,SaaS-GL,38152.99,0,USD,Wire Transfer,HyperCloud Infra #4,***4242,,PO-202412-SaaS-GL-0001,FALSE,FALSE,REF-166239,First Continental Bank,***4639,"Globex International Holdings, Inc.",US,7000918.15
05/12/2024,05/12/2024,Supplier Payment - CodeCraft Contractors #1,Supplier Payment,SaaS-GL,50033.04,0,USD,Wire Transfer,CodeCraft Contractors #1,***4291,,PO-202412-SaaS-GL-0010,FALSE,FALSE,REF-402826,First Continental Bank,***9750,"Globex International Holdings, Inc.",US,6950885.11
05/12/2024,05/12/2024,Supplier Payment - CodeCraft Contractors #10,Supplier Payment,SaaS-GL,116067.3,0,USD,Fedwire,CodeCraft Contractors #10,***5970,,PO-202412-SaaS-GL-0007,FALSE,FALSE,REF-403569,First Continental Bank,***7935,"Globex International Holdings, Inc.",US,6834817.81
05/12/2024,05/12/2024,Client Receipt - ShopSphere Partner #36,Sales Receipt,Retail-NA,0,3370,USD,Card Settlement,ShopSphere Partner #36,***3239,INV-202412-Retail-NA-0014,,FALSE,FALSE,REF-484549,First Continental Bank,***1217,"Globex International Holdings, Inc.",US,6838187.81
05/12/2024,05/12/2024,Client Receipt - CloudBridge Co. #60,Sales Receipt,SaaS-GL,0,21977.52,USD,Fedwire Credit,CloudBridge Co. #60,***9189,INV-202412-SaaS-GL-0019,,FALSE,FALSE,REF-922806,First Continental Bank,***2909,"Globex International Holdings, Inc.",US,6860165.33
05/12/2024,05/12/2024,Client Receipt - Card Settlement Batch #24,Sales Receipt,Retail-NA,0,32420.02,USD,Card Settlement,Card Settlement Batch #24,***5490,INV-202412-Retail-NA-0003,,FALSE,FALSE,REF-308460,First Continental Bank,***7155,"Globex International Holdings, Inc.",US,6892585.35
06/12/2024,06/12/2024,Marketing - Aurelia Media #2,Marketing,ALL,99195.25,0,USD,ACH Debit,Aurelia Media #2,***4412,,,FALSE,FALSE,REF-281220,First Continental Bank,***6712,"Globex International Holdings, Inc.",US,6793390.1
06/12/2024,06/12/2024,Client Receipt - ShopSphere Partner #76,Sales Receipt,Retail-NA,0,19119.92,USD,ACH Credit,ShopSphere Partner #76,***5876,INV-202412-Retail-NA-0006,,FALSE,FALSE,REF-653258,First Continental Bank,***4208,"Globex International Holdings, Inc.",US,6812510.02
06/12/2024,06/12/2024,Client Receipt - ShopSphere Partner #15,Sales Receipt,Retail-NA,0,61609.05,USD,Card Settlement,ShopSphere Partner #15,***6493,INV-202412-Retail-NA-0001,,FALSE,FALSE,REF-737231,First Continental Bank,***8521,"Globex International Holdings, Inc.",US,6874119.07
06/12/2024,06/12/2024,Client Receipt - ShopSphere Partner #30,Sales Receipt,Retail-NA,0,415633.67,USD,Card Settlement,ShopSphere Partner #30,***2046,INV-202412-Retail-NA-0015,,FALSE,FALSE,REF-687515,First Continental Bank,***4869,"Globex International Holdings, Inc.",US,7289752.74
08/12/2024,08/12/2024,Supplier Payment - NorthRiver Apparel Mfg #13,Supplier Payment,Retail-NA,81904.5,0,USD,ACH Debit,NorthRiver Apparel Mfg #13,***3712,,PO-202412-Retail-NA-0002,FALSE,FALSE,REF-736500,First Continental Bank,***8968,"Globex International Holdings, Inc.",US,7207848.24
08/12/2024,08/12/2024,Client Receipt - Vertex Advisory Client #46,Sales Receipt,PS-GL,0,79811.81,USD,Fedwire Credit,Vertex Advisory Client #46,***9344,INV-202412-PS-GL-0010,,FALSE,FALSE,REF-282232,First Continental Bank,***2855,"Globex International Holdings, Inc.",US,7287660.05
08/12/2024,08/12/2024,Client Receipt - Vertex Advisory Client #3,Sales Receipt,PS-GL,0,245112.92,USD,ACH Credit,Vertex Advisory Client #3,***9031,INV-202412-PS-GL-0011,,FALSE,FALSE,REF-205298,First Continental Bank,***4005,"Globex International Holdings, Inc.",US,7532772.97
09/12/2024,09/12/2024,Supplier Payment - ExpertNet Subcontractors #2,Supplier Payment,PS-GL,4884.96,0,USD,Fedwire,ExpertNet Subcontractors #2,***9245,,PO-202412-PS-GL-0005,FALSE,FALSE,REF-916516,First Continental Bank,***5814,"Globex International Holdings, Inc.",US,7527888.01
09/12/2024,09/12/2024,Client Receipt - Vertex Advisory Client #22,Sales Receipt,PS-GL,0,36555.44,USD,ACH Credit,Vertex Advisory Client #22,***6724,INV-202412-PS-GL-0002,,FALSE,FALSE,REF-782198,First Continental Bank,***7344,"Globex International Holdings, Inc.",US,7564443.45
09/12/2024,09/12/2024,Client Receipt - ShopSphere Partner #76,Sales Receipt,Retail-NA,0,65078.03,USD,Card Settlement,ShopSphere Partner #76,***6750,INV-202412-Retail-NA-0009,,FALSE,FALSE,REF-667164,First Continental Bank,***3702,"Globex International Holdings, Inc.",US,7629521.48
09/12/2024,09/12/2024,Client Receipt - Vertex Advisory Client #13,Sales Receipt,PS-GL,0,264933.97,USD,Card Settlement,Vertex Advisory Client #13,***8835,INV-202412-PS-GL-0006,,FALSE,FALSE,REF-669867,First Continental Bank,***1990,"Globex International Holdings, Inc.",US,7894455.45
10/12/2024,10/12/2024,Client Receipt - Vertex Advisory Client #11,Sales Receipt,PS-GL,0,9448.77,USD,ACH Credit,Vertex Advisory Client #11,***4461,INV-202412-PS-GL-0007,,FALSE,FALSE,REF-601754,First Continental Bank,***9555,"Globex International Holdings, Inc.",US,7903904.22
10/12/2024,10/12/2024,Client Receipt - CloudBridge Co. #11,Sales Receipt,SaaS-GL,0,61480.61,USD,Card Settlement,CloudBridge Co. #11,***7459,INV-202412-SaaS-GL-0022,,FALSE,FALSE,REF-239514,First Continental Bank,***6001,"Globex International Holdings, Inc.",US,7965384.83
11/12/2024,11/12/2024,Supplier Payment - NorthRiver Apparel Mfg #3,Supplier Payment,Retail-NA,44430.47,0,USD,Fedwire,NorthRiver Apparel Mfg #3,***9217,,PO-202412-Retail-NA-0010,FALSE,FALSE,REF-107569,First Continental Bank,***5273,"Globex International Holdings, Inc.",US,7920954.36
11/12/2024,11/12/2024,Client Receipt - ShopSphere Partner #78,Sales Receipt,Retail-NA,0,15193.29,USD,Fedwire Credit,ShopSphere Partner #78,***6297,INV-202412-Retail-NA-0008,,FALSE,FALSE,REF-441172,First Continental Bank,***3902,"Globex International Holdings, Inc.",US,7936147.65
11/12/2024,11/12/2024,Client Receipt - CloudBridge Co. #72,Sales Receipt,SaaS-GL,0,19100.51,USD,Fedwire Credit,CloudBridge Co. #72,***6309,INV-202412-SaaS-GL-0027,,FALSE,FALSE,REF-349514,First Continental Bank,***6068,"Globex International Holdings, Inc.",US,7955248.16
11/12/2024,11/12/2024,Client Receipt - CloudBridge Co. #23,Sales Receipt,SaaS-GL,0,64670.67,USD,Fedwire Credit,CloudBridge Co. #23,***7591,INV-202412-SaaS-GL-0028,,FALSE,FALSE,REF-924307,First Continental Bank,***6569,"Globex International Holdings, Inc.",US,8019918.83
12/12/2024,12/12/2024,Supplier Payment - PackFast Fulfillment #13,Supplier Payment,Retail-NA,34374.35,0,USD,Fedwire,PackFast Fulfillment #13,***6847,,PO-202412-Retail-NA-0001,FALSE,FALSE,REF-336397,First Continental Bank,***6993,"Globex International Holdings, Inc.",US,7985544.48
12/12/2024,12/12/2024,Supplier Payment - ExpertNet Subcontractors #3,Supplier Payment,PS-GL,54293.57,0,USD,Wire Transfer,ExpertNet Subcontractors #3,***7236,,PO-202412-PS-GL-0006,FALSE,FALSE,REF-575489,First Continental Bank,***7820,"Globex International Holdings, Inc.",US,7931250.91
12/12/2024,12/12/2024,Intercompany Settlement - Globex Retail NA LLC,Intercompany Transfer,ALL,693451,0,USD,Internal Transfer,Globex Retail NA LLC,***6296,,,TRUE,TRUE,REF-242124,First Continental Bank,***2536,"Globex International Holdings, Inc.",US,7237799.91
12/12/2024,12/12/2024,Client Receipt - Vertex Advisory Client #32,Sales Receipt,PS-GL,0,4508.63,USD,ACH Credit,Vertex Advisory Client #32,***3416,INV-202412-PS-GL-0001,,FALSE,FALSE,REF-745795,First Continental Bank,***8392,"Globex International Holdings, Inc.",US,7242308.54
12/12/2024,12/12/2024,Client Receipt - ShopSphere Partner #61,Sales Receipt,Retail-NA,0,24539.02,USD,Fedwire Credit,ShopSphere Partner #61,***1084,INV-202412-Retail-NA-0013,,FALSE,FALSE,REF-255623,First Continental Bank,***2905,"Globex International Holdings, Inc.",US,7266847.56
12/12/2024,12/12/2024,Client Receipt - CloudBridge Co. #60,Sales Receipt,SaaS-GL,0,39668.2,USD,Card Settlement,CloudBridge Co. #60,***1416,INV-202412-SaaS-GL-0015,,FALSE,FALSE,REF-711166,First Continental Bank,***4757,"Globex International Holdings, Inc.",US,7306515.76
12/12/2024,12/12/2024,Client Receipt - CloudBridge Co. #55,Sales Receipt,SaaS-GL,0,88346.3,USD,Card Settlement,CloudBridge Co. #55,***9594,INV-202412-SaaS-GL-0018,,FALSE,FALSE,REF-743495,First Continental Bank,***7018,"Globex International Holdings, Inc.",US,7394862.06
12/12/2024,12/12/2024,Client Receipt - ShopSphere Partner #27,Sales Receipt,Retail-NA,0,194338.67,USD,ACH Credit,ShopSphere Partner #27,***8213,INV-202412-Retail-NA-0012,,FALSE,FALSE,REF-184170,First Continental Bank,***3394,"Globex International Holdings, Inc.",US,7589200.73
12/12/2024,12/12/2024,Intercompany Reimbursement - Globex Retail NA LLC,Intercompany Transfer,ALL,0,277380.4,USD,Internal Transfer,Globex Retail NA LLC,***7199,,,TRUE,TRUE,REF-838765,First Continental Bank,***2565,"Globex International Holdings, Inc.",US,7866581.13
13/12/2024,13/12/2024,Supplier Payment - ExpertNet Subcontractors #11,Supplier Payment,PS-GL,15402.51,0,USD,ACH Debit,ExpertNet Subcontractors #11,***8234,,PO-202412-PS-GL-0001,FALSE,FALSE,REF-290053,First Continental Bank,***1710,"Globex International Holdings, Inc.",US,7851178.62
13/12/2024,13/12/2024,Supplier Payment - NorthRiver Apparel Mfg #24,Supplier Payment,Retail-NA,45616.51,0,USD,Fedwire,NorthRiver Apparel Mfg #24,***9124,,PO-202412-Retail-NA-0004,FALSE,FALSE,REF-103678,First Continental Bank,***3538,"Globex International Holdings, Inc.",US,7805562.11
13/12/2024,13/12/2024,Supplier Payment - ExpertNet Subcontractors #15,Supplier Payment,PS-GL,47355.38,0,USD,Wire Transfer,ExpertNet Subcontractors #15,***9843,,PO-202412-PS-GL-0007,FALSE,FALSE,REF-365172,First Continental Bank,***8108,"Globex International Holdings, Inc.",US,7758206.73
13/12/2024,13/12/2024,Client Receipt - CloudBridge Co. #24,Sales Receipt,SaaS-GL,0,123568.1,USD,ACH Credit,CloudBridge Co. #24,***1946,INV-202412-SaaS-GL-0004,,FALSE,FALSE,REF-408731,First Continental Bank,***2402,"Globex International Holdings, Inc.",US,7881774.83
13/12/2024,13/12/2024,Client Receipt - CloudBridge Co. #21,Sales Receipt,SaaS-GL,0,211525.47,USD,Card Settlement,CloudBridge Co. #21,***9419,INV-202412-SaaS-GL-0016,,FALSE,FALSE,REF-195805,First Continental Bank,***6835,"Globex International Holdings, Inc.",US,8093300.3
14/12/2024,14/12/2024,Supplier Payment - HyperCloud Infra #4,Supplier Payment,SaaS-GL,863.07,0,USD,ACH Debit,HyperCloud Infra #4,***1690,,PO-202412-SaaS-GL-0005,FALSE,FALSE,REF-689127,First Continental Bank,***8489,"Globex International Holdings, Inc.",US,8092437.23
15/12/2024,15/12/2024,Loan Interest Payment,Loan Interest,ALL,85000,0,USD,Fedwire,First Continental Bank - Corporate Lending,***6485,,,FALSE,FALSE,REF-568057,First Continental Bank,***7595,"Globex International Holdings, Inc.",US,8007437.23
15/12/2024,15/12/2024,Loan Principal Repayment,Loan Principal,ALL,500000,0,USD,Wire Transfer,First Continental Bank - Corporate Lending,***2518,,,FALSE,FALSE,REF-502984,First Continental Bank,***1922,"Globex International Holdings, Inc.",US,7507437.23
16/12/2024,16/12/2024,Client Receipt - CloudBridge Co. #17,Sales Receipt,SaaS-GL,0,13576.7,USD,Card Settlement,CloudBridge Co. #17,***2429,INV-202412-SaaS-GL-0001,,FALSE,FALSE,REF-115940,First Continental Bank,***3725,"Globex International Holdings, Inc.",US,7521013.93
16/12/2024,16/12/2024,Client Receipt - CloudBridge Co. #37,Sales Receipt,SaaS-GL,0,34207.94,USD,Fedwire Credit,CloudBridge Co. #37,***7435,INV-202412-SaaS-GL-0023,,FALSE,FALSE,REF-140668,First Continental Bank,***8190,"Globex International Holdings, Inc.",US,7555221.87
16/12/2024,16/12/2024,Client Receipt - CloudBridge Co. #74,Sales Receipt,SaaS-GL,0,40541.16,USD,Fedwire Credit,CloudBridge Co. #74,***6473,INV-202412-SaaS-GL-0002,,FALSE,FALSE,REF-873390,First Continental Bank,***4386,"Globex International Holdings, Inc.",US,7595763.03
16/12/2024,16/12/2024,Client Receipt - Vertex Advisory Client #59,Sales Receipt,PS-GL,0,44516.67,USD,Card Settlement,Vertex Advisory Client #59,***8147,INV-202412-PS-GL-0009,,FALSE,FALSE,REF-872078,First Continental Bank,***2135,"Globex International Holdings, Inc.",US,7640279.7
17/12/2024,17/12/2024,Client Receipt - CloudBridge Co. #16,Sales Receipt,SaaS-GL,0,3694.53,USD,Fedwire Credit,CloudBridge Co. #16,***2670,INV-202412-SaaS-GL-0025,,FALSE,FALSE,REF-206492,First Continental Bank,***6528,"Globex International Holdings, Inc.",US,7643974.23
17/12/2024,17/12/2024,Client Receipt - CloudBridge Co. #57,Sales Receipt,SaaS-GL,0,78669.69,USD,ACH Credit,CloudBridge Co. #57,***1961,INV-202412-SaaS-GL-0014,,FALSE,FALSE,REF-632862,First Continental Bank,***4605,"Globex International Holdings, Inc.",US,7722643.92
17/12/2024,17/12/2024,Client Receipt - Vertex Advisory Client #33,Sales Receipt,PS-GL,0,165425.18,USD,Fedwire Credit,Vertex Advisory Client #33,***3507,INV-202412-PS-GL-0005,,FALSE,FALSE,REF-946182,First Continental Bank,***2604,"Globex International Holdings, Inc.",US,7888069.1
18/12/2024,18/12/2024,Supplier Payment - ExpertNet Subcontractors #18,Supplier Payment,PS-GL,53562.6,0,USD,Fedwire,ExpertNet Subcontractors #18,***3574,,PO-202412-PS-GL-0003,FALSE,FALSE,REF-238304,First Continental Bank,***6256,"Globex International Holdings, Inc.",US,7834506.5
18/12/2024,18/12/2024,VAT/GST Remittance - US IRS,Tax Payment,ALL,277789.08,0,USD,ACH Debit,US IRS,***4069,,,FALSE,FALSE,REF-889742,First Continental Bank,***7150,"Globex International Holdings, Inc.",US,7556717.42
18/12/2024,18/12/2024,Client Receipt - CloudBridge Co. #77,Sales Receipt,SaaS-GL,0,92174.31,USD,Fedwire Credit,CloudBridge Co. #77,***2905,INV-202412-SaaS-GL-0020,,FALSE,FALSE,REF-923294,First Continental Bank,***3773,"Globex International Holdings, Inc.",US,7648891.73
19/12/2024,19/12/2024,Marketing - Aurelia Media #2,Marketing,ALL,16624.34,0,USD,Fedwire,Aurelia Media #2,***5022,,,FALSE,FALSE,REF-374368,First Continental Bank,***3396,"Globex International Holdings, Inc.",US,7632267.39
19/12/2024,19/12/2024,Client Receipt - CloudBridge Co. #6,Sales Receipt,SaaS-GL,0,120646.44,USD,Fedwire Credit,CloudBridge Co. #6,***8324,INV-202412-SaaS-GL-0011,,FALSE,FALSE,REF-499069,First Continental Bank,***5783,"Globex International Holdings, Inc.",US,7752913.83
20/12/2024,20/12/2024,Supplier Payment - ExpertNet Subcontractors #18,Supplier Payment,PS-GL,1363.28,0,USD,ACH Debit,ExpertNet Subcontractors #18,***8187,,PO-202412-PS-GL-0010,FALSE,FALSE,REF-772142,First Continental Bank,***9483,"Globex International Holdings, Inc.",US,7751550.55
20/12/2024,20/12/2024,Skyline Internet Services,Rent & Utilities,ALL,36843.59,0,USD,Fedwire,Skyline Internet Services,***4263,,,FALSE,FALSE,REF-661383,First Continental Bank,***6314,"Globex International Holdings, Inc.",US,7714706.96
23/12/2024,23/12/2024,Supplier Payment - ExpertNet Subcontractors #10,Supplier Payment,PS-GL,7023.45,0,USD,Wire Transfer,ExpertNet Subcontractors #10,***4892,,PO-202412-PS-GL-0008,FALSE,FALSE,REF-548438,First Continental Bank,***8686,"Globex International Holdings, Inc.",US,7707683.51
23/12/2024,23/12/2024,Supplier Payment - CodeCraft Contractors #8,Supplier Payment,SaaS-GL,59265.42,0,USD,ACH Debit,CodeCraft Contractors #8,***2961,,PO-202412-SaaS-GL-0004,FALSE,FALSE,REF-315327,First Continental Bank,***8480,"Globex International Holdings, Inc.",US,7648418.09
23/12/2024,23/12/2024,Client Receipt - Vertex Advisory Client #51,Sales Receipt,PS-GL,0,20354.67,USD,Card Settlement,Vertex Advisory Client #51,***3859,INV-202412-PS-GL-0003,,FALSE,FALSE,REF-202827,First Continental Bank,***9140,"Globex International Holdings, Inc.",US,7668772.76
23/12/2024,23/12/2024,Client Receipt - CloudBridge Co. #40,Sales Receipt,SaaS-GL,0,57478.35,USD,Fedwire Credit,CloudBridge Co. #40,***8366,INV-202412-SaaS-GL-0017,,FALSE,FALSE,REF-965633,First Continental Bank,***8889,"Globex International Holdings, Inc.",US,7726251.11
23/12/2024,23/12/2024,Client Receipt - ShopSphere Partner #14,Sales Receipt,Retail-NA,0,233994.06,USD,ACH Credit,ShopSphere Partner #14,***7878,INV-202412-Retail-NA-0002,,FALSE,FALSE,REF-746806,First Continental Bank,***8391,"Globex International Holdings, Inc.",US,7960245.17
24/12/2024,24/12/2024,Supplier Payment - PackFast Fulfillment #17,Supplier Payment,Retail-NA,23622.33,0,USD,ACH Debit,PackFast Fulfillment #17,***9076,,PO-202412-Retail-NA-0007,FALSE,FALSE,REF-423884,First Continental Bank,***3928,"Globex International Holdings, Inc.",US,7936622.84
24/12/2024,24/12/2024,Supplier Payment - ExpertNet Subcontractors #13,Supplier Payment,PS-GL,34741.18,0,USD,Fedwire,ExpertNet Subcontractors #13,***4139,,PO-202412-PS-GL-0004,FALSE,FALSE,REF-745044,First Continental Bank,***3350,"Globex International Holdings, Inc.",US,7901881.66
24/12/2024,24/12/2024,Client Receipt - CloudBridge Co. #51,Sales Receipt,SaaS-GL,0,8675.76,USD,ACH Credit,CloudBridge Co. #51,***5231,INV-202412-SaaS-GL-0024,,FALSE,FALSE,REF-590049,First Continental Bank,***9533,"Globex International Holdings, Inc.",US,7910557.42
24/12/2024,24/12/2024,Client Receipt - CloudBridge Co. #31,Sales Receipt,SaaS-GL,0,234804.8,USD,ACH Credit,CloudBridge Co. #31,***4273,INV-202412-SaaS-GL-0003,,FALSE,FALSE,REF-584826,First Continental Bank,***9624,"Globex International Holdings, Inc.",US,8145362.22
25/12/2024,25/12/2024,Supplier Payment - ExpertNet Subcontractors #3,Supplier Payment,PS-GL,39800.13,0,USD,ACH Debit,ExpertNet Subcontractors #3,***4896,,PO-202412-PS-GL-0009,FALSE,FALSE,REF-657535,First Continental Bank,***8702,"Globex International Holdings, Inc.",US,8105562.09
25/12/2024,25/12/2024,Client Receipt - CloudBridge Co. #30,Sales Receipt,SaaS-GL,0,4438.8,USD,ACH Credit,CloudBridge Co. #30,***1256,INV-202412-SaaS-GL-0009,,FALSE,FALSE,REF-185663,First Continental Bank,***9600,"Globex International Holdings, Inc.",US,8110000.89
25/12/2024,25/12/2024,Client Receipt - Card Settlement Batch #9,Sales Receipt,Retail-NA,0,57627.12,USD,ACH Credit,Card Settlement Batch #9,***7436,INV-202412-Retail-NA-0010,,FALSE,FALSE,REF-833474,First Continental Bank,***1640,"Globex International Holdings, Inc.",US,8167628.01
25/12/2024,25/12/2024,Client Receipt - Card Settlement Batch #10,Sales Receipt,Retail-NA,0,261497.48,USD,ACH Credit,Card Settlement Batch #10,***7541,INV-202412-Retail-NA-0004,,FALSE,FALSE,REF-890860,First Continental Bank,***3344,"Globex International Holdings, Inc.",US,8429125.49
26/12/2024,26/12/2024,Supplier Payment - NorthRiver Apparel Mfg #24,Supplier Payment,Retail-NA,208069.63,0,USD,ACH Debit,NorthRiver Apparel Mfg #24,***3163,,PO-202412-Retail-NA-0006,FALSE,FALSE,REF-987957,First Continental Bank,***1630,"Globex International Holdings, Inc.",US,8221055.86
26/12/2024,26/12/2024,Supplier Payment - PackFast Fulfillment #20,Supplier Payment,Retail-NA,237569.86,0,USD,Wire Transfer,PackFast Fulfillment #20,***8652,,PO-202412-Retail-NA-0009,FALSE,FALSE,REF-709715,First Continental Bank,***9618,"Globex International Holdings, Inc.",US,7983486
26/12/2024,26/12/2024,Payroll - GlobalPay Services Ltd,Payroll,ALL,363139.8,0,USD,Fedwire,GlobalPay Services Ltd,***9656,,,FALSE,FALSE,REF-517022,First Continental Bank,***9277,"Globex International Holdings, Inc.",US,7620346.2
26/12/2024,26/12/2024,Intercompany Settlement - Globex Retail NA LLC,Intercompany Transfer,ALL,858470,0,USD,Internal Transfer,Globex Retail NA LLC,***2713,,,TRUE,TRUE,REF-415315,First Continental Bank,***2456,"Globex International Holdings, Inc.",US,6761876.2
26/12/2024,26/12/2024,Client Receipt - CloudBridge Co. #21,Sales Receipt,SaaS-GL,0,4283.15,USD,Fedwire Credit,CloudBridge Co. #21,***5091,INV-202412-SaaS-GL-0010,,FALSE,FALSE,REF-863047,First Continental Bank,***8155,"Globex International Holdings, Inc.",US,6766159.35
26/12/2024,26/12/2024,Client Receipt - CloudBridge Co. #9,Sales Receipt,SaaS-GL,0,39123.18,USD,ACH Credit,CloudBridge Co. #9,***3185,INV-202412-SaaS-GL-0021,,FALSE,FALSE,REF-413747,First Continental Bank,***2913,"Globex International Holdings, Inc.",US,6805282.53
26/12/2024,26/12/2024,Client Receipt - ShopSphere Partner #42,Sales Receipt,Retail-NA,0,141783.23,USD,Fedwire Credit,ShopSphere Partner #42,***9841,INV-202412-Retail-NA-0005,,FALSE,FALSE,REF-563557,First Continental Bank,***6949,"Globex International Holdings, Inc.",US,6947065.76
27/12/2024,27/12/2024,Supplier Payment - CodeCraft Contractors #10,Supplier Payment,SaaS-GL,3553.08,0,USD,Fedwire,CodeCraft Contractors #10,***5584,,PO-202412-SaaS-GL-0006,FALSE,FALSE,REF-124893,First Continental Bank,***8947,"Globex International Holdings, Inc.",US,6943512.68
27/12/2024,27/12/2024,Supplier Payment - ExpertNet Subcontractors #1,Supplier Payment,PS-GL,23754.89,0,USD,Wire Transfer,ExpertNet Subcontractors #1,***2813,,PO-202412-PS-GL-0002,FALSE,FALSE,REF-159164,First Continental Bank,***3065,"Globex International Holdings, Inc.",US,6919757.79
27/12/2024,27/12/2024,Supplier Payment - PackFast Fulfillment #12,Supplier Payment,Retail-NA,44169.25,0,USD,Fedwire,PackFast Fulfillment #12,***5650,,PO-202412-Retail-NA-0005,FALSE,FALSE,REF-120965,First Continental Bank,***3099,"Globex International Holdings, Inc.",US,6875588.54
27/12/2024,27/12/2024,Client Receipt - CloudBridge Co. #7,Sales Receipt,SaaS-GL,0,21486.51,USD,Fedwire Credit,CloudBridge Co. #7,***5602,INV-202412-SaaS-GL-0026,,FALSE,FALSE,REF-545197,First Continental Bank,***9978,"Globex International Holdings, Inc.",US,6897075.05
28/12/2024,28/12/2024,Supplier Payment - HyperCloud Infra #1,Supplier Payment,SaaS-GL,33776.51,0,USD,Fedwire,HyperCloud Infra #1,***6723,,PO-202412-SaaS-GL-0009,FALSE,FALSE,REF-791449,First Continental Bank,***2851,"Globex International Holdings, Inc.",US,6863298.54
29/12/2024,29/12/2024,Supplier Payment - ExpertNet Subcontractors #10,Supplier Payment,PS-GL,33015.05,0,USD,Fedwire,ExpertNet Subcontractors #10,***6652,,PO-202412-PS-GL-0011,FALSE,FALSE,REF-620698,First Continental Bank,***2141,"Globex International Holdings, Inc.",US,6830283.49
29/12/2024,29/12/2024,Payroll - GlobalPay Services Ltd,Payroll,ALL,363139.8,0,USD,ACH Debit,GlobalPay Services Ltd,***8985,,,FALSE,FALSE,REF-833107,First Continental Bank,***2798,"Globex International Holdings, Inc.",US,6467143.69
30/12/2024,30/12/2024,Supplier Payment - NorthRiver Apparel Mfg #32,Supplier Payment,Retail-NA,326864.94,0,USD,Fedwire,NorthRiver Apparel Mfg #32,***1858,,PO-202412-Retail-NA-0003,FALSE,FALSE,REF-291098,First Continental Bank,***8555,"Globex International Holdings, Inc.",US,6140278.75
30/12/2024,30/12/2024,Client Receipt - CloudBridge Co. #28,Sales Receipt,SaaS-GL,0,8020.91,USD,Card Settlement,CloudBridge Co. #28,***6934,INV-202412-SaaS-GL-0005,,FALSE,FALSE,REF-349711,First Continental Bank,***1219,"Globex International Holdings, Inc.",US,6148299.66
30/12/2024,30/12/2024,Interest Earned,Interest Income,ALL,0,9508.86,USD,Fedwire Credit,First Continental Bank,***1125,,,FALSE,FALSE,REF-568817,First Continental Bank,***4016,"Globex International Holdings, Inc.",US,6157808.52
30/12/2024,30/12/2024,Client Receipt - CloudBridge Co. #25,Sales Receipt,SaaS-GL,0,39302.9,USD,Card Settlement,CloudBridge Co. #25,***5389,INV-202412-SaaS-GL-0006,,FALSE,FALSE,REF-556376,First Continental Bank,***1774,"Globex International Holdings, Inc.",US,6197111.42
30/12/2024,30/12/2024,Client Receipt - ShopSphere Partner #62,Sales Receipt,Retail-NA,0,163991.47,USD,ACH Credit,ShopSphere Partner #62,***9360,INV-202412-Retail-NA-0007,,FALSE,FALSE,REF-536940,First Continental Bank,***6261,"Globex International Holdings, Inc.",US,6361102.89
30/12/2024,30/12/2024,Client Receipt - ShopSphere Partner #32,Sales Receipt,Retail-NA,0,236008.85,USD,Fedwire Credit,ShopSphere Partner #32,***9296,INV-202412-Retail-NA-0011,,FALSE,FALSE,REF-520301,First Continental Bank,***6146,"Globex International Holdings, Inc.",US,6597111.74
31/12/2024,31/12/2024,Client Receipt - CloudBridge Co. #67,Sales Receipt,SaaS-GL,0,43431.78,USD,Fedwire Credit,CloudBridge Co. #67,***6855,INV-202412-SaaS-GL-0007,,FALSE,FALSE,REF-763848,First Continental Bank,***5381,"Globex International Holdings, Inc.",US,6640543.52
31/12/2024,31/12/2024,Client Receipt - Vertex Advisory Client #24,Sales Receipt,PS-GL,0,73238.95,USD,Card Settlement,Vertex Advisory Client #24,***3704,INV-202412-PS-GL-0004,,FALSE,FALSE,REF-586838,First Continental Bank,***2605,"Globex International Holdings, Inc.",US,6713782.47
01/01/2025,01/01/2025,Account Maintenance Fee,Bank/Merchant Fees,ALL,2500,0,USD,Fedwire,First Continental Bank,***1258,,,FALSE,FALSE,REF-841652,First Continental Bank,***6693,"Globex International Holdings, Inc.",US,6711282.47
01/01/2025,01/01/2025,Supplier Payment - NorthRiver Apparel Mfg #32,Supplier Payment,Retail-NA,127131.94,0,USD,Wire Transfer,NorthRiver Apparel Mfg #32,***1737,,PO-202501-Retail-NA-0002,FALSE,FALSE,REF-837281,First Continental Bank,***7489,"Globex International Holdings, Inc.",US,6584150.53
01/01/2025,01/01/2025,Client Receipt - Vertex Advisory Client #54,Sales Receipt,PS-GL,0,7079.8,USD,Fedwire Credit,Vertex Advisory Client #54,***2816,INV-202501-PS-GL-0001,,FALSE,FALSE,REF-135155,First Continental Bank,***9160,"Globex International Holdings, Inc.",US,6591230.33
01/01/2025,01/01/2025,Client Receipt - CloudBridge Co. #70,Sales Receipt,SaaS-GL,0,45786.45,USD,Card Settlement,CloudBridge Co. #70,***8201,INV-202501-SaaS-GL-0005,,FALSE,FALSE,REF-933527,First Continental Bank,***7571,"Globex International Holdings, Inc.",US,6637016.78
02/01/2025,02/01/2025,Supplier Payment - NorthRiver Apparel Mfg #25,Supplier Payment,Retail-NA,12430.02,0,USD,Fedwire,NorthRiver Apparel Mfg #25,***3666,,PO-202501-Retail-NA-0004,FALSE,FALSE,REF-606766,First Continental Bank,***8109,"Globex International Holdings, Inc.",US,6624586.76
02/01/2025,02/01/2025,Supplier Payment - CodeCraft Contractors #11,Supplier Payment,SaaS-GL,43329.1,0,USD,ACH Debit,CodeCraft Contractors #11,***2633,,PO-202501-SaaS-GL-0007,FALSE,FALSE,REF-936566,First Continental Bank,***9677,"Globex International Holdings, Inc.",US,6581257.66
03/01/2025,03/01/2025,Merchant Processing Fees,Bank/Merchant Fees,ALL,5018.96,0,USD,ACH Debit,First Continental Bank,***6934,,,FALSE,FALSE,REF-764539,First Continental Bank,***7764,"Globex International Holdings, Inc.",US,6576238.7
03/01/2025,03/01/2025,Client Receipt - CloudBridge Co. #45,Sales Receipt,SaaS-GL,0,44668.82,USD,Fedwire Credit,CloudBridge Co. #45,***9675,INV-202501-SaaS-GL-0021,,FALSE,FALSE,REF-452583,First Continental Bank,***3956,"Globex International Holdings, Inc.",US,6620907.52
04/01/2025,04/01/2025,Client Receipt - Card Settlement Batch #6,Sales Receipt,Retail-NA,0,2756.39,USD,Fedwire Credit,Card Settlement Batch #6,***3071,INV-202501-Retail-NA-0007,,FALSE,FALSE,REF-700182,First Continental Bank,***5403,"Globex International Holdings, Inc.",US,6623663.91
04/01/2025,04/01/2025,Client Receipt - CloudBridge Co. #19,Sales Receipt,SaaS-GL,0,3239.48,USD,Card Settlement,CloudBridge Co. #19,***4769,INV-202501-SaaS-GL-0019,,FALSE,FALSE,REF-199305,First Continental Bank,***4241,"Globex International Holdings, Inc.",US,6626903.39
05/01/2025,05/01/2025,Supplier Payment - ExpertNet Subcontractors #7,Supplier Payment,PS-GL,8901.73,0,USD,Fedwire,ExpertNet Subcontractors #7,***7548,,PO-202501-PS-GL-0005,FALSE,FALSE,REF-285840,First Continental Bank,***3430,"Globex International Holdings, Inc.",US,6618001.66
05/01/2025,05/01/2025,Supplier Payment - HyperCloud Infra #15,Supplier Payment,SaaS-GL,28608.47,0,USD,ACH Debit,HyperCloud Infra #15,***4644,,PO-202501-SaaS-GL-0001,FALSE,FALSE,REF-467508,First Continental Bank,***7999,"Globex International Holdings, Inc.",US,6589393.19
05/01/2025,05/01/2025,Supplier Payment - NorthRiver Apparel Mfg #18,Supplier Payment,Retail-NA,40842.3,0,USD,ACH Debit,NorthRiver Apparel Mfg #18,***3359,,PO-202501-Retail-NA-0001,FALSE,FALSE,REF-672026,First Continental Bank,***2883,"Globex International Holdings, Inc.",US,6548550.89
06/01/2025,06/01/2025,Client Receipt - CloudBridge Co. #32,Sales Receipt,SaaS-GL,0,4545.94,USD,Card Settlement,CloudBridge Co. #32,***4470,INV-202501-SaaS-GL-0013,,FALSE,FALSE,REF-531749,First Continental Bank,***9057,"Globex International Holdings, Inc.",US,6553096.83
06/01/2025,06/01/2025,Client Receipt - CloudBridge Co. #34,Sales Receipt,SaaS-GL,0,12276.8,USD,ACH Credit,CloudBridge Co. #34,***8371,INV-202501-SaaS-GL-0003,,FALSE,FALSE,REF-320358,First Continental Bank,***8260,"Globex International Holdings, Inc.",US,6565373.63
06/01/2025,06/01/2025,Client Receipt - Vertex Advisory Client #4,Sales Receipt,PS-GL,0,47046.5,USD,Fedwire Credit,Vertex Advisory Client #4,***9884,INV-202501-PS-GL-0009,,FALSE,FALSE,REF-360908,First Continental Bank,***6188,"Globex International Holdings, Inc.",US,6612420.13
06/01/2025,06/01/2025,Client Receipt - CloudBridge Co. #76,Sales Receipt,SaaS-GL,0,54674.54,USD,Card Settlement,CloudBridge Co. #76,***8586,INV-202501-SaaS-GL-0028,,FALSE,FALSE,REF-879999,First Continental Bank,***9164,"Globex International Holdings, Inc.",US,6667094.67
07/01/2025,07/01/2025,Supplier Payment - ExpertNet Subcontractors #14,Supplier Payment,PS-GL,17883.44,0,USD,Wire Transfer,ExpertNet Subcontractors #14,***6386,,PO-202501-PS-GL-0008,FALSE,FALSE,REF-211004,First Continental Bank,***3709,"Globex International Holdings, Inc.",US,6649211.23
07/01/2025,07/01/2025,Supplier Payment - NorthRiver Apparel Mfg #2,Supplier Payment,Retail-NA,41341.9,0,USD,ACH Debit,NorthRiver Apparel Mfg #2,***1249,,PO-202501-Retail-NA-0009,FALSE,FALSE,REF-448884,First Continental Bank,***8704,"Globex International Holdings, Inc.",US,6607869.33
07/01/2025,07/01/2025,Client Receipt - ShopSphere Partner #67,Sales Receipt,Retail-NA,0,60721.47,USD,Fedwire Credit,ShopSphere Partner #67,***6217,INV-202501-Retail-NA-0001,,FALSE,FALSE,REF-734947,First Continental Bank,***8181,"Globex International Holdings, Inc.",US,6668590.8
08/01/2025,08/01/2025,Client Receipt - CloudBridge Co. #69,Sales Receipt,SaaS-GL,0,1332.64,USD,Fedwire Credit,CloudBridge Co. #69,***9587,INV-202501-SaaS-GL-0002,,FALSE,FALSE,REF-228315,First Continental Bank,***7577,"Globex International Holdings, Inc.",US,6669923.44
08/01/2025,08/01/2025,Client Receipt - CloudBridge Co. #59,Sales Receipt,SaaS-GL,0,8741.8,USD,ACH Credit,CloudBridge Co. #59,***8949,INV-202501-SaaS-GL-0006,,FALSE,FALSE,REF-790067,First Continental Bank,***4631,"Globex International Holdings, Inc.",US,6678665.24
08/01/2025,08/01/2025,Client Receipt - CloudBridge Co. #69,Sales Receipt,SaaS-GL,0,9929.74,USD,Card Settlement,CloudBridge Co. #69,***3439,INV-202501-SaaS-GL-0009,,FALSE,FALSE,REF-859839,First Continental Bank,***9074,"Globex International Holdings, Inc.",US,6688594.98
08/01/2025,08/01/2025,Client Receipt - CloudBridge Co. #33,Sales Receipt,SaaS-GL,0,16103.98,USD,ACH Credit,CloudBridge Co. #33,***2274,INV-202501-SaaS-GL-0007,,FALSE,FALSE,REF-193553,First Continental Bank,***3934,"Globex International Holdings, Inc.",US,6704698.96
09/01/2025,09/01/2025,Supplier Payment - HyperCloud Infra #8,Supplier Payment,SaaS-GL,1156.15,0,USD,Fedwire,HyperCloud Infra #8,***9367,,PO-202501-SaaS-GL-0008,FALSE,FALSE,REF-281071,First Continental Bank,***6589,"Globex International Holdings, Inc.",US,6703542.81
09/01/2025,09/01/2025,Supplier Payment - CodeCraft Contractors #6,Supplier Payment,SaaS-GL,11397.17,0,USD,Fedwire,CodeCraft Contractors #6,***2800,,PO-202501-SaaS-GL-0009,FALSE,FALSE,REF-887546,First Continental Bank,***1942,"Globex International Holdings, Inc.",US,6692145.64
09/01/2025,09/01/2025,Supplier Payment - HyperCloud Infra #18,Supplier Payment,SaaS-GL,24172.5,0,USD,Wire Transfer,HyperCloud Infra #18,***5469,,PO-202501-SaaS-GL-0003,FALSE,FALSE,REF-347100,First Continental Bank,***6058,"Globex International Holdings, Inc.",US,6667973.14
09/01/2025,09/01/2025,Client Receipt - CloudBridge Co. #58,Sales Receipt,SaaS-GL,0,10655.79,USD,ACH Credit,CloudBridge Co. #58,***3094,INV-202501-SaaS-GL-0025,,FALSE,FALSE,REF-432501,First Continental Bank,***3269,"Globex International Holdings, Inc.",US,6678628.93
09/01/2025,09/01/2025,Client Receipt - CloudBridge Co. #65,Sales Receipt,SaaS-GL,0,15941.09,USD,Card Settlement,CloudBridge Co. #65,***3334,INV-202501-SaaS-GL-0004,,FALSE,FALSE,REF-636257,First Continental Bank,***4307,"Globex International Holdings, Inc.",US,6694570.02
09/01/2025,09/01/2025,Client Receipt - CloudBridge Co. #31,Sales Receipt,SaaS-GL,0,18650.6,USD,Card Settlement,CloudBridge Co. #31,***9816,INV-202501-SaaS-GL-0010,,FALSE,FALSE,REF-963596,First Continental Bank,***5490,"Globex International Holdings, Inc.",US,6713220.62
10/01/2025,10/01/2025,Supplier Payment - HyperCloud Infra #14,Supplier Payment,SaaS-GL,8152.38,0,USD,Fedwire,HyperCloud Infra #14,***2210,,PO-202501-SaaS-GL-0002,FALSE,FALSE,REF-794096,First Continental Bank,***1224,"Globex International Holdings, Inc.",US,6705068.24
10/01/2025,10/01/2025,Supplier Payment - CodeCraft Contractors #13,Supplier Payment,SaaS-GL,25383.18,0,USD,ACH Debit,CodeCraft Contractors #13,***4136,,PO-202501-SaaS-GL-0006,FALSE,FALSE,REF-974757,First Continental Bank,***6787,"Globex International Holdings, Inc.",US,6679685.06
10/01/2025,10/01/2025,Marketing - Aurelia Media #1,Marketing,ALL,33824.44,0,USD,ACH Debit,Aurelia Media #1,***7492,,,FALSE,FALSE,REF-498221,First Continental Bank,***4161,"Globex International Holdings, Inc.",US,6645860.62
12/01/2025,12/01/2025,Intercompany Settlement - Globex Consulting UK Ltd.,Intercompany Transfer,ALL,664420,0,USD,Internal Transfer,Globex Consulting UK Ltd.,***3111,,,TRUE,TRUE,REF-983994,First Continental Bank,***3682,"Globex International Holdings, Inc.",US,5981440.62
12/01/2025,12/01/2025,Client Receipt - Vertex Advisory Client #34,Sales Receipt,PS-GL,0,33527.08,USD,ACH Credit,Vertex Advisory Client #34,***1687,INV-202501-PS-GL-0003,,FALSE,FALSE,REF-939096,First Continental Bank,***3382,"Globex International Holdings, Inc.",US,6014967.7
12/01/2025,12/01/2025,Intercompany Reimbursement - Globex Consulting UK Ltd.,Intercompany Transfer,ALL,0,265768,USD,Internal Transfer,Globex Consulting UK Ltd.,***2175,,,TRUE,TRUE,REF-478319,First Continental Bank,***4098,"Globex International Holdings, Inc.",US,6280735.7
13/01/2025,13/01/2025,Merchant Processing Fees,Bank/Merchant Fees,ALL,1640.47,0,USD,ACH Debit,First Continental Bank,***2498,,,FALSE,FALSE,REF-314960,First Continental Bank,***8283,"Globex International Holdings, Inc.",US,6279095.23
13/01/2025,13/01/2025,Client Receipt - CloudBridge Co. #75,Sales Receipt,SaaS-GL,0,92316.73,USD,Fedwire Credit,CloudBridge Co. #75,***2541,INV-202501-SaaS-GL-0018,,FALSE,FALSE,REF-934044,First Continental Bank,***3576,"Globex International Holdings, Inc.",US,6371411.96
14/01/2025,14/01/2025,Northshore Power,Rent & Utilities,ALL,13016.76,0,USD,Wire Transfer,Northshore Power,***5608,,,FALSE,FALSE,REF-631166,First Continental Bank,***3658,"Globex International Holdings, Inc.",US,6358395.2
14/01/2025,14/01/2025,Client Receipt - Vertex Advisory Client #15,Sales Receipt,PS-GL,0,87958.86,USD,Card Settlement,Vertex Advisory Client #15,***4642,INV-202501-PS-GL-0004,,FALSE,FALSE,REF-151580,First Continental Bank,***7284,"Globex International Holdings, Inc.",US,6446354.06
15/01/2025,15/01/2025,Supplier Payment - PackFast Fulfillment #5,Supplier Payment,Retail-NA,43360.74,0,USD,Fedwire,PackFast Fulfillment #5,***9471,,PO-202501-Retail-NA-0007,FALSE,FALSE,REF-487072,First Continental Bank,***1231,"Globex International Holdings, Inc.",US,6402993.32
15/01/2025,15/01/2025,Loan Interest Payment,Loan Interest,ALL,85000,0,USD,ACH Debit,First Continental Bank - Corporate Lending,***5096,,,FALSE,FALSE,REF-425009,First Continental Bank,***3273,"Globex International Holdings, Inc.",US,6317993.32
15/01/2025,15/01/2025,Loan Principal Repayment,Loan Principal,ALL,500000,0,USD,ACH Debit,First Continental Bank - Corporate Lending,***4036,,,FALSE,FALSE,REF-628320,First Continental Bank,***6053,"Globex International Holdings, Inc.",US,5817993.32
15/01/2025,15/01/2025,Client Receipt - CloudBridge Co. #10,Sales Receipt,SaaS-GL,0,25230.86,USD,Card Settlement,CloudBridge Co. #10,***6417,INV-202501-SaaS-GL-0012,,FALSE,FALSE,REF-301164,First Continental Bank,***7093,"Globex International Holdings, Inc.",US,5843224.18
15/01/2025,15/01/2025,Client Receipt - Card Settlement Batch #9,Sales Receipt,Retail-NA,0,29233.76,USD,Fedwire Credit,Card Settlement Batch #9,***3300,INV-202501-Retail-NA-0009,,FALSE,FALSE,REF-895271,First Continental Bank,***4604,"Globex International Holdings, Inc.",US,5872457.94
15/01/2025,15/01/2025,Client Receipt - CloudBridge Co. #5,Sales Receipt,SaaS-GL,0,83517.5,USD,Fedwire Credit,CloudBridge Co. #5,***9261,INV-202501-SaaS-GL-0026,,FALSE,FALSE,REF-472752,First Continental Bank,***7870,"Globex International Holdings, Inc.",US,5955975.44
16/01/2025,16/01/2025,Supplier Payment - PackFast Fulfillment #12,Supplier Payment,Retail-NA,87195.46,0,USD,Wire Transfer,PackFast Fulfillment #12,***6607,,PO-202501-Retail-NA-0006,FALSE,FALSE,REF-603170,First Continental Bank,***5659,"Globex International Holdings, Inc.",US,5868779.98
17/01/2025,17/01/2025,Supplier Payment - ExpertNet Subcontractors #12,Supplier Payment,PS-GL,6390.32,0,USD,Fedwire,ExpertNet Subcontractors #12,***4655,,PO-202501-PS-GL-0002,FALSE,FALSE,REF-160381,First Continental Bank,***2631,"Globex International Holdings, Inc.",US,5862389.66
17/01/2025,17/01/2025,Client Receipt - Vertex Advisory Client #45,Sales Receipt,PS-GL,0,13437.36,USD,ACH Credit,Vertex Advisory Client #45,***5257,INV-202501-PS-GL-0008,,FALSE,FALSE,REF-293538,First Continental Bank,***2163,"Globex International Holdings, Inc.",US,5875827.02
19/01/2025,19/01/2025,Client Receipt - ShopSphere Partner #5,Sales Receipt,Retail-NA,0,20410.97,USD,ACH Credit,ShopSphere Partner #5,***6705,INV-202501-Retail-NA-0004,,FALSE,FALSE,REF-740754,First Continental Bank,***2229,"Globex International Holdings, Inc.",US,5896237.99
20/01/2025,20/01/2025,Client Receipt - Vertex Advisory Client #13,Sales Receipt,PS-GL,0,38623.62,USD,ACH Credit,Vertex Advisory Client #13,***6339,INV-202501-PS-GL-0005,,FALSE,FALSE,REF-343100,First Continental Bank,***6816,"Globex International Holdings, Inc.",US,5934861.61
21/01/2025,21/01/2025,Supplier Payment - HyperCloud Infra #4,Supplier Payment,SaaS-GL,5879.78,0,USD,ACH Debit,HyperCloud Infra #4,***2264,,PO-202501-SaaS-GL-0010,FALSE,FALSE,REF-183181,First Continental Bank,***4011,"Globex International Holdings, Inc.",US,5928981.83
21/01/2025,21/01/2025,VAT/GST Remittance - US IRS,Tax Payment,ALL,140496.59,0,USD,SWIFT MT103,US IRS,***7681,,,FALSE,FALSE,REF-476905,First Continental Bank,***6327,"Globex International Holdings, Inc.",US,5788485.24
21/01/2025,21/01/2025,Client Receipt - Vertex Advisory Client #49,Sales Receipt,PS-GL,0,769.06,USD,Card Settlement,Vertex Advisory Client #49,***8483,INV-202501-PS-GL-0007,,FALSE,FALSE,REF-283896,First Continental Bank,***2168,"Globex International Holdings, Inc.",US,5789254.3
21/01/2025,21/01/2025,Client Receipt - CloudBridge Co. #63,Sales Receipt,SaaS-GL,0,5040.13,USD,ACH Credit,CloudBridge Co. #63,***7576,INV-202501-SaaS-GL-0023,,FALSE,FALSE,REF-912167,First Continental Bank,***6264,"Globex International Holdings, Inc.",US,5794294.43
21/01/2025,21/01/2025,Client Receipt - CloudBridge Co. #9,Sales Receipt,SaaS-GL,0,67252.76,USD,Fedwire Credit,CloudBridge Co. #9,***9655,INV-202501-SaaS-GL-0001,,FALSE,FALSE,REF-364952,First Continental Bank,***9042,"Globex International Holdings, Inc.",US,5861547.19
21/01/2025,21/01/2025,Client Receipt - Card Settlement Batch #22,Sales Receipt,Retail-NA,0,233502.59,USD,Fedwire Credit,Card Settlement Batch #22,***4135,INV-202501-Retail-NA-0003,,FALSE,FALSE,REF-559030,First Continental Bank,***1615,"Globex International Holdings, Inc.",US,6095049.78
22/01/2025,22/01/2025,Supplier Payment - ExpertNet Subcontractors #14,Supplier Payment,PS-GL,15949.92,0,USD,ACH Debit,ExpertNet Subcontractors #14,***3140,,PO-202501-PS-GL-0006,FALSE,FALSE,REF-130891,First Continental Bank,***8739,"Globex International Holdings, Inc.",US,6079099.86
22/01/2025,22/01/2025,Supplier Payment - ExpertNet Subcontractors #15,Supplier Payment,PS-GL,79489.24,0,USD,Fedwire,ExpertNet Subcontractors #15,***6980,,PO-202501-PS-GL-0007,FALSE,FALSE,REF-301231,First Continental Bank,***4462,"Globex International Holdings, Inc.",US,5999610.62
22/01/2025,22/01/2025,Client Receipt - Card Settlement Batch #13,Sales Receipt,Retail-NA,0,228717.29,USD,ACH Credit,Card Settlement Batch #13,***6201,INV-202501-Retail-NA-0008,,FALSE,FALSE,REF-843849,First Continental Bank,***8369,"Globex International Holdings, Inc.",US,6228327.91
23/01/2025,23/01/2025,Supplier Payment - ExpertNet Subcontractors #14,Supplier Payment,PS-GL,5020.79,0,USD,Fedwire,ExpertNet Subcontractors #14,***1071,,PO-202501-PS-GL-0004,FALSE,FALSE,REF-771396,First Continental Bank,***7209,"Globex International Holdings, Inc.",US,6223307.12
23/01/2025,23/01/2025,Supplier Payment - ExpertNet Subcontractors #14,Supplier Payment,PS-GL,7891.86,0,USD,ACH Debit,ExpertNet Subcontractors #14,***2359,,PO-202501-PS-GL-0003,FALSE,FALSE,REF-413463,First Continental Bank,***2162,"Globex International Holdings, Inc.",US,6215415.26
23/01/2025,23/01/2025,Supplier Payment - PackFast Fulfillment #20,Supplier Payment,Retail-NA,83607.5,0,USD,ACH Debit,PackFast Fulfillment #20,***4132,,PO-202501-Retail-NA-0005,FALSE,FALSE,REF-559453,First Continental Bank,***4051,"Globex International Holdings, Inc.",US,6131807.76
23/01/2025,23/01/2025,Client Receipt - CloudBridge Co. #77,Sales Receipt,SaaS-GL,0,4278.81,USD,Fedwire Credit,CloudBridge Co. #77,***9075,INV-202501-SaaS-GL-0022,,FALSE,FALSE,REF-836913,First Continental Bank,***4915,"Globex International Holdings, Inc.",US,6136086.57
23/01/2025,23/01/2025,Client Receipt - CloudBridge Co. #3,Sales Receipt,SaaS-GL,0,17098.63,USD,Fedwire Credit,CloudBridge Co. #3,***5271,INV-202501-SaaS-GL-0017,,FALSE,FALSE,REF-288635,First Continental Bank,***6518,"Globex International Holdings, Inc.",US,6153185.2
23/01/2025,23/01/2025,Client Receipt - ShopSphere Partner #2,Sales Receipt,Retail-NA,0,194992.98,USD,Card Settlement,ShopSphere Partner #2,***8321,INV-202501-Retail-NA-0002,,FALSE,FALSE,REF-908357,First Continental Bank,***8482,"Globex International Holdings, Inc.",US,6348178.18
24/01/2025,24/01/2025,Skyline Internet Services,Rent & Utilities,ALL,5391.43,0,USD,Wire Transfer,Skyline Internet Services,***5480,,,FALSE,FALSE,REF-990523,First Continental Bank,***3615,"Globex International Holdings, Inc.",US,6342786.75
24/01/2025,24/01/2025,Supplier Payment - ExpertNet Subcontractors #17,Supplier Payment,PS-GL,6119.65,0,USD,Fedwire,ExpertNet Subcontractors #17,***8272,,PO-202501-PS-GL-0001,FALSE,FALSE,REF-939373,First Continental Bank,***4154,"Globex International Holdings, Inc.",US,6336667.1
24/01/2025,24/01/2025,Supplier Payment - CodeCraft Contractors #6,Supplier Payment,SaaS-GL,9033.1,0,USD,ACH Debit,CodeCraft Contractors #6,***7818,,PO-202501-SaaS-GL-0005,FALSE,FALSE,REF-433220,First Continental Bank,***3956,"Globex International Holdings, Inc.",US,6327634
24/01/2025,24/01/2025,Client Receipt - ShopSphere Partner #17,Sales Receipt,Retail-NA,0,47498.1,USD,Fedwire Credit,ShopSphere Partner #17,***4431,INV-202501-Retail-NA-0005,,FALSE,FALSE,REF-459892,First Continental Bank,***7848,"Globex International Holdings, Inc.",US,6375132.1
24/01/2025,24/01/2025,Client Receipt - ShopSphere Partner #69,Sales Receipt,Retail-NA,0,111399.07,USD,Card Settlement,ShopSphere Partner #69,***2289,INV-202501-Retail-NA-0006,,FALSE,FALSE,REF-658075,First Continental Bank,***6126,"Globex International Holdings, Inc.",US,6486531.17
25/01/2025,25/01/2025,Supplier Payment - NorthRiver Apparel Mfg #31,Supplier Payment,Retail-NA,2796.82,0,USD,ACH Debit,NorthRiver Apparel Mfg #31,***8516,,PO-202501-Retail-NA-0003,FALSE,FALSE,REF-659565,First Continental Bank,***6465,"Globex International Holdings, Inc.",US,6483734.35
25/01/2025,25/01/2025,Supplier Payment - HyperCloud Infra #11,Supplier Payment,SaaS-GL,11648.95,0,USD,Wire Transfer,HyperCloud Infra #11,***3690,,PO-202501-SaaS-GL-0011,FALSE,FALSE,REF-618651,First Continental Bank,***2547,"Globex International Holdings, Inc.",US,6472085.4
26/01/2025,26/01/2025,Intercompany Settlement - Globex Consulting UK Ltd.,Intercompany Transfer,ALL,373254,0,USD,Internal Transfer,Globex Consulting UK Ltd.,***1607,,,TRUE,TRUE,REF-707863,First Continental Bank,***7596,"Globex International Holdings, Inc.",US,6098831.4
27/01/2025,27/01/2025,Marketing - Aurelia Media #2,Marketing,ALL,22858.01,0,USD,Wire Transfer,Aurelia Media #2,***8919,,,FALSE,FALSE,REF-190112,First Continental Bank,***6289,"Globex International Holdings, Inc.",US,6075973.39
27/01/2025,27/01/2025,Client Receipt - CloudBridge Co. #18,Sales Receipt,SaaS-GL,0,12074.25,USD,ACH Credit,CloudBridge Co. #18,***9511,INV-202501-SaaS-GL-0008,,FALSE,FALSE,REF-537183,First Continental Bank,***5036,"Globex International Holdings, Inc.",US,6088047.64
27/01/2025,27/01/2025,Client Receipt - CloudBridge Co. #21,Sales Receipt,SaaS-GL,0,37831.85,USD,Card Settlement,CloudBridge Co. #21,***4787,INV-202501-SaaS-GL-0027,,FALSE,FALSE,REF-507969,First Continental Bank,***6546,"Globex International Holdings, Inc.",US,6125879.49
27/01/2025,27/01/2025,Client Receipt - CloudBridge Co. #65,Sales Receipt,SaaS-GL,0,43551.79,USD,ACH Credit,CloudBridge Co. #65,***9400,INV-202501-SaaS-GL-0016,,FALSE,FALSE,REF-994950,First Continental Bank,***9975,"Globex International Holdings, Inc.",US,6169431.28
27/01/2025,27/01/2025,Client Receipt - Vertex Advisory Client #17,Sales Receipt,PS-GL,0,217877.91,USD,Card Settlement,Vertex Advisory Client #17,***4792,INV-202501-PS-GL-0006,,FALSE,FALSE,REF-457949,First Continental Bank,***5063,"Globex International Holdings, Inc.",US,6387309.19
28/01/2025,28/01/2025,Corporate Tax Estimate,Tax Payment,ALL,106184.61,0,USD,ACH Debit,State of CA FTB,***9472,,,FALSE,FALSE,REF-441040,First Continental Bank,***1629,"Globex International Holdings, Inc.",US,6281124.58
29/01/2025,29/01/2025,Supplier Payment - ExpertNet Subcontractors #14,Supplier Payment,PS-GL,9951.55,0,USD,Wire Transfer,ExpertNet Subcontractors #14,***7079,,PO-202501-PS-GL-0009,FALSE,FALSE,REF-642604,First Continental Bank,***4704,"Globex International Holdings, Inc.",US,6271173.03
29/01/2025,29/01/2025,Supplier Payment - PackFast Fulfillment #4,Supplier Payment,Retail-NA,90999.39,0,USD,ACH Debit,PackFast Fulfillment #4,***6271,,PO-202501-Retail-NA-0008,FALSE,FALSE,REF-425205,First Continental Bank,***3315,"Globex International Holdings, Inc.",US,6180173.64
29/01/2025,29/01/2025,Payroll - GlobalPay Services Ltd,Payroll,ALL,182790.73,0,USD,Wire Transfer,GlobalPay Services Ltd,***6038,,,FALSE,FALSE,REF-763730,First Continental Bank,***1311,"Globex International Holdings, Inc.",US,5997382.91
30/01/2025,30/01/2025,Payroll - GlobalPay Services Ltd,Payroll,ALL,182790.73,0,USD,Wire Transfer,GlobalPay Services Ltd,***9373,,,FALSE,FALSE,REF-148731,First Continental Bank,***6449,"Globex International Holdings, Inc.",US,5814592.18
30/01/2025,30/01/2025,Interest Earned,Interest Income,ALL,0,11516.28,USD,Card Settlement,First Continental Bank,***2939,,,FALSE,FALSE,REF-251158,First Continental Bank,***7394,"Globex International Holdings, Inc.",US,5826108.46
30/01/2025,30/01/2025,Client Receipt - CloudBridge Co. #50,Sales Receipt,SaaS-GL,0,21599.58,USD,Card Settlement,CloudBridge Co. #50,***3947,INV-202501-SaaS-GL-0015,,FALSE,FALSE,REF-437143,First Continental Bank,***4889,"Globex International Holdings, Inc.",US,5847708.04
30/01/2025,30/01/2025,Client Receipt - CloudBridge Co. #9,Sales Receipt,SaaS-GL,0,23037.07,USD,Fedwire Credit,CloudBridge Co. #9,***2893,INV-202501-SaaS-GL-0020,,FALSE,FALSE,REF-759442,First Continental Bank,***6231,"Globex International Holdings, Inc.",US,5870745.11
30/01/2025,30/01/2025,Client Receipt - CloudBridge Co. #47,Sales Receipt,SaaS-GL,0,24822.09,USD,Card Settlement,CloudBridge Co. #47,***5976,INV-202501-SaaS-GL-0014,,FALSE,FALSE,REF-707724,First Continental Bank,***1316,"Globex International Holdings, Inc.",US,5895567.2
30/01/2025,30/01/2025,Client Receipt - CloudBridge Co. #72,Sales Receipt,SaaS-GL,0,38783.06,USD,Fedwire Credit,CloudBridge Co. #72,***8252,INV-202501-SaaS-GL-0011,,FALSE,FALSE,REF-646292,First Continental Bank,***2409,"Globex International Holdings, Inc.",US,5934350.26
30/01/2025,30/01/2025,Client Receipt - Vertex Advisory Client #28,Sales Receipt,PS-GL,0,79008.14,USD,Card Settlement,Vertex Advisory Client #28,***9944,INV-202501-PS-GL-0002,,FALSE,FALSE,REF-349766,First Continental Bank,***9778,"Globex International Holdings, Inc.",US,6013358.4
31/01/2025,31/01/2025,Supplier Payment - CodeCraft Contractors #3,Supplier Payment,SaaS-GL,4597.57,0,USD,ACH Debit,CodeCraft Contractors #3,***6527,,PO-202501-SaaS-GL-0004,FALSE,FALSE,REF-262310,First Continental Bank,***4781,"Globex International Holdings, Inc.",US,6008760.83
31/01/2025,31/01/2025,Client Receipt - Card Settlement Batch #20,Sales Receipt,Retail-NA,0,33869.32,USD,Fedwire Credit,Card Settlement Batch #20,***6090,INV-202501-Retail-NA-0010,,FALSE,FALSE,REF-543517,First Continental Bank,***2254,"Globex International Holdings, Inc.",US,6042630.15
31/01/2025,31/01/2025,Client Receipt - CloudBridge Co. #1,Sales Receipt,SaaS-GL,0,45009.72,USD,Fedwire Credit,CloudBridge Co. #1,***8057,INV-202501-SaaS-GL-0024,,FALSE,FALSE,REF-331745,First Continental Bank,***7149,"Globex International Holdings, Inc.",US,6087639.87
01/02/2025,01/02/2025,Account Maintenance Fee,Bank/Merchant Fees,ALL,2500,0,USD,ACH Debit,First Continental Bank,***1226,,,FALSE,FALSE,REF-662811,First Continental Bank,***7810,"Globex International Holdings, Inc.",US,6085139.87
01/02/2025,01/02/2025,Client Receipt - CloudBridge Co. #57,Sales Receipt,SaaS-GL,0,3194.73,USD,ACH Credit,CloudBridge Co. #57,***1923,INV-202502-SaaS-GL-0004,,FALSE,FALSE,REF-772358,First Continental Bank,***2111,"Globex International Holdings, Inc.",US,6088334.6
01/02/2025,01/02/2025,Client Receipt - Vertex Advisory Client #29,Sales Receipt,PS-GL,0,153821.4,USD,ACH Credit,Vertex Advisory Client #29,***3282,INV-202502-PS-GL-0004,,FALSE,FALSE,REF-222017,First Continental Bank,***2883,"Globex International Holdings, Inc.",US,6242156
02/02/2025,02/02/2025,Merchant Processing Fees,Bank/Merchant Fees,ALL,4986.26,0,USD,Fedwire,First Continental Bank,***5739,,,FALSE,FALSE,REF-617039,First Continental Bank,***3770,"Globex International Holdings, Inc.",US,6237169.74
02/02/2025,02/02/2025,Supplier Payment - HyperCloud Infra #1,Supplier Payment,SaaS-GL,17953.49,0,USD,Fedwire,HyperCloud Infra #1,***9018,,PO-202502-SaaS-GL-0004,FALSE,FALSE,REF-118042,First Continental Bank,***8662,"Globex International Holdings, Inc.",US,6219216.25
02/02/2025,02/02/2025,Client Receipt - CloudBridge Co. #52,Sales Receipt,SaaS-GL,0,25207.98,USD,Card Settlement,CloudBridge Co. #52,***9952,INV-202502-SaaS-GL-0008,,FALSE,FALSE,REF-954750,First Continental Bank,***5670,"Globex International Holdings, Inc.",US,6244424.23
03/02/2025,03/02/2025,Supplier Payment - CodeCraft Contractors #12,Supplier Payment,SaaS-GL,21533.25,0,USD,ACH Debit,CodeCraft Contractors #12,***4872,,PO-202502-SaaS-GL-0007,FALSE,FALSE,REF-362147,First Continental Bank,***5805,"Globex International Holdings, Inc.",US,6222890.98
03/02/2025,03/02/2025,Client Receipt - ShopSphere Partner #35,Sales Receipt,Retail-NA,0,35352.43,USD,ACH Credit,ShopSphere Partner #35,***2489,INV-202502-Retail-NA-0003,,FALSE,FALSE,REF-339889,First Continental Bank,***1186,"Globex International Holdings, Inc.",US,6258243.41
04/02/2025,04/02/2025,Supplier Payment - CodeCraft Contractors #6,Supplier Payment,SaaS-GL,984.63,0,USD,ACH Debit,CodeCraft Contractors #6,***8621,,PO-202502-SaaS-GL-0003,FALSE,FALSE,REF-738913,First Continental Bank,***8706,"Globex International Holdings, Inc.",US,6257258.78
04/02/2025,04/02/2025,Supplier Payment - ExpertNet Subcontractors #1,Supplier Payment,PS-GL,17203.3,0,USD,ACH Debit,ExpertNet Subcontractors #1,***9253,,PO-202502-PS-GL-0009,FALSE,FALSE,REF-302344,First Continental Bank,***6525,"Globex International Holdings, Inc.",US,6240055.48
04/02/2025,04/02/2025,Marketing - Beacon Digital #2,Marketing,ALL,29331.39,0,USD,Wire Transfer,Beacon Digital #2,***9916,,,FALSE,FALSE,REF-790434,First Continental Bank,***9884,"Globex International Holdings, Inc.",US,6210724.09
04/02/2025,04/02/2025,Client Receipt - ShopSphere Partner #62,Sales Receipt,Retail-NA,0,1071.72,USD,ACH Credit,ShopSphere Partner #62,***3061,INV-202502-Retail-NA-0009,,FALSE,FALSE,REF-941323,First Continental Bank,***9503,"Globex International Holdings, Inc.",US,6211795.81
04/02/2025,04/02/2025,Client Receipt - Vertex Advisory Client #42,Sales Receipt,PS-GL,0,4029.16,USD,Fedwire Credit,Vertex Advisory Client #42,***7879,INV-202502-PS-GL-0006,,FALSE,FALSE,REF-928550,First Continental Bank,***4208,"Globex International Holdings, Inc.",US,6215824.97
04/02/2025,04/02/2025,Client Receipt - Vertex Advisory Client #13,Sales Receipt,PS-GL,0,7594.53,USD,Fedwire Credit,Vertex Advisory Client #13,***9582,INV-202502-PS-GL-0005,,FALSE,FALSE,REF-453612,First Continental Bank,***9481,"Globex International Holdings, Inc.",US,6223419.5
04/02/2025,04/02/2025,Client Receipt - CloudBridge Co. #39,Sales Receipt,SaaS-GL,0,17666.65,USD,Card Settlement,CloudBridge Co. #39,***5247,INV-202502-SaaS-GL-0002,,FALSE,FALSE,REF-618474,First Continental Bank,***9219,"Globex International Holdings, Inc.",US,6241086.15
04/02/2025,04/02/2025,Client Receipt - CloudBridge Co. #33,Sales Receipt,SaaS-GL,0,22226.92,USD,Card Settlement,CloudBridge Co. #33,***2336,INV-202502-SaaS-GL-0006,,FALSE,FALSE,REF-911558,First Continental Bank,***2812,"Globex International Holdings, Inc.",US,6263313.07
04/02/2025,04/02/2025,Client Receipt - CloudBridge Co. #67,Sales Receipt,SaaS-GL,0,104767.95,USD,ACH Credit,CloudBridge Co. #67,***4765,INV-202502-SaaS-GL-0017,,FALSE,FALSE,REF-112715,First Continental Bank,***2568,"Globex International Holdings, Inc.",US,6368081.02
05/02/2025,05/02/2025,Supplier Payment - ExpertNet Subcontractors #4,Supplier Payment,PS-GL,1296.34,0,USD,ACH Debit,ExpertNet Subcontractors #4,***9663,,PO-202502-PS-GL-0004,FALSE,FALSE,REF-520184,First Continental Bank,***1483,"Globex International Holdings, Inc.",US,6366784.68
05/02/2025,05/02/2025,Supplier Payment - ExpertNet Subcontractors #18,Supplier Payment,PS-GL,13748.94,0,USD,Fedwire,ExpertNet Subcontractors #18,***1369,,PO-202502-PS-GL-0002,FALSE,FALSE,REF-932922,First Continental Bank,***7532,"Globex International Holdings, Inc.",US,6353035.74
05/02/2025,05/02/2025,Supplier Payment - ExpertNet Subcontractors #8,Supplier Payment,PS-GL,30109.37,0,USD,Wire Transfer,ExpertNet Subcontractors #8,***6986,,PO-202502-PS-GL-0011,FALSE,FALSE,REF-991613,First Continental Bank,***8605,"Globex International Holdings, Inc.",US,6322926.37
05/02/2025,05/02/2025,Client Receipt - CloudBridge Co. #52,Sales Receipt,SaaS-GL,0,8772.56,USD,ACH Credit,CloudBridge Co. #52,***4082,INV-202502-SaaS-GL-0033,,FALSE,FALSE,REF-399127,First Continental Bank,***6198,"Globex International Holdings, Inc.",US,6331698.93
05/02/2025,05/02/2025,Client Receipt - CloudBridge Co. #37,Sales Receipt,SaaS-GL,0,16997.49,USD,ACH Credit,CloudBridge Co. #37,***4284,INV-202502-SaaS-GL-0018,,FALSE,FALSE,REF-989518,First Continental Bank,***9370,"Globex International Holdings, Inc.",US,6348696.42
06/02/2025,06/02/2025,Supplier Payment - CodeCraft Contractors #1,Supplier Payment,SaaS-GL,67793.08,0,USD,Fedwire,CodeCraft Contractors #1,***6535,,PO-202502-SaaS-GL-0001,FALSE,FALSE,REF-813817,First Continental Bank,***8440,"Globex International Holdings, Inc.",US,6280903.34
06/02/2025,06/02/2025,Supplier Payment - PackFast Fulfillment #19,Supplier Payment,Retail-NA,91911.9,0,USD,ACH Debit,PackFast Fulfillment #19,***7305,,PO-202502-Retail-NA-0003,FALSE,FALSE,REF-796232,First Continental Bank,***7678,"Globex International Holdings, Inc.",US,6188991.44
06/02/2025,06/02/2025,Supplier Payment - PackFast Fulfillment #5,Supplier Payment,Retail-NA,226734.75,0,USD,Fedwire,PackFast Fulfillment #5,***7209,,PO-202502-Retail-NA-0007,FALSE,FALSE,REF-635290,First Continental Bank,***1541,"Globex International Holdings, Inc.",US,5962256.69
06/02/2025,06/02/2025,Client Receipt - CloudBridge Co. #68,Sales Receipt,SaaS-GL,0,6031.67,USD,Card Settlement,CloudBridge Co. #68,***5626,INV-202502-SaaS-GL-0032,,FALSE,FALSE,REF-140450,First Continental Bank,***2262,"Globex International Holdings, Inc.",US,5968288.36
06/02/2025,06/02/2025,Client Receipt - CloudBridge Co. #48,Sales Receipt,SaaS-GL,0,8174.79,USD,Card Settlement,CloudBridge Co. #48,***9964,INV-202502-SaaS-GL-0010,,FALSE,FALSE,REF-733137,First Continental Bank,***7996,"Globex International Holdings, Inc.",US,5976463.15
06/02/2025,06/02/2025,Client Receipt - CloudBridge Co. #9,Sales Receipt,SaaS-GL,0,25770.42,USD,Card Settlement,CloudBridge Co. #9,***3343,INV-202502-SaaS-GL-0027,,FALSE,FALSE,REF-111719,First Continental Bank,***6728,"Globex International Holdings, Inc.",US,6002233.57
06/02/2025,06/02/2025,Client Receipt - CloudBridge Co. #8,Sales Receipt,SaaS-GL,0,62651.08,USD,Fedwire Credit,CloudBridge Co. #8,***3203,INV-202502-SaaS-GL-0019,,FALSE,FALSE,REF-764179,First Continental Bank,***3758,"Globex International Holdings, Inc.",US,6064884.65
06/02/2025,06/02/2025,Client Receipt - Vertex Advisory Client #18,Sales Receipt,PS-GL,0,106534.77,USD,ACH Credit,Vertex Advisory Client #18,***1782,INV-202502-PS-GL-0001,,FALSE,FALSE,REF-526452,First Continental Bank,***4365,"Globex International Holdings, Inc.",US,6171419.42
07/02/2025,07/02/2025,Alphagrid Utilities,Rent & Utilities,ALL,8162.52,0,USD,ACH Debit,Alphagrid Utilities,***4359,,,FALSE,FALSE,REF-664074,First Continental Bank,***2959,"Globex International Holdings, Inc.",US,6163256.9
07/02/2025,07/02/2025,Supplier Payment - PackFast Fulfillment #21,Supplier Payment,Retail-NA,20918.74,0,USD,Fedwire,PackFast Fulfillment #21,***7491,,PO-202502-Retail-NA-0002,FALSE,FALSE,REF-436853,First Continental Bank,***5375,"Globex International Holdings, Inc.",US,6142338.16
07/02/2025,07/02/2025,Client Receipt - CloudBridge Co. #1,Sales Receipt,SaaS-GL,0,26168.59,USD,Fedwire Credit,CloudBridge Co. #1,***5834,INV-202502-SaaS-GL-0009,,FALSE,FALSE,REF-975815,First Continental Bank,***5545,"Globex International Holdings, Inc.",US,6168506.75
07/02/2025,07/02/2025,Client Receipt - CloudBridge Co. #38,Sales Receipt,SaaS-GL,0,80403.89,USD,ACH Credit,CloudBridge Co. #38,***2918,INV-202502-SaaS-GL-0003,,FALSE,FALSE,REF-936264,First Continental Bank,***4688,"Globex International Holdings, Inc.",US,6248910.64
07/02/2025,07/02/2025,Client Receipt - Card Settlement Batch #11,Sales Receipt,Retail-NA,0,116809.14,USD,Card Settlement,Card Settlement Batch #11,***3915,INV-202502-Retail-NA-0007,,FALSE,FALSE,REF-683859,First Continental Bank,***9130,"Globex International Holdings, Inc.",US,6365719.78
09/02/2025,09/02/2025,Client Receipt - CloudBridge Co. #67,Sales Receipt,SaaS-GL,0,13420.32,USD,Card Settlement,CloudBridge Co. #67,***1470,INV-202502-SaaS-GL-0024,,FALSE,FALSE,REF-760491,First Continental Bank,***2588,"Globex International Holdings, Inc.",US,6379140.1
10/02/2025,10/02/2025,Supplier Payment - NorthRiver Apparel Mfg #12,Supplier Payment,Retail-NA,48123.87,0,USD,Fedwire,NorthRiver Apparel Mfg #12,***2944,,PO-202502-Retail-NA-0006,FALSE,FALSE,REF-670765,First Continental Bank,***4683,"Globex International Holdings, Inc.",US,6331016.23
10/02/2025,10/02/2025,Client Receipt - CloudBridge Co. #12,Sales Receipt,SaaS-GL,0,14459.48,USD,Card Settlement,CloudBridge Co. #12,***7383,INV-202502-SaaS-GL-0016,,FALSE,FALSE,REF-188869,First Continental Bank,***7651,"Globex International Holdings, Inc.",US,6345475.71
10/02/2025,10/02/2025,Client Receipt - CloudBridge Co. #3,Sales Receipt,SaaS-GL,0,20398.49,USD,Fedwire Credit,CloudBridge Co. #3,***6437,INV-202502-SaaS-GL-0023,,FALSE,FALSE,REF-188119,First Continental Bank,***4651,"Globex International Holdings, Inc.",US,6365874.2
10/02/2025,10/02/2025,Client Receipt - CloudBridge Co. #10,Sales Receipt,SaaS-GL,0,81936.04,USD,Fedwire Credit,CloudBridge Co. #10,***2370,INV-202502-SaaS-GL-0022,,FALSE,FALSE,REF-276635,First Continental Bank,***1455,"Globex International Holdings, Inc.",US,6447810.24
10/02/2025,10/02/2025,Client Receipt - Card Settlement Batch #4,Sales Receipt,Retail-NA,0,227551.35,USD,ACH Credit,Card Settlement Batch #4,***1241,INV-202502-Retail-NA-0005,,FALSE,FALSE,REF-401763,First Continental Bank,***9770,"Globex International Holdings, Inc.",US,6675361.59
11/02/2025,11/02/2025,Supplier Payment - ExpertNet Subcontractors #15,Supplier Payment,PS-GL,40678.51,0,USD,Wire Transfer,ExpertNet Subcontractors #15,***6992,,PO-202502-PS-GL-0012,FALSE,FALSE,REF-507160,First Continental Bank,***8807,"Globex International Holdings, Inc.",US,6634683.08
11/02/2025,11/02/2025,Client Receipt - ShopSphere Partner #72,Sales Receipt,Retail-NA,0,15370.73,USD,ACH Credit,ShopSphere Partner #72,***6742,INV-202502-Retail-NA-0015,,FALSE,FALSE,REF-247592,First Continental Bank,***4778,"Globex International Holdings, Inc.",US,6650053.81
11/02/2025,11/02/2025,Client Receipt - CloudBridge Co. #46,Sales Receipt,SaaS-GL,0,19773.15,USD,Card Settlement,CloudBridge Co. #46,***1204,INV-202502-SaaS-GL-0025,,FALSE,FALSE,REF-647820,First Continental Bank,***2750,"Globex International Holdings, Inc.",US,6669826.96
11/02/2025,11/02/2025,Client Receipt - CloudBridge Co. #21,Sales Receipt,SaaS-GL,0,21061.44,USD,ACH Credit,CloudBridge Co. #21,***9639,INV-202502-SaaS-GL-0034,,FALSE,FALSE,REF-858607,First Continental Bank,***2024,"Globex International Holdings, Inc.",US,6690888.4
11/02/2025,11/02/2025,Client Receipt - ShopSphere Partner #50,Sales Receipt,Retail-NA,0,39338.43,USD,Card Settlement,ShopSphere Partner #50,***1136,INV-202502-Retail-NA-0002,,FALSE,FALSE,REF-742347,First Continental Bank,***8584,"Globex International Holdings, Inc.",US,6730226.83
11/02/2025,11/02/2025,Client Receipt - CloudBridge Co. #29,Sales Receipt,SaaS-GL,0,67660.1,USD,ACH Credit,CloudBridge Co. #29,***5857,INV-202502-SaaS-GL-0005,,FALSE,FALSE,REF-986304,First Continental Bank,***8231,"Globex International Holdings, Inc.",US,6797886.93
11/02/2025,11/02/2025,Client Receipt - Card Settlement Batch #11,Sales Receipt,Retail-NA,0,84493.03,USD,Fedwire Credit,Card Settlement Batch #11,***5171,INV-202502-Retail-NA-0004,,FALSE,FALSE,REF-421165,First Continental Bank,***3341,"Globex International Holdings, Inc.",US,6882379.96
12/02/2025,12/02/2025,BluePeak Property Mgmt,Rent & Utilities,ALL,13791.19,0,USD,Fedwire,BluePeak Property Mgmt,***6128,,,FALSE,FALSE,REF-687641,First Continental Bank,***1198,"Globex International Holdings, Inc.",US,6868588.77
12/02/2025,12/02/2025,Supplier Payment - ExpertNet Subcontractors #7,Supplier Payment,PS-GL,18957.6,0,USD,ACH Debit,ExpertNet Subcontractors #7,***5940,,PO-202502-PS-GL-0003,FALSE,FALSE,REF-172035,First Continental Bank,***5304,"Globex International Holdings, Inc.",US,6849631.17
12/02/2025,12/02/2025,Supplier Payment - HyperCloud Infra #9,Supplier Payment,SaaS-GL,69801.85,0,USD,Wire Transfer,HyperCloud Infra #9,***4125,,PO-202502-SaaS-GL-0005,FALSE,FALSE,REF-649986,First Continental Bank,***5843,"Globex International Holdings, Inc.",US,6779829.32
12/02/2025,12/02/2025,Intercompany Settlement - Globex APAC Logistics Pte. Ltd.,Intercompany Transfer,ALL,862287,0,USD,Internal Transfer,Globex APAC Logistics Pte. Ltd.,***1713,,,TRUE,TRUE,REF-991039,First Continental Bank,***6289,"Globex International Holdings, Inc.",US,5917542.32
12/02/2025,12/02/2025,Client Receipt - CloudBridge Co. #72,Sales Receipt,SaaS-GL,0,891.04,USD,ACH Credit,CloudBridge Co. #72,***8869,INV-202502-SaaS-GL-0028,,FALSE,FALSE,REF-139826,First Continental Bank,***6133,"Globex International Holdings, Inc.",US,5918433.36
12/02/2025,12/02/2025,Client Receipt - CloudBridge Co. #22,Sales Receipt,SaaS-GL,0,9286.18,USD,Card Settlement,CloudBridge Co. #22,***8875,INV-202502-SaaS-GL-0030,,FALSE,FALSE,REF-986531,First Continental Bank,***9549,"Globex International Holdings, Inc.",US,5927719.54
13/02/2025,13/02/2025,Supplier Payment - PackFast Fulfillment #21,Supplier Payment,Retail-NA,2961.9,0,USD,ACH Debit,PackFast Fulfillment #21,***8359,,PO-202502-Retail-NA-0005,FALSE,FALSE,REF-304544,First Continental Bank,***3003,"Globex International Holdings, Inc.",US,5924757.64
13/02/2025,13/02/2025,Supplier Payment - HyperCloud Infra #13,Supplier Payment,SaaS-GL,4778.25,0,USD,ACH Debit,HyperCloud Infra #13,***5127,,PO-202502-SaaS-GL-0008,FALSE,FALSE,REF-183133,First Continental Bank,***8306,"Globex International Holdings, Inc.",US,5919979.39
13/02/2025,13/02/2025,Supplier Payment - NorthRiver Apparel Mfg #18,Supplier Payment,Retail-NA,17386.38,0,USD,ACH Debit,NorthRiver Apparel Mfg #18,***5353,,PO-202502-Retail-NA-0001,FALSE,FALSE,REF-965538,First Continental Bank,***4409,"Globex International Holdings, Inc.",US,5902593.01
13/02/2025,13/02/2025,Client Receipt - Vertex Advisory Client #31,Sales Receipt,PS-GL,0,37909.91,USD,Fedwire Credit,Vertex Advisory Client #31,***5867,INV-202502-PS-GL-0008,,FALSE,FALSE,REF-589746,First Continental Bank,***9505,"Globex International Holdings, Inc.",US,5940502.92
13/02/2025,13/02/2025,Client Receipt - CloudBridge Co. #37,Sales Receipt,SaaS-GL,0,46935.23,USD,ACH Credit,CloudBridge Co. #37,***6213,INV-202502-SaaS-GL-0012,,FALSE,FALSE,REF-634206,First Continental Bank,***5092,"Globex International Holdings, Inc.",US,5987438.15
13/02/2025,13/02/2025,Client Receipt - ShopSphere Partner #78,Sales Receipt,Retail-NA,0,100200.07,USD,Card Settlement,ShopSphere Partner #78,***7601,INV-202502-Retail-NA-0006,,FALSE,FALSE,REF-306579,First Continental Bank,***7338,"Globex International Holdings, Inc.",US,6087638.22
14/02/2025,14/02/2025,Marketing - Aurelia Media #2,Marketing,ALL,7200.56,0,USD,Wire Transfer,Aurelia Media #2,***7913,,,FALSE,FALSE,REF-401340,First Continental Bank,***9172,"Globex International Holdings, Inc.",US,6080437.66
14/02/2025,14/02/2025,Supplier Payment - ExpertNet Subcontractors #10,Supplier Payment,PS-GL,23695.42,0,USD,ACH Debit,ExpertNet Subcontractors #10,***4516,,PO-202502-PS-GL-0006,FALSE,FALSE,REF-715456,First Continental Bank,***2565,"Globex International Holdings, Inc.",US,6056742.24
15/02/2025,15/02/2025,Supplier Payment - HyperCloud Infra #2,Supplier Payment,SaaS-GL,1636.35,0,USD,Fedwire,HyperCloud Infra #2,***6659,,PO-202502-SaaS-GL-0006,FALSE,FALSE,REF-217950,First Continental Bank,***7278,"Globex International Holdings, Inc.",US,6055105.89
15/02/2025,15/02/2025,Loan Interest Payment,Loan Interest,ALL,85000,0,USD,ACH Debit,First Continental Bank - Corporate Lending,***1294,,,FALSE,FALSE,REF-618063,First Continental Bank,***2323,"Globex International Holdings, Inc.",US,5970105.89
15/02/2025,15/02/2025,Loan Principal Repayment,Loan Principal,ALL,500000,0,USD,ACH Debit,First Continental Bank - Corporate Lending,***2597,,,FALSE,FALSE,REF-727027,First Continental Bank,***6889,"Globex International Holdings, Inc.",US,5470105.89
15/02/2025,15/02/2025,Client Receipt - CloudBridge Co. #48,Sales Receipt,SaaS-GL,0,34023.31,USD,ACH Credit,CloudBridge Co. #48,***8632,INV-202502-SaaS-GL-0015,,FALSE,FALSE,REF-809141,First Continental Bank,***7050,"Globex International Holdings, Inc.",US,5504129.2
16/02/2025,16/02/2025,Supplier Payment - HyperCloud Infra #2,Supplier Payment,SaaS-GL,26025.67,0,USD,Wire Transfer,HyperCloud Infra #2,***6097,,PO-202502-SaaS-GL-0002,FALSE,FALSE,REF-121958,First Continental Bank,***1488,"Globex International Holdings, Inc.",US,5478103.53
17/02/2025,17/02/2025,Supplier Payment - ExpertNet Subcontractors #8,Supplier Payment,PS-GL,6454.97,0,USD,ACH Debit,ExpertNet Subcontractors #8,***6628,,PO-202502-PS-GL-0008,FALSE,FALSE,REF-918513,First Continental Bank,***3719,"Globex International Holdings, Inc.",US,5471648.56
17/02/2025,17/02/2025,Supplier Payment - ExpertNet Subcontractors #5,Supplier Payment,PS-GL,27463.41,0,USD,Fedwire,ExpertNet Subcontractors #5,***8013,,PO-202502-PS-GL-0010,FALSE,FALSE,REF-508958,First Continental Bank,***1315,"Globex International Holdings, Inc.",US,5444185.15
18/02/2025,18/02/2025,Supplier Payment - ExpertNet Subcontractors #17,Supplier Payment,PS-GL,512.27,0,USD,Fedwire,ExpertNet Subcontractors #17,***5013,,PO-202502-PS-GL-0007,FALSE,FALSE,REF-408975,First Continental Bank,***1632,"Globex International Holdings, Inc.",US,5443672.88
18/02/2025,18/02/2025,Merchant Processing Fees,Bank/Merchant Fees,ALL,3448.84,0,USD,Fedwire,First Continental Bank,***4256,,,FALSE,FALSE,REF-217922,First Continental Bank,***1553,"Globex International Holdings, Inc.",US,5440224.04
18/02/2025,18/02/2025,Client Receipt - CloudBridge Co. #45,Sales Receipt,SaaS-GL,0,14233.57,USD,ACH Credit,CloudBridge Co. #45,***3762,INV-202502-SaaS-GL-0011,,FALSE,FALSE,REF-675240,First Continental Bank,***5197,"Globex International Holdings, Inc.",US,5454457.61
18/02/2025,18/02/2025,Client Receipt - ShopSphere Partner #15,Sales Receipt,Retail-NA,0,159258.29,USD,ACH Credit,ShopSphere Partner #15,***8241,INV-202502-Retail-NA-0011,,FALSE,FALSE,REF-488830,First Continental Bank,***5626,"Globex International Holdings, Inc.",US,5613715.9
19/02/2025,19/02/2025,Supplier Payment - NorthRiver Apparel Mfg #32,Supplier Payment,Retail-NA,179522.83,0,USD,Fedwire,NorthRiver Apparel Mfg #32,***9472,,PO-202502-Retail-NA-0004,FALSE,FALSE,REF-765574,First Continental Bank,***4592,"Globex International Holdings, Inc.",US,5434193.07
20/02/2025,20/02/2025,Marketing - Aurelia Media #11,Marketing,ALL,33553.34,0,USD,Wire Transfer,Aurelia Media #11,***6420,,,FALSE,FALSE,REF-344275,First Continental Bank,***8341,"Globex International Holdings, Inc.",US,5400639.73
20/02/2025,20/02/2025,Client Receipt - ShopSphere Partner #77,Sales Receipt,Retail-NA,0,12585.87,USD,Card Settlement,ShopSphere Partner #77,***3876,INV-202502-Retail-NA-0014,,FALSE,FALSE,REF-223420,First Continental Bank,***8681,"Globex International Holdings, Inc.",US,5413225.6
20/02/2025,20/02/2025,Client Receipt - Vertex Advisory Client #32,Sales Receipt,PS-GL,0,157508.68,USD,ACH Credit,Vertex Advisory Client #32,***6640,INV-202502-PS-GL-0003,,FALSE,FALSE,REF-461096,First Continental Bank,***4598,"Globex International Holdings, Inc.",US,5570734.28
21/02/2025,21/02/2025,Client Receipt - CloudBridge Co. #41,Sales Receipt,SaaS-GL,0,10718.19,USD,Card Settlement,CloudBridge Co. #41,***6112,INV-202502-SaaS-GL-0014,,FALSE,FALSE,REF-718729,First Continental Bank,***9386,"Globex International Holdings, Inc.",US,5581452.47
22/02/2025,22/02/2025,VAT/GST Remittance - US IRS,Tax Payment,ALL,170522.37,0,USD,SWIFT MT103,US IRS,***7563,,,FALSE,FALSE,REF-739587,First Continental Bank,***9327,"Globex International Holdings, Inc.",US,5410930.1
22/02/2025,22/02/2025,Client Receipt - Vertex Advisory Client #58,Sales Receipt,PS-GL,0,47057.15,USD,Card Settlement,Vertex Advisory Client #58,***5443,INV-202502-PS-GL-0002,,FALSE,FALSE,REF-446245,First Continental Bank,***4373,"Globex International Holdings, Inc.",US,5457987.25
24/02/2025,24/02/2025,Client Receipt - ShopSphere Partner #76,Sales Receipt,Retail-NA,0,52268.79,USD,Card Settlement,ShopSphere Partner #76,***6880,INV-202502-Retail-NA-0001,,FALSE,FALSE,REF-990307,First Continental Bank,***3540,"Globex International Holdings, Inc.",US,5510256.04
24/02/2025,24/02/2025,Client Receipt - ShopSphere Partner #65,Sales Receipt,Retail-NA,0,78033.25,USD,Fedwire Credit,ShopSphere Partner #65,***6153,INV-202502-Retail-NA-0012,,FALSE,FALSE,REF-858775,First Continental Bank,***6482,"Globex International Holdings, Inc.",US,5588289.29
24/02/2025,24/02/2025,Client Receipt - ShopSphere Partner #14,Sales Receipt,Retail-NA,0,142865.27,USD,Card Settlement,ShopSphere Partner #14,***9494,INV-202502-Retail-NA-0013,,FALSE,FALSE,REF-395872,First Continental Bank,***1988,"Globex International Holdings, Inc.",US,5731154.56
25/02/2025,25/02/2025,Supplier Payment - NorthRiver Apparel Mfg #7,Supplier Payment,Retail-NA,15579.57,0,USD,Wire Transfer,NorthRiver Apparel Mfg #7,***3004,,PO-202502-Retail-NA-0008,FALSE,FALSE,REF-305376,First Continental Bank,***1826,"Globex International Holdings, Inc.",US,5715574.99
25/02/2025,25/02/2025,Client Receipt - CloudBridge Co. #46,Sales Receipt,SaaS-GL,0,8892.04,USD,ACH Credit,CloudBridge Co. #46,***7140,INV-202502-SaaS-GL-0031,,FALSE,FALSE,REF-106578,First Continental Bank,***5867,"Globex International Holdings, Inc.",US,5724467.03
25/02/2025,25/02/2025,Client Receipt - CloudBridge Co. #43,Sales Receipt,SaaS-GL,0,10914.68,USD,Card Settlement,CloudBridge Co. #43,***4957,INV-202502-SaaS-GL-0007,,FALSE,FALSE,REF-686921,First Continental Bank,***2295,"Globex International Holdings, Inc.",US,5735381.71
26/02/2025,26/02/2025,Supplier Payment - ExpertNet Subcontractors #10,Supplier Payment,PS-GL,10614.15,0,USD,Fedwire,ExpertNet Subcontractors #10,***7080,,PO-202502-PS-GL-0005,FALSE,FALSE,REF-648958,First Continental Bank,***9631,"Globex International Holdings, Inc.",US,5724767.56
26/02/2025,26/02/2025,Supplier Payment - NorthRiver Apparel Mfg #27,Supplier Payment,Retail-NA,40074.57,0,USD,ACH Debit,NorthRiver Apparel Mfg #27,***6291,,PO-202502-Retail-NA-0009,FALSE,FALSE,REF-825118,First Continental Bank,***3562,"Globex International Holdings, Inc.",US,5684692.99
26/02/2025,26/02/2025,Intercompany Settlement - Globex APAC Logistics Pte. Ltd.,Intercompany Transfer,ALL,261304,0,USD,Internal Transfer,Globex APAC Logistics Pte. Ltd.,***6154,,,TRUE,TRUE,REF-583786,First Continental Bank,***7024,"Globex International Holdings, Inc.",US,5423388.99
26/02/2025,26/02/2025,Client Receipt - CloudBridge Co. #30,Sales Receipt,SaaS-GL,0,15915.86,USD,Fedwire Credit,CloudBridge Co. #30,***5801,INV-202502-SaaS-GL-0026,,FALSE,FALSE,REF-870230,First Continental Bank,***7708,"Globex International Holdings, Inc.",US,5439304.85
26/02/2025,26/02/2025,Client Receipt - CloudBridge Co. #10,Sales Receipt,SaaS-GL,0,27904.76,USD,Fedwire Credit,CloudBridge Co. #10,***4649,INV-202502-SaaS-GL-0013,,FALSE,FALSE,REF-526877,First Continental Bank,***9911,"Globex International Holdings, Inc.",US,5467209.61
26/02/2025,26/02/2025,Client Receipt - CloudBridge Co. #38,Sales Receipt,SaaS-GL,0,45417.87,USD,Card Settlement,CloudBridge Co. #38,***1850,INV-202502-SaaS-GL-0020,,FALSE,FALSE,REF-690175,First Continental Bank,***6060,"Globex International Holdings, Inc.",US,5512627.48
27/02/2025,27/02/2025,Client Receipt - Card Settlement Batch #24,Sales Receipt,Retail-NA,0,5047.62,USD,ACH Credit,Card Settlement Batch #24,***8066,INV-202502-Retail-NA-0010,,FALSE,FALSE,REF-885192,First Continental Bank,***4179,"Globex International Holdings, Inc.",US,5517675.1
27/02/2025,27/02/2025,Client Receipt - CloudBridge Co. #78,Sales Receipt,SaaS-GL,0,31453.52,USD,ACH Credit,CloudBridge Co. #78,***7242,INV-202502-SaaS-GL-0021,,FALSE,FALSE,REF-851844,First Continental Bank,***8173,"Globex International Holdings, Inc.",US,5549128.62
27/02/2025,27/02/2025,Client Receipt - CloudBridge Co. #39,Sales Receipt,SaaS-GL,0,31454.44,USD,Card Settlement,CloudBridge Co. #39,***9903,INV-202502-SaaS-GL-0001,,FALSE,FALSE,REF-701751,First Continental Bank,***6142,"Globex International Holdings, Inc.",US,5580583.06
28/02/2025,28/02/2025,Supplier Payment - ExpertNet Subcontractors #1,Supplier Payment,PS-GL,635.33,0,USD,ACH Debit,ExpertNet Subcontractors #1,***4906,,PO-202502-PS-GL-0001,FALSE,FALSE,REF-460939,First Continental Bank,***3060,"Globex International Holdings, Inc.",US,5579947.73
28/02/2025,28/02/2025,Payroll - GlobalPay Services Ltd,Payroll,ALL,438545.69,0,USD,Fedwire,GlobalPay Services Ltd,***7871,,,FALSE,FALSE,REF-684775,First Continental Bank,***5461,"Globex International Holdings, Inc.",US,5141402.04
28/02/2025,28/02/2025,Interest Earned,Interest Income,ALL,0,10979.82,USD,ACH Credit,First Continental Bank,***6312,,,FALSE,FALSE,REF-197436,First Continental Bank,***1112,"Globex International Holdings, Inc.",US,5152381.86
28/02/2025,28/02/2025,Client Receipt - CloudBridge Co. #74,Sales Receipt,SaaS-GL,0,22063.6,USD,ACH Credit,CloudBridge Co. #74,***6093,INV-202502-SaaS-GL-0029,,FALSE,FALSE,REF-317124,First Continental Bank,***2941,"Globex International Holdings, Inc.",US,5174445.46
28/02/2025,28/02/2025,Client Receipt - ShopSphere Partner #37,Sales Receipt,Retail-NA,0,99234.94,USD,Fedwire Credit,ShopSphere Partner #37,***5965,INV-202502-Retail-NA-0008,,FALSE,FALSE,REF-926855,First Continental Bank,***7254,"Globex International Holdings, Inc.",US,5273680.4
28/02/2025,28/02/2025,Client Receipt - Vertex Advisory Client #43,Sales Receipt,PS-GL,0,123443.09,USD,Fedwire Credit,Vertex Advisory Client #43,***6368,INV-202502-PS-GL-0007,,FALSE,FALSE,REF-826386,First Continental Bank,***3632,"Globex International Holdings, Inc.",US,5397123.49
01/03/2025,01/03/2025,Supplier Payment - ExpertNet Subcontractors #15,Supplier Payment,PS-GL,315.45,0,USD,ACH Debit,ExpertNet Subcontractors #15,***2096,,PO-202503-PS-GL-0007,FALSE,FALSE,REF-995798,First Continental Bank,***2584,"Globex International Holdings, Inc.",US,5396808.04
01/03/2025,01/03/2025,Account Maintenance Fee,Bank/Merchant Fees,ALL,2500,0,USD,Wire Transfer,First Continental Bank,***7271,,,FALSE,FALSE,REF-274531,First Continental Bank,***8460,"Globex International Holdings, Inc.",US,5394308.04
01/03/2025,01/03/2025,Client Receipt - CloudBridge Co. #71,Sales Receipt,SaaS-GL,0,4861.06,USD,Fedwire Credit,CloudBridge Co. #71,***4291,INV-202503-SaaS-GL-0009,,FALSE,FALSE,REF-758922,First Continental Bank,***1138,"Globex International Holdings, Inc.",US,5399169.1
02/03/2025,02/03/2025,Client Receipt - CloudBridge Co. #23,Sales Receipt,SaaS-GL,0,15795.58,USD,Card Settlement,CloudBridge Co. #23,***7778,INV-202503-SaaS-GL-0012,,FALSE,FALSE,REF-760379,First Continental Bank,***7076,"Globex International Holdings, Inc.",US,5414964.68
03/03/2025,03/03/2025,Supplier Payment - NorthRiver Apparel Mfg #16,Supplier Payment,Retail-NA,8571.82,0,USD,ACH Debit,NorthRiver Apparel Mfg #16,***6561,,PO-202503-Retail-NA-0005,FALSE,FALSE,REF-858745,First Continental Bank,***8511,"Globex International Holdings, Inc.",US,5406392.86
03/03/2025,03/03/2025,Supplier Payment - PackFast Fulfillment #5,Supplier Payment,Retail-NA,62854.53,0,USD,Wire Transfer,PackFast Fulfillment #5,***1634,,PO-202503-Retail-NA-0007,FALSE,FALSE,REF-162457,First Continental Bank,***7755,"Globex International Holdings, Inc.",US,5343538.33
03/03/2025,03/03/2025,Client Receipt - Vertex Advisory Client #2,Sales Receipt,PS-GL,0,30759.67,USD,Card Settlement,Vertex Advisory Client #2,***7987,INV-202503-PS-GL-0005,,FALSE,FALSE,REF-984100,First Continental Bank,***7495,"Globex International Holdings, Inc.",US,5374298
03/03/2025,03/03/2025,Client Receipt - ShopSphere Partner #38,Sales Receipt,Retail-NA,0,39020.99,USD,ACH Credit,ShopSphere Partner #38,***9891,INV-202503-Retail-NA-0005,,FALSE,FALSE,REF-730468,First Continental Bank,***4509,"Globex International Holdings, Inc.",US,5413318.99
04/03/2025,04/03/2025,Client Receipt - Card Settlement Batch #15,Sales Receipt,Retail-NA,0,111667.45,USD,Card Settlement,Card Settlement Batch #15,***7521,INV-202503-Retail-NA-0010,,FALSE,FALSE,REF-688244,First Continental Bank,***6819,"Globex International Holdings, Inc.",US,5524986.44
04/03/2025,04/03/2025,Client Receipt - CloudBridge Co. #72,Sales Receipt,SaaS-GL,0,137744.17,USD,Fedwire Credit,CloudBridge Co. #72,***2414,INV-202503-SaaS-GL-0019,,FALSE,FALSE,REF-363500,First Continental Bank,***2007,"Globex International Holdings, Inc.",US,5662730.61
04/03/2025,04/03/2025,Client Receipt - Vertex Advisory Client #35,Sales Receipt,PS-GL,0,181523.63,USD,Fedwire Credit,Vertex Advisory Client #35,***9015,INV-202503-PS-GL-0003,,FALSE,FALSE,REF-287119,First Continental Bank,***4916,"Globex International Holdings, Inc.",US,5844254.24
05/03/2025,05/03/2025,Marketing - Beacon Digital #9,Marketing,ALL,5157.21,0,USD,Fedwire,Beacon Digital #9,***5589,,,FALSE,FALSE,REF-422601,First Continental Bank,***7394,"Globex International Holdings, Inc.",US,5839097.03
05/03/2025,05/03/2025,Supplier Payment - PackFast Fulfillment #21,Supplier Payment,Retail-NA,20105.99,0,USD,Wire Transfer,PackFast Fulfillment #21,***6590,,PO-202503-Retail-NA-0012,FALSE,FALSE,REF-324996,First Continental Bank,***9351,"Globex International Holdings, Inc.",US,5818991.04
05/03/2025,05/03/2025,Supplier Payment - PackFast Fulfillment #6,Supplier Payment,Retail-NA,34443.97,0,USD,Wire Transfer,PackFast Fulfillment #6,***8527,,PO-202503-Retail-NA-0002,FALSE,FALSE,REF-542988,First Continental Bank,***4773,"Globex International Holdings, Inc.",US,5784547.07
06/03/2025,06/03/2025,Supplier Payment - NorthRiver Apparel Mfg #23,Supplier Payment,Retail-NA,20191.43,0,USD,Wire Transfer,NorthRiver Apparel Mfg #23,***3578,,PO-202503-Retail-NA-0006,FALSE,FALSE,REF-156549,First Continental Bank,***3557,"Globex International Holdings, Inc.",US,5764355.64
06/03/2025,06/03/2025,Client Receipt - CloudBridge Co. #49,Sales Receipt,SaaS-GL,0,98771.93,USD,ACH Credit,CloudBridge Co. #49,***2258,INV-202503-SaaS-GL-0020,,FALSE,FALSE,REF-489389,First Continental Bank,***1533,"Globex International Holdings, Inc.",US,5863127.57
07/03/2025,07/03/2025,Supplier Payment - CodeCraft Contractors #12,Supplier Payment,SaaS-GL,10649.18,0,USD,Fedwire,CodeCraft Contractors #12,***9058,,PO-202503-SaaS-GL-0002,FALSE,FALSE,REF-970592,First Continental Bank,***6370,"Globex International Holdings, Inc.",US,5852478.39
07/03/2025,07/03/2025,Supplier Payment - CodeCraft Contractors #9,Supplier Payment,SaaS-GL,28495.38,0,USD,ACH Debit,CodeCraft Contractors #9,***9844,,PO-202503-SaaS-GL-0005,FALSE,FALSE,REF-131832,First Continental Bank,***2737,"Globex International Holdings, Inc.",US,5823983.01
07/03/2025,07/03/2025,Supplier Payment - ExpertNet Subcontractors #1,Supplier Payment,PS-GL,36367.5,0,USD,Fedwire,ExpertNet Subcontractors #1,***9809,,PO-202503-PS-GL-0004,FALSE,FALSE,REF-169167,First Continental Bank,***3509,"Globex International Holdings, Inc.",US,5787615.51
08/03/2025,08/03/2025,Client Receipt - Vertex Advisory Client #54,Sales Receipt,PS-GL,0,9359.08,USD,ACH Credit,Vertex Advisory Client #54,***1313,INV-202503-PS-GL-0008,,FALSE,FALSE,REF-627972,First Continental Bank,***2269,"Globex International Holdings, Inc.",US,5796974.59
08/03/2025,08/03/2025,Client Receipt - CloudBridge Co. #51,Sales Receipt,SaaS-GL,0,31641.77,USD,Fedwire Credit,CloudBridge Co. #51,***3515,INV-202503-SaaS-GL-0018,,FALSE,FALSE,REF-162368,First Continental Bank,***5907,"Globex International Holdings, Inc.",US,5828616.36
10/03/2025,10/03/2025,Supplier Payment - HyperCloud Infra #10,Supplier Payment,SaaS-GL,12517.28,0,USD,Wire Transfer,HyperCloud Infra #10,***7743,,PO-202503-SaaS-GL-0003,FALSE,FALSE,REF-315255,First Continental Bank,***6958,"Globex International Holdings, Inc.",US,5816099.08
10/03/2025,10/03/2025,BluePeak Property Mgmt,Rent & Utilities,ALL,24809.81,0,USD,ACH Debit,BluePeak Property Mgmt,***5250,,,FALSE,FALSE,REF-541822,First Continental Bank,***9007,"Globex International Holdings, Inc.",US,5791289.27
10/03/2025,10/03/2025,Supplier Payment - ExpertNet Subcontractors #8,Supplier Payment,PS-GL,32419.49,0,USD,Fedwire,ExpertNet Subcontractors #8,***5401,,PO-202503-PS-GL-0002,FALSE,FALSE,REF-868244,First Continental Bank,***9274,"Globex International Holdings, Inc.",US,5758869.78
11/03/2025,11/03/2025,Client Receipt - CloudBridge Co. #33,Sales Receipt,SaaS-GL,0,7691.47,USD,ACH Credit,CloudBridge Co. #33,***8106,INV-202503-SaaS-GL-0014,,FALSE,FALSE,REF-794745,First Continental Bank,***7193,"Globex International Holdings, Inc.",US,5766561.25
11/03/2025,11/03/2025,Client Receipt - CloudBridge Co. #31,Sales Receipt,SaaS-GL,0,115591.38,USD,ACH Credit,CloudBridge Co. #31,***1594,INV-202503-SaaS-GL-0016,,FALSE,FALSE,REF-504724,First Continental Bank,***8046,"Globex International Holdings, Inc.",US,5882152.63
12/03/2025,12/03/2025,Supplier Payment - HyperCloud Infra #17,Supplier Payment,SaaS-GL,15217.21,0,USD,Fedwire,HyperCloud Infra #17,***4916,,PO-202503-SaaS-GL-0008,FALSE,FALSE,REF-172406,First Continental Bank,***1075,"Globex International Holdings, Inc.",US,5866935.42
12/03/2025,12/03/2025,Supplier Payment - PackFast Fulfillment #8,Supplier Payment,Retail-NA,46565.89,0,USD,Wire Transfer,PackFast Fulfillment #8,***2061,,PO-202503-Retail-NA-0009,FALSE,FALSE,REF-721704,First Continental Bank,***2783,"Globex International Holdings, Inc.",US,5820369.53
12/03/2025,12/03/2025,Intercompany Settlement - Globex EMEA Manufacturing Ltd.,Intercompany Transfer,ALL,811397,0,USD,Internal Transfer,Globex EMEA Manufacturing Ltd.,***7448,,,TRUE,TRUE,REF-526465,First Continental Bank,***3659,"Globex International Holdings, Inc.",US,5008972.53
12/03/2025,12/03/2025,Client Receipt - CloudBridge Co. #60,Sales Receipt,SaaS-GL,0,34182.64,USD,ACH Credit,CloudBridge Co. #60,***2495,INV-202503-SaaS-GL-0005,,FALSE,FALSE,REF-889476,First Continental Bank,***4919,"Globex International Holdings, Inc.",US,5043155.17
12/03/2025,12/03/2025,Client Receipt - CloudBridge Co. #72,Sales Receipt,SaaS-GL,0,62568.99,USD,Card Settlement,CloudBridge Co. #72,***3520,INV-202503-SaaS-GL-0001,,FALSE,FALSE,REF-969298,First Continental Bank,***2457,"Globex International Holdings, Inc.",US,5105724.16
12/03/2025,12/03/2025,Client Receipt - ShopSphere Partner #33,Sales Receipt,Retail-NA,0,78891.42,USD,Fedwire Credit,ShopSphere Partner #33,***1822,INV-202503-Retail-NA-0014,,FALSE,FALSE,REF-943283,First Continental Bank,***7763,"Globex International Holdings, Inc.",US,5184615.58
12/03/2025,12/03/2025,Client Receipt - Vertex Advisory Client #15,Sales Receipt,PS-GL,0,189139.03,USD,Card Settlement,Vertex Advisory Client #15,***1864,INV-202503-PS-GL-0009,,FALSE,FALSE,REF-647422,First Continental Bank,***2763,"Globex International Holdings, Inc.",US,5373754.61
12/03/2025,12/03/2025,Intercompany Reimbursement - Globex EMEA Manufacturing Ltd.,Intercompany Transfer,ALL,0,324558.8,USD,Internal Transfer,Globex EMEA Manufacturing Ltd.,***8198,,,TRUE,TRUE,REF-295491,First Continental Bank,***3052,"Globex International Holdings, Inc.",US,5698313.41
13/03/2025,13/03/2025,Client Receipt - CloudBridge Co. #52,Sales Receipt,SaaS-GL,0,7534.02,USD,Card Settlement,CloudBridge Co. #52,***4030,INV-202503-SaaS-GL-0010,,FALSE,FALSE,REF-874888,First Continental Bank,***1216,"Globex International Holdings, Inc.",US,5705847.43
14/03/2025,14/03/2025,Client Receipt - Card Settlement Batch #17,Sales Receipt,Retail-NA,0,7633.09,USD,ACH Credit,Card Settlement Batch #17,***9819,INV-202503-Retail-NA-0003,,FALSE,FALSE,REF-906416,First Continental Bank,***3733,"Globex International Holdings, Inc.",US,5713480.52
14/03/2025,14/03/2025,Client Receipt - Card Settlement Batch #3,Sales Receipt,Retail-NA,0,52792.52,USD,Card Settlement,Card Settlement Batch #3,***5546,INV-202503-Retail-NA-0011,,FALSE,FALSE,REF-979793,First Continental Bank,***6035,"Globex International Holdings, Inc.",US,5766273.04
15/03/2025,15/03/2025,Loan Interest Payment,Loan Interest,ALL,85000,0,USD,Fedwire,First Continental Bank - Corporate Lending,***8426,,,FALSE,FALSE,REF-582452,First Continental Bank,***7008,"Globex International Holdings, Inc.",US,5681273.04
15/03/2025,15/03/2025,Loan Principal Repayment,Loan Principal,ALL,500000,0,USD,ACH Debit,First Continental Bank - Corporate Lending,***3431,,,FALSE,FALSE,REF-591083,First Continental Bank,***7770,"Globex International Holdings, Inc.",US,5181273.04
15/03/2025,15/03/2025,Client Receipt - ShopSphere Partner #1,Sales Receipt,Retail-NA,0,4677.47,USD,ACH Credit,ShopSphere Partner #1,***4078,INV-202503-Retail-NA-0013,,FALSE,FALSE,REF-225431,First Continental Bank,***1523,"Globex International Holdings, Inc.",US,5185950.51
17/03/2025,17/03/2025,Client Receipt - Vertex Advisory Client #25,Sales Receipt,PS-GL,0,109777.45,USD,Fedwire Credit,Vertex Advisory Client #25,***6115,INV-202503-PS-GL-0006,,FALSE,FALSE,REF-206436,First Continental Bank,***6682,"Globex International Holdings, Inc.",US,5295727.96
18/03/2025,18/03/2025,Supplier Payment - NorthRiver Apparel Mfg #26,Supplier Payment,Retail-NA,129028.45,0,USD,Wire Transfer,NorthRiver Apparel Mfg #26,***4088,,PO-202503-Retail-NA-0003,FALSE,FALSE,REF-807165,First Continental Bank,***2106,"Globex International Holdings, Inc.",US,5166699.51
18/03/2025,18/03/2025,Client Receipt - CloudBridge Co. #77,Sales Receipt,SaaS-GL,0,44717.21,USD,ACH Credit,CloudBridge Co. #77,***3802,INV-202503-SaaS-GL-0008,,FALSE,FALSE,REF-194452,First Continental Bank,***2845,"Globex International Holdings, Inc.",US,5211416.72
18/03/2025,18/03/2025,Client Receipt - ShopSphere Partner #40,Sales Receipt,Retail-NA,0,145342.01,USD,Fedwire Credit,ShopSphere Partner #40,***1077,INV-202503-Retail-NA-0002,,FALSE,FALSE,REF-253244,First Continental Bank,***1528,"Globex International Holdings, Inc.",US,5356758.73
19/03/2025,19/03/2025,Merchant Processing Fees,Bank/Merchant Fees,ALL,1406.54,0,USD,Wire Transfer,First Continental Bank,***7451,,,FALSE,FALSE,REF-260635,First Continental Bank,***4624,"Globex International Holdings, Inc.",US,5355352.19
19/03/2025,19/03/2025,Supplier Payment - HyperCloud Infra #8,Supplier Payment,SaaS-GL,7548.07,0,USD,Wire Transfer,HyperCloud Infra #8,***1764,,PO-202503-SaaS-GL-0009,FALSE,FALSE,REF-507542,First Continental Bank,***7580,"Globex International Holdings, Inc.",US,5347804.12
19/03/2025,19/03/2025,Supplier Payment - HyperCloud Infra #7,Supplier Payment,SaaS-GL,10131.64,0,USD,ACH Debit,HyperCloud Infra #7,***5190,,PO-202503-SaaS-GL-0001,FALSE,FALSE,REF-205205,First Continental Bank,***4229,"Globex International Holdings, Inc.",US,5337672.48
19/03/2025,19/03/2025,Supplier Payment - ExpertNet Subcontractors #19,Supplier Payment,PS-GL,39668.08,0,USD,Fedwire,ExpertNet Subcontractors #19,***3375,,PO-202503-PS-GL-0001,FALSE,FALSE,REF-333192,First Continental Bank,***6044,"Globex International Holdings, Inc.",US,5298004.4
19/03/2025,19/03/2025,Supplier Payment - PackFast Fulfillment #14,Supplier Payment,Retail-NA,59768.45,0,USD,Fedwire,PackFast Fulfillment #14,***7829,,PO-202503-Retail-NA-0010,FALSE,FALSE,REF-489818,First Continental Bank,***1969,"Globex International Holdings, Inc.",US,5238235.95
19/03/2025,19/03/2025,VAT/GST Remittance - US IRS,Tax Payment,ALL,186287.8,0,USD,Fedwire,US IRS,***1280,,,FALSE,FALSE,REF-427346,First Continental Bank,***8336,"Globex International Holdings, Inc.",US,5051948.15
19/03/2025,19/03/2025,Client Receipt - CloudBridge Co. #47,Sales Receipt,SaaS-GL,0,42889.04,USD,ACH Credit,CloudBridge Co. #47,***7853,INV-202503-SaaS-GL-0002,,FALSE,FALSE,REF-907781,First Continental Bank,***9697,"Globex International Holdings, Inc.",US,5094837.19
19/03/2025,19/03/2025,Client Receipt - CloudBridge Co. #58,Sales Receipt,SaaS-GL,0,61394.48,USD,Card Settlement,CloudBridge Co. #58,***8867,INV-202503-SaaS-GL-0013,,FALSE,FALSE,REF-685491,First Continental Bank,***9933,"Globex International Holdings, Inc.",US,5156231.67
20/03/2025,20/03/2025,Merchant Processing Fees,Bank/Merchant Fees,ALL,8351.77,0,USD,Wire Transfer,First Continental Bank,***8892,,,FALSE,FALSE,REF-335613,First Continental Bank,***4797,"Globex International Holdings, Inc.",US,5147879.9
20/03/2025,20/03/2025,Supplier Payment - CodeCraft Contractors #11,Supplier Payment,SaaS-GL,14669.61,0,USD,Wire Transfer,CodeCraft Contractors #11,***6673,,PO-202503-SaaS-GL-0007,FALSE,FALSE,REF-203158,First Continental Bank,***5806,"Globex International Holdings, Inc.",US,5133210.29
20/03/2025,20/03/2025,Supplier Payment - NorthRiver Apparel Mfg #8,Supplier Payment,Retail-NA,20331.5,0,USD,Wire Transfer,NorthRiver Apparel Mfg #8,***5476,,PO-202503-Retail-NA-0008,FALSE,FALSE,REF-870123,First Continental Bank,***2108,"Globex International Holdings, Inc.",US,5112878.79
20/03/2025,20/03/2025,Client Receipt - Vertex Advisory Client #52,Sales Receipt,PS-GL,0,8095.52,USD,Card Settlement,Vertex Advisory Client #52,***5122,INV-202503-PS-GL-0002,,FALSE,FALSE,REF-114324,First Continental Bank,***9420,"Globex International Holdings, Inc.",US,5120974.31
20/03/2025,20/03/2025,Client Receipt - Card Settlement Batch #6,Sales Receipt,Retail-NA,0,8822.7,USD,Card Settlement,Card Settlement Batch #6,***1907,INV-202503-Retail-NA-0008,,FALSE,FALSE,REF-271304,First Continental Bank,***1917,"Globex International Holdings, Inc.",US,5129797.01
21/03/2025,21/03/2025,Supplier Payment - HyperCloud Infra #9,Supplier Payment,SaaS-GL,19697.47,0,USD,ACH Debit,HyperCloud Infra #9,***7410,,PO-202503-SaaS-GL-0004,FALSE,FALSE,REF-222522,First Continental Bank,***5475,"Globex International Holdings, Inc.",US,5110099.54
21/03/2025,21/03/2025,Supplier Payment - NorthRiver Apparel Mfg #28,Supplier Payment,Retail-NA,89840.36,0,USD,Fedwire,NorthRiver Apparel Mfg #28,***1685,,PO-202503-Retail-NA-0001,FALSE,FALSE,REF-120792,First Continental Bank,***3213,"Globex International Holdings, Inc.",US,5020259.18
21/03/2025,21/03/2025,Client Receipt - CloudBridge Co. #56,Sales Receipt,SaaS-GL,0,28130.6,USD,ACH Credit,CloudBridge Co. #56,***4060,INV-202503-SaaS-GL-0021,,FALSE,FALSE,REF-536987,First Continental Bank,***1170,"Globex International Holdings, Inc.",US,5048389.78
23/03/2025,23/03/2025,Client Receipt - CloudBridge Co. #24,Sales Receipt,SaaS-GL,0,42230.88,USD,Card Settlement,CloudBridge Co. #24,***8782,INV-202503-SaaS-GL-0015,,FALSE,FALSE,REF-828395,First Continental Bank,***5568,"Globex International Holdings, Inc.",US,5090620.66
23/03/2025,23/03/2025,Client Receipt - ShopSphere Partner #29,Sales Receipt,Retail-NA,0,135445.92,USD,ACH Credit,ShopSphere Partner #29,***9917,INV-202503-Retail-NA-0001,,FALSE,FALSE,REF-916968,First Continental Bank,***6427,"Globex International Holdings, Inc.",US,5226066.58
24/03/2025,24/03/2025,Supplier Payment - ExpertNet Subcontractors #11,Supplier Payment,PS-GL,45471.37,0,USD,Wire Transfer,ExpertNet Subcontractors #11,***7329,,PO-202503-PS-GL-0003,FALSE,FALSE,REF-577072,First Continental Bank,***7561,"Globex International Holdings, Inc.",US,5180595.21
24/03/2025,24/03/2025,Supplier Payment - NorthRiver Apparel Mfg #32,Supplier Payment,Retail-NA,105201.44,0,USD,ACH Debit,NorthRiver Apparel Mfg #32,***6543,,PO-202503-Retail-NA-0011,FALSE,FALSE,REF-315554,First Continental Bank,***5208,"Globex International Holdings, Inc.",US,5075393.77
24/03/2025,24/03/2025,Supplier Payment - NorthRiver Apparel Mfg #21,Supplier Payment,Retail-NA,121982.97,0,USD,Fedwire,NorthRiver Apparel Mfg #21,***9058,,PO-202503-Retail-NA-0004,FALSE,FALSE,REF-342895,First Continental Bank,***3276,"Globex International Holdings, Inc.",US,4953410.8
24/03/2025,24/03/2025,Client Receipt - CloudBridge Co. #71,Sales Receipt,SaaS-GL,0,83049.55,USD,ACH Credit,CloudBridge Co. #71,***1490,INV-202503-SaaS-GL-0011,,FALSE,FALSE,REF-160726,First Continental Bank,***5883,"Globex International Holdings, Inc.",US,5036460.35
24/03/2025,24/03/2025,Client Receipt - ShopSphere Partner #41,Sales Receipt,Retail-NA,0,123563.21,USD,Card Settlement,ShopSphere Partner #41,***3142,INV-202503-Retail-NA-0012,,FALSE,FALSE,REF-623286,First Continental Bank,***1669,"Globex International Holdings, Inc.",US,5160023.56
25/03/2025,25/03/2025,Supplier Payment - ExpertNet Subcontractors #18,Supplier Payment,PS-GL,28554.45,0,USD,Wire Transfer,ExpertNet Subcontractors #18,***2801,,PO-202503-PS-GL-0005,FALSE,FALSE,REF-511366,First Continental Bank,***1093,"Globex International Holdings, Inc.",US,5131469.11
25/03/2025,25/03/2025,Payroll - GlobalPay Services Ltd,Payroll,ALL,497541.68,0,USD,ACH Debit,GlobalPay Services Ltd,***8706,,,FALSE,FALSE,REF-176867,First Continental Bank,***8733,"Globex International Holdings, Inc.",US,4633927.43
25/03/2025,25/03/2025,Client Receipt - Vertex Advisory Client #29,Sales Receipt,PS-GL,0,30213.97,USD,Card Settlement,Vertex Advisory Client #29,***9221,INV-202503-PS-GL-0001,,FALSE,FALSE,REF-903901,First Continental Bank,***5105,"Globex International Holdings, Inc.",US,4664141.4
25/03/2025,25/03/2025,Client Receipt - ShopSphere Partner #4,Sales Receipt,Retail-NA,0,162029.89,USD,Fedwire Credit,ShopSphere Partner #4,***7812,INV-202503-Retail-NA-0009,,FALSE,FALSE,REF-124356,First Continental Bank,***2582,"Globex International Holdings, Inc.",US,4826171.29
25/03/2025,25/03/2025,Client Receipt - ShopSphere Partner #53,Sales Receipt,Retail-NA,0,353381.14,USD,ACH Credit,ShopSphere Partner #53,***8745,INV-202503-Retail-NA-0006,,FALSE,FALSE,REF-225195,First Continental Bank,***3296,"Globex International Holdings, Inc.",US,5179552.43
26/03/2025,26/03/2025,Intercompany Settlement - Globex APAC Logistics Pte. Ltd.,Intercompany Transfer,ALL,848767,0,USD,Internal Transfer,Globex APAC Logistics Pte. Ltd.,***2984,,,TRUE,TRUE,REF-587814,First Continental Bank,***9798,"Globex International Holdings, Inc.",US,4330785.43
26/03/2025,26/03/2025,Client Receipt - ShopSphere Partner #37,Sales Receipt,Retail-NA,0,26448.36,USD,ACH Credit,ShopSphere Partner #37,***2818,INV-202503-Retail-NA-0004,,FALSE,FALSE,REF-980972,First Continental Bank,***5143,"Globex International Holdings, Inc.",US,4357233.79
26/03/2025,26/03/2025,Client Receipt - Vertex Advisory Client #13,Sales Receipt,PS-GL,0,110957.36,USD,Card Settlement,Vertex Advisory Client #13,***1238,INV-202503-PS-GL-0004,,FALSE,FALSE,REF-205184,First Continental Bank,***3480,"Globex International Holdings, Inc.",US,4468191.15
26/03/2025,26/03/2025,Intercompany Reimbursement - Globex APAC Logistics Pte. Ltd.,Intercompany Transfer,ALL,0,339506.8,USD,Internal Transfer,Globex APAC Logistics Pte. Ltd.,***1360,,,TRUE,TRUE,REF-472218,First Continental Bank,***7794,"Globex International Holdings, Inc.",US,4807697.95
27/03/2025,27/03/2025,Supplier Payment - ExpertNet Subcontractors #9,Supplier Payment,PS-GL,21338.96,0,USD,Wire Transfer,ExpertNet Subcontractors #9,***9566,,PO-202503-PS-GL-0006,FALSE,FALSE,REF-594962,First Continental Bank,***9447,"Globex International Holdings, Inc.",US,4786358.99
27/03/2025,27/03/2025,Supplier Payment - HyperCloud Infra #14,Supplier Payment,SaaS-GL,32128.23,0,USD,Wire Transfer,HyperCloud Infra #14,***8843,,PO-202503-SaaS-GL-0006,FALSE,FALSE,REF-484584,First Continental Bank,***4743,"Globex International Holdings, Inc.",US,4754230.76
27/03/2025,27/03/2025,Client Receipt - CloudBridge Co. #42,Sales Receipt,SaaS-GL,0,14785.71,USD,ACH Credit,CloudBridge Co. #42,***9821,INV-202503-SaaS-GL-0006,,FALSE,FALSE,REF-415224,First Continental Bank,***1557,"Globex International Holdings, Inc.",US,4769016.47
27/03/2025,27/03/2025,Client Receipt - Vertex Advisory Client #56,Sales Receipt,PS-GL,0,43119.88,USD,Fedwire Credit,Vertex Advisory Client #56,***5430,INV-202503-PS-GL-0007,,FALSE,FALSE,REF-232303,First Continental Bank,***3952,"Globex International Holdings, Inc.",US,4812136.35
28/03/2025,28/03/2025,Marketing - Beacon Digital #8,Marketing,ALL,74201.95,0,USD,ACH Debit,Beacon Digital #8,***8122,,,FALSE,FALSE,REF-870316,First Continental Bank,***6290,"Globex International Holdings, Inc.",US,4737934.4
30/03/2025,30/03/2025,Interest Earned,Interest Income,ALL,0,11184,USD,Fedwire Credit,First Continental Bank,***4895,,,FALSE,FALSE,REF-510910,First Continental Bank,***6192,"Globex International Holdings, Inc.",US,4749118.4
30/03/2025,30/03/2025,Client Receipt - CloudBridge Co. #64,Sales Receipt,SaaS-GL,0,87962.24,USD,Card Settlement,CloudBridge Co. #64,***3058,INV-202503-SaaS-GL-0007,,FALSE,FALSE,REF-363390,First Continental Bank,***3219,"Globex International Holdings, Inc.",US,4837080.64
31/03/2025,31/03/2025,Supplier Payment - ExpertNet Subcontractors #3,Supplier Payment,PS-GL,9748.38,0,USD,Fedwire,ExpertNet Subcontractors #3,***6825,,PO-202503-PS-GL-0008,FALSE,FALSE,REF-988193,First Continental Bank,***4994,"Globex International Holdings, Inc.",US,4827332.26
31/03/2025,31/03/2025,Supplier Payment - CodeCraft Contractors #10,Supplier Payment,SaaS-GL,84217.98,0,USD,ACH Debit,CodeCraft Contractors #10,***8245,,PO-202503-SaaS-GL-0010,FALSE,FALSE,REF-659209,First Continental Bank,***5629,"Globex International Holdings, Inc.",US,4743114.28
31/03/2025,31/03/2025,Client Receipt - CloudBridge Co. #13,Sales Receipt,SaaS-GL,0,8493.7,USD,Card Settlement,CloudBridge Co. #13,***5598,INV-202503-SaaS-GL-0003,,FALSE,FALSE,REF-793944,First Continental Bank,***9755,"Globex International Holdings, Inc.",US,4751607.98
31/03/2025,31/03/2025,Client Receipt - ShopSphere Partner #16,Sales Receipt,Retail-NA,0,57350.75,USD,Fedwire Credit,ShopSphere Partner #16,***5605,INV-202503-Retail-NA-0007,,FALSE,FALSE,REF-658609,First Continental Bank,***1991,"Globex International Holdings, Inc.",US,4808958.73
31/03/2025,31/03/2025,Client Receipt - CloudBridge Co. #21,Sales Receipt,SaaS-GL,0,58553.51,USD,Fedwire Credit,CloudBridge Co. #21,***3495,INV-202503-SaaS-GL-0017,,FALSE,FALSE,REF-707890,First Continental Bank,***6918,"Globex International Holdings, Inc.",US,4867512.24
31/03/2025,31/03/2025,Client Receipt - CloudBridge Co. #38,Sales Receipt,SaaS-GL,0,80828.46,USD,ACH Credit,CloudBridge Co. #38,***7446,INV-202503-SaaS-GL-0004,,FALSE,FALSE,REF-198355,First Continental Bank,***5697,"Globex International Holdings, Inc.",US,4948340.7
01/04/2025,01/04/2025,Account Maintenance Fee,Bank/Merchant Fees,ALL,2500,0,USD,ACH Debit,First Continental Bank,***9084,,,FALSE,FALSE,REF-511523,First Continental Bank,***7209,"Globex International Holdings, Inc.",US,4945840.7
01/04/2025,01/04/2025,Supplier Payment - CodeCraft Contractors #11,Supplier Payment,SaaS-GL,30426.34,0,USD,Fedwire,CodeCraft Contractors #11,***3668,,PO-202504-SaaS-GL-0004,FALSE,FALSE,REF-265038,First Continental Bank,***4218,"Globex International Holdings, Inc.",US,4915414.36
01/04/2025,01/04/2025,Client Receipt - ShopSphere Partner #10,Sales Receipt,Retail-NA,0,8327.98,USD,ACH Credit,ShopSphere Partner #10,***4718,INV-202504-Retail-NA-0006,,FALSE,FALSE,REF-624075,First Continental Bank,***4500,"Globex International Holdings, Inc.",US,4923742.34
01/04/2025,01/04/2025,Client Receipt - CloudBridge Co. #32,Sales Receipt,SaaS-GL,0,101075.27,USD,Fedwire Credit,CloudBridge Co. #32,***4672,INV-202504-SaaS-GL-0020,,FALSE,FALSE,REF-372702,First Continental Bank,***9877,"Globex International Holdings, Inc.",US,5024817.61
02/04/2025,02/04/2025,Supplier Payment - HyperCloud Infra #17,Supplier Payment,SaaS-GL,11561.68,0,USD,ACH Debit,HyperCloud Infra #17,***2399,,PO-202504-SaaS-GL-0002,FALSE,FALSE,REF-256919,First Continental Bank,***7991,"Globex International Holdings, Inc.",US,5013255.93
02/04/2025,02/04/2025,Client Receipt - CloudBridge Co. #3,Sales Receipt,SaaS-GL,0,5315.84,USD,Fedwire Credit,CloudBridge Co. #3,***9138,INV-202504-SaaS-GL-0014,,FALSE,FALSE,REF-882023,First Continental Bank,***7681,"Globex International Holdings, Inc.",US,5018571.77
02/04/2025,02/04/2025,Client Receipt - ShopSphere Partner #16,Sales Receipt,Retail-NA,0,35179.68,USD,Card Settlement,ShopSphere Partner #16,***9969,INV-202504-Retail-NA-0013,,FALSE,FALSE,REF-454952,First Continental Bank,***1205,"Globex International Holdings, Inc.",US,5053751.45
02/04/2025,02/04/2025,Client Receipt - CloudBridge Co. #37,Sales Receipt,SaaS-GL,0,48447.57,USD,Fedwire Credit,CloudBridge Co. #37,***1086,INV-202504-SaaS-GL-0010,,FALSE,FALSE,REF-422286,First Continental Bank,***9569,"Globex International Holdings, Inc.",US,5102199.02
03/04/2025,03/04/2025,Supplier Payment - CodeCraft Contractors #1,Supplier Payment,SaaS-GL,20952.44,0,USD,Wire Transfer,CodeCraft Contractors #1,***4100,,PO-202504-SaaS-GL-0005,FALSE,FALSE,REF-131513,First Continental Bank,***9355,"Globex International Holdings, Inc.",US,5081246.58
03/04/2025,03/04/2025,Supplier Payment - CodeCraft Contractors #8,Supplier Payment,SaaS-GL,23612.81,0,USD,Wire Transfer,CodeCraft Contractors #8,***1723,,PO-202504-SaaS-GL-0007,FALSE,FALSE,REF-261637,First Continental Bank,***3824,"Globex International Holdings, Inc.",US,5057633.77
03/04/2025,03/04/2025,Supplier Payment - ExpertNet Subcontractors #4,Supplier Payment,PS-GL,28617.27,0,USD,ACH Debit,ExpertNet Subcontractors #4,***4663,,PO-202504-PS-GL-0006,FALSE,FALSE,REF-630193,First Continental Bank,***1155,"Globex International Holdings, Inc.",US,5029016.5
03/04/2025,03/04/2025,Supplier Payment - NorthRiver Apparel Mfg #7,Supplier Payment,Retail-NA,45631.33,0,USD,Fedwire,NorthRiver Apparel Mfg #7,***5386,,PO-202504-Retail-NA-0004,FALSE,FALSE,REF-388135,First Continental Bank,***3708,"Globex International Holdings, Inc.",US,4983385.17
03/04/2025,03/04/2025,Supplier Payment - NorthRiver Apparel Mfg #2,Supplier Payment,Retail-NA,76527.12,0,USD,ACH Debit,NorthRiver Apparel Mfg #2,***2341,,PO-202504-Retail-NA-0002,FALSE,FALSE,REF-786977,First Continental Bank,***1961,"Globex International Holdings, Inc.",US,4906858.05
03/04/2025,03/04/2025,Client Receipt - CloudBridge Co. #12,Sales Receipt,SaaS-GL,0,8318.82,USD,ACH Credit,CloudBridge Co. #12,***1047,INV-202504-SaaS-GL-0028,,FALSE,FALSE,REF-135363,First Continental Bank,***7226,"Globex International Holdings, Inc.",US,4915176.87
04/04/2025,04/04/2025,Marketing - Aurelia Media #7,Marketing,ALL,28538.92,0,USD,Wire Transfer,Aurelia Media #7,***8905,,,FALSE,FALSE,REF-124067,First Continental Bank,***9001,"Globex International Holdings, Inc.",US,4886637.95
04/04/2025,04/04/2025,Supplier Payment - HyperCloud Infra #7,Supplier Payment,SaaS-GL,39010.06,0,USD,ACH Debit,HyperCloud Infra #7,***9637,,PO-202504-SaaS-GL-0011,FALSE,FALSE,REF-686611,First Continental Bank,***5206,"Globex International Holdings, Inc.",US,4847627.89
04/04/2025,04/04/2025,Client Receipt - CloudBridge Co. #50,Sales Receipt,SaaS-GL,0,3151.7,USD,ACH Credit,CloudBridge Co. #50,***6227,INV-202504-SaaS-GL-0005,,FALSE,FALSE,REF-551576,First Continental Bank,***3601,"Globex International Holdings, Inc.",US,4850779.59
04/04/2025,04/04/2025,Client Receipt - CloudBridge Co. #2,Sales Receipt,SaaS-GL,0,20100.23,USD,Fedwire Credit,CloudBridge Co. #2,***1750,INV-202504-SaaS-GL-0003,,FALSE,FALSE,REF-800571,First Continental Bank,***1657,"Globex International Holdings, Inc.",US,4870879.82
05/04/2025,05/04/2025,Client Receipt - ShopSphere Partner #7,Sales Receipt,Retail-NA,0,60555.85,USD,ACH Credit,ShopSphere Partner #7,***6126,INV-202504-Retail-NA-0004,,FALSE,FALSE,REF-549079,First Continental Bank,***9343,"Globex International Holdings, Inc.",US,4931435.67
07/04/2025,07/04/2025,Client Receipt - Vertex Advisory Client #20,Sales Receipt,PS-GL,0,56140.45,USD,Card Settlement,Vertex Advisory Client #20,***3309,INV-202504-PS-GL-0006,,FALSE,FALSE,REF-770696,First Continental Bank,***2169,"Globex International Holdings, Inc.",US,4987576.12
08/04/2025,08/04/2025,Client Receipt - CloudBridge Co. #25,Sales Receipt,SaaS-GL,0,3096.28,USD,Fedwire Credit,CloudBridge Co. #25,***1954,INV-202504-SaaS-GL-0019,,FALSE,FALSE,REF-972458,First Continental Bank,***6271,"Globex International Holdings, Inc.",US,4990672.4
09/04/2025,09/04/2025,Client Receipt - CloudBridge Co. #44,Sales Receipt,SaaS-GL,0,8053.93,USD,ACH Credit,CloudBridge Co. #44,***4068,INV-202504-SaaS-GL-0033,,FALSE,FALSE,REF-792303,First Continental Bank,***1037,"Globex International Holdings, Inc.",US,4998726.33
09/04/2025,09/04/2025,Client Receipt - CloudBridge Co. #62,Sales Receipt,SaaS-GL,0,74663.61,USD,Fedwire Credit,CloudBridge Co. #62,***5768,INV-202504-SaaS-GL-0011,,FALSE,FALSE,REF-984499,First Continental Bank,***3635,"Globex International Holdings, Inc.",US,5073389.94
10/04/2025,10/04/2025,Supplier Payment - ExpertNet Subcontractors #15,Supplier Payment,PS-GL,32073.1,0,USD,Fedwire,ExpertNet Subcontractors #15,***4046,,PO-202504-PS-GL-0003,FALSE,FALSE,REF-547080,First Continental Bank,***3495,"Globex International Holdings, Inc.",US,5041316.84
10/04/2025,10/04/2025,Marketing - Beacon Digital #5,Marketing,ALL,42572.28,0,USD,Wire Transfer,Beacon Digital #5,***8933,,,FALSE,FALSE,REF-766372,First Continental Bank,***2996,"Globex International Holdings, Inc.",US,4998744.56
10/04/2025,10/04/2025,Client Receipt - Vertex Advisory Client #18,Sales Receipt,PS-GL,0,14598.33,USD,Card Settlement,Vertex Advisory Client #18,***3850,INV-202504-PS-GL-0008,,FALSE,FALSE,REF-194767,First Continental Bank,***6110,"Globex International Holdings, Inc.",US,5013342.89
10/04/2025,10/04/2025,Client Receipt - ShopSphere Partner #70,Sales Receipt,Retail-NA,0,20333.49,USD,Card Settlement,ShopSphere Partner #70,***7320,INV-202504-Retail-NA-0014,,FALSE,FALSE,REF-756700,First Continental Bank,***5259,"Globex International Holdings, Inc.",US,5033676.38
10/04/2025,10/04/2025,Client Receipt - Card Settlement Batch #17,Sales Receipt,Retail-NA,0,127129.25,USD,ACH Credit,Card Settlement Batch #17,***9233,INV-202504-Retail-NA-0005,,FALSE,FALSE,REF-534544,First Continental Bank,***4265,"Globex International Holdings, Inc.",US,5160805.63
10/04/2025,10/04/2025,Client Receipt - CloudBridge Co. #17,Sales Receipt,SaaS-GL,0,128895.25,USD,Card Settlement,CloudBridge Co. #17,***6515,INV-202504-SaaS-GL-0013,,FALSE,FALSE,REF-716424,First Continental Bank,***9540,"Globex International Holdings, Inc.",US,5289700.88
10/04/2025,10/04/2025,Client Receipt - ShopSphere Partner #2,Sales Receipt,Retail-NA,0,159085.77,USD,ACH Credit,ShopSphere Partner #2,***5336,INV-202504-Retail-NA-0002,,FALSE,FALSE,REF-495201,First Continental Bank,***2905,"Globex International Holdings, Inc.",US,5448786.65
10/04/2025,10/04/2025,Client Receipt - Card Settlement Batch #24,Sales Receipt,Retail-NA,0,176787.08,USD,Fedwire Credit,Card Settlement Batch #24,***2720,INV-202504-Retail-NA-0001,,FALSE,FALSE,REF-869753,First Continental Bank,***8563,"Globex International Holdings, Inc.",US,5625573.73
11/04/2025,11/04/2025,Supplier Payment - HyperCloud Infra #9,Supplier Payment,SaaS-GL,5938.29,0,USD,ACH Debit,HyperCloud Infra #9,***3684,,PO-202504-SaaS-GL-0008,FALSE,FALSE,REF-447057,First Continental Bank,***7651,"Globex International Holdings, Inc.",US,5619635.44
11/04/2025,11/04/2025,Marketing - Beacon Digital #3,Marketing,ALL,9041.39,0,USD,Fedwire,Beacon Digital #3,***8025,,,FALSE,FALSE,REF-641041,First Continental Bank,***4923,"Globex International Holdings, Inc.",US,5610594.05
12/04/2025,12/04/2025,Supplier Payment - NorthRiver Apparel Mfg #8,Supplier Payment,Retail-NA,24249.13,0,USD,Fedwire,NorthRiver Apparel Mfg #8,***3528,,PO-202504-Retail-NA-0001,FALSE,FALSE,REF-278488,First Continental Bank,***5216,"Globex International Holdings, Inc.",US,5586344.92
12/04/2025,12/04/2025,Intercompany Settlement - Globex APAC Logistics Pte. Ltd.,Intercompany Transfer,ALL,336115,0,USD,Internal Transfer,Globex APAC Logistics Pte. Ltd.,***5037,,,TRUE,TRUE,REF-274967,First Continental Bank,***7629,"Globex International Holdings, Inc.",US,5250229.92
12/04/2025,12/04/2025,Client Receipt - CloudBridge Co. #9,Sales Receipt,SaaS-GL,0,55611.75,USD,Fedwire Credit,CloudBridge Co. #9,***4761,INV-202504-SaaS-GL-0025,,FALSE,FALSE,REF-401428,First Continental Bank,***3559,"Globex International Holdings, Inc.",US,5305841.67
14/04/2025,14/04/2025,Alphagrid Utilities,Rent & Utilities,ALL,7679.46,0,USD,Fedwire,Alphagrid Utilities,***2804,,,FALSE,FALSE,REF-279639,First Continental Bank,***4640,"Globex International Holdings, Inc.",US,5298162.21
14/04/2025,14/04/2025,Supplier Payment - NorthRiver Apparel Mfg #18,Supplier Payment,Retail-NA,172040.14,0,USD,Fedwire,NorthRiver Apparel Mfg #18,***5689,,PO-202504-Retail-NA-0009,FALSE,FALSE,REF-874024,First Continental Bank,***2489,"Globex International Holdings, Inc.",US,5126122.07
14/04/2025,14/04/2025,Client Receipt - Vertex Advisory Client #54,Sales Receipt,PS-GL,0,177286.24,USD,ACH Credit,Vertex Advisory Client #54,***8246,INV-202504-PS-GL-0002,,FALSE,FALSE,REF-874944,First Continental Bank,***1761,"Globex International Holdings, Inc.",US,5303408.31
15/04/2025,15/04/2025,Supplier Payment - HyperCloud Infra #1,Supplier Payment,SaaS-GL,22249.69,0,USD,Fedwire,HyperCloud Infra #1,***5907,,PO-202504-SaaS-GL-0010,FALSE,FALSE,REF-401562,First Continental Bank,***4410,"Globex International Holdings, Inc.",US,5281158.62
15/04/2025,15/04/2025,Loan Interest Payment,Loan Interest,ALL,85000,0,USD,Wire Transfer,First Continental Bank - Corporate Lending,***9091,,,FALSE,FALSE,REF-251372,First Continental Bank,***2982,"Globex International Holdings, Inc.",US,5196158.62
15/04/2025,15/04/2025,Loan Principal Repayment,Loan Principal,ALL,500000,0,USD,Fedwire,First Continental Bank - Corporate Lending,***4980,,,FALSE,FALSE,REF-908805,First Continental Bank,***5995,"Globex International Holdings, Inc.",US,4696158.62
15/04/2025,15/04/2025,Client Receipt - CloudBridge Co. #18,Sales Receipt,SaaS-GL,0,27526.01,USD,ACH Credit,CloudBridge Co. #18,***2488,INV-202504-SaaS-GL-0021,,FALSE,FALSE,REF-304074,First Continental Bank,***7763,"Globex International Holdings, Inc.",US,4723684.63
15/04/2025,15/04/2025,Client Receipt - CloudBridge Co. #62,Sales Receipt,SaaS-GL,0,76120.28,USD,Fedwire Credit,CloudBridge Co. #62,***9225,INV-202504-SaaS-GL-0027,,FALSE,FALSE,REF-707754,First Continental Bank,***5900,"Globex International Holdings, Inc.",US,4799804.91
15/04/2025,15/04/2025,Client Receipt - Vertex Advisory Client #56,Sales Receipt,PS-GL,0,95629.48,USD,Card Settlement,Vertex Advisory Client #56,***8388,INV-202504-PS-GL-0007,,FALSE,FALSE,REF-207632,First Continental Bank,***8288,"Globex International Holdings, Inc.",US,4895434.39
15/04/2025,15/04/2025,Client Receipt - Vertex Advisory Client #44,Sales Receipt,PS-GL,0,166271.25,USD,Card Settlement,Vertex Advisory Client #44,***8401,INV-202504-PS-GL-0004,,FALSE,FALSE,REF-923572,First Continental Bank,***8387,"Globex International Holdings, Inc.",US,5061705.64
16/04/2025,16/04/2025,Supplier Payment - ExpertNet Subcontractors #14,Supplier Payment,PS-GL,16208.2,0,USD,Wire Transfer,ExpertNet Subcontractors #14,***8157,,PO-202504-PS-GL-0002,FALSE,FALSE,REF-584683,First Continental Bank,***9802,"Globex International Holdings, Inc.",US,5045497.44
16/04/2025,16/04/2025,Supplier Payment - PackFast Fulfillment #1,Supplier Payment,Retail-NA,48293.4,0,USD,Fedwire,PackFast Fulfillment #1,***9387,,PO-202504-Retail-NA-0010,FALSE,FALSE,REF-229643,First Continental Bank,***7904,"Globex International Holdings, Inc.",US,4997204.04
16/04/2025,16/04/2025,Client Receipt - CloudBridge Co. #11,Sales Receipt,SaaS-GL,0,10905.8,USD,ACH Credit,CloudBridge Co. #11,***5650,INV-202504-SaaS-GL-0012,,FALSE,FALSE,REF-625804,First Continental Bank,***1729,"Globex International Holdings, Inc.",US,5008109.84
16/04/2025,16/04/2025,Client Receipt - CloudBridge Co. #74,Sales Receipt,SaaS-GL,0,16707.25,USD,Card Settlement,CloudBridge Co. #74,***6877,INV-202504-SaaS-GL-0007,,FALSE,FALSE,REF-618319,First Continental Bank,***1767,"Globex International Holdings, Inc.",US,5024817.09
16/04/2025,16/04/2025,Client Receipt - CloudBridge Co. #31,Sales Receipt,SaaS-GL,0,40409.73,USD,ACH Credit,CloudBridge Co. #31,***8870,INV-202504-SaaS-GL-0001,,FALSE,FALSE,REF-196373,First Continental Bank,***3484,"Globex International Holdings, Inc.",US,5065226.82
17/04/2025,17/04/2025,Supplier Payment - ExpertNet Subcontractors #15,Supplier Payment,PS-GL,11845.26,0,USD,Fedwire,ExpertNet Subcontractors #15,***1592,,PO-202504-PS-GL-0005,FALSE,FALSE,REF-565113,First Continental Bank,***4633,"Globex International Holdings, Inc.",US,5053381.56
17/04/2025,17/04/2025,Client Receipt - Vertex Advisory Client #25,Sales Receipt,PS-GL,0,19061.26,USD,Fedwire Credit,Vertex Advisory Client #25,***6092,INV-202504-PS-GL-0005,,FALSE,FALSE,REF-420573,First Continental Bank,***1915,"Globex International Holdings, Inc.",US,5072442.82
18/04/2025,18/04/2025,VAT/GST Remittance - US IRS,Tax Payment,ALL,196301.62,0,USD,Fedwire,US IRS,***7363,,,FALSE,FALSE,REF-215911,First Continental Bank,***6986,"Globex International Holdings, Inc.",US,4876141.2
18/04/2025,18/04/2025,Client Receipt - CloudBridge Co. #69,Sales Receipt,SaaS-GL,0,17946.84,USD,ACH Credit,CloudBridge Co. #69,***1308,INV-202504-SaaS-GL-0009,,FALSE,FALSE,REF-391425,First Continental Bank,***1027,"Globex International Holdings, Inc.",US,4894088.04
18/04/2025,18/04/2025,Client Receipt - CloudBridge Co. #64,Sales Receipt,SaaS-GL,0,21471.06,USD,ACH Credit,CloudBridge Co. #64,***5696,INV-202504-SaaS-GL-0030,,FALSE,FALSE,REF-442121,First Continental Bank,***4694,"Globex International Holdings, Inc.",US,4915559.1
18/04/2025,18/04/2025,Client Receipt - CloudBridge Co. #15,Sales Receipt,SaaS-GL,0,46660.42,USD,Fedwire Credit,CloudBridge Co. #15,***1308,INV-202504-SaaS-GL-0008,,FALSE,FALSE,REF-123935,First Continental Bank,***6513,"Globex International Holdings, Inc.",US,4962219.52
19/04/2025,19/04/2025,Supplier Payment - HyperCloud Infra #17,Supplier Payment,SaaS-GL,20444.25,0,USD,Fedwire,HyperCloud Infra #17,***3458,,PO-202504-SaaS-GL-0012,FALSE,FALSE,REF-731994,First Continental Bank,***2985,"Globex International Holdings, Inc.",US,4941775.27
19/04/2025,19/04/2025,Supplier Payment - NorthRiver Apparel Mfg #34,Supplier Payment,Retail-NA,25379.19,0,USD,Fedwire,NorthRiver Apparel Mfg #34,***9832,,PO-202504-Retail-NA-0007,FALSE,FALSE,REF-746995,First Continental Bank,***2082,"Globex International Holdings, Inc.",US,4916396.08
19/04/2025,19/04/2025,Client Receipt - Card Settlement Batch #17,Sales Receipt,Retail-NA,0,184369.68,USD,Card Settlement,Card Settlement Batch #17,***1186,INV-202504-Retail-NA-0015,,FALSE,FALSE,REF-343624,First Continental Bank,***9075,"Globex International Holdings, Inc.",US,5100765.76
20/04/2025,20/04/2025,Client Receipt - ShopSphere Partner #2,Sales Receipt,Retail-NA,0,13242.38,USD,Card Settlement,ShopSphere Partner #2,***2134,INV-202504-Retail-NA-0008,,FALSE,FALSE,REF-282372,First Continental Bank,***8962,"Globex International Holdings, Inc.",US,5114008.14
21/04/2025,21/04/2025,Supplier Payment - NorthRiver Apparel Mfg #25,Supplier Payment,Retail-NA,67603.27,0,USD,Wire Transfer,NorthRiver Apparel Mfg #25,***6727,,PO-202504-Retail-NA-0003,FALSE,FALSE,REF-972284,First Continental Bank,***4600,"Globex International Holdings, Inc.",US,5046404.87
21/04/2025,21/04/2025,Client Receipt - CloudBridge Co. #68,Sales Receipt,SaaS-GL,0,41984.28,USD,ACH Credit,CloudBridge Co. #68,***4425,INV-202504-SaaS-GL-0032,,FALSE,FALSE,REF-418333,First Continental Bank,***5403,"Globex International Holdings, Inc.",US,5088389.15
21/04/2025,21/04/2025,Client Receipt - CloudBridge Co. #51,Sales Receipt,SaaS-GL,0,53200.19,USD,Card Settlement,CloudBridge Co. #51,***6348,INV-202504-SaaS-GL-0024,,FALSE,FALSE,REF-915689,First Continental Bank,***2445,"Globex International Holdings, Inc.",US,5141589.34
22/04/2025,22/04/2025,Supplier Payment - NorthRiver Apparel Mfg #7,Supplier Payment,Retail-NA,109572.08,0,USD,Wire Transfer,NorthRiver Apparel Mfg #7,***9636,,PO-202504-Retail-NA-0011,FALSE,FALSE,REF-550636,First Continental Bank,***9271,"Globex International Holdings, Inc.",US,5032017.26
22/04/2025,22/04/2025,Client Receipt - CloudBridge Co. #28,Sales Receipt,SaaS-GL,0,36872.77,USD,ACH Credit,CloudBridge Co. #28,***6644,INV-202504-SaaS-GL-0016,,FALSE,FALSE,REF-203918,First Continental Bank,***1012,"Globex International Holdings, Inc.",US,5068890.03
22/04/2025,22/04/2025,Client Receipt - ShopSphere Partner #74,Sales Receipt,Retail-NA,0,60990.7,USD,ACH Credit,ShopSphere Partner #74,***1034,INV-202504-Retail-NA-0003,,FALSE,FALSE,REF-143449,First Continental Bank,***3166,"Globex International Holdings, Inc.",US,5129880.73
23/04/2025,23/04/2025,Supplier Payment - CodeCraft Contractors #6,Supplier Payment,SaaS-GL,416.34,0,USD,Fedwire,CodeCraft Contractors #6,***3740,,PO-202504-SaaS-GL-0006,FALSE,FALSE,REF-859909,First Continental Bank,***3281,"Globex International Holdings, Inc.",US,5129464.39
23/04/2025,23/04/2025,Supplier Payment - CodeCraft Contractors #4,Supplier Payment,SaaS-GL,26438.21,0,USD,Fedwire,CodeCraft Contractors #4,***9729,,PO-202504-SaaS-GL-0003,FALSE,FALSE,REF-459466,First Continental Bank,***7561,"Globex International Holdings, Inc.",US,5103026.18
23/04/2025,23/04/2025,Supplier Payment - HyperCloud Infra #12,Supplier Payment,SaaS-GL,37371.58,0,USD,ACH Debit,HyperCloud Infra #12,***9703,,PO-202504-SaaS-GL-0001,FALSE,FALSE,REF-392380,First Continental Bank,***6395,"Globex International Holdings, Inc.",US,5065654.6
23/04/2025,23/04/2025,Supplier Payment - ExpertNet Subcontractors #7,Supplier Payment,PS-GL,50669.43,0,USD,Fedwire,ExpertNet Subcontractors #7,***7063,,PO-202504-PS-GL-0004,FALSE,FALSE,REF-994852,First Continental Bank,***5118,"Globex International Holdings, Inc.",US,5014985.17
23/04/2025,23/04/2025,Client Receipt - CloudBridge Co. #53,Sales Receipt,SaaS-GL,0,724.33,USD,Fedwire Credit,CloudBridge Co. #53,***1885,INV-202504-SaaS-GL-0004,,FALSE,FALSE,REF-129619,First Continental Bank,***7744,"Globex International Holdings, Inc.",US,5015709.5
23/04/2025,23/04/2025,Client Receipt - CloudBridge Co. #28,Sales Receipt,SaaS-GL,0,14844.09,USD,ACH Credit,CloudBridge Co. #28,***9098,INV-202504-SaaS-GL-0017,,FALSE,FALSE,REF-115572,First Continental Bank,***9601,"Globex International Holdings, Inc.",US,5030553.59
23/04/2025,23/04/2025,Client Receipt - CloudBridge Co. #31,Sales Receipt,SaaS-GL,0,23033.13,USD,Card Settlement,CloudBridge Co. #31,***1464,INV-202504-SaaS-GL-0022,,FALSE,FALSE,REF-151772,First Continental Bank,***1054,"Globex International Holdings, Inc.",US,5053586.72
23/04/2025,23/04/2025,Client Receipt - CloudBridge Co. #75,Sales Receipt,SaaS-GL,0,27114.32,USD,Fedwire Credit,CloudBridge Co. #75,***9790,INV-202504-SaaS-GL-0006,,FALSE,FALSE,REF-925666,First Continental Bank,***1182,"Globex International Holdings, Inc.",US,5080701.04
24/04/2025,24/04/2025,Supplier Payment - ExpertNet Subcontractors #14,Supplier Payment,PS-GL,3756.9,0,USD,Fedwire,ExpertNet Subcontractors #14,***2407,,PO-202504-PS-GL-0001,FALSE,FALSE,REF-687385,First Continental Bank,***8312,"Globex International Holdings, Inc.",US,5076944.14
24/04/2025,24/04/2025,Merchant Processing Fees,Bank/Merchant Fees,ALL,5915.34,0,USD,Fedwire,First Continental Bank,***2548,,,FALSE,FALSE,REF-386642,First Continental Bank,***8591,"Globex International Holdings, Inc.",US,5071028.8
24/04/2025,24/04/2025,Supplier Payment - ExpertNet Subcontractors #5,Supplier Payment,PS-GL,15786.34,0,USD,Fedwire,ExpertNet Subcontractors #5,***8485,,PO-202504-PS-GL-0007,FALSE,FALSE,REF-399642,First Continental Bank,***5047,"Globex International Holdings, Inc.",US,5055242.46
24/04/2025,24/04/2025,Supplier Payment - NorthRiver Apparel Mfg #11,Supplier Payment,Retail-NA,56602.97,0,USD,ACH Debit,NorthRiver Apparel Mfg #11,***3579,,PO-202504-Retail-NA-0008,FALSE,FALSE,REF-417827,First Continental Bank,***4586,"Globex International Holdings, Inc.",US,4998639.49
24/04/2025,24/04/2025,Client Receipt - CloudBridge Co. #26,Sales Receipt,SaaS-GL,0,5413.33,USD,Card Settlement,CloudBridge Co. #26,***1959,INV-202504-SaaS-GL-0034,,FALSE,FALSE,REF-891446,First Continental Bank,***6954,"Globex International Holdings, Inc.",US,5004052.82
24/04/2025,24/04/2025,Client Receipt - ShopSphere Partner #61,Sales Receipt,Retail-NA,0,51712.24,USD,Fedwire Credit,ShopSphere Partner #61,***3252,INV-202504-Retail-NA-0012,,FALSE,FALSE,REF-247410,First Continental Bank,***9074,"Globex International Holdings, Inc.",US,5055765.06
24/04/2025,24/04/2025,Client Receipt - ShopSphere Partner #77,Sales Receipt,Retail-NA,0,59243.11,USD,Fedwire Credit,ShopSphere Partner #77,***3626,INV-202504-Retail-NA-0010,,FALSE,FALSE,REF-940391,First Continental Bank,***2557,"Globex International Holdings, Inc.",US,5115008.17
26/04/2025,26/04/2025,Intercompany Settlement - Globex APAC Logistics Pte. Ltd.,Intercompany Transfer,ALL,831598,0,USD,Internal Transfer,Globex APAC Logistics Pte. Ltd.,***3625,,,TRUE,TRUE,REF-271123,First Continental Bank,***6799,"Globex International Holdings, Inc.",US,4283410.17
26/04/2025,26/04/2025,Client Receipt - Card Settlement Batch #13,Sales Receipt,Retail-NA,0,16334.72,USD,ACH Credit,Card Settlement Batch #13,***7915,INV-202504-Retail-NA-0007,,FALSE,FALSE,REF-485171,First Continental Bank,***5448,"Globex International Holdings, Inc.",US,4299744.89
26/04/2025,26/04/2025,Client Receipt - ShopSphere Partner #51,Sales Receipt,Retail-NA,0,350667.28,USD,Fedwire Credit,ShopSphere Partner #51,***1477,INV-202504-Retail-NA-0009,,FALSE,FALSE,REF-845119,First Continental Bank,***6578,"Globex International Holdings, Inc.",US,4650412.17
27/04/2025,27/04/2025,Supplier Payment - NorthRiver Apparel Mfg #1,Supplier Payment,Retail-NA,23034.51,0,USD,Wire Transfer,NorthRiver Apparel Mfg #1,***9033,,PO-202504-Retail-NA-0006,FALSE,FALSE,REF-293331,First Continental Bank,***2740,"Globex International Holdings, Inc.",US,4627377.66
27/04/2025,27/04/2025,Payroll - GlobalPay Services Ltd,Payroll,ALL,258227.67,0,USD,Fedwire,GlobalPay Services Ltd,***8549,,,FALSE,FALSE,REF-586193,First Continental Bank,***6253,"Globex International Holdings, Inc.",US,4369149.99
27/04/2025,27/04/2025,Payroll - GlobalPay Services Ltd,Payroll,ALL,258227.67,0,USD,ACH Debit,GlobalPay Services Ltd,***6450,,,FALSE,FALSE,REF-757611,First Continental Bank,***2683,"Globex International Holdings, Inc.",US,4110922.32
28/04/2025,28/04/2025,Alphagrid Utilities,Rent & Utilities,ALL,18448.87,0,USD,Fedwire,Alphagrid Utilities,***2820,,,FALSE,FALSE,REF-220474,First Continental Bank,***6615,"Globex International Holdings, Inc.",US,4092473.45
28/04/2025,28/04/2025,Supplier Payment - NorthRiver Apparel Mfg #32,Supplier Payment,Retail-NA,107789.81,0,USD,Wire Transfer,NorthRiver Apparel Mfg #32,***1914,,PO-202504-Retail-NA-0005,FALSE,FALSE,REF-831715,First Continental Bank,***7103,"Globex International Holdings, Inc.",US,3984683.64
28/04/2025,28/04/2025,Corporate Tax Estimate,Tax Payment,ALL,152240.27,0,USD,ACH Debit,US IRS,***3719,,,FALSE,FALSE,REF-359228,First Continental Bank,***1365,"Globex International Holdings, Inc.",US,3832443.37
28/04/2025,28/04/2025,Client Receipt - CloudBridge Co. #53,Sales Receipt,SaaS-GL,0,2969,USD,ACH Credit,CloudBridge Co. #53,***7957,INV-202504-SaaS-GL-0023,,FALSE,FALSE,REF-299262,First Continental Bank,***1047,"Globex International Holdings, Inc.",US,3835412.37
28/04/2025,28/04/2025,Client Receipt - CloudBridge Co. #74,Sales Receipt,SaaS-GL,0,7728.38,USD,Fedwire Credit,CloudBridge Co. #74,***3528,INV-202504-SaaS-GL-0015,,FALSE,FALSE,REF-123279,First Continental Bank,***8320,"Globex International Holdings, Inc.",US,3843140.75
28/04/2025,28/04/2025,Client Receipt - CloudBridge Co. #56,Sales Receipt,SaaS-GL,0,8720.04,USD,ACH Credit,CloudBridge Co. #56,***9986,INV-202504-SaaS-GL-0029,,FALSE,FALSE,REF-389678,First Continental Bank,***6310,"Globex International Holdings, Inc.",US,3851860.79
28/04/2025,28/04/2025,Client Receipt - Vertex Advisory Client #47,Sales Receipt,PS-GL,0,23929.65,USD,Card Settlement,Vertex Advisory Client #47,***5394,INV-202504-PS-GL-0001,,FALSE,FALSE,REF-344347,First Continental Bank,***9888,"Globex International Holdings, Inc.",US,3875790.44
28/04/2025,28/04/2025,Client Receipt - CloudBridge Co. #66,Sales Receipt,SaaS-GL,0,31474.36,USD,ACH Credit,CloudBridge Co. #66,***2881,INV-202504-SaaS-GL-0018,,FALSE,FALSE,REF-614344,First Continental Bank,***1064,"Globex International Holdings, Inc.",US,3907264.8
29/04/2025,29/04/2025,Merchant Processing Fees,Bank/Merchant Fees,ALL,3838.49,0,USD,Wire Transfer,First Continental Bank,***5031,,,FALSE,FALSE,REF-895824,First Continental Bank,***8360,"Globex International Holdings, Inc.",US,3903426.31
29/04/2025,29/04/2025,Supplier Payment - ExpertNet Subcontractors #19,Supplier Payment,PS-GL,66184.21,0,USD,Fedwire,ExpertNet Subcontractors #19,***4468,,PO-202504-PS-GL-0008,FALSE,FALSE,REF-796990,First Continental Bank,***3933,"Globex International Holdings, Inc.",US,3837242.1
29/04/2025,29/04/2025,Client Receipt - Vertex Advisory Client #34,Sales Receipt,PS-GL,0,197552.38,USD,Card Settlement,Vertex Advisory Client #34,***7980,INV-202504-PS-GL-0003,,FALSE,FALSE,REF-452214,First Continental Bank,***5085,"Globex International Holdings, Inc.",US,4034794.48
30/04/2025,30/04/2025,Supplier Payment - CodeCraft Contractors #11,Supplier Payment,SaaS-GL,9233.09,0,USD,Wire Transfer,CodeCraft Contractors #11,***6027,,PO-202504-SaaS-GL-0009,FALSE,FALSE,REF-733416,First Continental Bank,***3177,"Globex International Holdings, Inc.",US,4025561.39
30/04/2025,30/04/2025,Interest Earned,Interest Income,ALL,0,12182.58,USD,ACH Credit,First Continental Bank,***2496,,,FALSE,FALSE,REF-890427,First Continental Bank,***9192,"Globex International Holdings, Inc.",US,4037743.97
30/04/2025,30/04/2025,Client Receipt - CloudBridge Co. #57,Sales Receipt,SaaS-GL,0,22532.46,USD,Fedwire Credit,CloudBridge Co. #57,***4732,INV-202504-SaaS-GL-0026,,FALSE,FALSE,REF-567466,First Continental Bank,***5412,"Globex International Holdings, Inc.",US,4060276.43
30/04/2025,30/04/2025,Client Receipt - CloudBridge Co. #40,Sales Receipt,SaaS-GL,0,39921.01,USD,ACH Credit,CloudBridge Co. #40,***8646,INV-202504-SaaS-GL-0031,,FALSE,FALSE,REF-410870,First Continental Bank,***1746,"Globex International Holdings, Inc.",US,4100197.44
30/04/2025,30/04/2025,Client Receipt - ShopSphere Partner #51,Sales Receipt,Retail-NA,0,51900.7,USD,Fedwire Credit,ShopSphere Partner #51,***9363,INV-202504-Retail-NA-0011,,FALSE,FALSE,REF-605694,First Continental Bank,***5500,"Globex International Holdings, Inc.",US,4152098.14
30/04/2025,30/04/2025,Client Receipt - CloudBridge Co. #2,Sales Receipt,SaaS-GL,0,94694.23,USD,Card Settlement,CloudBridge Co. #2,***7509,INV-202504-SaaS-GL-0002,,FALSE,FALSE,REF-553765,First Continental Bank,***7149,"Globex International Holdings, Inc.",US,4246792.37
01/05/2025,01/05/2025,Account Maintenance Fee,Bank/Merchant Fees,ALL,2500,0,USD,ACH Debit,First Continental Bank,***8377,,,FALSE,FALSE,REF-464703,First Continental Bank,***9074,"Globex International Holdings, Inc.",US,4244292.37
01/05/2025,01/05/2025,Supplier Payment - ExpertNet Subcontractors #19,Supplier Payment,PS-GL,34316.27,0,USD,ACH Debit,ExpertNet Subcontractors #19,***1779,,PO-202505-PS-GL-0009,FALSE,FALSE,REF-815653,First Continental Bank,***5158,"Globex International Holdings, Inc.",US,4209976.1
01/05/2025,01/05/2025,Client Receipt - Vertex Advisory Client #11,Sales Receipt,PS-GL,0,51068.05,USD,Card Settlement,Vertex Advisory Client #11,***7261,INV-202505-PS-GL-0009,,FALSE,FALSE,REF-347718,First Continental Bank,***1451,"Globex International Holdings, Inc.",US,4261044.15
02/05/2025,02/05/2025,Supplier Payment - PackFast Fulfillment #14,Supplier Payment,Retail-NA,15205.14,0,USD,Fedwire,PackFast Fulfillment #14,***4850,,PO-202505-Retail-NA-0002,FALSE,FALSE,REF-618767,First Continental Bank,***3840,"Globex International Holdings, Inc.",US,4245839.01
02/05/2025,02/05/2025,Supplier Payment - HyperCloud Infra #3,Supplier Payment,SaaS-GL,18331.87,0,USD,Fedwire,HyperCloud Infra #3,***2824,,PO-202505-SaaS-GL-0011,FALSE,FALSE,REF-760256,First Continental Bank,***2505,"Globex International Holdings, Inc.",US,4227507.14
02/05/2025,02/05/2025,Supplier Payment - PackFast Fulfillment #6,Supplier Payment,Retail-NA,93147.35,0,USD,Wire Transfer,PackFast Fulfillment #6,***8776,,PO-202505-Retail-NA-0009,FALSE,FALSE,REF-482432,First Continental Bank,***9723,"Globex International Holdings, Inc.",US,4134359.79
02/05/2025,02/05/2025,Client Receipt - ShopSphere Partner #58,Sales Receipt,Retail-NA,0,96511.66,USD,ACH Credit,ShopSphere Partner #58,***7921,INV-202505-Retail-NA-0016,,FALSE,FALSE,REF-129953,First Continental Bank,***8790,"Globex International Holdings, Inc.",US,4230871.45
05/05/2025,05/05/2025,Supplier Payment - PackFast Fulfillment #21,Supplier Payment,Retail-NA,50546.48,0,USD,Fedwire,PackFast Fulfillment #21,***1861,,PO-202505-Retail-NA-0003,FALSE,FALSE,REF-926776,First Continental Bank,***7245,"Globex International Holdings, Inc.",US,4180324.97
05/05/2025,05/05/2025,Client Receipt - Vertex Advisory Client #21,Sales Receipt,PS-GL,0,53756.86,USD,Card Settlement,Vertex Advisory Client #21,***6374,INV-202505-PS-GL-0004,,FALSE,FALSE,REF-370142,First Continental Bank,***7415,"Globex International Holdings, Inc.",US,4234081.83
05/05/2025,05/05/2025,Client Receipt - ShopSphere Partner #42,Sales Receipt,Retail-NA,0,153439.83,USD,ACH Credit,ShopSphere Partner #42,***6493,INV-202505-Retail-NA-0017,,FALSE,FALSE,REF-937570,First Continental Bank,***9603,"Globex International Holdings, Inc.",US,4387521.66
05/05/2025,05/05/2025,Client Receipt - ShopSphere Partner #18,Sales Receipt,Retail-NA,0,239273.98,USD,ACH Credit,ShopSphere Partner #18,***3336,INV-202505-Retail-NA-0006,,FALSE,FALSE,REF-714696,First Continental Bank,***2612,"Globex International Holdings, Inc.",US,4626795.64
06/05/2025,06/05/2025,Supplier Payment - HyperCloud Infra #10,Supplier Payment,SaaS-GL,15678.62,0,USD,ACH Debit,HyperCloud Infra #10,***3288,,PO-202505-SaaS-GL-0005,FALSE,FALSE,REF-131361,First Continental Bank,***2034,"Globex International Holdings, Inc.",US,4611117.02
06/05/2025,06/05/2025,Client Receipt - CloudBridge Co. #73,Sales Receipt,SaaS-GL,0,21589.86,USD,Card Settlement,CloudBridge Co. #73,***3807,INV-202505-SaaS-GL-0013,,FALSE,FALSE,REF-251251,First Continental Bank,***1095,"Globex International Holdings, Inc.",US,4632706.88
06/05/2025,06/05/2025,Client Receipt - Vertex Advisory Client #9,Sales Receipt,PS-GL,0,69610.77,USD,Fedwire Credit,Vertex Advisory Client #9,***9832,INV-202505-PS-GL-0008,,FALSE,FALSE,REF-689458,First Continental Bank,***8180,"Globex International Holdings, Inc.",US,4702317.65
07/05/2025,07/05/2025,Supplier Payment - HyperCloud Infra #16,Supplier Payment,SaaS-GL,11277.72,0,USD,Wire Transfer,HyperCloud Infra #16,***3016,,PO-202505-SaaS-GL-0003,FALSE,FALSE,REF-637364,First Continental Bank,***6124,"Globex International Holdings, Inc.",US,4691039.93
07/05/2025,07/05/2025,Marketing - Aurelia Media #8,Marketing,ALL,25552.31,0,USD,Fedwire,Aurelia Media #8,***5884,,,FALSE,FALSE,REF-905953,First Continental Bank,***5198,"Globex International Holdings, Inc.",US,4665487.62
07/05/2025,07/05/2025,Supplier Payment - PackFast Fulfillment #12,Supplier Payment,Retail-NA,158608.1,0,USD,Wire Transfer,PackFast Fulfillment #12,***4148,,PO-202505-Retail-NA-0008,FALSE,FALSE,REF-503897,First Continental Bank,***4650,"Globex International Holdings, Inc.",US,4506879.52
07/05/2025,07/05/2025,Client Receipt - ShopSphere Partner #51,Sales Receipt,Retail-NA,0,26173.96,USD,ACH Credit,ShopSphere Partner #51,***7081,INV-202505-Retail-NA-0009,,FALSE,FALSE,REF-852647,First Continental Bank,***2056,"Globex International Holdings, Inc.",US,4533053.48
07/05/2025,07/05/2025,Client Receipt - ShopSphere Partner #16,Sales Receipt,Retail-NA,0,31460.24,USD,Card Settlement,ShopSphere Partner #16,***3737,INV-202505-Retail-NA-0014,,FALSE,FALSE,REF-215737,First Continental Bank,***4929,"Globex International Holdings, Inc.",US,4564513.72
07/05/2025,07/05/2025,Client Receipt - CloudBridge Co. #70,Sales Receipt,SaaS-GL,0,92727.65,USD,ACH Credit,CloudBridge Co. #70,***7060,INV-202505-SaaS-GL-0018,,FALSE,FALSE,REF-249099,First Continental Bank,***6672,"Globex International Holdings, Inc.",US,4657241.37
07/05/2025,07/05/2025,Client Receipt - CloudBridge Co. #23,Sales Receipt,SaaS-GL,0,103126.45,USD,Fedwire Credit,CloudBridge Co. #23,***5537,INV-202505-SaaS-GL-0005,,FALSE,FALSE,REF-504687,First Continental Bank,***4838,"Globex International Holdings, Inc.",US,4760367.82
07/05/2025,07/05/2025,Client Receipt - CloudBridge Co. #60,Sales Receipt,SaaS-GL,0,111406.94,USD,ACH Credit,CloudBridge Co. #60,***7285,INV-202505-SaaS-GL-0017,,FALSE,FALSE,REF-561846,First Continental Bank,***2587,"Globex International Holdings, Inc.",US,4871774.76
08/05/2025,08/05/2025,Northshore Power,Rent & Utilities,ALL,20581.19,0,USD,Fedwire,Northshore Power,***3436,,,FALSE,FALSE,REF-356539,First Continental Bank,***5608,"Globex International Holdings, Inc.",US,4851193.57
08/05/2025,08/05/2025,Marketing - Aurelia Media #8,Marketing,ALL,56990.77,0,USD,ACH Debit,Aurelia Media #8,***2415,,,FALSE,FALSE,REF-610318,First Continental Bank,***1384,"Globex International Holdings, Inc.",US,4794202.8
08/05/2025,08/05/2025,Client Receipt - CloudBridge Co. #40,Sales Receipt,SaaS-GL,0,554.35,USD,Fedwire Credit,CloudBridge Co. #40,***7002,INV-202505-SaaS-GL-0003,,FALSE,FALSE,REF-356130,First Continental Bank,***6870,"Globex International Holdings, Inc.",US,4794757.15
08/05/2025,08/05/2025,Client Receipt - CloudBridge Co. #1,Sales Receipt,SaaS-GL,0,25982.03,USD,ACH Credit,CloudBridge Co. #1,***4767,INV-202505-SaaS-GL-0007,,FALSE,FALSE,REF-442206,First Continental Bank,***4138,"Globex International Holdings, Inc.",US,4820739.18
08/05/2025,08/05/2025,Client Receipt - Vertex Advisory Client #6,Sales Receipt,PS-GL,0,82187,USD,ACH Credit,Vertex Advisory Client #6,***9924,INV-202505-PS-GL-0006,,FALSE,FALSE,REF-169948,First Continental Bank,***4760,"Globex International Holdings, Inc.",US,4902926.18
08/05/2025,08/05/2025,Client Receipt - CloudBridge Co. #53,Sales Receipt,SaaS-GL,0,197925.6,USD,Fedwire Credit,CloudBridge Co. #53,***1605,INV-202505-SaaS-GL-0012,,FALSE,FALSE,REF-355710,First Continental Bank,***4729,"Globex International Holdings, Inc.",US,5100851.78
09/05/2025,09/05/2025,Merchant Processing Fees,Bank/Merchant Fees,ALL,9081.9,0,USD,Fedwire,First Continental Bank,***3871,,,FALSE,FALSE,REF-807679,First Continental Bank,***4898,"Globex International Holdings, Inc.",US,5091769.88
09/05/2025,09/05/2025,Supplier Payment - PackFast Fulfillment #6,Supplier Payment,Retail-NA,87719.6,0,USD,ACH Debit,PackFast Fulfillment #6,***7933,,PO-202505-Retail-NA-0010,FALSE,FALSE,REF-991422,First Continental Bank,***2863,"Globex International Holdings, Inc.",US,5004050.28
09/05/2025,09/05/2025,Client Receipt - ShopSphere Partner #77,Sales Receipt,Retail-NA,0,18894.64,USD,Fedwire Credit,ShopSphere Partner #77,***8250,INV-202505-Retail-NA-0015,,FALSE,FALSE,REF-779912,First Continental Bank,***2173,"Globex International Holdings, Inc.",US,5022944.92
09/05/2025,09/05/2025,Client Receipt - CloudBridge Co. #9,Sales Receipt,SaaS-GL,0,30092.84,USD,Card Settlement,CloudBridge Co. #9,***2277,INV-202505-SaaS-GL-0010,,FALSE,FALSE,REF-822095,First Continental Bank,***2702,"Globex International Holdings, Inc.",US,5053037.76
12/05/2025,12/05/2025,Supplier Payment - ExpertNet Subcontractors #12,Supplier Payment,PS-GL,7255.85,0,USD,Wire Transfer,ExpertNet Subcontractors #12,***9302,,PO-202505-PS-GL-0006,FALSE,FALSE,REF-964969,First Continental Bank,***3709,"Globex International Holdings, Inc.",US,5045781.91
12/05/2025,12/05/2025,Supplier Payment - HyperCloud Infra #18,Supplier Payment,SaaS-GL,14384.56,0,USD,ACH Debit,HyperCloud Infra #18,***1514,,PO-202505-SaaS-GL-0006,FALSE,FALSE,REF-474331,First Continental Bank,***1474,"Globex International Holdings, Inc.",US,5031397.35
12/05/2025,12/05/2025,Supplier Payment - CodeCraft Contractors #3,Supplier Payment,SaaS-GL,15570.85,0,USD,Wire Transfer,CodeCraft Contractors #3,***8460,,PO-202505-SaaS-GL-0001,FALSE,FALSE,REF-393206,First Continental Bank,***2328,"Globex International Holdings, Inc.",US,5015826.5
12/05/2025,12/05/2025,Supplier Payment - HyperCloud Infra #16,Supplier Payment,SaaS-GL,41289.57,0,USD,Fedwire,HyperCloud Infra #16,***2952,,PO-202505-SaaS-GL-0010,FALSE,FALSE,REF-666566,First Continental Bank,***3801,"Globex International Holdings, Inc.",US,4974536.93
12/05/2025,12/05/2025,Supplier Payment - NorthRiver Apparel Mfg #16,Supplier Payment,Retail-NA,56994.08,0,USD,Fedwire,NorthRiver Apparel Mfg #16,***1478,,PO-202505-Retail-NA-0001,FALSE,FALSE,REF-396712,First Continental Bank,***7496,"Globex International Holdings, Inc.",US,4917542.85
12/05/2025,12/05/2025,Supplier Payment - ExpertNet Subcontractors #4,Supplier Payment,PS-GL,73813.21,0,USD,ACH Debit,ExpertNet Subcontractors #4,***7541,,PO-202505-PS-GL-0004,FALSE,FALSE,REF-637633,First Continental Bank,***8568,"Globex International Holdings, Inc.",US,4843729.64
12/05/2025,12/05/2025,Intercompany Settlement - Globex Retail NA LLC,Intercompany Transfer,ALL,875338,0,USD,Internal Transfer,Globex Retail NA LLC,***6386,,,TRUE,TRUE,REF-347770,First Continental Bank,***8104,"Globex International Holdings, Inc.",US,3968391.64
12/05/2025,12/05/2025,Client Receipt - ShopSphere Partner #43,Sales Receipt,Retail-NA,0,23430.53,USD,Fedwire Credit,ShopSphere Partner #43,***7366,INV-202505-Retail-NA-0012,,FALSE,FALSE,REF-558956,First Continental Bank,***1867,"Globex International Holdings, Inc.",US,3991822.17
12/05/2025,12/05/2025,Client Receipt - CloudBridge Co. #54,Sales Receipt,SaaS-GL,0,232819.86,USD,ACH Credit,CloudBridge Co. #54,***3170,INV-202505-SaaS-GL-0011,,FALSE,FALSE,REF-404183,First Continental Bank,***6831,"Globex International Holdings, Inc.",US,4224642.03
13/05/2025,13/05/2025,Supplier Payment - HyperCloud Infra #16,Supplier Payment,SaaS-GL,59627.54,0,USD,Wire Transfer,HyperCloud Infra #16,***6615,,PO-202505-SaaS-GL-0008,FALSE,FALSE,REF-272733,First Continental Bank,***6493,"Globex International Holdings, Inc.",US,4165014.49
13/05/2025,13/05/2025,Client Receipt - CloudBridge Co. #27,Sales Receipt,SaaS-GL,0,6683.1,USD,Card Settlement,CloudBridge Co. #27,***4639,INV-202505-SaaS-GL-0016,,FALSE,FALSE,REF-781816,First Continental Bank,***6107,"Globex International Holdings, Inc.",US,4171697.59
13/05/2025,13/05/2025,Client Receipt - CloudBridge Co. #55,Sales Receipt,SaaS-GL,0,15046.6,USD,Fedwire Credit,CloudBridge Co. #55,***1746,INV-202505-SaaS-GL-0008,,FALSE,FALSE,REF-985905,First Continental Bank,***2015,"Globex International Holdings, Inc.",US,4186744.19
14/05/2025,14/05/2025,Supplier Payment - HyperCloud Infra #9,Supplier Payment,SaaS-GL,21183.9,0,USD,Fedwire,HyperCloud Infra #9,***9847,,PO-202505-SaaS-GL-0004,FALSE,FALSE,REF-337456,First Continental Bank,***6154,"Globex International Holdings, Inc.",US,4165560.29
14/05/2025,14/05/2025,Supplier Payment - PackFast Fulfillment #7,Supplier Payment,Retail-NA,93921.58,0,USD,ACH Debit,PackFast Fulfillment #7,***2607,,PO-202505-Retail-NA-0006,FALSE,FALSE,REF-324494,First Continental Bank,***7149,"Globex International Holdings, Inc.",US,4071638.71
14/05/2025,14/05/2025,Client Receipt - Vertex Advisory Client #1,Sales Receipt,PS-GL,0,18532.26,USD,ACH Credit,Vertex Advisory Client #1,***7316,INV-202505-PS-GL-0001,,FALSE,FALSE,REF-608594,First Continental Bank,***3741,"Globex International Holdings, Inc.",US,4090170.97
14/05/2025,14/05/2025,Client Receipt - ShopSphere Partner #67,Sales Receipt,Retail-NA,0,133930.26,USD,Card Settlement,ShopSphere Partner #67,***8758,INV-202505-Retail-NA-0002,,FALSE,FALSE,REF-511793,First Continental Bank,***1706,"Globex International Holdings, Inc.",US,4224101.23
14/05/2025,14/05/2025,Client Receipt - ShopSphere Partner #28,Sales Receipt,Retail-NA,0,161622.33,USD,ACH Credit,ShopSphere Partner #28,***3633,INV-202505-Retail-NA-0007,,FALSE,FALSE,REF-603998,First Continental Bank,***9948,"Globex International Holdings, Inc.",US,4385723.56
14/05/2025,14/05/2025,Client Receipt - ShopSphere Partner #64,Sales Receipt,Retail-NA,0,260788.08,USD,Fedwire Credit,ShopSphere Partner #64,***6472,INV-202505-Retail-NA-0013,,FALSE,FALSE,REF-587996,First Continental Bank,***4458,"Globex International Holdings, Inc.",US,4646511.64
15/05/2025,15/05/2025,Loan Interest Payment,Loan Interest,ALL,85000,0,USD,Fedwire,First Continental Bank - Corporate Lending,***4109,,,FALSE,FALSE,REF-334601,First Continental Bank,***8776,"Globex International Holdings, Inc.",US,4561511.64
15/05/2025,15/05/2025,Supplier Payment - PackFast Fulfillment #21,Supplier Payment,Retail-NA,99848.41,0,USD,ACH Debit,PackFast Fulfillment #21,***8716,,PO-202505-Retail-NA-0005,FALSE,FALSE,REF-846560,First Continental Bank,***4779,"Globex International Holdings, Inc.",US,4461663.23
15/05/2025,15/05/2025,Loan Principal Repayment,Loan Principal,ALL,500000,0,USD,ACH Debit,First Continental Bank - Corporate Lending,***6989,,,FALSE,FALSE,REF-638580,First Continental Bank,***1447,"Globex International Holdings, Inc.",US,3961663.23
15/05/2025,15/05/2025,Client Receipt - CloudBridge Co. #65,Sales Receipt,SaaS-GL,0,71542.74,USD,Card Settlement,CloudBridge Co. #65,***2963,INV-202505-SaaS-GL-0001,,FALSE,FALSE,REF-123686,First Continental Bank,***7989,"Globex International Holdings, Inc.",US,4033205.97
15/05/2025,15/05/2025,Client Receipt - Vertex Advisory Client #27,Sales Receipt,PS-GL,0,355136.75,USD,Card Settlement,Vertex Advisory Client #27,***4867,INV-202505-PS-GL-0007,,FALSE,FALSE,REF-260876,First Continental Bank,***7040,"Globex International Holdings, Inc.",US,4388342.72
16/05/2025,16/05/2025,Client Receipt - CloudBridge Co. #78,Sales Receipt,SaaS-GL,0,8521.08,USD,ACH Credit,CloudBridge Co. #78,***1434,INV-202505-SaaS-GL-0019,,FALSE,FALSE,REF-229526,First Continental Bank,***7015,"Globex International Holdings, Inc.",US,4396863.8
16/05/2025,16/05/2025,Client Receipt - Vertex Advisory Client #47,Sales Receipt,PS-GL,0,15671.81,USD,ACH Credit,Vertex Advisory Client #47,***9342,INV-202505-PS-GL-0003,,FALSE,FALSE,REF-765636,First Continental Bank,***3980,"Globex International Holdings, Inc.",US,4412535.61
16/05/2025,16/05/2025,Client Receipt - CloudBridge Co. #70,Sales Receipt,SaaS-GL,0,16994.45,USD,Fedwire Credit,CloudBridge Co. #70,***2496,INV-202505-SaaS-GL-0009,,FALSE,FALSE,REF-853291,First Continental Bank,***5075,"Globex International Holdings, Inc.",US,4429530.06
16/05/2025,16/05/2025,Client Receipt - ShopSphere Partner #64,Sales Receipt,Retail-NA,0,25984.55,USD,Card Settlement,ShopSphere Partner #64,***4864,INV-202505-Retail-NA-0005,,FALSE,FALSE,REF-430876,First Continental Bank,***5561,"Globex International Holdings, Inc.",US,4455514.61
19/05/2025,19/05/2025,VAT/GST Remittance - US IRS,Tax Payment,ALL,201578.3,0,USD,Wire Transfer,US IRS,***9208,,,FALSE,FALSE,REF-613341,First Continental Bank,***6804,"Globex International Holdings, Inc.",US,4253936.31
19/05/2025,19/05/2025,Client Receipt - Vertex Advisory Client #15,Sales Receipt,PS-GL,0,89160.27,USD,ACH Credit,Vertex Advisory Client #15,***3854,INV-202505-PS-GL-0002,,FALSE,FALSE,REF-788167,First Continental Bank,***4976,"Globex International Holdings, Inc.",US,4343096.58
20/05/2025,20/05/2025,BluePeak Property Mgmt,Rent & Utilities,ALL,6867.22,0,USD,ACH Debit,BluePeak Property Mgmt,***4692,,,FALSE,FALSE,REF-117937,First Continental Bank,***4986,"Globex International Holdings, Inc.",US,4336229.36
20/05/2025,20/05/2025,Supplier Payment - ExpertNet Subcontractors #8,Supplier Payment,PS-GL,24851.8,0,USD,ACH Debit,ExpertNet Subcontractors #8,***2584,,PO-202505-PS-GL-0002,FALSE,FALSE,REF-708141,First Continental Bank,***4522,"Globex International Holdings, Inc.",US,4311377.56
20/05/2025,20/05/2025,Client Receipt - CloudBridge Co. #47,Sales Receipt,SaaS-GL,0,10466.56,USD,Fedwire Credit,CloudBridge Co. #47,***1748,INV-202505-SaaS-GL-0014,,FALSE,FALSE,REF-105426,First Continental Bank,***7073,"Globex International Holdings, Inc.",US,4321844.12
21/05/2025,21/05/2025,Merchant Processing Fees,Bank/Merchant Fees,ALL,1001.58,0,USD,ACH Debit,First Continental Bank,***7418,,,FALSE,FALSE,REF-798394,First Continental Bank,***8791,"Globex International Holdings, Inc.",US,4320842.54
21/05/2025,21/05/2025,Supplier Payment - ExpertNet Subcontractors #3,Supplier Payment,PS-GL,20941.6,0,USD,ACH Debit,ExpertNet Subcontractors #3,***6991,,PO-202505-PS-GL-0001,FALSE,FALSE,REF-299180,First Continental Bank,***3837,"Globex International Holdings, Inc.",US,4299900.94
21/05/2025,21/05/2025,Client Receipt - ShopSphere Partner #73,Sales Receipt,Retail-NA,0,22154.05,USD,ACH Credit,ShopSphere Partner #73,***7126,INV-202505-Retail-NA-0018,,FALSE,FALSE,REF-263113,First Continental Bank,***3219,"Globex International Holdings, Inc.",US,4322054.99
22/05/2025,22/05/2025,Supplier Payment - ExpertNet Subcontractors #7,Supplier Payment,PS-GL,14820.46,0,USD,Fedwire,ExpertNet Subcontractors #7,***4996,,PO-202505-PS-GL-0008,FALSE,FALSE,REF-442337,First Continental Bank,***4339,"Globex International Holdings, Inc.",US,4307234.53
22/05/2025,22/05/2025,Client Receipt - CloudBridge Co. #17,Sales Receipt,SaaS-GL,0,57695.31,USD,ACH Credit,CloudBridge Co. #17,***5419,INV-202505-SaaS-GL-0006,,FALSE,FALSE,REF-737076,First Continental Bank,***4664,"Globex International Holdings, Inc.",US,4364929.84
23/05/2025,23/05/2025,Supplier Payment - PackFast Fulfillment #6,Supplier Payment,Retail-NA,31008.57,0,USD,ACH Debit,PackFast Fulfillment #6,***9623,,PO-202505-Retail-NA-0004,FALSE,FALSE,REF-867330,First Continental Bank,***6932,"Globex International Holdings, Inc.",US,4333921.27
23/05/2025,23/05/2025,Supplier Payment - NorthRiver Apparel Mfg #16,Supplier Payment,Retail-NA,107559.79,0,USD,ACH Debit,NorthRiver Apparel Mfg #16,***2045,,PO-202505-Retail-NA-0007,FALSE,FALSE,REF-922022,First Continental Bank,***4968,"Globex International Holdings, Inc.",US,4226361.48
24/05/2025,24/05/2025,Supplier Payment - HyperCloud Infra #13,Supplier Payment,SaaS-GL,11044.56,0,USD,Wire Transfer,HyperCloud Infra #13,***1642,,PO-202505-SaaS-GL-0002,FALSE,FALSE,REF-820575,First Continental Bank,***6450,"Globex International Holdings, Inc.",US,4215316.92
25/05/2025,25/05/2025,Client Receipt - CloudBridge Co. #30,Sales Receipt,SaaS-GL,0,4330.69,USD,Card Settlement,CloudBridge Co. #30,***5315,INV-202505-SaaS-GL-0004,,FALSE,FALSE,REF-692763,First Continental Bank,***2337,"Globex International Holdings, Inc.",US,4219647.61
26/05/2025,26/05/2025,Supplier Payment - ExpertNet Subcontractors #11,Supplier Payment,PS-GL,25890.71,0,USD,ACH Debit,ExpertNet Subcontractors #11,***4252,,PO-202505-PS-GL-0003,FALSE,FALSE,REF-801282,First Continental Bank,***1366,"Globex International Holdings, Inc.",US,4193756.9
26/05/2025,26/05/2025,Intercompany Settlement - Globex EMEA Manufacturing Ltd.,Intercompany Transfer,ALL,765304,0,USD,Internal Transfer,Globex EMEA Manufacturing Ltd.,***6001,,,TRUE,TRUE,REF-801898,First Continental Bank,***7962,"Globex International Holdings, Inc.",US,3428452.9
26/05/2025,26/05/2025,Client Receipt - CloudBridge Co. #54,Sales Receipt,SaaS-GL,0,108437.25,USD,ACH Credit,CloudBridge Co. #54,***1267,INV-202505-SaaS-GL-0002,,FALSE,FALSE,REF-464614,First Continental Bank,***4764,"Globex International Holdings, Inc.",US,3536890.15
27/05/2025,27/05/2025,Supplier Payment - HyperCloud Infra #1,Supplier Payment,SaaS-GL,5404.87,0,USD,ACH Debit,HyperCloud Infra #1,***5306,,PO-202505-SaaS-GL-0009,FALSE,FALSE,REF-323550,First Continental Bank,***6063,"Globex International Holdings, Inc.",US,3531485.28
27/05/2025,27/05/2025,Supplier Payment - CodeCraft Contractors #5,Supplier Payment,SaaS-GL,46243.46,0,USD,Wire Transfer,CodeCraft Contractors #5,***3750,,PO-202505-SaaS-GL-0007,FALSE,FALSE,REF-471455,First Continental Bank,***5244,"Globex International Holdings, Inc.",US,3485241.82
27/05/2025,27/05/2025,Client Receipt - CloudBridge Co. #50,Sales Receipt,SaaS-GL,0,36187.31,USD,ACH Credit,CloudBridge Co. #50,***2837,INV-202505-SaaS-GL-0015,,FALSE,FALSE,REF-150591,First Continental Bank,***8586,"Globex International Holdings, Inc.",US,3521429.13
28/05/2025,28/05/2025,Payroll - GlobalPay Services Ltd,Payroll,ALL,546768.8,0,USD,Wire Transfer,GlobalPay Services Ltd,***2847,,,FALSE,FALSE,REF-184134,First Continental Bank,***6944,"Globex International Holdings, Inc.",US,2974660.33
28/05/2025,28/05/2025,Client Receipt - ShopSphere Partner #29,Sales Receipt,Retail-NA,0,2088.78,USD,ACH Credit,ShopSphere Partner #29,***5170,INV-202505-Retail-NA-0010,,FALSE,FALSE,REF-600123,First Continental Bank,***1899,"Globex International Holdings, Inc.",US,2976749.11
28/05/2025,28/05/2025,Client Receipt - Card Settlement Batch #11,Sales Receipt,Retail-NA,0,70789.38,USD,Card Settlement,Card Settlement Batch #11,***9577,INV-202505-Retail-NA-0008,,FALSE,FALSE,REF-407575,First Continental Bank,***3355,"Globex International Holdings, Inc.",US,3047538.49
29/05/2025,29/05/2025,Supplier Payment - ExpertNet Subcontractors #12,Supplier Payment,PS-GL,2057.54,0,USD,Wire Transfer,ExpertNet Subcontractors #12,***3253,,PO-202505-PS-GL-0005,FALSE,FALSE,REF-262590,First Continental Bank,***4951,"Globex International Holdings, Inc.",US,3045480.95
29/05/2025,29/05/2025,Supplier Payment - ExpertNet Subcontractors #16,Supplier Payment,PS-GL,32450.31,0,USD,Fedwire,ExpertNet Subcontractors #16,***2426,,PO-202505-PS-GL-0007,FALSE,FALSE,REF-854044,First Continental Bank,***9441,"Globex International Holdings, Inc.",US,3013030.64
29/05/2025,29/05/2025,Client Receipt - CloudBridge Co. #47,Sales Receipt,SaaS-GL,0,29858.07,USD,Card Settlement,CloudBridge Co. #47,***3636,INV-202505-SaaS-GL-0020,,FALSE,FALSE,REF-746160,First Continental Bank,***6782,"Globex International Holdings, Inc.",US,3042888.71
29/05/2025,29/05/2025,Client Receipt - ShopSphere Partner #30,Sales Receipt,Retail-NA,0,61483.34,USD,Card Settlement,ShopSphere Partner #30,***5887,INV-202505-Retail-NA-0004,,FALSE,FALSE,REF-316942,First Continental Bank,***6984,"Globex International Holdings, Inc.",US,3104372.05
30/05/2025,30/05/2025,Interest Earned,Interest Income,ALL,0,10535.74,USD,Card Settlement,First Continental Bank,***1269,,,FALSE,FALSE,REF-327320,First Continental Bank,***8349,"Globex International Holdings, Inc.",US,3114907.79
30/05/2025,30/05/2025,Client Receipt - Card Settlement Batch #14,Sales Receipt,Retail-NA,0,52011,USD,ACH Credit,Card Settlement Batch #14,***4847,INV-202505-Retail-NA-0003,,FALSE,FALSE,REF-181257,First Continental Bank,***9263,"Globex International Holdings, Inc.",US,3166918.79
30/05/2025,30/05/2025,Client Receipt - Vertex Advisory Client #31,Sales Receipt,PS-GL,0,52868.73,USD,ACH Credit,Vertex Advisory Client #31,***1403,INV-202505-PS-GL-0005,,FALSE,FALSE,REF-527625,First Continental Bank,***2456,"Globex International Holdings, Inc.",US,3219787.52
30/05/2025,30/05/2025,Client Receipt - ShopSphere Partner #50,Sales Receipt,Retail-NA,0,56240.47,USD,ACH Credit,ShopSphere Partner #50,***1912,INV-202505-Retail-NA-0001,,FALSE,FALSE,REF-356023,First Continental Bank,***8758,"Globex International Holdings, Inc.",US,3276027.99
31/05/2025,31/05/2025,Client Receipt - ShopSphere Partner #74,Sales Receipt,Retail-NA,0,8375.83,USD,Card Settlement,ShopSphere Partner #74,***1991,INV-202505-Retail-NA-0011,,FALSE,FALSE,REF-310557,First Continental Bank,***2098,"Globex International Holdings, Inc.",US,3284403.82
01/06/2025,01/06/2025,Account Maintenance Fee,Bank/Merchant Fees,ALL,2500,0,USD,Wire Transfer,First Continental Bank,***8945,,,FALSE,FALSE,REF-753705,First Continental Bank,***7365,"Globex International Holdings, Inc.",US,3281903.82
01/06/2025,01/06/2025,Supplier Payment - NorthRiver Apparel Mfg #29,Supplier Payment,Retail-NA,43936.85,0,USD,ACH Debit,NorthRiver Apparel Mfg #29,***1881,,PO-202506-Retail-NA-0008,FALSE,FALSE,REF-568145,First Continental Bank,***3924,"Globex International Holdings, Inc.",US,3237966.97
01/06/2025,01/06/2025,Supplier Payment - PackFast Fulfillment #20,Supplier Payment,Retail-NA,129656.57,0,USD,Wire Transfer,PackFast Fulfillment #20,***7154,,PO-202506-Retail-NA-0007,FALSE,FALSE,REF-356597,First Continental Bank,***2457,"Globex International Holdings, Inc.",US,3108310.4
02/06/2025,02/06/2025,Client Receipt - ShopSphere Partner #18,Sales Receipt,Retail-NA,0,73079.16,USD,Card Settlement,ShopSphere Partner #18,***6992,INV-202506-Retail-NA-0002,,FALSE,FALSE,REF-947707,First Continental Bank,***4747,"Globex International Holdings, Inc.",US,3181389.56
04/06/2025,04/06/2025,Supplier Payment - HyperCloud Infra #2,Supplier Payment,SaaS-GL,14902.79,0,USD,ACH Debit,HyperCloud Infra #2,***3566,,PO-202506-SaaS-GL-0003,FALSE,FALSE,REF-359766,First Continental Bank,***5367,"Globex International Holdings, Inc.",US,3166486.77
04/06/2025,04/06/2025,Supplier Payment - NorthRiver Apparel Mfg #3,Supplier Payment,Retail-NA,31075.89,0,USD,ACH Debit,NorthRiver Apparel Mfg #3,***2189,,PO-202506-Retail-NA-0005,FALSE,FALSE,REF-851244,First Continental Bank,***3332,"Globex International Holdings, Inc.",US,3135410.88
04/06/2025,04/06/2025,Supplier Payment - NorthRiver Apparel Mfg #2,Supplier Payment,Retail-NA,55674.48,0,USD,Wire Transfer,NorthRiver Apparel Mfg #2,***9373,,PO-202506-Retail-NA-0004,FALSE,FALSE,REF-177335,First Continental Bank,***6799,"Globex International Holdings, Inc.",US,3079736.4
04/06/2025,04/06/2025,Supplier Payment - PackFast Fulfillment #5,Supplier Payment,Retail-NA,104460.33,0,USD,Wire Transfer,PackFast Fulfillment #5,***3427,,PO-202506-Retail-NA-0003,FALSE,FALSE,REF-132695,First Continental Bank,***6820,"Globex International Holdings, Inc.",US,2975276.07
04/06/2025,04/06/2025,Client Receipt - Vertex Advisory Client #45,Sales Receipt,PS-GL,0,23701.18,USD,ACH Credit,Vertex Advisory Client #45,***5514,INV-202506-PS-GL-0001,,FALSE,FALSE,REF-903763,First Continental Bank,***1537,"Globex International Holdings, Inc.",US,2998977.25
04/06/2025,04/06/2025,Client Receipt - Card Settlement Batch #10,Sales Receipt,Retail-NA,0,50996.78,USD,Card Settlement,Card Settlement Batch #10,***3294,INV-202506-Retail-NA-0004,,FALSE,FALSE,REF-202336,First Continental Bank,***5245,"Globex International Holdings, Inc.",US,3049974.03
04/06/2025,04/06/2025,Client Receipt - ShopSphere Partner #40,Sales Receipt,Retail-NA,0,150191.07,USD,Card Settlement,ShopSphere Partner #40,***1380,INV-202506-Retail-NA-0003,,FALSE,FALSE,REF-685145,First Continental Bank,***3483,"Globex International Holdings, Inc.",US,3200165.1
05/06/2025,05/06/2025,Supplier Payment - ExpertNet Subcontractors #2,Supplier Payment,PS-GL,11299.51,0,USD,ACH Debit,ExpertNet Subcontractors #2,***4804,,PO-202506-PS-GL-0012,FALSE,FALSE,REF-213580,First Continental Bank,***9418,"Globex International Holdings, Inc.",US,3188865.59
05/06/2025,05/06/2025,Supplier Payment - ExpertNet Subcontractors #14,Supplier Payment,PS-GL,20723.47,0,USD,ACH Debit,ExpertNet Subcontractors #14,***1620,,PO-202506-PS-GL-0004,FALSE,FALSE,REF-869664,First Continental Bank,***8770,"Globex International Holdings, Inc.",US,3168142.12
05/06/2025,05/06/2025,Supplier Payment - ExpertNet Subcontractors #4,Supplier Payment,PS-GL,27432.59,0,USD,Fedwire,ExpertNet Subcontractors #4,***2099,,PO-202506-PS-GL-0009,FALSE,FALSE,REF-335891,First Continental Bank,***2281,"Globex International Holdings, Inc.",US,3140709.53
05/06/2025,05/06/2025,Supplier Payment - HyperCloud Infra #15,Supplier Payment,SaaS-GL,28684.11,0,USD,ACH Debit,HyperCloud Infra #15,***9669,,PO-202506-SaaS-GL-0001,FALSE,FALSE,REF-722109,First Continental Bank,***7337,"Globex International Holdings, Inc.",US,3112025.42
05/06/2025,05/06/2025,Client Receipt - CloudBridge Co. #45,Sales Receipt,SaaS-GL,0,45139.15,USD,Card Settlement,CloudBridge Co. #45,***1701,INV-202506-SaaS-GL-0021,,FALSE,FALSE,REF-130504,First Continental Bank,***1542,"Globex International Holdings, Inc.",US,3157164.57
06/06/2025,06/06/2025,Supplier Payment - HyperCloud Infra #12,Supplier Payment,SaaS-GL,67649.6,0,USD,ACH Debit,HyperCloud Infra #12,***2306,,PO-202506-SaaS-GL-0008,FALSE,FALSE,REF-133175,First Continental Bank,***4134,"Globex International Holdings, Inc.",US,3089514.97
06/06/2025,06/06/2025,Client Receipt - Card Settlement Batch #9,Sales Receipt,Retail-NA,0,64010.9,USD,Card Settlement,Card Settlement Batch #9,***8309,INV-202506-Retail-NA-0005,,FALSE,FALSE,REF-747811,First Continental Bank,***6534,"Globex International Holdings, Inc.",US,3153525.87
06/06/2025,06/06/2025,Client Receipt - Vertex Advisory Client #50,Sales Receipt,PS-GL,0,124485.37,USD,ACH Credit,Vertex Advisory Client #50,***2206,INV-202506-PS-GL-0010,,FALSE,FALSE,REF-465309,First Continental Bank,***1758,"Globex International Holdings, Inc.",US,3278011.24
07/06/2025,07/06/2025,Supplier Payment - NorthRiver Apparel Mfg #12,Supplier Payment,Retail-NA,19143.44,0,USD,ACH Debit,NorthRiver Apparel Mfg #12,***7225,,PO-202506-Retail-NA-0002,FALSE,FALSE,REF-329397,First Continental Bank,***6862,"Globex International Holdings, Inc.",US,3258867.8
09/06/2025,09/06/2025,Skyline Internet Services,Rent & Utilities,ALL,22304.76,0,USD,Wire Transfer,Skyline Internet Services,***1459,,,FALSE,FALSE,REF-973683,First Continental Bank,***7104,"Globex International Holdings, Inc.",US,3236563.04
09/06/2025,09/06/2025,Client Receipt - CloudBridge Co. #36,Sales Receipt,SaaS-GL,0,9949.34,USD,ACH Credit,CloudBridge Co. #36,***4622,INV-202506-SaaS-GL-0022,,FALSE,FALSE,REF-188707,First Continental Bank,***1769,"Globex International Holdings, Inc.",US,3246512.38
09/06/2025,09/06/2025,Client Receipt - Vertex Advisory Client #58,Sales Receipt,PS-GL,0,50672.7,USD,Card Settlement,Vertex Advisory Client #58,***4709,INV-202506-PS-GL-0008,,FALSE,FALSE,REF-926367,First Continental Bank,***8282,"Globex International Holdings, Inc.",US,3297185.08
10/06/2025,10/06/2025,Supplier Payment - HyperCloud Infra #8,Supplier Payment,SaaS-GL,493.3,0,USD,Wire Transfer,HyperCloud Infra #8,***7192,,PO-202506-SaaS-GL-0007,FALSE,FALSE,REF-971103,First Continental Bank,***9785,"Globex International Holdings, Inc.",US,3296691.78
10/06/2025,10/06/2025,Merchant Processing Fees,Bank/Merchant Fees,ALL,1679.39,0,USD,Fedwire,First Continental Bank,***4285,,,FALSE,FALSE,REF-629487,First Continental Bank,***2662,"Globex International Holdings, Inc.",US,3295012.39
10/06/2025,10/06/2025,Supplier Payment - HyperCloud Infra #2,Supplier Payment,SaaS-GL,27542.7,0,USD,ACH Debit,HyperCloud Infra #2,***6223,,PO-202506-SaaS-GL-0011,FALSE,FALSE,REF-883248,First Continental Bank,***7188,"Globex International Holdings, Inc.",US,3267469.69
10/06/2025,10/06/2025,Supplier Payment - NorthRiver Apparel Mfg #4,Supplier Payment,Retail-NA,31365.24,0,USD,Wire Transfer,NorthRiver Apparel Mfg #4,***9595,,PO-202506-Retail-NA-0006,FALSE,FALSE,REF-697507,First Continental Bank,***6184,"Globex International Holdings, Inc.",US,3236104.45
10/06/2025,10/06/2025,Supplier Payment - CodeCraft Contractors #12,Supplier Payment,SaaS-GL,37057.53,0,USD,ACH Debit,CodeCraft Contractors #12,***8107,,PO-202506-SaaS-GL-0006,FALSE,FALSE,REF-810320,First Continental Bank,***8060,"Globex International Holdings, Inc.",US,3199046.92
10/06/2025,10/06/2025,Marketing - Beacon Digital #4,Marketing,ALL,78674.37,0,USD,ACH Debit,Beacon Digital #4,***8546,,,FALSE,FALSE,REF-719836,First Continental Bank,***7866,"Globex International Holdings, Inc.",US,3120372.55
10/06/2025,10/06/2025,Client Receipt - CloudBridge Co. #14,Sales Receipt,SaaS-GL,0,14155.27,USD,Fedwire Credit,CloudBridge Co. #14,***3518,INV-202506-SaaS-GL-0004,,FALSE,FALSE,REF-865821,First Continental Bank,***6428,"Globex International Holdings, Inc.",US,3134527.82
10/06/2025,10/06/2025,Client Receipt - CloudBridge Co. #33,Sales Receipt,SaaS-GL,0,82766.69,USD,Card Settlement,CloudBridge Co. #33,***4387,INV-202506-SaaS-GL-0009,,FALSE,FALSE,REF-715472,First Continental Bank,***8104,"Globex International Holdings, Inc.",US,3217294.51
11/06/2025,11/06/2025,Supplier Payment - ExpertNet Subcontractors #14,Supplier Payment,PS-GL,2098.28,0,USD,ACH Debit,ExpertNet Subcontractors #14,***4924,,PO-202506-PS-GL-0003,FALSE,FALSE,REF-735441,First Continental Bank,***7611,"Globex International Holdings, Inc.",US,3215196.23
11/06/2025,11/06/2025,Supplier Payment - ExpertNet Subcontractors #7,Supplier Payment,PS-GL,7527.87,0,USD,Wire Transfer,ExpertNet Subcontractors #7,***6504,,PO-202506-PS-GL-0005,FALSE,FALSE,REF-361409,First Continental Bank,***3391,"Globex International Holdings, Inc.",US,3207668.36
11/06/2025,11/06/2025,Client Receipt - CloudBridge Co. #8,Sales Receipt,SaaS-GL,0,13702.34,USD,Fedwire Credit,CloudBridge Co. #8,***8099,INV-202506-SaaS-GL-0001,,FALSE,FALSE,REF-737515,First Continental Bank,***6363,"Globex International Holdings, Inc.",US,3221370.7
11/06/2025,11/06/2025,Client Receipt - CloudBridge Co. #7,Sales Receipt,SaaS-GL,0,36717.34,USD,Fedwire Credit,CloudBridge Co. #7,***8350,INV-202506-SaaS-GL-0024,,FALSE,FALSE,REF-110999,First Continental Bank,***8142,"Globex International Holdings, Inc.",US,3258088.04
11/06/2025,11/06/2025,Client Receipt - ShopSphere Partner #16,Sales Receipt,Retail-NA,0,106571.95,USD,Card Settlement,ShopSphere Partner #16,***6084,INV-202506-Retail-NA-0010,,FALSE,FALSE,REF-227750,First Continental Bank,***8966,"Globex International Holdings, Inc.",US,3364659.99
11/06/2025,11/06/2025,Client Receipt - CloudBridge Co. #53,Sales Receipt,SaaS-GL,0,165478.08,USD,Card Settlement,CloudBridge Co. #53,***8673,INV-202506-SaaS-GL-0017,,FALSE,FALSE,REF-536754,First Continental Bank,***4056,"Globex International Holdings, Inc.",US,3530138.07
12/06/2025,12/06/2025,Supplier Payment - ExpertNet Subcontractors #17,Supplier Payment,PS-GL,7408.96,0,USD,Wire Transfer,ExpertNet Subcontractors #17,***1046,,PO-202506-PS-GL-0010,FALSE,FALSE,REF-832254,First Continental Bank,***8580,"Globex International Holdings, Inc.",US,3522729.11
12/06/2025,12/06/2025,Supplier Payment - NorthRiver Apparel Mfg #1,Supplier Payment,Retail-NA,295699.89,0,USD,ACH Debit,NorthRiver Apparel Mfg #1,***1723,,PO-202506-Retail-NA-0009,FALSE,FALSE,REF-325324,First Continental Bank,***5778,"Globex International Holdings, Inc.",US,3227029.22
12/06/2025,12/06/2025,Intercompany Settlement - Globex Retail NA LLC,Intercompany Transfer,ALL,309403,0,USD,Internal Transfer,Globex Retail NA LLC,***8227,,,TRUE,TRUE,REF-246296,First Continental Bank,***4791,"Globex International Holdings, Inc.",US,2917626.22
12/06/2025,12/06/2025,Client Receipt - CloudBridge Co. #77,Sales Receipt,SaaS-GL,0,26797.47,USD,Fedwire Credit,CloudBridge Co. #77,***2823,INV-202506-SaaS-GL-0010,,FALSE,FALSE,REF-951559,First Continental Bank,***5459,"Globex International Holdings, Inc.",US,2944423.69
12/06/2025,12/06/2025,Client Receipt - CloudBridge Co. #62,Sales Receipt,SaaS-GL,0,55373.6,USD,Card Settlement,CloudBridge Co. #62,***9325,INV-202506-SaaS-GL-0020,,FALSE,FALSE,REF-438489,First Continental Bank,***2085,"Globex International Holdings, Inc.",US,2999797.29
15/06/2025,15/06/2025,Alphagrid Utilities,Rent & Utilities,ALL,4671.41,0,USD,ACH Debit,Alphagrid Utilities,***1543,,,FALSE,FALSE,REF-326382,First Continental Bank,***2120,"Globex International Holdings, Inc.",US,2995125.88
15/06/2025,15/06/2025,Loan Interest Payment,Loan Interest,ALL,85000,0,USD,Wire Transfer,First Continental Bank - Corporate Lending,***9944,,,FALSE,FALSE,REF-602532,First Continental Bank,***1624,"Globex International Holdings, Inc.",US,2910125.88
15/06/2025,15/06/2025,Loan Principal Repayment,Loan Principal,ALL,500000,0,USD,ACH Debit,First Continental Bank - Corporate Lending,***5599,,,FALSE,FALSE,REF-589877,First Continental Bank,***5941,"Globex International Holdings, Inc.",US,2410125.88
15/06/2025,15/06/2025,Client Receipt - CloudBridge Co. #40,Sales Receipt,SaaS-GL,0,48099.6,USD,Card Settlement,CloudBridge Co. #40,***9334,INV-202506-SaaS-GL-0014,,FALSE,FALSE,REF-676209,First Continental Bank,***9503,"Globex International Holdings, Inc.",US,2458225.48
16/06/2025,16/06/2025,Supplier Payment - HyperCloud Infra #6,Supplier Payment,SaaS-GL,5936.67,0,USD,Wire Transfer,HyperCloud Infra #6,***8927,,PO-202506-SaaS-GL-0009,FALSE,FALSE,REF-513072,First Continental Bank,***6208,"Globex International Holdings, Inc.",US,2452288.81
16/06/2025,16/06/2025,Supplier Payment - ExpertNet Subcontractors #1,Supplier Payment,PS-GL,14177.14,0,USD,ACH Debit,ExpertNet Subcontractors #1,***7456,,PO-202506-PS-GL-0002,FALSE,FALSE,REF-114489,First Continental Bank,***5458,"Globex International Holdings, Inc.",US,2438111.67
16/06/2025,16/06/2025,Client Receipt - ShopSphere Partner #30,Sales Receipt,Retail-NA,0,2913.11,USD,Fedwire Credit,ShopSphere Partner #30,***2462,INV-202506-Retail-NA-0011,,FALSE,FALSE,REF-426604,First Continental Bank,***9376,"Globex International Holdings, Inc.",US,2441024.78
16/06/2025,16/06/2025,Client Receipt - CloudBridge Co. #19,Sales Receipt,SaaS-GL,0,128412.51,USD,ACH Credit,CloudBridge Co. #19,***8668,INV-202506-SaaS-GL-0016,,FALSE,FALSE,REF-585371,First Continental Bank,***9643,"Globex International Holdings, Inc.",US,2569437.29
17/06/2025,17/06/2025,Client Receipt - CloudBridge Co. #18,Sales Receipt,SaaS-GL,0,4386.25,USD,Fedwire Credit,CloudBridge Co. #18,***5341,INV-202506-SaaS-GL-0006,,FALSE,FALSE,REF-406553,First Continental Bank,***1793,"Globex International Holdings, Inc.",US,2573823.54
17/06/2025,17/06/2025,Client Receipt - CloudBridge Co. #7,Sales Receipt,SaaS-GL,0,64220.07,USD,Card Settlement,CloudBridge Co. #7,***9406,INV-202506-SaaS-GL-0007,,FALSE,FALSE,REF-224501,First Continental Bank,***3478,"Globex International Holdings, Inc.",US,2638043.61
18/06/2025,18/06/2025,Marketing - Beacon Digital #7,Marketing,ALL,7306.67,0,USD,Wire Transfer,Beacon Digital #7,***1801,,,FALSE,FALSE,REF-691465,First Continental Bank,***9434,"Globex International Holdings, Inc.",US,2630736.94
18/06/2025,18/06/2025,Supplier Payment - ExpertNet Subcontractors #12,Supplier Payment,PS-GL,49557.32,0,USD,ACH Debit,ExpertNet Subcontractors #12,***2967,,PO-202506-PS-GL-0011,FALSE,FALSE,REF-193371,First Continental Bank,***5700,"Globex International Holdings, Inc.",US,2581179.62
18/06/2025,18/06/2025,Client Receipt - CloudBridge Co. #16,Sales Receipt,SaaS-GL,0,48440.76,USD,ACH Credit,CloudBridge Co. #16,***1322,INV-202506-SaaS-GL-0012,,FALSE,FALSE,REF-747527,First Continental Bank,***2947,"Globex International Holdings, Inc.",US,2629620.38
18/06/2025,18/06/2025,Client Receipt - Card Settlement Batch #10,Sales Receipt,Retail-NA,0,78045.86,USD,Card Settlement,Card Settlement Batch #10,***4955,INV-202506-Retail-NA-0007,,FALSE,FALSE,REF-790445,First Continental Bank,***3211,"Globex International Holdings, Inc.",US,2707666.24
18/06/2025,18/06/2025,Client Receipt - CloudBridge Co. #3,Sales Receipt,SaaS-GL,0,129880.98,USD,ACH Credit,CloudBridge Co. #3,***1623,INV-202506-SaaS-GL-0013,,FALSE,FALSE,REF-341501,First Continental Bank,***8606,"Globex International Holdings, Inc.",US,2837547.22
19/06/2025,19/06/2025,Merchant Processing Fees,Bank/Merchant Fees,ALL,8568.24,0,USD,Wire Transfer,First Continental Bank,***1565,,,FALSE,FALSE,REF-292399,First Continental Bank,***3064,"Globex International Holdings, Inc.",US,2828978.98
19/06/2025,19/06/2025,Supplier Payment - HyperCloud Infra #1,Supplier Payment,SaaS-GL,14612.39,0,USD,Wire Transfer,HyperCloud Infra #1,***1143,,PO-202506-SaaS-GL-0010,FALSE,FALSE,REF-665063,First Continental Bank,***1768,"Globex International Holdings, Inc.",US,2814366.59
19/06/2025,19/06/2025,Supplier Payment - HyperCloud Infra #4,Supplier Payment,SaaS-GL,18095.88,0,USD,Wire Transfer,HyperCloud Infra #4,***4203,,PO-202506-SaaS-GL-0004,FALSE,FALSE,REF-123882,First Continental Bank,***4534,"Globex International Holdings, Inc.",US,2796270.71
19/06/2025,19/06/2025,Client Receipt - Vertex Advisory Client #49,Sales Receipt,PS-GL,0,51904.9,USD,Card Settlement,Vertex Advisory Client #49,***9134,INV-202506-PS-GL-0004,,FALSE,FALSE,REF-764874,First Continental Bank,***3759,"Globex International Holdings, Inc.",US,2848175.61
19/06/2025,19/06/2025,Client Receipt - ShopSphere Partner #4,Sales Receipt,Retail-NA,0,61480.88,USD,Card Settlement,ShopSphere Partner #4,***7784,INV-202506-Retail-NA-0014,,FALSE,FALSE,REF-244326,First Continental Bank,***6982,"Globex International Holdings, Inc.",US,2909656.49
19/06/2025,19/06/2025,Client Receipt - Vertex Advisory Client #17,Sales Receipt,PS-GL,0,101157.02,USD,Fedwire Credit,Vertex Advisory Client #17,***7635,INV-202506-PS-GL-0006,,FALSE,FALSE,REF-566603,First Continental Bank,***8569,"Globex International Holdings, Inc.",US,3010813.51
19/06/2025,19/06/2025,Client Receipt - Vertex Advisory Client #52,Sales Receipt,PS-GL,0,120455.96,USD,Card Settlement,Vertex Advisory Client #52,***4052,INV-202506-PS-GL-0009,,FALSE,FALSE,REF-435153,First Continental Bank,***9545,"Globex International Holdings, Inc.",US,3131269.47
20/06/2025,20/06/2025,Client Receipt - CloudBridge Co. #78,Sales Receipt,SaaS-GL,0,7954.8,USD,Fedwire Credit,CloudBridge Co. #78,***8287,INV-202506-SaaS-GL-0011,,FALSE,FALSE,REF-750064,First Continental Bank,***1470,"Globex International Holdings, Inc.",US,3139224.27
20/06/2025,20/06/2025,Client Receipt - Vertex Advisory Client #15,Sales Receipt,PS-GL,0,21462.63,USD,Fedwire Credit,Vertex Advisory Client #15,***2729,INV-202506-PS-GL-0005,,FALSE,FALSE,REF-912892,First Continental Bank,***1310,"Globex International Holdings, Inc.",US,3160686.9
20/06/2025,20/06/2025,Client Receipt - ShopSphere Partner #25,Sales Receipt,Retail-NA,0,43710.62,USD,Fedwire Credit,ShopSphere Partner #25,***3624,INV-202506-Retail-NA-0008,,FALSE,FALSE,REF-280348,First Continental Bank,***7209,"Globex International Holdings, Inc.",US,3204397.52
20/06/2025,20/06/2025,Client Receipt - ShopSphere Partner #50,Sales Receipt,Retail-NA,0,57974.09,USD,ACH Credit,ShopSphere Partner #50,***6486,INV-202506-Retail-NA-0012,,FALSE,FALSE,REF-496851,First Continental Bank,***5554,"Globex International Holdings, Inc.",US,3262371.61
20/06/2025,20/06/2025,Client Receipt - CloudBridge Co. #44,Sales Receipt,SaaS-GL,0,64613.43,USD,Card Settlement,CloudBridge Co. #44,***2581,INV-202506-SaaS-GL-0015,,FALSE,FALSE,REF-865381,First Continental Bank,***6523,"Globex International Holdings, Inc.",US,3326985.04
21/06/2025,21/06/2025,Client Receipt - Card Settlement Batch #2,Sales Receipt,Retail-NA,0,44970.88,USD,Card Settlement,Card Settlement Batch #2,***4272,INV-202506-Retail-NA-0017,,FALSE,FALSE,REF-623834,First Continental Bank,***5512,"Globex International Holdings, Inc.",US,3371955.92
22/06/2025,22/06/2025,VAT/GST Remittance - US IRS,Tax Payment,ALL,200621.61,0,USD,ACH Debit,US IRS,***9015,,,FALSE,FALSE,REF-345551,First Continental Bank,***2556,"Globex International Holdings, Inc.",US,3171334.31
23/06/2025,23/06/2025,Supplier Payment - ExpertNet Subcontractors #15,Supplier Payment,PS-GL,6323.29,0,USD,Wire Transfer,ExpertNet Subcontractors #15,***6075,,PO-202506-PS-GL-0001,FALSE,FALSE,REF-543257,First Continental Bank,***3640,"Globex International Holdings, Inc.",US,3165011.02
23/06/2025,23/06/2025,Supplier Payment - NorthRiver Apparel Mfg #3,Supplier Payment,Retail-NA,56769.12,0,USD,Fedwire,NorthRiver Apparel Mfg #3,***3642,,PO-202506-Retail-NA-0010,FALSE,FALSE,REF-611149,First Continental Bank,***4712,"Globex International Holdings, Inc.",US,3108241.9
23/06/2025,23/06/2025,Client Receipt - ShopSphere Partner #70,Sales Receipt,Retail-NA,0,63426.2,USD,ACH Credit,ShopSphere Partner #70,***8294,INV-202506-Retail-NA-0013,,FALSE,FALSE,REF-752406,First Continental Bank,***3575,"Globex International Holdings, Inc.",US,3171668.1
23/06/2025,23/06/2025,Client Receipt - ShopSphere Partner #39,Sales Receipt,Retail-NA,0,116097.66,USD,Fedwire Credit,ShopSphere Partner #39,***5710,INV-202506-Retail-NA-0001,,FALSE,FALSE,REF-307139,First Continental Bank,***2628,"Globex International Holdings, Inc.",US,3287765.76
23/06/2025,23/06/2025,Client Receipt - Vertex Advisory Client #4,Sales Receipt,PS-GL,0,129357.03,USD,ACH Credit,Vertex Advisory Client #4,***2549,INV-202506-PS-GL-0002,,FALSE,FALSE,REF-601102,First Continental Bank,***1873,"Globex International Holdings, Inc.",US,3417122.79
23/06/2025,23/06/2025,Client Receipt - Card Settlement Batch #1,Sales Receipt,Retail-NA,0,148261.5,USD,ACH Credit,Card Settlement Batch #1,***6918,INV-202506-Retail-NA-0016,,FALSE,FALSE,REF-420382,First Continental Bank,***7837,"Globex International Holdings, Inc.",US,3565384.29
24/06/2025,24/06/2025,Supplier Payment - CodeCraft Contractors #10,Supplier Payment,SaaS-GL,11777.67,0,USD,ACH Debit,CodeCraft Contractors #10,***6809,,PO-202506-SaaS-GL-0005,FALSE,FALSE,REF-646060,First Continental Bank,***3072,"Globex International Holdings, Inc.",US,3553606.62
24/06/2025,24/06/2025,Supplier Payment - ExpertNet Subcontractors #19,Supplier Payment,PS-GL,23328.52,0,USD,Fedwire,ExpertNet Subcontractors #19,***1372,,PO-202506-PS-GL-0007,FALSE,FALSE,REF-562657,First Continental Bank,***4384,"Globex International Holdings, Inc.",US,3530278.1
24/06/2025,24/06/2025,Supplier Payment - PackFast Fulfillment #16,Supplier Payment,Retail-NA,26777.29,0,USD,Fedwire,PackFast Fulfillment #16,***4780,,PO-202506-Retail-NA-0001,FALSE,FALSE,REF-229390,First Continental Bank,***1279,"Globex International Holdings, Inc.",US,3503500.81
24/06/2025,24/06/2025,Client Receipt - CloudBridge Co. #11,Sales Receipt,SaaS-GL,0,9369.9,USD,ACH Credit,CloudBridge Co. #11,***9148,INV-202506-SaaS-GL-0018,,FALSE,FALSE,REF-823378,First Continental Bank,***9656,"Globex International Holdings, Inc.",US,3512870.71
24/06/2025,24/06/2025,Client Receipt - ShopSphere Partner #76,Sales Receipt,Retail-NA,0,28137.47,USD,Fedwire Credit,ShopSphere Partner #76,***4480,INV-202506-Retail-NA-0006,,FALSE,FALSE,REF-308359,First Continental Bank,***2925,"Globex International Holdings, Inc.",US,3541008.18
24/06/2025,24/06/2025,Client Receipt - CloudBridge Co. #48,Sales Receipt,SaaS-GL,0,37561.85,USD,Card Settlement,CloudBridge Co. #48,***5702,INV-202506-SaaS-GL-0003,,FALSE,FALSE,REF-173988,First Continental Bank,***9099,"Globex International Holdings, Inc.",US,3578570.03
24/06/2025,24/06/2025,Client Receipt - CloudBridge Co. #58,Sales Receipt,SaaS-GL,0,50091.01,USD,Fedwire Credit,CloudBridge Co. #58,***1044,INV-202506-SaaS-GL-0005,,FALSE,FALSE,REF-519183,First Continental Bank,***2866,"Globex International Holdings, Inc.",US,3628661.04
24/06/2025,24/06/2025,Client Receipt - CloudBridge Co. #11,Sales Receipt,SaaS-GL,0,69133.67,USD,ACH Credit,CloudBridge Co. #11,***5454,INV-202506-SaaS-GL-0002,,FALSE,FALSE,REF-386354,First Continental Bank,***5553,"Globex International Holdings, Inc.",US,3697794.71
24/06/2025,24/06/2025,Client Receipt - Vertex Advisory Client #18,Sales Receipt,PS-GL,0,128890.51,USD,Card Settlement,Vertex Advisory Client #18,***9362,INV-202506-PS-GL-0003,,FALSE,FALSE,REF-106484,First Continental Bank,***5327,"Globex International Holdings, Inc.",US,3826685.22
25/06/2025,25/06/2025,Supplier Payment - HyperCloud Infra #10,Supplier Payment,SaaS-GL,7696.88,0,USD,ACH Debit,HyperCloud Infra #10,***1180,,PO-202506-SaaS-GL-0002,FALSE,FALSE,REF-496412,First Continental Bank,***7065,"Globex International Holdings, Inc.",US,3818988.34
26/06/2025,26/06/2025,Supplier Payment - ExpertNet Subcontractors #17,Supplier Payment,PS-GL,48344.18,0,USD,ACH Debit,ExpertNet Subcontractors #17,***2179,,PO-202506-PS-GL-0008,FALSE,FALSE,REF-964835,First Continental Bank,***9762,"Globex International Holdings, Inc.",US,3770644.16
26/06/2025,26/06/2025,Intercompany Settlement - Globex APAC Logistics Pte. Ltd.,Intercompany Transfer,ALL,416069,0,USD,Internal Transfer,Globex APAC Logistics Pte. Ltd.,***5479,,,TRUE,TRUE,REF-423708,First Continental Bank,***2013,"Globex International Holdings, Inc.",US,3354575.16
26/06/2025,26/06/2025,Client Receipt - CloudBridge Co. #69,Sales Receipt,SaaS-GL,0,43312.15,USD,Fedwire Credit,CloudBridge Co. #69,***2552,INV-202506-SaaS-GL-0023,,FALSE,FALSE,REF-248171,First Continental Bank,***5124,"Globex International Holdings, Inc.",US,3397887.31
27/06/2025,27/06/2025,Supplier Payment - HyperCloud Infra #5,Supplier Payment,SaaS-GL,25588,0,USD,Wire Transfer,HyperCloud Infra #5,***8555,,PO-202506-SaaS-GL-0012,FALSE,FALSE,REF-412358,First Continental Bank,***7441,"Globex International Holdings, Inc.",US,3372299.31
27/06/2025,27/06/2025,Payroll - GlobalPay Services Ltd,Payroll,ALL,550979.7,0,USD,ACH Debit,GlobalPay Services Ltd,***5145,,,FALSE,FALSE,REF-205035,First Continental Bank,***1126,"Globex International Holdings, Inc.",US,2821319.61
29/06/2025,29/06/2025,Client Receipt - CloudBridge Co. #72,Sales Receipt,SaaS-GL,0,7240.97,USD,Fedwire Credit,CloudBridge Co. #72,***3679,INV-202506-SaaS-GL-0008,,FALSE,FALSE,REF-263532,First Continental Bank,***6824,"Globex International Holdings, Inc.",US,2828560.58
29/06/2025,29/06/2025,Client Receipt - CloudBridge Co. #33,Sales Receipt,SaaS-GL,0,19191.51,USD,Card Settlement,CloudBridge Co. #33,***3790,INV-202506-SaaS-GL-0019,,FALSE,FALSE,REF-883572,First Continental Bank,***8918,"Globex International Holdings, Inc.",US,2847752.09
30/06/2025,30/06/2025,Supplier Payment - ExpertNet Subcontractors #16,Supplier Payment,PS-GL,18176.62,0,USD,Wire Transfer,ExpertNet Subcontractors #16,***2187,,PO-202506-PS-GL-0006,FALSE,FALSE,REF-853398,First Continental Bank,***4043,"Globex International Holdings, Inc.",US,2829575.47
30/06/2025,30/06/2025,Client Receipt - ShopSphere Partner #62,Sales Receipt,Retail-NA,0,5430.08,USD,Card Settlement,ShopSphere Partner #62,***6637,INV-202506-Retail-NA-0009,,FALSE,FALSE,REF-460486,First Continental Bank,***3515,"Globex International Holdings, Inc.",US,2835005.55
30/06/2025,30/06/2025,Interest Earned,Interest Income,ALL,0,10568.29,USD,Fedwire Credit,First Continental Bank,***7237,,,FALSE,FALSE,REF-509797,First Continental Bank,***2208,"Globex International Holdings, Inc.",US,2845573.84
30/06/2025,30/06/2025,Client Receipt - Vertex Advisory Client #27,Sales Receipt,PS-GL,0,35905.2,USD,Fedwire Credit,Vertex Advisory Client #27,***4073,INV-202506-PS-GL-0007,,FALSE,FALSE,REF-956755,First Continental Bank,***2530,"Globex International Holdings, Inc.",US,2881479.04
30/06/2025,30/06/2025,Client Receipt - ShopSphere Partner #63,Sales Receipt,Retail-NA,0,349354.7,USD,ACH Credit,ShopSphere Partner #63,***6689,INV-202506-Retail-NA-0015,,FALSE,FALSE,REF-158596,First Continental Bank,***1377,"Globex International Holdings, Inc.",US,3230833.74
01/07/2025,01/07/2025,Account Maintenance Fee,Bank/Merchant Fees,ALL,2500,0,USD,Fedwire,First Continental Bank,***6273,,,FALSE,FALSE,REF-533892,First Continental Bank,***1038,"Globex International Holdings, Inc.",US,3228333.74
01/07/2025,01/07/2025,Client Receipt - CloudBridge Co. #39,Sales Receipt,SaaS-GL,0,21397.2,USD,Fedwire Credit,CloudBridge Co. #39,***7825,INV-202507-SaaS-GL-0017,,FALSE,FALSE,REF-414809,First Continental Bank,***3917,"Globex International Holdings, Inc.",US,3249730.94
01/07/2025,01/07/2025,Client Receipt - CloudBridge Co. #46,Sales Receipt,SaaS-GL,0,66402.55,USD,ACH Credit,CloudBridge Co. #46,***6787,INV-202507-SaaS-GL-0005,,FALSE,FALSE,REF-856661,First Continental Bank,***8058,"Globex International Holdings, Inc.",US,3316133.49
02/07/2025,02/07/2025,Merchant Processing Fees,Bank/Merchant Fees,ALL,2197.14,0,USD,Wire Transfer,First Continental Bank,***7108,,,FALSE,FALSE,REF-550929,First Continental Bank,***4670,"Globex International Holdings, Inc.",US,3313936.35
02/07/2025,02/07/2025,Client Receipt - Vertex Advisory Client #57,Sales Receipt,PS-GL,0,45140.45,USD,ACH Credit,Vertex Advisory Client #57,***9665,INV-202507-PS-GL-0009,,FALSE,FALSE,REF-189212,First Continental Bank,***3558,"Globex International Holdings, Inc.",US,3359076.8
03/07/2025,03/07/2025,Supplier Payment - PackFast Fulfillment #12,Supplier Payment,Retail-NA,21417.7,0,USD,Fedwire,PackFast Fulfillment #12,***4899,,PO-202507-Retail-NA-0007,FALSE,FALSE,REF-784173,First Continental Bank,***9621,"Globex International Holdings, Inc.",US,3337659.1
03/07/2025,03/07/2025,Client Receipt - Vertex Advisory Client #45,Sales Receipt,PS-GL,0,29455.93,USD,Card Settlement,Vertex Advisory Client #45,***9284,INV-202507-PS-GL-0007,,FALSE,FALSE,REF-574527,First Continental Bank,***2370,"Globex International Holdings, Inc.",US,3367115.03
03/07/2025,03/07/2025,Client Receipt - CloudBridge Co. #52,Sales Receipt,SaaS-GL,0,37193.63,USD,Card Settlement,CloudBridge Co. #52,***6514,INV-202507-SaaS-GL-0001,,FALSE,FALSE,REF-850344,First Continental Bank,***7149,"Globex International Holdings, Inc.",US,3404308.66
04/07/2025,04/07/2025,Supplier Payment - HyperCloud Infra #7,Supplier Payment,SaaS-GL,9740.64,0,USD,Wire Transfer,HyperCloud Infra #7,***5628,,PO-202507-SaaS-GL-0004,FALSE,FALSE,REF-855259,First Continental Bank,***4296,"Globex International Holdings, Inc.",US,3394568.02
04/07/2025,04/07/2025,Client Receipt - Vertex Advisory Client #55,Sales Receipt,PS-GL,0,141673.03,USD,Fedwire Credit,Vertex Advisory Client #55,***8409,INV-202507-PS-GL-0004,,FALSE,FALSE,REF-873465,First Continental Bank,***6116,"Globex International Holdings, Inc.",US,3536241.05
05/07/2025,05/07/2025,Client Receipt - CloudBridge Co. #49,Sales Receipt,SaaS-GL,0,5766.83,USD,Fedwire Credit,CloudBridge Co. #49,***9440,INV-202507-SaaS-GL-0010,,FALSE,FALSE,REF-469164,First Continental Bank,***4602,"Globex International Holdings, Inc.",US,3542007.88
05/07/2025,05/07/2025,Client Receipt - ShopSphere Partner #24,Sales Receipt,Retail-NA,0,253725.41,USD,ACH Credit,ShopSphere Partner #24,***9357,INV-202507-Retail-NA-0007,,FALSE,FALSE,REF-825147,First Continental Bank,***5277,"Globex International Holdings, Inc.",US,3795733.29
06/07/2025,06/07/2025,Supplier Payment - PackFast Fulfillment #21,Supplier Payment,Retail-NA,160355.51,0,USD,Fedwire,PackFast Fulfillment #21,***7902,,PO-202507-Retail-NA-0004,FALSE,FALSE,REF-363070,First Continental Bank,***9192,"Globex International Holdings, Inc.",US,3635377.78
07/07/2025,07/07/2025,Supplier Payment - ExpertNet Subcontractors #7,Supplier Payment,PS-GL,40057.34,0,USD,Wire Transfer,ExpertNet Subcontractors #7,***8176,,PO-202507-PS-GL-0007,FALSE,FALSE,REF-997746,First Continental Bank,***1110,"Globex International Holdings, Inc.",US,3595320.44
07/07/2025,07/07/2025,Client Receipt - ShopSphere Partner #15,Sales Receipt,Retail-NA,0,7051.5,USD,Card Settlement,ShopSphere Partner #15,***8889,INV-202507-Retail-NA-0004,,FALSE,FALSE,REF-132975,First Continental Bank,***7260,"Globex International Holdings, Inc.",US,3602371.94
07/07/2025,07/07/2025,Client Receipt - CloudBridge Co. #46,Sales Receipt,SaaS-GL,0,55661.02,USD,Fedwire Credit,CloudBridge Co. #46,***6615,INV-202507-SaaS-GL-0014,,FALSE,FALSE,REF-297384,First Continental Bank,***8662,"Globex International Holdings, Inc.",US,3658032.96
08/07/2025,08/07/2025,Supplier Payment - PackFast Fulfillment #1,Supplier Payment,Retail-NA,167841.63,0,USD,ACH Debit,PackFast Fulfillment #1,***2467,,PO-202507-Retail-NA-0008,FALSE,FALSE,REF-135545,First Continental Bank,***8188,"Globex International Holdings, Inc.",US,3490191.33
08/07/2025,08/07/2025,Client Receipt - ShopSphere Partner #31,Sales Receipt,Retail-NA,0,7004.21,USD,ACH Credit,ShopSphere Partner #31,***8184,INV-202507-Retail-NA-0006,,FALSE,FALSE,REF-944379,First Continental Bank,***6303,"Globex International Holdings, Inc.",US,3497195.54
09/07/2025,09/07/2025,Supplier Payment - ExpertNet Subcontractors #9,Supplier Payment,PS-GL,23383.98,0,USD,ACH Debit,ExpertNet Subcontractors #9,***8489,,PO-202507-PS-GL-0002,FALSE,FALSE,REF-576812,First Continental Bank,***1049,"Globex International Holdings, Inc.",US,3473811.56
10/07/2025,10/07/2025,Client Receipt - Vertex Advisory Client #28,Sales Receipt,PS-GL,0,57109.84,USD,Fedwire Credit,Vertex Advisory Client #28,***9002,INV-202507-PS-GL-0005,,FALSE,FALSE,REF-569759,First Continental Bank,***9104,"Globex International Holdings, Inc.",US,3530921.4
10/07/2025,10/07/2025,Client Receipt - CloudBridge Co. #11,Sales Receipt,SaaS-GL,0,150428.23,USD,Card Settlement,CloudBridge Co. #11,***7525,INV-202507-SaaS-GL-0012,,FALSE,FALSE,REF-109172,First Continental Bank,***8069,"Globex International Holdings, Inc.",US,3681349.63
11/07/2025,11/07/2025,Supplier Payment - ExpertNet Subcontractors #7,Supplier Payment,PS-GL,59081.5,0,USD,Fedwire,ExpertNet Subcontractors #7,***5321,,PO-202507-PS-GL-0001,FALSE,FALSE,REF-137329,First Continental Bank,***3248,"Globex International Holdings, Inc.",US,3622268.13
11/07/2025,11/07/2025,Client Receipt - ShopSphere Partner #3,Sales Receipt,Retail-NA,0,48471.38,USD,ACH Credit,ShopSphere Partner #3,***2965,INV-202507-Retail-NA-0003,,FALSE,FALSE,REF-789991,First Continental Bank,***4925,"Globex International Holdings, Inc.",US,3670739.51
11/07/2025,11/07/2025,Client Receipt - Card Settlement Batch #11,Sales Receipt,Retail-NA,0,149224.7,USD,Fedwire Credit,Card Settlement Batch #11,***6140,INV-202507-Retail-NA-0008,,FALSE,FALSE,REF-166489,First Continental Bank,***5023,"Globex International Holdings, Inc.",US,3819964.21
12/07/2025,12/07/2025,Merchant Processing Fees,Bank/Merchant Fees,ALL,7319.58,0,USD,Fedwire,First Continental Bank,***5190,,,FALSE,FALSE,REF-501516,First Continental Bank,***3010,"Globex International Holdings, Inc.",US,3812644.63
12/07/2025,12/07/2025,Intercompany Settlement - Globex Retail NA LLC,Intercompany Transfer,ALL,489587,0,USD,Internal Transfer,Globex Retail NA LLC,***7607,,,TRUE,TRUE,REF-137992,First Continental Bank,***6510,"Globex International Holdings, Inc.",US,3323057.63
14/07/2025,14/07/2025,Supplier Payment - NorthRiver Apparel Mfg #22,Supplier Payment,Retail-NA,15317,0,USD,Fedwire,NorthRiver Apparel Mfg #22,***7209,,PO-202507-Retail-NA-0003,FALSE,FALSE,REF-937478,First Continental Bank,***9916,"Globex International Holdings, Inc.",US,3307740.63
15/07/2025,15/07/2025,Supplier Payment - NorthRiver Apparel Mfg #5,Supplier Payment,Retail-NA,66240.3,0,USD,Wire Transfer,NorthRiver Apparel Mfg #5,***9222,,PO-202507-Retail-NA-0006,FALSE,FALSE,REF-643791,First Continental Bank,***8069,"Globex International Holdings, Inc.",US,3241500.33
15/07/2025,15/07/2025,Loan Interest Payment,Loan Interest,ALL,85000,0,USD,Fedwire,First Continental Bank - Corporate Lending,***1274,,,FALSE,FALSE,REF-339484,First Continental Bank,***1063,"Globex International Holdings, Inc.",US,3156500.33
15/07/2025,15/07/2025,Loan Principal Repayment,Loan Principal,ALL,500000,0,USD,Wire Transfer,First Continental Bank - Corporate Lending,***3647,,,FALSE,FALSE,REF-569512,First Continental Bank,***4553,"Globex International Holdings, Inc.",US,2656500.33
15/07/2025,15/07/2025,Client Receipt - CloudBridge Co. #2,Sales Receipt,SaaS-GL,0,17325.66,USD,Card Settlement,CloudBridge Co. #2,***8837,INV-202507-SaaS-GL-0003,,FALSE,FALSE,REF-498251,First Continental Bank,***4264,"Globex International Holdings, Inc.",US,2673825.99
15/07/2025,15/07/2025,Client Receipt - CloudBridge Co. #5,Sales Receipt,SaaS-GL,0,134315.43,USD,Card Settlement,CloudBridge Co. #5,***9961,INV-202507-SaaS-GL-0015,,FALSE,FALSE,REF-901851,First Continental Bank,***5208,"Globex International Holdings, Inc.",US,2808141.42
15/07/2025,15/07/2025,Client Receipt - Vertex Advisory Client #16,Sales Receipt,PS-GL,0,164143.99,USD,Fedwire Credit,Vertex Advisory Client #16,***5566,INV-202507-PS-GL-0001,,FALSE,FALSE,REF-811269,First Continental Bank,***9211,"Globex International Holdings, Inc.",US,2972285.41
15/07/2025,15/07/2025,Client Receipt - ShopSphere Partner #49,Sales Receipt,Retail-NA,0,221881.47,USD,ACH Credit,ShopSphere Partner #49,***4465,INV-202507-Retail-NA-0005,,FALSE,FALSE,REF-686955,First Continental Bank,***8466,"Globex International Holdings, Inc.",US,3194166.88
16/07/2025,16/07/2025,Supplier Payment - ExpertNet Subcontractors #18,Supplier Payment,PS-GL,9880.74,0,USD,ACH Debit,ExpertNet Subcontractors #18,***4169,,PO-202507-PS-GL-0008,FALSE,FALSE,REF-399320,First Continental Bank,***7011,"Globex International Holdings, Inc.",US,3184286.14
16/07/2025,16/07/2025,Marketing - Beacon Digital #6,Marketing,ALL,31684.5,0,USD,ACH Debit,Beacon Digital #6,***1974,,,FALSE,FALSE,REF-872685,First Continental Bank,***6992,"Globex International Holdings, Inc.",US,3152601.64
16/07/2025,16/07/2025,Supplier Payment - HyperCloud Infra #12,Supplier Payment,SaaS-GL,35386.68,0,USD,ACH Debit,HyperCloud Infra #12,***1441,,PO-202507-SaaS-GL-0009,FALSE,FALSE,REF-313274,First Continental Bank,***3042,"Globex International Holdings, Inc.",US,3117214.96
16/07/2025,16/07/2025,Supplier Payment - ExpertNet Subcontractors #1,Supplier Payment,PS-GL,38452.31,0,USD,Wire Transfer,ExpertNet Subcontractors #1,***2246,,PO-202507-PS-GL-0006,FALSE,FALSE,REF-795260,First Continental Bank,***5412,"Globex International Holdings, Inc.",US,3078762.65
16/07/2025,16/07/2025,Client Receipt - CloudBridge Co. #38,Sales Receipt,SaaS-GL,0,29527.9,USD,Card Settlement,CloudBridge Co. #38,***4994,INV-202507-SaaS-GL-0013,,FALSE,FALSE,REF-457711,First Continental Bank,***2566,"Globex International Holdings, Inc.",US,3108290.55
16/07/2025,16/07/2025,Client Receipt - Vertex Advisory Client #5,Sales Receipt,PS-GL,0,89296.39,USD,ACH Credit,Vertex Advisory Client #5,***1316,INV-202507-PS-GL-0003,,FALSE,FALSE,REF-831006,First Continental Bank,***6384,"Globex International Holdings, Inc.",US,3197586.94
16/07/2025,16/07/2025,Client Receipt - CloudBridge Co. #43,Sales Receipt,SaaS-GL,0,113662.43,USD,ACH Credit,CloudBridge Co. #43,***9955,INV-202507-SaaS-GL-0016,,FALSE,FALSE,REF-648341,First Continental Bank,***8652,"Globex International Holdings, Inc.",US,3311249.37
17/07/2025,17/07/2025,Supplier Payment - ExpertNet Subcontractors #9,Supplier Payment,PS-GL,16385,0,USD,Wire Transfer,ExpertNet Subcontractors #9,***1820,,PO-202507-PS-GL-0004,FALSE,FALSE,REF-445885,First Continental Bank,***2796,"Globex International Holdings, Inc.",US,3294864.37
17/07/2025,17/07/2025,Supplier Payment - ExpertNet Subcontractors #1,Supplier Payment,PS-GL,26009.94,0,USD,ACH Debit,ExpertNet Subcontractors #1,***9562,,PO-202507-PS-GL-0005,FALSE,FALSE,REF-950663,First Continental Bank,***2214,"Globex International Holdings, Inc.",US,3268854.43
17/07/2025,17/07/2025,Supplier Payment - NorthRiver Apparel Mfg #2,Supplier Payment,Retail-NA,166453.43,0,USD,ACH Debit,NorthRiver Apparel Mfg #2,***3934,,PO-202507-Retail-NA-0009,FALSE,FALSE,REF-869106,First Continental Bank,***5089,"Globex International Holdings, Inc.",US,3102401
17/07/2025,17/07/2025,Client Receipt - ShopSphere Partner #27,Sales Receipt,Retail-NA,0,16876.91,USD,ACH Credit,ShopSphere Partner #27,***2388,INV-202507-Retail-NA-0002,,FALSE,FALSE,REF-172663,First Continental Bank,***6840,"Globex International Holdings, Inc.",US,3119277.91
17/07/2025,17/07/2025,Client Receipt - CloudBridge Co. #75,Sales Receipt,SaaS-GL,0,34059.32,USD,Card Settlement,CloudBridge Co. #75,***2201,INV-202507-SaaS-GL-0020,,FALSE,FALSE,REF-420456,First Continental Bank,***4669,"Globex International Holdings, Inc.",US,3153337.23
19/07/2025,19/07/2025,VAT/GST Remittance - US IRS,Tax Payment,ALL,193684.1,0,USD,Wire Transfer,US IRS,***2739,,,FALSE,FALSE,REF-861514,First Continental Bank,***5375,"Globex International Holdings, Inc.",US,2959653.13
20/07/2025,20/07/2025,Supplier Payment - ExpertNet Subcontractors #12,Supplier Payment,PS-GL,11889.9,0,USD,Wire Transfer,ExpertNet Subcontractors #12,***7707,,PO-202507-PS-GL-0003,FALSE,FALSE,REF-328615,First Continental Bank,***1909,"Globex International Holdings, Inc.",US,2947763.23
20/07/2025,20/07/2025,Client Receipt - CloudBridge Co. #6,Sales Receipt,SaaS-GL,0,104294.2,USD,Fedwire Credit,CloudBridge Co. #6,***9554,INV-202507-SaaS-GL-0009,,FALSE,FALSE,REF-613391,First Continental Bank,***8414,"Globex International Holdings, Inc.",US,3052057.43
22/07/2025,22/07/2025,Northshore Power,Rent & Utilities,ALL,26025.26,0,USD,Wire Transfer,Northshore Power,***7417,,,FALSE,FALSE,REF-687843,First Continental Bank,***6975,"Globex International Holdings, Inc.",US,3026032.17
22/07/2025,22/07/2025,Client Receipt - CloudBridge Co. #37,Sales Receipt,SaaS-GL,0,3745.85,USD,Fedwire Credit,CloudBridge Co. #37,***3193,INV-202507-SaaS-GL-0002,,FALSE,FALSE,REF-981243,First Continental Bank,***3765,"Globex International Holdings, Inc.",US,3029778.02
22/07/2025,22/07/2025,Client Receipt - CloudBridge Co. #51,Sales Receipt,SaaS-GL,0,5858.74,USD,Card Settlement,CloudBridge Co. #51,***8275,INV-202507-SaaS-GL-0011,,FALSE,FALSE,REF-332121,First Continental Bank,***2594,"Globex International Holdings, Inc.",US,3035636.76
23/07/2025,23/07/2025,Supplier Payment - HyperCloud Infra #17,Supplier Payment,SaaS-GL,6594.19,0,USD,ACH Debit,HyperCloud Infra #17,***6607,,PO-202507-SaaS-GL-0001,FALSE,FALSE,REF-156990,First Continental Bank,***6881,"Globex International Holdings, Inc.",US,3029042.57
23/07/2025,23/07/2025,Supplier Payment - NorthRiver Apparel Mfg #3,Supplier Payment,Retail-NA,75881.12,0,USD,ACH Debit,NorthRiver Apparel Mfg #3,***7367,,PO-202507-Retail-NA-0005,FALSE,FALSE,REF-743889,First Continental Bank,***7175,"Globex International Holdings, Inc.",US,2953161.45
23/07/2025,23/07/2025,Client Receipt - CloudBridge Co. #19,Sales Receipt,SaaS-GL,0,9122.74,USD,ACH Credit,CloudBridge Co. #19,***5730,INV-202507-SaaS-GL-0022,,FALSE,FALSE,REF-409001,First Continental Bank,***6423,"Globex International Holdings, Inc.",US,2962284.19
23/07/2025,23/07/2025,Client Receipt - Vertex Advisory Client #21,Sales Receipt,PS-GL,0,18338.9,USD,Card Settlement,Vertex Advisory Client #21,***3138,INV-202507-PS-GL-0002,,FALSE,FALSE,REF-166743,First Continental Bank,***5720,"Globex International Holdings, Inc.",US,2980623.09
23/07/2025,23/07/2025,Client Receipt - ShopSphere Partner #26,Sales Receipt,Retail-NA,0,157761.44,USD,ACH Credit,ShopSphere Partner #26,***7411,INV-202507-Retail-NA-0011,,FALSE,FALSE,REF-219405,First Continental Bank,***2987,"Globex International Holdings, Inc.",US,3138384.53
24/07/2025,24/07/2025,Supplier Payment - HyperCloud Infra #18,Supplier Payment,SaaS-GL,21880.94,0,USD,ACH Debit,HyperCloud Infra #18,***1524,,PO-202507-SaaS-GL-0005,FALSE,FALSE,REF-700499,First Continental Bank,***4131,"Globex International Holdings, Inc.",US,3116503.59
24/07/2025,24/07/2025,Marketing - Beacon Digital #7,Marketing,ALL,51453.68,0,USD,Wire Transfer,Beacon Digital #7,***9216,,,FALSE,FALSE,REF-972245,First Continental Bank,***8577,"Globex International Holdings, Inc.",US,3065049.91
24/07/2025,24/07/2025,Client Receipt - CloudBridge Co. #29,Sales Receipt,SaaS-GL,0,30983.56,USD,Card Settlement,CloudBridge Co. #29,***6854,INV-202507-SaaS-GL-0019,,FALSE,FALSE,REF-680223,First Continental Bank,***2500,"Globex International Holdings, Inc.",US,3096033.47
25/07/2025,25/07/2025,Supplier Payment - NorthRiver Apparel Mfg #18,Supplier Payment,Retail-NA,19293.14,0,USD,Wire Transfer,NorthRiver Apparel Mfg #18,***1469,,PO-202507-Retail-NA-0001,FALSE,FALSE,REF-973450,First Continental Bank,***8780,"Globex International Holdings, Inc.",US,3076740.33
25/07/2025,25/07/2025,Client Receipt - CloudBridge Co. #55,Sales Receipt,SaaS-GL,0,90852.39,USD,Fedwire Credit,CloudBridge Co. #55,***2659,INV-202507-SaaS-GL-0007,,FALSE,FALSE,REF-279654,First Continental Bank,***7562,"Globex International Holdings, Inc.",US,3167592.72
26/07/2025,26/07/2025,Payroll - GlobalPay Services Ltd,Payroll,ALL,259695.5,0,USD,Wire Transfer,GlobalPay Services Ltd,***9160,,,FALSE,FALSE,REF-755286,First Continental Bank,***9837,"Globex International Holdings, Inc.",US,2907897.22
26/07/2025,26/07/2025,Intercompany Settlement - Globex APAC Logistics Pte. Ltd.,Intercompany Transfer,ALL,372259,0,USD,Internal Transfer,Globex APAC Logistics Pte. Ltd.,***3917,,,TRUE,TRUE,REF-951221,First Continental Bank,***1810,"Globex International Holdings, Inc.",US,2535638.22
27/07/2025,27/07/2025,Supplier Payment - CodeCraft Contractors #4,Supplier Payment,SaaS-GL,42959.32,0,USD,ACH Debit,CodeCraft Contractors #4,***5431,,PO-202507-SaaS-GL-0008,FALSE,FALSE,REF-453768,First Continental Bank,***1822,"Globex International Holdings, Inc.",US,2492678.9
28/07/2025,28/07/2025,Corporate Tax Estimate,Tax Payment,ALL,147731.1,0,USD,ACH Debit,State of NY DoF,***8640,,,FALSE,FALSE,REF-948663,First Continental Bank,***6340,"Globex International Holdings, Inc.",US,2344947.8
28/07/2025,28/07/2025,Client Receipt - ShopSphere Partner #69,Sales Receipt,Retail-NA,0,13780.71,USD,Fedwire Credit,ShopSphere Partner #69,***7413,INV-202507-Retail-NA-0010,,FALSE,FALSE,REF-259571,First Continental Bank,***8958,"Globex International Holdings, Inc.",US,2358728.51
28/07/2025,28/07/2025,Client Receipt - Vertex Advisory Client #15,Sales Receipt,PS-GL,0,18755.11,USD,Fedwire Credit,Vertex Advisory Client #15,***9956,INV-202507-PS-GL-0008,,FALSE,FALSE,REF-212927,First Continental Bank,***3300,"Globex International Holdings, Inc.",US,2377483.62
28/07/2025,28/07/2025,Client Receipt - CloudBridge Co. #6,Sales Receipt,SaaS-GL,0,36955.39,USD,ACH Credit,CloudBridge Co. #6,***1355,INV-202507-SaaS-GL-0021,,FALSE,FALSE,REF-892772,First Continental Bank,***3999,"Globex International Holdings, Inc.",US,2414439.01
28/07/2025,28/07/2025,Client Receipt - CloudBridge Co. #4,Sales Receipt,SaaS-GL,0,46917.92,USD,Fedwire Credit,CloudBridge Co. #4,***7139,INV-202507-SaaS-GL-0006,,FALSE,FALSE,REF-541108,First Continental Bank,***2478,"Globex International Holdings, Inc.",US,2461356.93
28/07/2025,28/07/2025,Client Receipt - Card Settlement Batch #6,Sales Receipt,Retail-NA,0,322700.59,USD,Fedwire Credit,Card Settlement Batch #6,***6296,INV-202507-Retail-NA-0009,,FALSE,FALSE,REF-681480,First Continental Bank,***2354,"Globex International Holdings, Inc.",US,2784057.52
29/07/2025,29/07/2025,Supplier Payment - HyperCloud Infra #1,Supplier Payment,SaaS-GL,40153.87,0,USD,Fedwire,HyperCloud Infra #1,***1686,,PO-202507-SaaS-GL-0003,FALSE,FALSE,REF-238802,First Continental Bank,***5353,"Globex International Holdings, Inc.",US,2743903.65
29/07/2025,29/07/2025,Client Receipt - ShopSphere Partner #35,Sales Receipt,Retail-NA,0,177381.59,USD,ACH Credit,ShopSphere Partner #35,***1424,INV-202507-Retail-NA-0001,,FALSE,FALSE,REF-336575,First Continental Bank,***4410,"Globex International Holdings, Inc.",US,2921285.24
29/07/2025,29/07/2025,Client Receipt - Vertex Advisory Client #17,Sales Receipt,PS-GL,0,181777.68,USD,Card Settlement,Vertex Advisory Client #17,***8884,INV-202507-PS-GL-0010,,FALSE,FALSE,REF-818531,First Continental Bank,***1886,"Globex International Holdings, Inc.",US,3103062.92
30/07/2025,30/07/2025,Supplier Payment - CodeCraft Contractors #2,Supplier Payment,SaaS-GL,21958.38,0,USD,Fedwire,CodeCraft Contractors #2,***9022,,PO-202507-SaaS-GL-0007,FALSE,FALSE,REF-776634,First Continental Bank,***9320,"Globex International Holdings, Inc.",US,3081104.54
30/07/2025,30/07/2025,Supplier Payment - CodeCraft Contractors #4,Supplier Payment,SaaS-GL,38082.26,0,USD,Wire Transfer,CodeCraft Contractors #4,***4821,,PO-202507-SaaS-GL-0006,FALSE,FALSE,REF-201850,First Continental Bank,***3760,"Globex International Holdings, Inc.",US,3043022.28
30/07/2025,30/07/2025,Payroll - GlobalPay Services Ltd,Payroll,ALL,259695.5,0,USD,Wire Transfer,GlobalPay Services Ltd,***2096,,,FALSE,FALSE,REF-258278,First Continental Bank,***5987,"Globex International Holdings, Inc.",US,2783326.78
30/07/2025,30/07/2025,Interest Earned,Interest Income,ALL,0,9615.31,USD,ACH Credit,First Continental Bank,***5230,,,FALSE,FALSE,REF-311527,First Continental Bank,***3326,"Globex International Holdings, Inc.",US,2792942.09
31/07/2025,31/07/2025,Supplier Payment - HyperCloud Infra #3,Supplier Payment,SaaS-GL,30898.5,0,USD,Wire Transfer,HyperCloud Infra #3,***1229,,PO-202507-SaaS-GL-0002,FALSE,FALSE,REF-431075,First Continental Bank,***3592,"Globex International Holdings, Inc.",US,2762043.59
31/07/2025,31/07/2025,Supplier Payment - NorthRiver Apparel Mfg #12,Supplier Payment,Retail-NA,63923.12,0,USD,Fedwire,NorthRiver Apparel Mfg #12,***3050,,PO-202507-Retail-NA-0002,FALSE,FALSE,REF-762825,First Continental Bank,***9923,"Globex International Holdings, Inc.",US,2698120.47
31/07/2025,31/07/2025,Client Receipt - Vertex Advisory Client #30,Sales Receipt,PS-GL,0,4777.72,USD,Fedwire Credit,Vertex Advisory Client #30,***2006,INV-202507-PS-GL-0006,,FALSE,FALSE,REF-718210,First Continental Bank,***2433,"Globex International Holdings, Inc.",US,2702898.19
31/07/2025,31/07/2025,Client Receipt - CloudBridge Co. #19,Sales Receipt,SaaS-GL,0,21816.92,USD,ACH Credit,CloudBridge Co. #19,***2127,INV-202507-SaaS-GL-0018,,FALSE,FALSE,REF-128767,First Continental Bank,***9442,"Globex International Holdings, Inc.",US,2724715.11
31/07/2025,31/07/2025,Client Receipt - CloudBridge Co. #12,Sales Receipt,SaaS-GL,0,41206.19,USD,ACH Credit,CloudBridge Co. #12,***3287,INV-202507-SaaS-GL-0008,,FALSE,FALSE,REF-791376,First Continental Bank,***2118,"Globex International Holdings, Inc.",US,2765921.3
31/07/2025,31/07/2025,Client Receipt - CloudBridge Co. #6,Sales Receipt,SaaS-GL,0,68209.46,USD,Card Settlement,CloudBridge Co. #6,***9988,INV-202507-SaaS-GL-0004,,FALSE,FALSE,REF-508650,First Continental Bank,***4712,"Globex International Holdings, Inc.",US,2834130.76
01/08/2025,01/08/2025,Account Maintenance Fee,Bank/Merchant Fees,ALL,2500,0,USD,Wire Transfer,First Continental Bank,***6902,,,FALSE,FALSE,REF-959386,First Continental Bank,***1339,"Globex International Holdings, Inc.",US,2831630.76
01/08/2025,01/08/2025,Client Receipt - CloudBridge Co. #73,Sales Receipt,SaaS-GL,0,1508.37,USD,Fedwire Credit,CloudBridge Co. #73,***6278,INV-202508-SaaS-GL-0005,,FALSE,FALSE,REF-317438,First Continental Bank,***5317,"Globex International Holdings, Inc.",US,2833139.13
01/08/2025,01/08/2025,Client Receipt - CloudBridge Co. #42,Sales Receipt,SaaS-GL,0,13012.24,USD,Card Settlement,CloudBridge Co. #42,***9114,INV-202508-SaaS-GL-0030,,FALSE,FALSE,REF-710125,First Continental Bank,***9271,"Globex International Holdings, Inc.",US,2846151.37
01/08/2025,01/08/2025,Client Receipt - CloudBridge Co. #47,Sales Receipt,SaaS-GL,0,39349.01,USD,Fedwire Credit,CloudBridge Co. #47,***1493,INV-202508-SaaS-GL-0028,,FALSE,FALSE,REF-386272,First Continental Bank,***2034,"Globex International Holdings, Inc.",US,2885500.38
02/08/2025,02/08/2025,Client Receipt - CloudBridge Co. #32,Sales Receipt,SaaS-GL,0,8950.48,USD,ACH Credit,CloudBridge Co. #32,***8303,INV-202508-SaaS-GL-0013,,FALSE,FALSE,REF-964359,First Continental Bank,***5913,"Globex International Holdings, Inc.",US,2894450.86
02/08/2025,02/08/2025,Client Receipt - CloudBridge Co. #39,Sales Receipt,SaaS-GL,0,27041.2,USD,ACH Credit,CloudBridge Co. #39,***3299,INV-202508-SaaS-GL-0021,,FALSE,FALSE,REF-612107,First Continental Bank,***1610,"Globex International Holdings, Inc.",US,2921492.06
03/08/2025,03/08/2025,Client Receipt - CloudBridge Co. #70,Sales Receipt,SaaS-GL,0,35020.78,USD,Card Settlement,CloudBridge Co. #70,***9776,INV-202508-SaaS-GL-0029,,FALSE,FALSE,REF-442019,First Continental Bank,***8496,"Globex International Holdings, Inc.",US,2956512.84
04/08/2025,04/08/2025,Supplier Payment - ExpertNet Subcontractors #13,Supplier Payment,PS-GL,29181,0,USD,Wire Transfer,ExpertNet Subcontractors #13,***9705,,PO-202508-PS-GL-0010,FALSE,FALSE,REF-514006,First Continental Bank,***4224,"Globex International Holdings, Inc.",US,2927331.84
04/08/2025,04/08/2025,Supplier Payment - NorthRiver Apparel Mfg #23,Supplier Payment,Retail-NA,31160.34,0,USD,Wire Transfer,NorthRiver Apparel Mfg #23,***6596,,PO-202508-Retail-NA-0010,FALSE,FALSE,REF-625125,First Continental Bank,***3666,"Globex International Holdings, Inc.",US,2896171.5
04/08/2025,04/08/2025,Client Receipt - CloudBridge Co. #18,Sales Receipt,SaaS-GL,0,12900.79,USD,ACH Credit,CloudBridge Co. #18,***4236,INV-202508-SaaS-GL-0024,,FALSE,FALSE,REF-556541,First Continental Bank,***8857,"Globex International Holdings, Inc.",US,2909072.29
04/08/2025,04/08/2025,Client Receipt - CloudBridge Co. #43,Sales Receipt,SaaS-GL,0,27422.89,USD,Fedwire Credit,CloudBridge Co. #43,***3660,INV-202508-SaaS-GL-0025,,FALSE,FALSE,REF-406375,First Continental Bank,***9518,"Globex International Holdings, Inc.",US,2936495.18
05/08/2025,05/08/2025,Marketing - Aurelia Media #9,Marketing,ALL,20246.84,0,USD,ACH Debit,Aurelia Media #9,***5879,,,FALSE,FALSE,REF-376172,First Continental Bank,***5665,"Globex International Holdings, Inc.",US,2916248.34
05/08/2025,05/08/2025,Client Receipt - CloudBridge Co. #58,Sales Receipt,SaaS-GL,0,22809.23,USD,Card Settlement,CloudBridge Co. #58,***1705,INV-202508-SaaS-GL-0023,,FALSE,FALSE,REF-416439,First Continental Bank,***3600,"Globex International Holdings, Inc.",US,2939057.57
05/08/2025,05/08/2025,Client Receipt - Vertex Advisory Client #39,Sales Receipt,PS-GL,0,72503.24,USD,ACH Credit,Vertex Advisory Client #39,***1271,INV-202508-PS-GL-0002,,FALSE,FALSE,REF-904045,First Continental Bank,***1880,"Globex International Holdings, Inc.",US,3011560.81
07/08/2025,07/08/2025,Supplier Payment - PackFast Fulfillment #18,Supplier Payment,Retail-NA,62833.99,0,USD,Wire Transfer,PackFast Fulfillment #18,***5486,,PO-202508-Retail-NA-0004,FALSE,FALSE,REF-798240,First Continental Bank,***4114,"Globex International Holdings, Inc.",US,2948726.82
07/08/2025,07/08/2025,Client Receipt - CloudBridge Co. #62,Sales Receipt,SaaS-GL,0,10892.74,USD,Fedwire Credit,CloudBridge Co. #62,***9262,INV-202508-SaaS-GL-0007,,FALSE,FALSE,REF-416863,First Continental Bank,***3919,"Globex International Holdings, Inc.",US,2959619.56
07/08/2025,07/08/2025,Client Receipt - CloudBridge Co. #26,Sales Receipt,SaaS-GL,0,35603.02,USD,Card Settlement,CloudBridge Co. #26,***2940,INV-202508-SaaS-GL-0022,,FALSE,FALSE,REF-358141,First Continental Bank,***3086,"Globex International Holdings, Inc.",US,2995222.58
07/08/2025,07/08/2025,Client Receipt - CloudBridge Co. #41,Sales Receipt,SaaS-GL,0,80376.16,USD,ACH Credit,CloudBridge Co. #41,***6748,INV-202508-SaaS-GL-0014,,FALSE,FALSE,REF-462325,First Continental Bank,***8146,"Globex International Holdings, Inc.",US,3075598.74
08/08/2025,08/08/2025,Supplier Payment - HyperCloud Infra #11,Supplier Payment,SaaS-GL,17069.41,0,USD,Wire Transfer,HyperCloud Infra #11,***3155,,PO-202508-SaaS-GL-0009,FALSE,FALSE,REF-706592,First Continental Bank,***9089,"Globex International Holdings, Inc.",US,3058529.33
08/08/2025,08/08/2025,Supplier Payment - HyperCloud Infra #16,Supplier Payment,SaaS-GL,21978.21,0,USD,Wire Transfer,HyperCloud Infra #16,***9763,,PO-202508-SaaS-GL-0007,FALSE,FALSE,REF-901154,First Continental Bank,***6398,"Globex International Holdings, Inc.",US,3036551.12
08/08/2025,08/08/2025,Supplier Payment - ExpertNet Subcontractors #14,Supplier Payment,PS-GL,28954.23,0,USD,ACH Debit,ExpertNet Subcontractors #14,***1672,,PO-202508-PS-GL-0003,FALSE,FALSE,REF-212343,First Continental Bank,***8108,"Globex International Holdings, Inc.",US,3007596.89
08/08/2025,08/08/2025,Supplier Payment - NorthRiver Apparel Mfg #4,Supplier Payment,Retail-NA,48220.47,0,USD,Wire Transfer,NorthRiver Apparel Mfg #4,***2894,,PO-202508-Retail-NA-0012,FALSE,FALSE,REF-195761,First Continental Bank,***1196,"Globex International Holdings, Inc.",US,2959376.42
08/08/2025,08/08/2025,Client Receipt - ShopSphere Partner #79,Sales Receipt,Retail-NA,0,6803.35,USD,Card Settlement,ShopSphere Partner #79,***7638,INV-202508-Retail-NA-0008,,FALSE,FALSE,REF-524320,First Continental Bank,***6542,"Globex International Holdings, Inc.",US,2966179.77
08/08/2025,08/08/2025,Client Receipt - CloudBridge Co. #24,Sales Receipt,SaaS-GL,0,38269.19,USD,Fedwire Credit,CloudBridge Co. #24,***8336,INV-202508-SaaS-GL-0004,,FALSE,FALSE,REF-337457,First Continental Bank,***5654,"Globex International Holdings, Inc.",US,3004448.96
08/08/2025,08/08/2025,Client Receipt - ShopSphere Partner #58,Sales Receipt,Retail-NA,0,50167.23,USD,Card Settlement,ShopSphere Partner #58,***3337,INV-202508-Retail-NA-0011,,FALSE,FALSE,REF-913344,First Continental Bank,***2193,"Globex International Holdings, Inc.",US,3054616.19
08/08/2025,08/08/2025,Client Receipt - CloudBridge Co. #15,Sales Receipt,SaaS-GL,0,68801.6,USD,Card Settlement,CloudBridge Co. #15,***5687,INV-202508-SaaS-GL-0031,,FALSE,FALSE,REF-219873,First Continental Bank,***6816,"Globex International Holdings, Inc.",US,3123417.79
08/08/2025,08/08/2025,Client Receipt - CloudBridge Co. #14,Sales Receipt,SaaS-GL,0,93087.01,USD,Card Settlement,CloudBridge Co. #14,***9990,INV-202508-SaaS-GL-0012,,FALSE,FALSE,REF-992898,First Continental Bank,***2258,"Globex International Holdings, Inc.",US,3216504.8
09/08/2025,09/08/2025,Client Receipt - CloudBridge Co. #56,Sales Receipt,SaaS-GL,0,2011.85,USD,Card Settlement,CloudBridge Co. #56,***4742,INV-202508-SaaS-GL-0002,,FALSE,FALSE,REF-592670,First Continental Bank,***1010,"Globex International Holdings, Inc.",US,3218516.65
09/08/2025,09/08/2025,Client Receipt - Card Settlement Batch #2,Sales Receipt,Retail-NA,0,94337.36,USD,ACH Credit,Card Settlement Batch #2,***3225,INV-202508-Retail-NA-0004,,FALSE,FALSE,REF-504601,First Continental Bank,***3345,"Globex International Holdings, Inc.",US,3312854.01
10/08/2025,10/08/2025,Client Receipt - Vertex Advisory Client #57,Sales Receipt,PS-GL,0,25263.99,USD,ACH Credit,Vertex Advisory Client #57,***5619,INV-202508-PS-GL-0006,,FALSE,FALSE,REF-968125,First Continental Bank,***8715,"Globex International Holdings, Inc.",US,3338118
11/08/2025,11/08/2025,Client Receipt - CloudBridge Co. #31,Sales Receipt,SaaS-GL,0,28177.59,USD,Fedwire Credit,CloudBridge Co. #31,***4302,INV-202508-SaaS-GL-0018,,FALSE,FALSE,REF-599409,First Continental Bank,***8159,"Globex International Holdings, Inc.",US,3366295.59
11/08/2025,11/08/2025,Client Receipt - CloudBridge Co. #6,Sales Receipt,SaaS-GL,0,30527.75,USD,Fedwire Credit,CloudBridge Co. #6,***4634,INV-202508-SaaS-GL-0011,,FALSE,FALSE,REF-987593,First Continental Bank,***9160,"Globex International Holdings, Inc.",US,3396823.34
11/08/2025,11/08/2025,Client Receipt - Vertex Advisory Client #6,Sales Receipt,PS-GL,0,81266.62,USD,ACH Credit,Vertex Advisory Client #6,***4687,INV-202508-PS-GL-0009,,FALSE,FALSE,REF-497580,First Continental Bank,***1052,"Globex International Holdings, Inc.",US,3478089.96
11/08/2025,11/08/2025,Client Receipt - ShopSphere Partner #52,Sales Receipt,Retail-NA,0,185759.8,USD,Fedwire Credit,ShopSphere Partner #52,***2060,INV-202508-Retail-NA-0007,,FALSE,FALSE,REF-752621,First Continental Bank,***1013,"Globex International Holdings, Inc.",US,3663849.76
12/08/2025,12/08/2025,Merchant Processing Fees,Bank/Merchant Fees,ALL,5195.65,0,USD,ACH Debit,First Continental Bank,***8145,,,FALSE,FALSE,REF-313557,First Continental Bank,***5512,"Globex International Holdings, Inc.",US,3658654.11
12/08/2025,12/08/2025,Supplier Payment - ExpertNet Subcontractors #1,Supplier Payment,PS-GL,8388.9,0,USD,Wire Transfer,ExpertNet Subcontractors #1,***8258,,PO-202508-PS-GL-0008,FALSE,FALSE,REF-807427,First Continental Bank,***6987,"Globex International Holdings, Inc.",US,3650265.21
12/08/2025,12/08/2025,Supplier Payment - ExpertNet Subcontractors #17,Supplier Payment,PS-GL,14175.3,0,USD,Fedwire,ExpertNet Subcontractors #17,***6244,,PO-202508-PS-GL-0002,FALSE,FALSE,REF-970008,First Continental Bank,***3478,"Globex International Holdings, Inc.",US,3636089.91
12/08/2025,12/08/2025,Intercompany Settlement - Globex EMEA Manufacturing Ltd.,Intercompany Transfer,ALL,634813,0,USD,Internal Transfer,Globex EMEA Manufacturing Ltd.,***5909,,,TRUE,TRUE,REF-656312,First Continental Bank,***1340,"Globex International Holdings, Inc.",US,3001276.91
13/08/2025,13/08/2025,Supplier Payment - NorthRiver Apparel Mfg #12,Supplier Payment,Retail-NA,179794.75,0,USD,Fedwire,NorthRiver Apparel Mfg #12,***6856,,PO-202508-Retail-NA-0005,FALSE,FALSE,REF-130902,First Continental Bank,***3604,"Globex International Holdings, Inc.",US,2821482.16
13/08/2025,13/08/2025,Client Receipt - CloudBridge Co. #61,Sales Receipt,SaaS-GL,0,23155.3,USD,Fedwire Credit,CloudBridge Co. #61,***5028,INV-202508-SaaS-GL-0001,,FALSE,FALSE,REF-330120,First Continental Bank,***5269,"Globex International Holdings, Inc.",US,2844637.46
13/08/2025,13/08/2025,Client Receipt - ShopSphere Partner #26,Sales Receipt,Retail-NA,0,61294.03,USD,Fedwire Credit,ShopSphere Partner #26,***8531,INV-202508-Retail-NA-0001,,FALSE,FALSE,REF-627154,First Continental Bank,***6712,"Globex International Holdings, Inc.",US,2905931.49
14/08/2025,14/08/2025,Metro Water & Waste,Rent & Utilities,ALL,24648.61,0,USD,ACH Debit,Metro Water & Waste,***4490,,,FALSE,FALSE,REF-202707,First Continental Bank,***2982,"Globex International Holdings, Inc.",US,2881282.88
14/08/2025,14/08/2025,Supplier Payment - NorthRiver Apparel Mfg #11,Supplier Payment,Retail-NA,90773.43,0,USD,Fedwire,NorthRiver Apparel Mfg #11,***3189,,PO-202508-Retail-NA-0001,FALSE,FALSE,REF-673440,First Continental Bank,***7387,"Globex International Holdings, Inc.",US,2790509.45
14/08/2025,14/08/2025,Client Receipt - CloudBridge Co. #25,Sales Receipt,SaaS-GL,0,42554.97,USD,Card Settlement,CloudBridge Co. #25,***8813,INV-202508-SaaS-GL-0020,,FALSE,FALSE,REF-488142,First Continental Bank,***7448,"Globex International Holdings, Inc.",US,2833064.42
15/08/2025,15/08/2025,Supplier Payment - HyperCloud Infra #16,Supplier Payment,SaaS-GL,12644.44,0,USD,Fedwire,HyperCloud Infra #16,***6411,,PO-202508-SaaS-GL-0006,FALSE,FALSE,REF-604235,First Continental Bank,***3721,"Globex International Holdings, Inc.",US,2820419.98
15/08/2025,15/08/2025,Loan Interest Payment,Loan Interest,ALL,85000,0,USD,ACH Debit,First Continental Bank - Corporate Lending,***1885,,,FALSE,FALSE,REF-169490,First Continental Bank,***6058,"Globex International Holdings, Inc.",US,2735419.98
15/08/2025,15/08/2025,Loan Principal Repayment,Loan Principal,ALL,500000,0,USD,Fedwire,First Continental Bank - Corporate Lending,***1299,,,FALSE,FALSE,REF-778663,First Continental Bank,***2541,"Globex International Holdings, Inc.",US,2235419.98
15/08/2025,15/08/2025,Client Receipt - CloudBridge Co. #4,Sales Receipt,SaaS-GL,0,70948.51,USD,Fedwire Credit,CloudBridge Co. #4,***7423,INV-202508-SaaS-GL-0009,,FALSE,FALSE,REF-593547,First Continental Bank,***9464,"Globex International Holdings, Inc.",US,2306368.49
15/08/2025,15/08/2025,Client Receipt - Vertex Advisory Client #2,Sales Receipt,PS-GL,0,94059.33,USD,Card Settlement,Vertex Advisory Client #2,***6847,INV-202508-PS-GL-0004,,FALSE,FALSE,REF-819328,First Continental Bank,***7357,"Globex International Holdings, Inc.",US,2400427.82
16/08/2025,16/08/2025,Supplier Payment - ExpertNet Subcontractors #10,Supplier Payment,PS-GL,7672.53,0,USD,Wire Transfer,ExpertNet Subcontractors #10,***4307,,PO-202508-PS-GL-0004,FALSE,FALSE,REF-852103,First Continental Bank,***9336,"Globex International Holdings, Inc.",US,2392755.29
16/08/2025,16/08/2025,Supplier Payment - HyperCloud Infra #7,Supplier Payment,SaaS-GL,15765.95,0,USD,Wire Transfer,HyperCloud Infra #7,***2162,,PO-202508-SaaS-GL-0008,FALSE,FALSE,REF-404044,First Continental Bank,***9218,"Globex International Holdings, Inc.",US,2376989.34
16/08/2025,16/08/2025,Supplier Payment - NorthRiver Apparel Mfg #26,Supplier Payment,Retail-NA,54011.86,0,USD,Wire Transfer,NorthRiver Apparel Mfg #26,***9698,,PO-202508-Retail-NA-0011,FALSE,FALSE,REF-800687,First Continental Bank,***5173,"Globex International Holdings, Inc.",US,2322977.48
16/08/2025,16/08/2025,Client Receipt - CloudBridge Co. #47,Sales Receipt,SaaS-GL,0,716.85,USD,Fedwire Credit,CloudBridge Co. #47,***2064,INV-202508-SaaS-GL-0027,,FALSE,FALSE,REF-254664,First Continental Bank,***9156,"Globex International Holdings, Inc.",US,2323694.33
17/08/2025,17/08/2025,Client Receipt - CloudBridge Co. #6,Sales Receipt,SaaS-GL,0,5441.94,USD,ACH Credit,CloudBridge Co. #6,***7439,INV-202508-SaaS-GL-0026,,FALSE,FALSE,REF-158705,First Continental Bank,***1429,"Globex International Holdings, Inc.",US,2329136.27
17/08/2025,17/08/2025,Client Receipt - Vertex Advisory Client #9,Sales Receipt,PS-GL,0,25509.61,USD,ACH Credit,Vertex Advisory Client #9,***8531,INV-202508-PS-GL-0005,,FALSE,FALSE,REF-901775,First Continental Bank,***6925,"Globex International Holdings, Inc.",US,2354645.88
18/08/2025,18/08/2025,Supplier Payment - ExpertNet Subcontractors #8,Supplier Payment,PS-GL,3057.03,0,USD,ACH Debit,ExpertNet Subcontractors #8,***7809,,PO-202508-PS-GL-0001,FALSE,FALSE,REF-355459,First Continental Bank,***3606,"Globex International Holdings, Inc.",US,2351588.85
18/08/2025,18/08/2025,Supplier Payment - NorthRiver Apparel Mfg #8,Supplier Payment,Retail-NA,92774.48,0,USD,Fedwire,NorthRiver Apparel Mfg #8,***8390,,PO-202508-Retail-NA-0003,FALSE,FALSE,REF-742948,First Continental Bank,***9649,"Globex International Holdings, Inc.",US,2258814.37
18/08/2025,18/08/2025,Client Receipt - ShopSphere Partner #39,Sales Receipt,Retail-NA,0,2787.06,USD,ACH Credit,ShopSphere Partner #39,***9893,INV-202508-Retail-NA-0012,,FALSE,FALSE,REF-979795,First Continental Bank,***7100,"Globex International Holdings, Inc.",US,2261601.43
18/08/2025,18/08/2025,Client Receipt - Card Settlement Batch #8,Sales Receipt,Retail-NA,0,41474.3,USD,ACH Credit,Card Settlement Batch #8,***8719,INV-202508-Retail-NA-0002,,FALSE,FALSE,REF-215133,First Continental Bank,***7847,"Globex International Holdings, Inc.",US,2303075.73
18/08/2025,18/08/2025,Client Receipt - Vertex Advisory Client #29,Sales Receipt,PS-GL,0,80674.79,USD,Fedwire Credit,Vertex Advisory Client #29,***1609,INV-202508-PS-GL-0003,,FALSE,FALSE,REF-380110,First Continental Bank,***9242,"Globex International Holdings, Inc.",US,2383750.52
18/08/2025,18/08/2025,Client Receipt - ShopSphere Partner #41,Sales Receipt,Retail-NA,0,99157.13,USD,Fedwire Credit,ShopSphere Partner #41,***2924,INV-202508-Retail-NA-0009,,FALSE,FALSE,REF-310472,First Continental Bank,***7878,"Globex International Holdings, Inc.",US,2482907.65
19/08/2025,19/08/2025,Supplier Payment - HyperCloud Infra #16,Supplier Payment,SaaS-GL,49505.2,0,USD,Fedwire,HyperCloud Infra #16,***6542,,PO-202508-SaaS-GL-0011,FALSE,FALSE,REF-717250,First Continental Bank,***1954,"Globex International Holdings, Inc.",US,2433402.45
19/08/2025,19/08/2025,Client Receipt - Vertex Advisory Client #12,Sales Receipt,PS-GL,0,3797.27,USD,Fedwire Credit,Vertex Advisory Client #12,***4443,INV-202508-PS-GL-0001,,FALSE,FALSE,REF-434277,First Continental Bank,***2978,"Globex International Holdings, Inc.",US,2437199.72
19/08/2025,19/08/2025,Client Receipt - ShopSphere Partner #12,Sales Receipt,Retail-NA,0,16445.61,USD,ACH Credit,ShopSphere Partner #12,***7356,INV-202508-Retail-NA-0003,,FALSE,FALSE,REF-804626,First Continental Bank,***6275,"Globex International Holdings, Inc.",US,2453645.33
19/08/2025,19/08/2025,Client Receipt - Vertex Advisory Client #52,Sales Receipt,PS-GL,0,71119.31,USD,ACH Credit,Vertex Advisory Client #52,***3489,INV-202508-PS-GL-0007,,FALSE,FALSE,REF-938898,First Continental Bank,***7903,"Globex International Holdings, Inc.",US,2524764.64
20/08/2025,20/08/2025,Supplier Payment - HyperCloud Infra #14,Supplier Payment,SaaS-GL,31192.06,0,USD,Fedwire,HyperCloud Infra #14,***7707,,PO-202508-SaaS-GL-0002,FALSE,FALSE,REF-995992,First Continental Bank,***8860,"Globex International Holdings, Inc.",US,2493572.58
20/08/2025,20/08/2025,Supplier Payment - PackFast Fulfillment #10,Supplier Payment,Retail-NA,84546.45,0,USD,Fedwire,PackFast Fulfillment #10,***6034,,PO-202508-Retail-NA-0002,FALSE,FALSE,REF-531494,First Continental Bank,***9986,"Globex International Holdings, Inc.",US,2409026.13
20/08/2025,20/08/2025,Client Receipt - ShopSphere Partner #55,Sales Receipt,Retail-NA,0,214767.82,USD,Card Settlement,ShopSphere Partner #55,***5879,INV-202508-Retail-NA-0005,,FALSE,FALSE,REF-775683,First Continental Bank,***1538,"Globex International Holdings, Inc.",US,2623793.95
21/08/2025,21/08/2025,Supplier Payment - CodeCraft Contractors #8,Supplier Payment,SaaS-GL,11885.62,0,USD,ACH Debit,CodeCraft Contractors #8,***6110,,PO-202508-SaaS-GL-0004,FALSE,FALSE,REF-834697,First Continental Bank,***7294,"Globex International Holdings, Inc.",US,2611908.33
21/08/2025,21/08/2025,Supplier Payment - PackFast Fulfillment #17,Supplier Payment,Retail-NA,17985.14,0,USD,ACH Debit,PackFast Fulfillment #17,***7418,,PO-202508-Retail-NA-0009,FALSE,FALSE,REF-982721,First Continental Bank,***1142,"Globex International Holdings, Inc.",US,2593923.19
21/08/2025,21/08/2025,Supplier Payment - ExpertNet Subcontractors #16,Supplier Payment,PS-GL,53405,0,USD,Wire Transfer,ExpertNet Subcontractors #16,***4428,,PO-202508-PS-GL-0006,FALSE,FALSE,REF-763150,First Continental Bank,***3550,"Globex International Holdings, Inc.",US,2540518.19
21/08/2025,21/08/2025,Client Receipt - Card Settlement Batch #7,Sales Receipt,Retail-NA,0,49.87,USD,Fedwire Credit,Card Settlement Batch #7,***6745,INV-202508-Retail-NA-0010,,FALSE,FALSE,REF-945103,First Continental Bank,***8084,"Globex International Holdings, Inc.",US,2540568.06
21/08/2025,21/08/2025,Client Receipt - CloudBridge Co. #4,Sales Receipt,SaaS-GL,0,3400.37,USD,Fedwire Credit,CloudBridge Co. #4,***3195,INV-202508-SaaS-GL-0016,,FALSE,FALSE,REF-953852,First Continental Bank,***5419,"Globex International Holdings, Inc.",US,2543968.43
22/08/2025,22/08/2025,Supplier Payment - PackFast Fulfillment #20,Supplier Payment,Retail-NA,23440.77,0,USD,Fedwire,PackFast Fulfillment #20,***5116,,PO-202508-Retail-NA-0006,FALSE,FALSE,REF-685215,First Continental Bank,***4697,"Globex International Holdings, Inc.",US,2520527.66
22/08/2025,22/08/2025,VAT/GST Remittance - US IRS,Tax Payment,ALL,186834.06,0,USD,Wire Transfer,US IRS,***1978,,,FALSE,FALSE,REF-441170,First Continental Bank,***6169,"Globex International Holdings, Inc.",US,2333693.6
22/08/2025,22/08/2025,Client Receipt - ShopSphere Partner #33,Sales Receipt,Retail-NA,0,74928.64,USD,Card Settlement,ShopSphere Partner #33,***8967,INV-202508-Retail-NA-0014,,FALSE,FALSE,REF-657858,First Continental Bank,***7567,"Globex International Holdings, Inc.",US,2408622.24
23/08/2025,23/08/2025,Marketing - Beacon Digital #2,Marketing,ALL,42690.64,0,USD,Fedwire,Beacon Digital #2,***8210,,,FALSE,FALSE,REF-969697,First Continental Bank,***7249,"Globex International Holdings, Inc.",US,2365931.6
23/08/2025,23/08/2025,Client Receipt - CloudBridge Co. #62,Sales Receipt,SaaS-GL,0,10140.52,USD,Card Settlement,CloudBridge Co. #62,***4203,INV-202508-SaaS-GL-0003,,FALSE,FALSE,REF-980601,First Continental Bank,***9644,"Globex International Holdings, Inc.",US,2376072.12
25/08/2025,25/08/2025,Supplier Payment - ExpertNet Subcontractors #12,Supplier Payment,PS-GL,29410.73,0,USD,Fedwire,ExpertNet Subcontractors #12,***3930,,PO-202508-PS-GL-0005,FALSE,FALSE,REF-769663,First Continental Bank,***3795,"Globex International Holdings, Inc.",US,2346661.39
26/08/2025,26/08/2025,Marketing - Aurelia Media #3,Marketing,ALL,14542.15,0,USD,ACH Debit,Aurelia Media #3,***4809,,,FALSE,FALSE,REF-130285,First Continental Bank,***2822,"Globex International Holdings, Inc.",US,2332119.24
26/08/2025,26/08/2025,Supplier Payment - CodeCraft Contractors #8,Supplier Payment,SaaS-GL,28685.71,0,USD,Wire Transfer,CodeCraft Contractors #8,***9645,,PO-202508-SaaS-GL-0001,FALSE,FALSE,REF-601536,First Continental Bank,***4667,"Globex International Holdings, Inc.",US,2303433.53
26/08/2025,26/08/2025,Supplier Payment - ExpertNet Subcontractors #1,Supplier Payment,PS-GL,33562.34,0,USD,ACH Debit,ExpertNet Subcontractors #1,***8667,,PO-202508-PS-GL-0007,FALSE,FALSE,REF-752928,First Continental Bank,***2164,"Globex International Holdings, Inc.",US,2269871.19
26/08/2025,26/08/2025,Supplier Payment - HyperCloud Infra #3,Supplier Payment,SaaS-GL,44956.3,0,USD,ACH Debit,HyperCloud Infra #3,***1831,,PO-202508-SaaS-GL-0003,FALSE,FALSE,REF-603226,First Continental Bank,***1323,"Globex International Holdings, Inc.",US,2224914.89
26/08/2025,26/08/2025,Payroll - GlobalPay Services Ltd,Payroll,ALL,244726.53,0,USD,ACH Debit,GlobalPay Services Ltd,***1975,,,FALSE,FALSE,REF-821466,First Continental Bank,***6196,"Globex International Holdings, Inc.",US,1980188.36
26/08/2025,26/08/2025,Intercompany Settlement - Globex APAC Logistics Pte. Ltd.,Intercompany Transfer,ALL,424855,0,USD,Internal Transfer,Globex APAC Logistics Pte. Ltd.,***6067,,,TRUE,TRUE,REF-334738,First Continental Bank,***4466,"Globex International Holdings, Inc.",US,1555333.36
26/08/2025,26/08/2025,Client Receipt - CloudBridge Co. #16,Sales Receipt,SaaS-GL,0,71757.55,USD,ACH Credit,CloudBridge Co. #16,***7241,INV-202508-SaaS-GL-0015,,FALSE,FALSE,REF-626584,First Continental Bank,***7343,"Globex International Holdings, Inc.",US,1627090.91
27/08/2025,27/08/2025,Supplier Payment - CodeCraft Contractors #9,Supplier Payment,SaaS-GL,1390.83,0,USD,Wire Transfer,CodeCraft Contractors #9,***8743,,PO-202508-SaaS-GL-0005,FALSE,FALSE,REF-367543,First Continental Bank,***7175,"Globex International Holdings, Inc.",US,1625700.08
27/08/2025,27/08/2025,Merchant Processing Fees,Bank/Merchant Fees,ALL,4053.16,0,USD,Wire Transfer,First Continental Bank,***6476,,,FALSE,FALSE,REF-636700,First Continental Bank,***6957,"Globex International Holdings, Inc.",US,1621646.92
27/08/2025,27/08/2025,Supplier Payment - ExpertNet Subcontractors #19,Supplier Payment,PS-GL,6076.62,0,USD,Fedwire,ExpertNet Subcontractors #19,***7756,,PO-202508-PS-GL-0009,FALSE,FALSE,REF-104289,First Continental Bank,***9377,"Globex International Holdings, Inc.",US,1615570.3
27/08/2025,27/08/2025,Supplier Payment - NorthRiver Apparel Mfg #1,Supplier Payment,Retail-NA,21504.83,0,USD,Fedwire,NorthRiver Apparel Mfg #1,***4322,,PO-202508-Retail-NA-0007,FALSE,FALSE,REF-713980,First Continental Bank,***2958,"Globex International Holdings, Inc.",US,1594065.47
27/08/2025,27/08/2025,Client Receipt - CloudBridge Co. #7,Sales Receipt,SaaS-GL,0,51248.53,USD,Fedwire Credit,CloudBridge Co. #7,***1944,INV-202508-SaaS-GL-0010,,FALSE,FALSE,REF-137264,First Continental Bank,***2373,"Globex International Holdings, Inc.",US,1645314
28/08/2025,28/08/2025,Supplier Payment - HyperCloud Infra #7,Supplier Payment,SaaS-GL,198.32,0,USD,Wire Transfer,HyperCloud Infra #7,***8665,,PO-202508-SaaS-GL-0010,FALSE,FALSE,REF-427276,First Continental Bank,***3247,"Globex International Holdings, Inc.",US,1645115.68
28/08/2025,28/08/2025,Supplier Payment - PackFast Fulfillment #12,Supplier Payment,Retail-NA,11840.29,0,USD,ACH Debit,PackFast Fulfillment #12,***1974,,PO-202508-Retail-NA-0008,FALSE,FALSE,REF-314624,First Continental Bank,***8029,"Globex International Holdings, Inc.",US,1633275.39
28/08/2025,28/08/2025,Payroll - GlobalPay Services Ltd,Payroll,ALL,244726.53,0,USD,Fedwire,GlobalPay Services Ltd,***9213,,,FALSE,FALSE,REF-891115,First Continental Bank,***2223,"Globex International Holdings, Inc.",US,1388548.86
28/08/2025,28/08/2025,Client Receipt - ShopSphere Partner #32,Sales Receipt,Retail-NA,0,28584.19,USD,Card Settlement,ShopSphere Partner #32,***6001,INV-202508-Retail-NA-0013,,FALSE,FALSE,REF-136216,First Continental Bank,***3445,"Globex International Holdings, Inc.",US,1417133.05
28/08/2025,28/08/2025,Client Receipt - CloudBridge Co. #78,Sales Receipt,SaaS-GL,0,42543.74,USD,Fedwire Credit,CloudBridge Co. #78,***2573,INV-202508-SaaS-GL-0006,,FALSE,FALSE,REF-607395,First Continental Bank,***4318,"Globex International Holdings, Inc.",US,1459676.79
28/08/2025,28/08/2025,Client Receipt - CloudBridge Co. #52,Sales Receipt,SaaS-GL,0,49893.49,USD,Card Settlement,CloudBridge Co. #52,***5493,INV-202508-SaaS-GL-0008,,FALSE,FALSE,REF-407213,First Continental Bank,***7080,"Globex International Holdings, Inc.",US,1509570.28
28/08/2025,28/08/2025,Client Receipt - Vertex Advisory Client #40,Sales Receipt,PS-GL,0,258751.43,USD,ACH Credit,Vertex Advisory Client #40,***8645,INV-202508-PS-GL-0008,,FALSE,FALSE,REF-466445,First Continental Bank,***8904,"Globex International Holdings, Inc.",US,1768321.71
28/08/2025,28/08/2025,Client Receipt - Card Settlement Batch #14,Sales Receipt,Retail-NA,0,430510.53,USD,Fedwire Credit,Card Settlement Batch #14,***1363,INV-202508-Retail-NA-0006,,FALSE,FALSE,REF-134630,First Continental Bank,***7365,"Globex International Holdings, Inc.",US,2198832.24
29/08/2025,29/08/2025,Client Receipt - CloudBridge Co. #35,Sales Receipt,SaaS-GL,0,15041.92,USD,Fedwire Credit,CloudBridge Co. #35,***5875,INV-202508-SaaS-GL-0019,,FALSE,FALSE,REF-566336,First Continental Bank,***3416,"Globex International Holdings, Inc.",US,2213874.16
29/08/2025,29/08/2025,Client Receipt - CloudBridge Co. #66,Sales Receipt,SaaS-GL,0,106812.8,USD,Card Settlement,CloudBridge Co. #66,***3808,INV-202508-SaaS-GL-0017,,FALSE,FALSE,REF-690681,First Continental Bank,***2458,"Globex International Holdings, Inc.",US,2320686.96
30/08/2025,30/08/2025,Interest Earned,Interest Income,ALL,0,11108.87,USD,ACH Credit,First Continental Bank,***5140,,,FALSE,FALSE,REF-982172,First Continental Bank,***9892,"Globex International Holdings, Inc.",US,2331795.83
