Date,ValueDate,Description,Category,BusinessUnit,Debit,Credit,Currency,PaymentRail,Counterparty,CounterpartyAccount,InvoiceID,PONumber,Intercompany,EliminateInConsolidation,Reference,Bank,AccountNumberMasked,Company,Jurisdiction,Balance
2023-09-01,2023-09-01,Account Maintenance Fee,Bank/Merchant Fees,ALL,2500.0,0.0,SGD,SWIFT MT103,First Continental Bank,***8650,,,False,False,REF-513287,First Continental Bank,***1731,Globex APAC Logistics Pte. Ltd.,SG,9997500.0
2023-09-01,2023-09-01,Supplier Payment - ExpertNet Subcontractors #2,Supplier Payment,PS-GL,3048.37,0.0,SGD,MEPS+,ExpertNet Subcontractors #2,***7335,,PO-202309-PS-GL-0006,False,False,REF-429590,First Continental Bank,***6415,Globex APAC Logistics Pte. Ltd.,SG,9994451.63
2023-09-01,2023-09-01,Supplier Payment - ExpertNet Subcontractors #10,Supplier Payment,PS-GL,3145.97,0.0,SGD,SWIFT MT103,ExpertNet Subcontractors #10,***6831,,PO-202309-PS-GL-0002,False,False,REF-276467,First Continental Bank,***3240,Globex APAC Logistics Pte. Ltd.,SG,9991305.66
2023-09-01,2023-09-01,Supplier Payment - Port Services #2,Supplier Payment,Logistics-APAC,40292.21,0.0,SGD,MEPS+,Port Services #2,***3483,,PO-202309-Logistics-APAC-0005,False,False,REF-699342,First Continental Bank,***7132,Globex APAC Logistics Pte. Ltd.,SG,9951013.45
2023-09-01,2023-09-01,Client Receipt - Vertex Advisory Client #3,Sales Receipt,PS-GL,0.0,832.93,SGD,SWIFT MT103,Vertex Advisory Client #3,***4001,INV-202309-PS-GL-0007,,False,False,REF-553571,First Continental Bank,***2891,Globex APAC Logistics Pte. Ltd.,SG,9951846.38
2023-09-02,2023-09-02,Client Receipt - CloudBridge Co. #18,Sales Receipt,SaaS-GL,0.0,33090.25,SGD,FAST Credit,CloudBridge Co. #18,***5519,INV-202309-SaaS-GL-0018,,False,False,REF-948320,First Continental Bank,***6279,Globex APAC Logistics Pte. Ltd.,SG,9984936.63
2023-09-03,2023-09-03,Merchant Processing Fees,Bank/Merchant Fees,ALL,2233.38,0.0,SGD,FAST Debit,First Continental Bank,***8654,,,False,False,REF-589705,First Continental Bank,***8511,Globex APAC Logistics Pte. Ltd.,SG,9982703.25
2023-09-03,2023-09-03,Client Receipt - Vertex Advisory Client #19,Sales Receipt,PS-GL,0.0,5234.81,SGD,FAST Credit,Vertex Advisory Client #19,***8317,INV-202309-PS-GL-0001,,False,False,REF-592705,First Continental Bank,***5838,Globex APAC Logistics Pte. Ltd.,SG,9987938.06
2023-09-04,2023-09-04,Supplier Payment - CodeCraft Contractors #6,Supplier Payment,SaaS-GL,4564.54,0.0,SGD,SWIFT MT103,CodeCraft Contractors #6,***6253,,PO-202309-SaaS-GL-0008,False,False,REF-684902,First Continental Bank,***4412,Globex APAC Logistics Pte. Ltd.,SG,9983373.52
2023-09-04,2023-09-04,Client Receipt - Pacific Trade Co. #2,Sales Receipt,Logistics-APAC,0.0,9449.33,SGD,FAST Credit,Pacific Trade Co. #2,***1962,INV-202309-Logistics-APAC-0015,,False,False,REF-387716,First Continental Bank,***7739,Globex APAC Logistics Pte. Ltd.,SG,9992822.85
2023-09-05,2023-09-05,Supplier Payment - HyperCloud Infra #10,Supplier Payment,SaaS-GL,460.32,0.0,SGD,MEPS+,HyperCloud Infra #10,***7717,,PO-202309-SaaS-GL-0001,False,False,REF-798647,First Continental Bank,***2324,Globex APAC Logistics Pte. Ltd.,SG,9992362.53
2023-09-05,2023-09-05,Supplier Payment - TransAsia Freight #27,Supplier Payment,Logistics-APAC,5094.94,0.0,SGD,MEPS+,TransAsia Freight #27,***1107,,PO-202309-Logistics-APAC-0003,False,False,REF-457213,First Continental Bank,***4196,Globex APAC Logistics Pte. Ltd.,SG,9987267.59
2023-09-05,2023-09-05,Supplier Payment - ExpertNet Subcontractors #1,Supplier Payment,PS-GL,24533.67,0.0,SGD,FAST Debit,ExpertNet Subcontractors #1,***2442,,PO-202309-PS-GL-0009,False,False,REF-963068,First Continental Bank,***1761,Globex APAC Logistics Pte. Ltd.,SG,9962733.92
2023-09-05,2023-09-05,Supplier Payment - TransAsia Freight #33,Supplier Payment,Logistics-APAC,89508.2,0.0,SGD,SWIFT MT103,TransAsia Freight #33,***6966,,PO-202309-Logistics-APAC-0011,False,False,REF-974578,First Continental Bank,***7621,Globex APAC Logistics Pte. Ltd.,SG,9873225.72
2023-09-05,2023-09-05,Client Receipt - CloudBridge Co. #38,Sales Receipt,SaaS-GL,0.0,4003.54,SGD,FAST Credit,CloudBridge Co. #38,***1773,INV-202309-SaaS-GL-0009,,False,False,REF-288813,First Continental Bank,***9896,Globex APAC Logistics Pte. Ltd.,SG,9877229.26
2023-09-05,2023-09-05,Client Receipt - CloudBridge Co. #2,Sales Receipt,SaaS-GL,0.0,13344.5,SGD,FAST Credit,CloudBridge Co. #2,***4698,INV-202309-SaaS-GL-0002,,False,False,REF-777994,First Continental Bank,***1234,Globex APAC Logistics Pte. Ltd.,SG,9890573.76
2023-09-05,2023-09-05,Client Receipt - Pacific Trade Co. #57,Sales Receipt,Logistics-APAC,0.0,14953.98,SGD,SWIFT MT103,Pacific Trade Co. #57,***3720,INV-202309-Logistics-APAC-0001,,False,False,REF-503927,First Continental Bank,***6723,Globex APAC Logistics Pte. Ltd.,SG,9905527.74
2023-09-05,2023-09-05,Client Receipt - Pacific Trade Co. #22,Sales Receipt,Logistics-APAC,0.0,66843.9,SGD,FAST Credit,Pacific Trade Co. #22,***4378,INV-202309-Logistics-APAC-0008,,False,False,REF-106754,First Continental Bank,***3539,Globex APAC Logistics Pte. Ltd.,SG,9972371.64
2023-09-06,2023-09-06,Supplier Payment - Port Services #15,Supplier Payment,Logistics-APAC,25025.81,0.0,SGD,SWIFT MT103,Port Services #15,***7043,,PO-202309-Logistics-APAC-0012,False,False,REF-498718,First Continental Bank,***2605,Globex APAC Logistics Pte. Ltd.,SG,9947345.83
2023-09-06,2023-09-06,Client Receipt - Vertex Advisory Client #14,Sales Receipt,PS-GL,0.0,26373.2,SGD,SWIFT MT103,Vertex Advisory Client #14,***6541,INV-202309-PS-GL-0003,,False,False,REF-152005,First Continental Bank,***4262,Globex APAC Logistics Pte. Ltd.,SG,9973719.03
2023-09-07,2023-09-07,Supplier Payment - ExpertNet Subcontractors #17,Supplier Payment,PS-GL,16746.77,0.0,SGD,MEPS+,ExpertNet Subcontractors #17,***3448,,PO-202309-PS-GL-0001,False,False,REF-416578,First Continental Bank,***6608,Globex APAC Logistics Pte. Ltd.,SG,9956972.26
2023-09-07,2023-09-07,Client Receipt - Pacific Trade Co. #67,Sales Receipt,Logistics-APAC,0.0,29674.24,SGD,FAST Credit,Pacific Trade Co. #67,***6663,INV-202309-Logistics-APAC-0004,,False,False,REF-447331,First Continental Bank,***5723,Globex APAC Logistics Pte. Ltd.,SG,9986646.5
2023-09-08,2023-09-08,Marketing - Aurelia Media #2,Marketing,ALL,13618.39,0.0,SGD,SWIFT MT103,Aurelia Media #2,***9498,,,False,False,REF-949102,First Continental Bank,***7225,Globex APAC Logistics Pte. Ltd.,SG,9973028.11
2023-09-08,2023-09-08,Client Receipt - CloudBridge Co. #23,Sales Receipt,SaaS-GL,0.0,4444.71,SGD,SWIFT MT103,CloudBridge Co. #23,***8612,INV-202309-SaaS-GL-0019,,False,False,REF-395497,First Continental Bank,***9707,Globex APAC Logistics Pte. Ltd.,SG,9977472.82
2023-09-08,2023-09-08,Client Receipt - CloudBridge Co. #10,Sales Receipt,SaaS-GL,0.0,13967.96,SGD,FAST Credit,CloudBridge Co. #10,***6874,INV-202309-SaaS-GL-0007,,False,False,REF-632159,First Continental Bank,***4765,Globex APAC Logistics Pte. Ltd.,SG,9991440.78
2023-09-09,2023-09-09,Supplier Payment - TransAsia Freight #44,Supplier Payment,Logistics-APAC,63650.64,0.0,SGD,SWIFT MT103,TransAsia Freight #44,***2413,,PO-202309-Logistics-APAC-0007,False,False,REF-396056,First Continental Bank,***1264,Globex APAC Logistics Pte. Ltd.,SG,9927790.14
2023-09-09,2023-09-09,Client Receipt - CloudBridge Co. #68,Sales Receipt,SaaS-GL,0.0,16035.13,SGD,SWIFT MT103,CloudBridge Co. #68,***3799,INV-202309-SaaS-GL-0003,,False,False,REF-691333,First Continental Bank,***7541,Globex APAC Logistics Pte. Ltd.,SG,9943825.27
2023-09-10,2023-09-10,Metro Water & Waste,Rent & Utilities,ALL,1032.09,0.0,SGD,FAST Debit,Metro Water & Waste,***7432,,,False,False,REF-643936,First Continental Bank,***3828,Globex APAC Logistics Pte. Ltd.,SG,9942793.18
2023-09-10,2023-09-10,Supplier Payment - ExpertNet Subcontractors #17,Supplier Payment,PS-GL,10711.17,0.0,SGD,FAST Debit,ExpertNet Subcontractors #17,***5905,,PO-202309-PS-GL-0008,False,False,REF-655897,First Continental Bank,***8423,Globex APAC Logistics Pte. Ltd.,SG,9932082.01
2023-09-10,2023-09-10,Client Receipt - Pacific Trade Co. #10,Sales Receipt,Logistics-APAC,0.0,6116.56,SGD,SWIFT MT103,Pacific Trade Co. #10,***9843,INV-202309-Logistics-APAC-0006,,False,False,REF-686031,First Continental Bank,***7693,Globex APAC Logistics Pte. Ltd.,SG,9938198.57
2023-09-11,2023-09-11,Supplier Payment - TransAsia Freight #34,Supplier Payment,Logistics-APAC,2838.0,0.0,SGD,FAST Debit,TransAsia Freight #34,***8388,,PO-202309-Logistics-APAC-0009,False,False,REF-149365,First Continental Bank,***9087,Globex APAC Logistics Pte. Ltd.,SG,9935360.57
2023-09-11,2023-09-11,Client Receipt - Pacific Trade Co. #61,Sales Receipt,Logistics-APAC,0.0,3421.45,SGD,SWIFT MT103,Pacific Trade Co. #61,***4173,INV-202309-Logistics-APAC-0010,,False,False,REF-570998,First Continental Bank,***1559,Globex APAC Logistics Pte. Ltd.,SG,9938782.02
2023-09-11,2023-09-11,Client Receipt - Pacific Trade Co. #30,Sales Receipt,Logistics-APAC,0.0,3937.84,SGD,FAST Credit,Pacific Trade Co. #30,***2205,INV-202309-Logistics-APAC-0016,,False,False,REF-468491,First Continental Bank,***5308,Globex APAC Logistics Pte. Ltd.,SG,9942719.86
2023-09-12,2023-09-12,Supplier Payment - Port Services #2,Supplier Payment,Logistics-APAC,22893.93,0.0,SGD,MEPS+,Port Services #2,***7512,,PO-202309-Logistics-APAC-0002,False,False,REF-204759,First Continental Bank,***5272,Globex APAC Logistics Pte. Ltd.,SG,9919825.93
2023-09-12,2023-09-12,Intercompany Settlement - Globex Retail NA LLC,Intercompany Transfer,ALL,273693.0,0.0,SGD,Internal Transfer,Globex Retail NA LLC,***4717,,,True,True,REF-327375,First Continental Bank,***5200,Globex APAC Logistics Pte. Ltd.,SG,9646132.93
2023-09-13,2023-09-13,BluePeak Property Mgmt,Rent & Utilities,ALL,8718.48,0.0,SGD,FAST Debit,BluePeak Property Mgmt,***1809,,,False,False,REF-936516,First Continental Bank,***2181,Globex APAC Logistics Pte. Ltd.,SG,9637414.45
2023-09-13,2023-09-13,Client Receipt - CloudBridge Co. #53,Sales Receipt,SaaS-GL,0.0,20989.07,SGD,SWIFT MT103,CloudBridge Co. #53,***8864,INV-202309-SaaS-GL-0011,,False,False,REF-963585,First Continental Bank,***4781,Globex APAC Logistics Pte. Ltd.,SG,9658403.52
2023-09-13,2023-09-13,Client Receipt - CloudBridge Co. #77,Sales Receipt,SaaS-GL,0.0,41890.6,SGD,SWIFT MT103,CloudBridge Co. #77,***4726,INV-202309-SaaS-GL-0001,,False,False,REF-652139,First Continental Bank,***6848,Globex APAC Logistics Pte. Ltd.,SG,9700294.12
2023-09-14,2023-09-14,Client Receipt - CloudBridge Co. #50,Sales Receipt,SaaS-GL,0.0,8826.08,SGD,SWIFT MT103,CloudBridge Co. #50,***3375,INV-202309-SaaS-GL-0017,,False,False,REF-824661,First Continental Bank,***9382,Globex APAC Logistics Pte. Ltd.,SG,9709120.2
2023-09-14,2023-09-14,Client Receipt - CloudBridge Co. #51,Sales Receipt,SaaS-GL,0.0,9843.32,SGD,SWIFT MT103,CloudBridge Co. #51,***4806,INV-202309-SaaS-GL-0006,,False,False,REF-659445,First Continental Bank,***2750,Globex APAC Logistics Pte. Ltd.,SG,9718963.52
2023-09-14,2023-09-14,Client Receipt - Vertex Advisory Client #2,Sales Receipt,PS-GL,0.0,13646.18,SGD,FAST Credit,Vertex Advisory Client #2,***9392,INV-202309-PS-GL-0004,,False,False,REF-347287,First Continental Bank,***8226,Globex APAC Logistics Pte. Ltd.,SG,9732609.7
2023-09-14,2023-09-14,Client Receipt - CloudBridge Co. #19,Sales Receipt,SaaS-GL,0.0,29083.55,SGD,SWIFT MT103,CloudBridge Co. #19,***2864,INV-202309-SaaS-GL-0004,,False,False,REF-685766,First Continental Bank,***8486,Globex APAC Logistics Pte. Ltd.,SG,9761693.25
2023-09-14,2023-09-14,Client Receipt - Pacific Trade Co. #66,Sales Receipt,Logistics-APAC,0.0,82978.27,SGD,FAST Credit,Pacific Trade Co. #66,***7958,INV-202309-Logistics-APAC-0009,,False,False,REF-667339,First Continental Bank,***6717,Globex APAC Logistics Pte. Ltd.,SG,9844671.52
2023-09-15,2023-09-15,Supplier Payment - HyperCloud Infra #8,Supplier Payment,SaaS-GL,230.32,0.0,SGD,MEPS+,HyperCloud Infra #8,***2360,,PO-202309-SaaS-GL-0004,False,False,REF-793382,First Continental Bank,***7728,Globex APAC Logistics Pte. Ltd.,SG,9844441.2
2023-09-15,2023-09-15,Supplier Payment - HyperCloud Infra #13,Supplier Payment,SaaS-GL,640.9,0.0,SGD,FAST Debit,HyperCloud Infra #13,***8397,,PO-202309-SaaS-GL-0009,False,False,REF-971407,First Continental Bank,***3245,Globex APAC Logistics Pte. Ltd.,SG,9843800.3
2023-09-15,2023-09-15,Supplier Payment - TransAsia Freight #26,Supplier Payment,Logistics-APAC,35903.03,0.0,SGD,FAST Debit,TransAsia Freight #26,***3433,,PO-202309-Logistics-APAC-0004,False,False,REF-643302,First Continental Bank,***8271,Globex APAC Logistics Pte. Ltd.,SG,9807897.27
2023-09-15,2023-09-15,Client Receipt - CloudBridge Co. #5,Sales Receipt,SaaS-GL,0.0,11247.92,SGD,SWIFT MT103,CloudBridge Co. #5,***7668,INV-202309-SaaS-GL-0010,,False,False,REF-384503,First Continental Bank,***2527,Globex APAC Logistics Pte. Ltd.,SG,9819145.19
2023-09-15,2023-09-15,Client Receipt - CloudBridge Co. #39,Sales Receipt,SaaS-GL,0.0,32645.23,SGD,FAST Credit,CloudBridge Co. #39,***7176,INV-202309-SaaS-GL-0024,,False,False,REF-199416,First Continental Bank,***4717,Globex APAC Logistics Pte. Ltd.,SG,9851790.42
2023-09-18,2023-09-18,Supplier Payment - TransAsia Freight #13,Supplier Payment,Logistics-APAC,6676.33,0.0,SGD,SWIFT MT103,TransAsia Freight #13,***3250,,PO-202309-Logistics-APAC-0010,False,False,REF-120989,First Continental Bank,***7763,Globex APAC Logistics Pte. Ltd.,SG,9845114.09
2023-09-18,2023-09-18,Client Receipt - CloudBridge Co. #73,Sales Receipt,SaaS-GL,0.0,31178.97,SGD,FAST Credit,CloudBridge Co. #73,***2626,INV-202309-SaaS-GL-0015,,False,False,REF-968251,First Continental Bank,***1461,Globex APAC Logistics Pte. Ltd.,SG,9876293.06
2023-09-19,2023-09-19,Supplier Payment - HyperCloud Infra #11,Supplier Payment,SaaS-GL,13500.04,0.0,SGD,MEPS+,HyperCloud Infra #11,***9909,,PO-202309-SaaS-GL-0006,False,False,REF-112877,First Continental Bank,***8832,Globex APAC Logistics Pte. Ltd.,SG,9862793.02
2023-09-19,2023-09-19,Supplier Payment - ExpertNet Subcontractors #16,Supplier Payment,PS-GL,15871.34,0.0,SGD,FAST Debit,ExpertNet Subcontractors #16,***9850,,PO-202309-PS-GL-0010,False,False,REF-105286,First Continental Bank,***1148,Globex APAC Logistics Pte. Ltd.,SG,9846921.68
2023-09-19,2023-09-19,Client Receipt - Vertex Advisory Client #27,Sales Receipt,PS-GL,0.0,7399.07,SGD,FAST Credit,Vertex Advisory Client #27,***4543,INV-202309-PS-GL-0002,,False,False,REF-409220,First Continental Bank,***6651,Globex APAC Logistics Pte. Ltd.,SG,9854320.75
2023-09-19,2023-09-19,Client Receipt - Vertex Advisory Client #10,Sales Receipt,PS-GL,0.0,11838.04,SGD,FAST Credit,Vertex Advisory Client #10,***3573,INV-202309-PS-GL-0008,,False,False,REF-377660,First Continental Bank,***9612,Globex APAC Logistics Pte. Ltd.,SG,9866158.79
2023-09-19,2023-09-19,Client Receipt - CloudBridge Co. #6,Sales Receipt,SaaS-GL,0.0,15636.96,SGD,SWIFT MT103,CloudBridge Co. #6,***8043,INV-202309-SaaS-GL-0005,,False,False,REF-801247,First Continental Bank,***3703,Globex APAC Logistics Pte. Ltd.,SG,9881795.75
2023-09-19,2023-09-19,Client Receipt - CloudBridge Co. #19,Sales Receipt,SaaS-GL,0.0,17099.46,SGD,SWIFT MT103,CloudBridge Co. #19,***6108,INV-202309-SaaS-GL-0023,,False,False,REF-293624,First Continental Bank,***7718,Globex APAC Logistics Pte. Ltd.,SG,9898895.21
2023-09-20,2023-09-20,Supplier Payment - CodeCraft Contractors #3,Supplier Payment,SaaS-GL,5998.78,0.0,SGD,SWIFT MT103,CodeCraft Contractors #3,***6914,,PO-202309-SaaS-GL-0005,False,False,REF-515515,First Continental Bank,***8422,Globex APAC Logistics Pte. Ltd.,SG,9892896.43
2023-09-20,2023-09-20,VAT/GST Remittance - IRAS Singapore,Tax Payment,ALL,73441.17,0.0,SGD,SWIFT MT103,IRAS Singapore,***6609,,,False,False,REF-569103,First Continental Bank,***7792,Globex APAC Logistics Pte. Ltd.,SG,9819455.26
2023-09-20,2023-09-20,Client Receipt - Pacific Trade Co. #41,Sales Receipt,Logistics-APAC,0.0,72930.42,SGD,FAST Credit,Pacific Trade Co. #41,***2056,INV-202309-Logistics-APAC-0002,,False,False,REF-999938,First Continental Bank,***5223,Globex APAC Logistics Pte. Ltd.,SG,9892385.68
2023-09-20,2023-09-20,Client Receipt - Vertex Advisory Client #38,Sales Receipt,PS-GL,0.0,226502.31,SGD,SWIFT MT103,Vertex Advisory Client #38,***6327,INV-202309-PS-GL-0006,,False,False,REF-854360,First Continental Bank,***3695,Globex APAC Logistics Pte. Ltd.,SG,10118887.99
2023-09-21,2023-09-21,Merchant Processing Fees,Bank/Merchant Fees,ALL,1427.33,0.0,SGD,SWIFT MT103,First Continental Bank,***2770,,,False,False,REF-336365,First Continental Bank,***5080,Globex APAC Logistics Pte. Ltd.,SG,10117460.66
2023-09-21,2023-09-21,Supplier Payment - TransAsia Freight #25,Supplier Payment,Logistics-APAC,21965.87,0.0,SGD,FAST Debit,TransAsia Freight #25,***2522,,PO-202309-Logistics-APAC-0008,False,False,REF-648546,First Continental Bank,***4162,Globex APAC Logistics Pte. Ltd.,SG,10095494.79
2023-09-21,2023-09-21,Client Receipt - CloudBridge Co. #73,Sales Receipt,SaaS-GL,0.0,7009.66,SGD,SWIFT MT103,CloudBridge Co. #73,***2946,INV-202309-SaaS-GL-0013,,False,False,REF-336256,First Continental Bank,***8991,Globex APAC Logistics Pte. Ltd.,SG,10102504.45
2023-09-22,2023-09-22,Supplier Payment - HyperCloud Infra #18,Supplier Payment,SaaS-GL,4718.67,0.0,SGD,FAST Debit,HyperCloud Infra #18,***1689,,PO-202309-SaaS-GL-0003,False,False,REF-140284,First Continental Bank,***2535,Globex APAC Logistics Pte. Ltd.,SG,10097785.78
2023-09-22,2023-09-22,Supplier Payment - ExpertNet Subcontractors #18,Supplier Payment,PS-GL,5827.83,0.0,SGD,MEPS+,ExpertNet Subcontractors #18,***8140,,PO-202309-PS-GL-0005,False,False,REF-470396,First Continental Bank,***5966,Globex APAC Logistics Pte. Ltd.,SG,10091957.95
2023-09-22,2023-09-22,Marketing - Aurelia Media #8,Marketing,ALL,16746.13,0.0,SGD,FAST Debit,Aurelia Media #8,***6917,,,False,False,REF-913018,First Continental Bank,***6987,Globex APAC Logistics Pte. Ltd.,SG,10075211.82
2023-09-22,2023-09-22,Supplier Payment - TransAsia Freight #10,Supplier Payment,Logistics-APAC,23864.05,0.0,SGD,MEPS+,TransAsia Freight #10,***4819,,PO-202309-Logistics-APAC-0001,False,False,REF-778509,First Continental Bank,***9089,Globex APAC Logistics Pte. Ltd.,SG,10051347.77
2023-09-22,2023-09-22,Client Receipt - CloudBridge Co. #50,Sales Receipt,SaaS-GL,0.0,1124.74,SGD,SWIFT MT103,CloudBridge Co. #50,***9152,INV-202309-SaaS-GL-0022,,False,False,REF-760973,First Continental Bank,***8895,Globex APAC Logistics Pte. Ltd.,SG,10052472.51
2023-09-22,2023-09-22,Client Receipt - CloudBridge Co. #29,Sales Receipt,SaaS-GL,0.0,21663.49,SGD,FAST Credit,CloudBridge Co. #29,***2875,INV-202309-SaaS-GL-0020,,False,False,REF-972386,First Continental Bank,***4698,Globex APAC Logistics Pte. Ltd.,SG,10074136.0
2023-09-22,2023-09-22,Client Receipt - Pacific Trade Co. #38,Sales Receipt,Logistics-APAC,0.0,95136.86,SGD,FAST Credit,Pacific Trade Co. #38,***6971,INV-202309-Logistics-APAC-0012,,False,False,REF-147375,First Continental Bank,***2616,Globex APAC Logistics Pte. Ltd.,SG,10169272.86
2023-09-23,2023-09-23,Supplier Payment - ExpertNet Subcontractors #13,Supplier Payment,PS-GL,3142.6,0.0,SGD,FAST Debit,ExpertNet Subcontractors #13,***4506,,PO-202309-PS-GL-0007,False,False,REF-848935,First Continental Bank,***4038,Globex APAC Logistics Pte. Ltd.,SG,10166130.26
2023-09-24,2023-09-24,Client Receipt - Pacific Trade Co. #3,Sales Receipt,Logistics-APAC,0.0,3451.03,SGD,FAST Credit,Pacific Trade Co. #3,***7619,INV-202309-Logistics-APAC-0007,,False,False,REF-149318,First Continental Bank,***6170,Globex APAC Logistics Pte. Ltd.,SG,10169581.29
2023-09-24,2023-09-24,Client Receipt - CloudBridge Co. #30,Sales Receipt,SaaS-GL,0.0,21444.75,SGD,SWIFT MT103,CloudBridge Co. #30,***5896,INV-202309-SaaS-GL-0012,,False,False,REF-817556,First Continental Bank,***6083,Globex APAC Logistics Pte. Ltd.,SG,10191026.04
2023-09-25,2023-09-25,Supplier Payment - CodeCraft Contractors #7,Supplier Payment,SaaS-GL,32913.92,0.0,SGD,MEPS+,CodeCraft Contractors #7,***4344,,PO-202309-SaaS-GL-0010,False,False,REF-900471,First Continental Bank,***8770,Globex APAC Logistics Pte. Ltd.,SG,10158112.12
2023-09-25,2023-09-25,Client Receipt - Vertex Advisory Client #49,Sales Receipt,PS-GL,0.0,856.39,SGD,FAST Credit,Vertex Advisory Client #49,***9095,INV-202309-PS-GL-0005,,False,False,REF-670554,First Continental Bank,***3629,Globex APAC Logistics Pte. Ltd.,SG,10158968.51
2023-09-25,2023-09-25,Client Receipt - Pacific Trade Co. #40,Sales Receipt,Logistics-APAC,0.0,8091.44,SGD,SWIFT MT103,Pacific Trade Co. #40,***5406,INV-202309-Logistics-APAC-0013,,False,False,REF-343650,First Continental Bank,***8393,Globex APAC Logistics Pte. Ltd.,SG,10167059.95
2023-09-25,2023-09-25,Client Receipt - CloudBridge Co. #47,Sales Receipt,SaaS-GL,0.0,18023.92,SGD,SWIFT MT103,CloudBridge Co. #47,***7247,INV-202309-SaaS-GL-0016,,False,False,REF-266633,First Continental Bank,***3544,Globex APAC Logistics Pte. Ltd.,SG,10185083.87
2023-09-25,2023-09-25,Client Receipt - Pacific Trade Co. #18,Sales Receipt,Logistics-APAC,0.0,29394.22,SGD,FAST Credit,Pacific Trade Co. #18,***8176,INV-202309-Logistics-APAC-0003,,False,False,REF-859707,First Continental Bank,***3901,Globex APAC Logistics Pte. Ltd.,SG,10214478.09
2023-09-26,2023-09-26,Supplier Payment - TransAsia Freight #8,Supplier Payment,Logistics-APAC,3750.4,0.0,SGD,SWIFT MT103,TransAsia Freight #8,***7710,,PO-202309-Logistics-APAC-0006,False,False,REF-285369,First Continental Bank,***2441,Globex APAC Logistics Pte. Ltd.,SG,10210727.69
2023-09-26,2023-09-26,Intercompany Settlement - Globex EMEA Manufacturing Ltd.,Intercompany Transfer,ALL,861348.0,0.0,SGD,Internal Transfer,Globex EMEA Manufacturing Ltd.,***2388,,,True,True,REF-792254,First Continental Bank,***2884,Globex APAC Logistics Pte. Ltd.,SG,9349379.69
2023-09-26,2023-09-26,Client Receipt - CloudBridge Co. #32,Sales Receipt,SaaS-GL,0.0,38872.14,SGD,FAST Credit,CloudBridge Co. #32,***7397,INV-202309-SaaS-GL-0008,,False,False,REF-800425,First Continental Bank,***7054,Globex APAC Logistics Pte. Ltd.,SG,9388251.83
2023-09-27,2023-09-27,Supplier Payment - HyperCloud Infra #17,Supplier Payment,SaaS-GL,6601.47,0.0,SGD,SWIFT MT103,HyperCloud Infra #17,***7400,,PO-202309-SaaS-GL-0007,False,False,REF-883088,First Continental Bank,***2862,Globex APAC Logistics Pte. Ltd.,SG,9381650.36
2023-09-27,2023-09-27,Payroll - GlobalPay Services Ltd,Payroll,ALL,96987.29,0.0,SGD,MEPS+,GlobalPay Services Ltd,***2223,,,False,False,REF-863398,First Continental Bank,***7490,Globex APAC Logistics Pte. Ltd.,SG,9284663.07
2023-09-28,2023-09-28,Supplier Payment - ExpertNet Subcontractors #11,Supplier Payment,PS-GL,2283.25,0.0,SGD,MEPS+,ExpertNet Subcontractors #11,***8996,,PO-202309-PS-GL-0003,False,False,REF-506434,First Continental Bank,***1506,Globex APAC Logistics Pte. Ltd.,SG,9282379.82
2023-09-28,2023-09-28,Supplier Payment - CodeCraft Contractors #3,Supplier Payment,SaaS-GL,26956.41,0.0,SGD,SWIFT MT103,CodeCraft Contractors #3,***8472,,PO-202309-SaaS-GL-0002,False,False,REF-657406,First Continental Bank,***8490,Globex APAC Logistics Pte. Ltd.,SG,9255423.41
2023-09-28,2023-09-28,Client Receipt - CloudBridge Co. #13,Sales Receipt,SaaS-GL,0.0,9549.65,SGD,FAST Credit,CloudBridge Co. #13,***1466,INV-202309-SaaS-GL-0014,,False,False,REF-415967,First Continental Bank,***1949,Globex APAC Logistics Pte. Ltd.,SG,9264973.06
2023-09-28,2023-09-28,Client Receipt - Pacific Trade Co. #58,Sales Receipt,Logistics-APAC,0.0,16104.59,SGD,SWIFT MT103,Pacific Trade Co. #58,***7792,INV-202309-Logistics-APAC-0011,,False,False,REF-956936,First Continental Bank,***4779,Globex APAC Logistics Pte. Ltd.,SG,9281077.65
2023-09-28,2023-09-28,Client Receipt - CloudBridge Co. #74,Sales Receipt,SaaS-GL,0.0,18008.79,SGD,FAST Credit,CloudBridge Co. #74,***4290,INV-202309-SaaS-GL-0021,,False,False,REF-777725,First Continental Bank,***6547,Globex APAC Logistics Pte. Ltd.,SG,9299086.44
2023-09-29,2023-09-29,Payroll - GlobalPay Services Ltd,Payroll,ALL,96987.29,0.0,SGD,MEPS+,GlobalPay Services Ltd,***9984,,,False,False,REF-431373,First Continental Bank,***9511,Globex APAC Logistics Pte. Ltd.,SG,9202099.15
2023-09-29,2023-09-29,Client Receipt - Pacific Trade Co. #32,Sales Receipt,Logistics-APAC,0.0,7307.09,SGD,SWIFT MT103,Pacific Trade Co. #32,***4249,INV-202309-Logistics-APAC-0014,,False,False,REF-524116,First Continental Bank,***1873,Globex APAC Logistics Pte. Ltd.,SG,9209406.24
2023-09-29,2023-09-29,Client Receipt - Pacific Trade Co. #68,Sales Receipt,Logistics-APAC,0.0,38013.66,SGD,FAST Credit,Pacific Trade Co. #68,***2126,INV-202309-Logistics-APAC-0005,,False,False,REF-888152,First Continental Bank,***8874,Globex APAC Logistics Pte. Ltd.,SG,9247419.9
2023-09-30,2023-09-30,Supplier Payment - ExpertNet Subcontractors #2,Supplier Payment,PS-GL,2493.91,0.0,SGD,MEPS+,ExpertNet Subcontractors #2,***5231,,PO-202309-PS-GL-0004,False,False,REF-870158,First Continental Bank,***7481,Globex APAC Logistics Pte. Ltd.,SG,9244925.99
2023-09-30,2023-09-30,Interest Earned,Interest Income,ALL,0.0,10435.99,SGD,FAST Credit,First Continental Bank,***8097,,,False,False,REF-296075,First Continental Bank,***4931,Globex APAC Logistics Pte. Ltd.,SG,9255361.98
2023-10-01,2023-10-01,Account Maintenance Fee,Bank/Merchant Fees,ALL,2500.0,0.0,SGD,SWIFT MT103,First Continental Bank,***6979,,,False,False,REF-237488,First Continental Bank,***1325,Globex APAC Logistics Pte. Ltd.,SG,9252861.98
2023-10-02,2023-10-02,Merchant Processing Fees,Bank/Merchant Fees,ALL,2022.06,0.0,SGD,MEPS+,First Continental Bank,***2504,,,False,False,REF-609042,First Continental Bank,***3704,Globex APAC Logistics Pte. Ltd.,SG,9250839.92
2023-10-03,2023-10-03,Supplier Payment - TransAsia Freight #13,Supplier Payment,Logistics-APAC,52790.72,0.0,SGD,FAST Debit,TransAsia Freight #13,***6788,,PO-202310-Logistics-APAC-0005,False,False,REF-486492,First Continental Bank,***9975,Globex APAC Logistics Pte. Ltd.,SG,9198049.2
2023-10-03,2023-10-03,Client Receipt - Vertex Advisory Client #32,Sales Receipt,PS-GL,0.0,13994.37,SGD,FAST Credit,Vertex Advisory Client #32,***1301,INV-202310-PS-GL-0005,,False,False,REF-166905,First Continental Bank,***6918,Globex APAC Logistics Pte. Ltd.,SG,9212043.57
2023-10-03,2023-10-03,Client Receipt - Vertex Advisory Client #5,Sales Receipt,PS-GL,0.0,14039.53,SGD,SWIFT MT103,Vertex Advisory Client #5,***7881,INV-202310-PS-GL-0008,,False,False,REF-576835,First Continental Bank,***3452,Globex APAC Logistics Pte. Ltd.,SG,9226083.1
2023-10-04,2023-10-04,Supplier Payment - ExpertNet Subcontractors #14,Supplier Payment,PS-GL,13713.25,0.0,SGD,MEPS+,ExpertNet Subcontractors #14,***1369,,PO-202310-PS-GL-0009,False,False,REF-813003,First Continental Bank,***3102,Globex APAC Logistics Pte. Ltd.,SG,9212369.85
2023-10-04,2023-10-04,Client Receipt - CloudBridge Co. #73,Sales Receipt,SaaS-GL,0.0,23505.92,SGD,SWIFT MT103,CloudBridge Co. #73,***4836,INV-202310-SaaS-GL-0013,,False,False,REF-631067,First Continental Bank,***8087,Globex APAC Logistics Pte. Ltd.,SG,9235875.77
2023-10-04,2023-10-04,Client Receipt - CloudBridge Co. #14,Sales Receipt,SaaS-GL,0.0,28323.79,SGD,FAST Credit,CloudBridge Co. #14,***5686,INV-202310-SaaS-GL-0023,,False,False,REF-190931,First Continental Bank,***4673,Globex APAC Logistics Pte. Ltd.,SG,9264199.56
2023-10-05,2023-10-05,Client Receipt - CloudBridge Co. #72,Sales Receipt,SaaS-GL,0.0,3245.39,SGD,SWIFT MT103,CloudBridge Co. #72,***7892,INV-202310-SaaS-GL-0017,,False,False,REF-122521,First Continental Bank,***6081,Globex APAC Logistics Pte. Ltd.,SG,9267444.95
2023-10-05,2023-10-05,Client Receipt - Pacific Trade Co. #16,Sales Receipt,Logistics-APAC,0.0,27942.49,SGD,SWIFT MT103,Pacific Trade Co. #16,***7445,INV-202310-Logistics-APAC-0016,,False,False,REF-153385,First Continental Bank,***7307,Globex APAC Logistics Pte. Ltd.,SG,9295387.44
2023-10-05,2023-10-05,Client Receipt - CloudBridge Co. #9,Sales Receipt,SaaS-GL,0.0,33172.75,SGD,FAST Credit,CloudBridge Co. #9,***5210,INV-202310-SaaS-GL-0026,,False,False,REF-960123,First Continental Bank,***1376,Globex APAC Logistics Pte. Ltd.,SG,9328560.19
2023-10-05,2023-10-05,Client Receipt - Pacific Trade Co. #66,Sales Receipt,Logistics-APAC,0.0,35889.93,SGD,FAST Credit,Pacific Trade Co. #66,***9038,INV-202310-Logistics-APAC-0004,,False,False,REF-891684,First Continental Bank,***1378,Globex APAC Logistics Pte. Ltd.,SG,9364450.12
2023-10-05,2023-10-05,Client Receipt - Pacific Trade Co. #49,Sales Receipt,Logistics-APAC,0.0,41969.29,SGD,SWIFT MT103,Pacific Trade Co. #49,***6457,INV-202310-Logistics-APAC-0007,,False,False,REF-514831,First Continental Bank,***6066,Globex APAC Logistics Pte. Ltd.,SG,9406419.41
2023-10-06,2023-10-06,Supplier Payment - Port Services #7,Supplier Payment,Logistics-APAC,12762.77,0.0,SGD,SWIFT MT103,Port Services #7,***2888,,PO-202310-Logistics-APAC-0009,False,False,REF-974179,First Continental Bank,***5636,Globex APAC Logistics Pte. Ltd.,SG,9393656.64
2023-10-06,2023-10-06,Client Receipt - Vertex Advisory Client #3,Sales Receipt,PS-GL,0.0,2830.93,SGD,FAST Credit,Vertex Advisory Client #3,***5382,INV-202310-PS-GL-0007,,False,False,REF-517037,First Continental Bank,***5347,Globex APAC Logistics Pte. Ltd.,SG,9396487.57
2023-10-06,2023-10-06,Client Receipt - Vertex Advisory Client #5,Sales Receipt,PS-GL,0.0,5771.8,SGD,SWIFT MT103,Vertex Advisory Client #5,***8510,INV-202310-PS-GL-0002,,False,False,REF-627771,First Continental Bank,***3936,Globex APAC Logistics Pte. Ltd.,SG,9402259.37
2023-10-06,2023-10-06,Client Receipt - Vertex Advisory Client #23,Sales Receipt,PS-GL,0.0,86411.08,SGD,SWIFT MT103,Vertex Advisory Client #23,***7451,INV-202310-PS-GL-0006,,False,False,REF-920517,First Continental Bank,***3882,Globex APAC Logistics Pte. Ltd.,SG,9488670.45
2023-10-07,2023-10-07,Client Receipt - Pacific Trade Co. #9,Sales Receipt,Logistics-APAC,0.0,9560.36,SGD,FAST Credit,Pacific Trade Co. #9,***6203,INV-202310-Logistics-APAC-0011,,False,False,REF-707356,First Continental Bank,***8492,Globex APAC Logistics Pte. Ltd.,SG,9498230.81
2023-10-07,2023-10-07,Client Receipt - Vertex Advisory Client #52,Sales Receipt,PS-GL,0.0,19688.39,SGD,SWIFT MT103,Vertex Advisory Client #52,***9512,INV-202310-PS-GL-0010,,False,False,REF-961948,First Continental Bank,***4880,Globex APAC Logistics Pte. Ltd.,SG,9517919.2
2023-10-08,2023-10-08,Client Receipt - Pacific Trade Co. #1,Sales Receipt,Logistics-APAC,0.0,3337.69,SGD,SWIFT MT103,Pacific Trade Co. #1,***8243,INV-202310-Logistics-APAC-0013,,False,False,REF-887193,First Continental Bank,***6173,Globex APAC Logistics Pte. Ltd.,SG,9521256.89
2023-10-09,2023-10-09,Marketing - Beacon Digital #4,Marketing,ALL,6466.91,0.0,SGD,SWIFT MT103,Beacon Digital #4,***8108,,,False,False,REF-430815,First Continental Bank,***5586,Globex APAC Logistics Pte. Ltd.,SG,9514789.98
2023-10-09,2023-10-09,Client Receipt - Pacific Trade Co. #24,Sales Receipt,Logistics-APAC,0.0,4443.89,SGD,SWIFT MT103,Pacific Trade Co. #24,***4072,INV-202310-Logistics-APAC-0018,,False,False,REF-186605,First Continental Bank,***3749,Globex APAC Logistics Pte. Ltd.,SG,9519233.87
2023-10-09,2023-10-09,Client Receipt - CloudBridge Co. #72,Sales Receipt,SaaS-GL,0.0,46959.58,SGD,FAST Credit,CloudBridge Co. #72,***7338,INV-202310-SaaS-GL-0015,,False,False,REF-764072,First Continental Bank,***6198,Globex APAC Logistics Pte. Ltd.,SG,9566193.45
2023-10-10,2023-10-10,Client Receipt - CloudBridge Co. #49,Sales Receipt,SaaS-GL,0.0,4608.83,SGD,SWIFT MT103,CloudBridge Co. #49,***8134,INV-202310-SaaS-GL-0009,,False,False,REF-806438,First Continental Bank,***6043,Globex APAC Logistics Pte. Ltd.,SG,9570802.28
2023-10-10,2023-10-10,Client Receipt - CloudBridge Co. #26,Sales Receipt,SaaS-GL,0.0,13815.1,SGD,FAST Credit,CloudBridge Co. #26,***4310,INV-202310-SaaS-GL-0003,,False,False,REF-698690,First Continental Bank,***4013,Globex APAC Logistics Pte. Ltd.,SG,9584617.38
2023-10-10,2023-10-10,Client Receipt - Vertex Advisory Client #53,Sales Receipt,PS-GL,0.0,17702.82,SGD,FAST Credit,Vertex Advisory Client #53,***5637,INV-202310-PS-GL-0004,,False,False,REF-105932,First Continental Bank,***1986,Globex APAC Logistics Pte. Ltd.,SG,9602320.2
2023-10-10,2023-10-10,Client Receipt - CloudBridge Co. #19,Sales Receipt,SaaS-GL,0.0,45595.05,SGD,SWIFT MT103,CloudBridge Co. #19,***7869,INV-202310-SaaS-GL-0027,,False,False,REF-582423,First Continental Bank,***5244,Globex APAC Logistics Pte. Ltd.,SG,9647915.25
2023-10-11,2023-10-11,Supplier Payment - CodeCraft Contractors #14,Supplier Payment,SaaS-GL,7515.52,0.0,SGD,MEPS+,CodeCraft Contractors #14,***4226,,PO-202310-SaaS-GL-0008,False,False,REF-867868,First Continental Bank,***1112,Globex APAC Logistics Pte. Ltd.,SG,9640399.73
2023-10-11,2023-10-11,Supplier Payment - TransAsia Freight #29,Supplier Payment,Logistics-APAC,31873.71,0.0,SGD,MEPS+,TransAsia Freight #29,***6566,,PO-202310-Logistics-APAC-0004,False,False,REF-805531,First Continental Bank,***8754,Globex APAC Logistics Pte. Ltd.,SG,9608526.02
2023-10-11,2023-10-11,Supplier Payment - TransAsia Freight #22,Supplier Payment,Logistics-APAC,70028.56,0.0,SGD,MEPS+,TransAsia Freight #22,***4394,,PO-202310-Logistics-APAC-0008,False,False,REF-621110,First Continental Bank,***8501,Globex APAC Logistics Pte. Ltd.,SG,9538497.46
2023-10-11,2023-10-11,Client Receipt - CloudBridge Co. #64,Sales Receipt,SaaS-GL,0.0,7164.19,SGD,SWIFT MT103,CloudBridge Co. #64,***2139,INV-202310-SaaS-GL-0022,,False,False,REF-493606,First Continental Bank,***9509,Globex APAC Logistics Pte. Ltd.,SG,9545661.65
2023-10-11,2023-10-11,Client Receipt - Pacific Trade Co. #47,Sales Receipt,Logistics-APAC,0.0,10770.2,SGD,FAST Credit,Pacific Trade Co. #47,***4378,INV-202310-Logistics-APAC-0009,,False,False,REF-335230,First Continental Bank,***4616,Globex APAC Logistics Pte. Ltd.,SG,9556431.85
2023-10-11,2023-10-11,Client Receipt - CloudBridge Co. #8,Sales Receipt,SaaS-GL,0.0,27067.49,SGD,FAST Credit,CloudBridge Co. #8,***8736,INV-202310-SaaS-GL-0025,,False,False,REF-776560,First Continental Bank,***7426,Globex APAC Logistics Pte. Ltd.,SG,9583499.34
2023-10-12,2023-10-12,Supplier Payment - ExpertNet Subcontractors #1,Supplier Payment,PS-GL,13254.97,0.0,SGD,SWIFT MT103,ExpertNet Subcontractors #1,***6374,,PO-202310-PS-GL-0002,False,False,REF-311055,First Continental Bank,***3945,Globex APAC Logistics Pte. Ltd.,SG,9570244.37
2023-10-12,2023-10-12,Supplier Payment - HyperCloud Infra #3,Supplier Payment,SaaS-GL,15424.43,0.0,SGD,FAST Debit,HyperCloud Infra #3,***5447,,PO-202310-SaaS-GL-0003,False,False,REF-320936,First Continental Bank,***5068,Globex APAC Logistics Pte. Ltd.,SG,9554819.94
2023-10-12,2023-10-12,Supplier Payment - ExpertNet Subcontractors #14,Supplier Payment,PS-GL,29918.31,0.0,SGD,FAST Debit,ExpertNet Subcontractors #14,***9651,,PO-202310-PS-GL-0004,False,False,REF-135751,First Continental Bank,***9576,Globex APAC Logistics Pte. Ltd.,SG,9524901.63
2023-10-12,2023-10-12,Supplier Payment - TransAsia Freight #42,Supplier Payment,Logistics-APAC,60125.55,0.0,SGD,SWIFT MT103,TransAsia Freight #42,***7449,,PO-202310-Logistics-APAC-0003,False,False,REF-589823,First Continental Bank,***6083,Globex APAC Logistics Pte. Ltd.,SG,9464776.08
2023-10-12,2023-10-12,"Intercompany Settlement - Globex International Holdings, Inc.",Intercompany Transfer,ALL,554464.0,0.0,SGD,Internal Transfer,"Globex International Holdings, Inc.",***2447,,,True,True,REF-919208,First Continental Bank,***7832,Globex APAC Logistics Pte. Ltd.,SG,8910312.08
2023-10-12,2023-10-12,Client Receipt - Pacific Trade Co. #32,Sales Receipt,Logistics-APAC,0.0,24905.97,SGD,SWIFT MT103,Pacific Trade Co. #32,***3324,INV-202310-Logistics-APAC-0012,,False,False,REF-633063,First Continental Bank,***8297,Globex APAC Logistics Pte. Ltd.,SG,8935218.05
2023-10-12,2023-10-12,Client Receipt - Pacific Trade Co. #10,Sales Receipt,Logistics-APAC,0.0,40094.51,SGD,FAST Credit,Pacific Trade Co. #10,***4225,INV-202310-Logistics-APAC-0015,,False,False,REF-845743,First Continental Bank,***8579,Globex APAC Logistics Pte. Ltd.,SG,8975312.56
2023-10-12,2023-10-12,Client Receipt - CloudBridge Co. #58,Sales Receipt,SaaS-GL,0.0,86290.27,SGD,FAST Credit,CloudBridge Co. #58,***1708,INV-202310-SaaS-GL-0011,,False,False,REF-105967,First Continental Bank,***9566,Globex APAC Logistics Pte. Ltd.,SG,9061602.83
2023-10-12,2023-10-12,"Intercompany Reimbursement - Globex International Holdings, Inc.",Intercompany Transfer,ALL,0.0,221785.6,SGD,Internal Transfer,"Globex International Holdings, Inc.",***9926,,,True,True,REF-793153,First Continental Bank,***5063,Globex APAC Logistics Pte. Ltd.,SG,9283388.43
2023-10-13,2023-10-13,Supplier Payment - HyperCloud Infra #7,Supplier Payment,SaaS-GL,1712.64,0.0,SGD,SWIFT MT103,HyperCloud Infra #7,***8130,,PO-202310-SaaS-GL-0006,False,False,REF-889460,First Continental Bank,***2962,Globex APAC Logistics Pte. Ltd.,SG,9281675.79
2023-10-13,2023-10-13,Supplier Payment - ExpertNet Subcontractors #10,Supplier Payment,PS-GL,4219.67,0.0,SGD,SWIFT MT103,ExpertNet Subcontractors #10,***8769,,PO-202310-PS-GL-0003,False,False,REF-926290,First Continental Bank,***3478,Globex APAC Logistics Pte. Ltd.,SG,9277456.12
2023-10-13,2023-10-13,Client Receipt - Vertex Advisory Client #14,Sales Receipt,PS-GL,0.0,145311.49,SGD,SWIFT MT103,Vertex Advisory Client #14,***4148,INV-202310-PS-GL-0009,,False,False,REF-260890,First Continental Bank,***9542,Globex APAC Logistics Pte. Ltd.,SG,9422767.61
2023-10-14,2023-10-14,Supplier Payment - ExpertNet Subcontractors #1,Supplier Payment,PS-GL,562.95,0.0,SGD,MEPS+,ExpertNet Subcontractors #1,***1014,,PO-202310-PS-GL-0007,False,False,REF-844895,First Continental Bank,***7429,Globex APAC Logistics Pte. Ltd.,SG,9422204.66
2023-10-14,2023-10-14,Skyline Internet Services,Rent & Utilities,ALL,8219.06,0.0,SGD,FAST Debit,Skyline Internet Services,***6872,,,False,False,REF-101272,First Continental Bank,***5855,Globex APAC Logistics Pte. Ltd.,SG,9413985.6
2023-10-14,2023-10-14,Supplier Payment - TransAsia Freight #27,Supplier Payment,Logistics-APAC,24341.39,0.0,SGD,FAST Debit,TransAsia Freight #27,***1831,,PO-202310-Logistics-APAC-0011,False,False,REF-242676,First Continental Bank,***9593,Globex APAC Logistics Pte. Ltd.,SG,9389644.21
2023-10-14,2023-10-14,Client Receipt - CloudBridge Co. #42,Sales Receipt,SaaS-GL,0.0,17167.73,SGD,FAST Credit,CloudBridge Co. #42,***7457,INV-202310-SaaS-GL-0004,,False,False,REF-425767,First Continental Bank,***4629,Globex APAC Logistics Pte. Ltd.,SG,9406811.94
2023-10-15,2023-10-15,Client Receipt - CloudBridge Co. #4,Sales Receipt,SaaS-GL,0.0,8656.54,SGD,FAST Credit,CloudBridge Co. #4,***9258,INV-202310-SaaS-GL-0016,,False,False,REF-662141,First Continental Bank,***1729,Globex APAC Logistics Pte. Ltd.,SG,9415468.48
2023-10-16,2023-10-16,Supplier Payment - HyperCloud Infra #10,Supplier Payment,SaaS-GL,5043.93,0.0,SGD,FAST Debit,HyperCloud Infra #10,***2387,,PO-202310-SaaS-GL-0005,False,False,REF-909133,First Continental Bank,***6642,Globex APAC Logistics Pte. Ltd.,SG,9410424.55
2023-10-16,2023-10-16,Supplier Payment - TransAsia Freight #41,Supplier Payment,Logistics-APAC,45198.83,0.0,SGD,MEPS+,TransAsia Freight #41,***5318,,PO-202310-Logistics-APAC-0007,False,False,REF-126939,First Continental Bank,***7285,Globex APAC Logistics Pte. Ltd.,SG,9365225.72
2023-10-16,2023-10-16,Client Receipt - Pacific Trade Co. #4,Sales Receipt,Logistics-APAC,0.0,860.97,SGD,FAST Credit,Pacific Trade Co. #4,***4645,INV-202310-Logistics-APAC-0003,,False,False,REF-777344,First Continental Bank,***3426,Globex APAC Logistics Pte. Ltd.,SG,9366086.69
2023-10-16,2023-10-16,Client Receipt - CloudBridge Co. #29,Sales Receipt,SaaS-GL,0.0,13207.36,SGD,FAST Credit,CloudBridge Co. #29,***8765,INV-202310-SaaS-GL-0024,,False,False,REF-942929,First Continental Bank,***2505,Globex APAC Logistics Pte. Ltd.,SG,9379294.05
2023-10-17,2023-10-17,Supplier Payment - ExpertNet Subcontractors #14,Supplier Payment,PS-GL,14620.37,0.0,SGD,SWIFT MT103,ExpertNet Subcontractors #14,***8984,,PO-202310-PS-GL-0005,False,False,REF-524695,First Continental Bank,***6509,Globex APAC Logistics Pte. Ltd.,SG,9364673.68
2023-10-17,2023-10-17,Supplier Payment - TransAsia Freight #6,Supplier Payment,Logistics-APAC,15188.0,0.0,SGD,MEPS+,TransAsia Freight #6,***2651,,PO-202310-Logistics-APAC-0002,False,False,REF-706293,First Continental Bank,***7019,Globex APAC Logistics Pte. Ltd.,SG,9349485.68
2023-10-17,2023-10-17,Client Receipt - Vertex Advisory Client #46,Sales Receipt,PS-GL,0.0,3317.69,SGD,SWIFT MT103,Vertex Advisory Client #46,***6343,INV-202310-PS-GL-0001,,False,False,REF-539997,First Continental Bank,***2896,Globex APAC Logistics Pte. Ltd.,SG,9352803.37
2023-10-18,2023-10-18,Merchant Processing Fees,Bank/Merchant Fees,ALL,1981.14,0.0,SGD,FAST Debit,First Continental Bank,***4023,,,False,False,REF-468125,First Continental Bank,***1711,Globex APAC Logistics Pte. Ltd.,SG,9350822.23
2023-10-18,2023-10-18,Supplier Payment - ExpertNet Subcontractors #5,Supplier Payment,PS-GL,6604.56,0.0,SGD,MEPS+,ExpertNet Subcontractors #5,***7387,,PO-202310-PS-GL-0001,False,False,REF-885343,First Continental Bank,***4615,Globex APAC Logistics Pte. Ltd.,SG,9344217.67
2023-10-18,2023-10-18,Marketing - Aurelia Media #7,Marketing,ALL,14418.59,0.0,SGD,FAST Debit,Aurelia Media #7,***9990,,,False,False,REF-535687,First Continental Bank,***5128,Globex APAC Logistics Pte. Ltd.,SG,9329799.08
2023-10-18,2023-10-18,Supplier Payment - CodeCraft Contractors #8,Supplier Payment,SaaS-GL,24354.97,0.0,SGD,FAST Debit,CodeCraft Contractors #8,***3493,,PO-202310-SaaS-GL-0007,False,False,REF-316933,First Continental Bank,***1545,Globex APAC Logistics Pte. Ltd.,SG,9305444.11
2023-10-18,2023-10-18,Client Receipt - Pacific Trade Co. #68,Sales Receipt,Logistics-APAC,0.0,51508.86,SGD,FAST Credit,Pacific Trade Co. #68,***1590,INV-202310-Logistics-APAC-0002,,False,False,REF-768359,First Continental Bank,***8219,Globex APAC Logistics Pte. Ltd.,SG,9356952.97
2023-10-19,2023-10-19,VAT/GST Remittance - IRAS Singapore,Tax Payment,ALL,82607.21,0.0,SGD,SWIFT MT103,IRAS Singapore,***3100,,,False,False,REF-228831,First Continental Bank,***9616,Globex APAC Logistics Pte. Ltd.,SG,9274345.76
2023-10-19,2023-10-19,Client Receipt - CloudBridge Co. #69,Sales Receipt,SaaS-GL,0.0,13713.14,SGD,SWIFT MT103,CloudBridge Co. #69,***5393,INV-202310-SaaS-GL-0020,,False,False,REF-920066,First Continental Bank,***7502,Globex APAC Logistics Pte. Ltd.,SG,9288058.9
2023-10-20,2023-10-20,Supplier Payment - TransAsia Freight #10,Supplier Payment,Logistics-APAC,36346.27,0.0,SGD,FAST Debit,TransAsia Freight #10,***9926,,PO-202310-Logistics-APAC-0001,False,False,REF-985950,First Continental Bank,***6994,Globex APAC Logistics Pte. Ltd.,SG,9251712.63
2023-10-20,2023-10-20,Client Receipt - CloudBridge Co. #51,Sales Receipt,SaaS-GL,0.0,5352.23,SGD,SWIFT MT103,CloudBridge Co. #51,***1373,INV-202310-SaaS-GL-0001,,False,False,REF-754655,First Continental Bank,***6825,Globex APAC Logistics Pte. Ltd.,SG,9257064.86
2023-10-20,2023-10-20,Client Receipt - CloudBridge Co. #71,Sales Receipt,SaaS-GL,0.0,11301.31,SGD,FAST Credit,CloudBridge Co. #71,***3191,INV-202310-SaaS-GL-0021,,False,False,REF-367170,First Continental Bank,***8822,Globex APAC Logistics Pte. Ltd.,SG,9268366.17
2023-10-22,2023-10-22,Client Receipt - Vertex Advisory Client #15,Sales Receipt,PS-GL,0.0,12883.12,SGD,FAST Credit,Vertex Advisory Client #15,***4076,INV-202310-PS-GL-0003,,False,False,REF-727721,First Continental Bank,***3348,Globex APAC Logistics Pte. Ltd.,SG,9281249.29
2023-10-22,2023-10-22,Client Receipt - CloudBridge Co. #64,Sales Receipt,SaaS-GL,0.0,16275.52,SGD,SWIFT MT103,CloudBridge Co. #64,***7790,INV-202310-SaaS-GL-0006,,False,False,REF-828456,First Continental Bank,***1840,Globex APAC Logistics Pte. Ltd.,SG,9297524.81
2023-10-23,2023-10-23,Supplier Payment - TransAsia Freight #34,Supplier Payment,Logistics-APAC,6602.18,0.0,SGD,MEPS+,TransAsia Freight #34,***2789,,PO-202310-Logistics-APAC-0006,False,False,REF-115193,First Continental Bank,***9632,Globex APAC Logistics Pte. Ltd.,SG,9290922.63
2023-10-23,2023-10-23,Supplier Payment - ExpertNet Subcontractors #11,Supplier Payment,PS-GL,8312.93,0.0,SGD,SWIFT MT103,ExpertNet Subcontractors #11,***6536,,PO-202310-PS-GL-0006,False,False,REF-851641,First Continental Bank,***5014,Globex APAC Logistics Pte. Ltd.,SG,9282609.7
2023-10-23,2023-10-23,Client Receipt - Pacific Trade Co. #32,Sales Receipt,Logistics-APAC,0.0,1534.51,SGD,FAST Credit,Pacific Trade Co. #32,***2625,INV-202310-Logistics-APAC-0008,,False,False,REF-490040,First Continental Bank,***8723,Globex APAC Logistics Pte. Ltd.,SG,9284144.21
2023-10-23,2023-10-23,Client Receipt - CloudBridge Co. #37,Sales Receipt,SaaS-GL,0.0,14855.3,SGD,SWIFT MT103,CloudBridge Co. #37,***8064,INV-202310-SaaS-GL-0014,,False,False,REF-319000,First Continental Bank,***1113,Globex APAC Logistics Pte. Ltd.,SG,9298999.51
2023-10-23,2023-10-23,Client Receipt - Pacific Trade Co. #47,Sales Receipt,Logistics-APAC,0.0,70003.7,SGD,FAST Credit,Pacific Trade Co. #47,***2192,INV-202310-Logistics-APAC-0001,,False,False,REF-811591,First Continental Bank,***5878,Globex APAC Logistics Pte. Ltd.,SG,9369003.21
2023-10-24,2023-10-24,Client Receipt - CloudBridge Co. #37,Sales Receipt,SaaS-GL,0.0,7390.19,SGD,FAST Credit,CloudBridge Co. #37,***6696,INV-202310-SaaS-GL-0010,,False,False,REF-711703,First Continental Bank,***6657,Globex APAC Logistics Pte. Ltd.,SG,9376393.4
2023-10-24,2023-10-24,Client Receipt - CloudBridge Co. #54,Sales Receipt,SaaS-GL,0.0,8012.63,SGD,FAST Credit,CloudBridge Co. #54,***4728,INV-202310-SaaS-GL-0019,,False,False,REF-823689,First Continental Bank,***1629,Globex APAC Logistics Pte. Ltd.,SG,9384406.03
2023-10-24,2023-10-24,Client Receipt - CloudBridge Co. #54,Sales Receipt,SaaS-GL,0.0,9156.28,SGD,SWIFT MT103,CloudBridge Co. #54,***5500,INV-202310-SaaS-GL-0018,,False,False,REF-861699,First Continental Bank,***6241,Globex APAC Logistics Pte. Ltd.,SG,9393562.31
2023-10-24,2023-10-24,Client Receipt - CloudBridge Co. #67,Sales Receipt,SaaS-GL,0.0,12101.94,SGD,SWIFT MT103,CloudBridge Co. #67,***8764,INV-202310-SaaS-GL-0002,,False,False,REF-118781,First Continental Bank,***3985,Globex APAC Logistics Pte. Ltd.,SG,9405664.25
2023-10-25,2023-10-25,Client Receipt - Pacific Trade Co. #26,Sales Receipt,Logistics-APAC,0.0,29222.54,SGD,FAST Credit,Pacific Trade Co. #26,***9070,INV-202310-Logistics-APAC-0005,,False,False,REF-338093,First Continental Bank,***9069,Globex APAC Logistics Pte. Ltd.,SG,9434886.79
2023-10-25,2023-10-25,Client Receipt - Pacific Trade Co. #29,Sales Receipt,Logistics-APAC,0.0,60509.88,SGD,FAST Credit,Pacific Trade Co. #29,***2220,INV-202310-Logistics-APAC-0006,,False,False,REF-299766,First Continental Bank,***6324,Globex APAC Logistics Pte. Ltd.,SG,9495396.67
2023-10-26,2023-10-26,Supplier Payment - HyperCloud Infra #12,Supplier Payment,SaaS-GL,4743.11,0.0,SGD,MEPS+,HyperCloud Infra #12,***4610,,PO-202310-SaaS-GL-0001,False,False,REF-579328,First Continental Bank,***2726,Globex APAC Logistics Pte. Ltd.,SG,9490653.56
2023-10-26,2023-10-26,Payroll - GlobalPay Services Ltd,Payroll,ALL,216708.13,0.0,SGD,FAST Debit,GlobalPay Services Ltd,***8809,,,False,False,REF-409953,First Continental Bank,***4664,Globex APAC Logistics Pte. Ltd.,SG,9273945.43
2023-10-26,2023-10-26,"Intercompany Settlement - Globex International Holdings, Inc.",Intercompany Transfer,ALL,837583.0,0.0,SGD,Internal Transfer,"Globex International Holdings, Inc.",***2626,,,True,True,REF-440687,First Continental Bank,***8373,Globex APAC Logistics Pte. Ltd.,SG,8436362.43
2023-10-27,2023-10-27,Marketing - Aurelia Media #10,Marketing,ALL,11720.32,0.0,SGD,SWIFT MT103,Aurelia Media #10,***8953,,,False,False,REF-616803,First Continental Bank,***5071,Globex APAC Logistics Pte. Ltd.,SG,8424642.11
2023-10-27,2023-10-27,Client Receipt - Pacific Trade Co. #49,Sales Receipt,Logistics-APAC,0.0,23994.06,SGD,SWIFT MT103,Pacific Trade Co. #49,***8459,INV-202310-Logistics-APAC-0014,,False,False,REF-477853,First Continental Bank,***2198,Globex APAC Logistics Pte. Ltd.,SG,8448636.17
2023-10-28,2023-10-28,Corporate Tax Estimate,Tax Payment,ALL,61040.59,0.0,SGD,FAST Debit,IRAS Singapore,***8382,,,False,False,REF-246553,First Continental Bank,***3482,Globex APAC Logistics Pte. Ltd.,SG,8387595.58
2023-10-28,2023-10-28,Client Receipt - Pacific Trade Co. #47,Sales Receipt,Logistics-APAC,0.0,9177.79,SGD,FAST Credit,Pacific Trade Co. #47,***5055,INV-202310-Logistics-APAC-0017,,False,False,REF-114060,First Continental Bank,***8772,Globex APAC Logistics Pte. Ltd.,SG,8396773.37
2023-10-29,2023-10-29,Supplier Payment - HyperCloud Infra #16,Supplier Payment,SaaS-GL,204.89,0.0,SGD,FAST Debit,HyperCloud Infra #16,***1567,,PO-202310-SaaS-GL-0004,False,False,REF-563258,First Continental Bank,***6553,Globex APAC Logistics Pte. Ltd.,SG,8396568.48
2023-10-30,2023-10-30,Metro Water & Waste,Rent & Utilities,ALL,2464.11,0.0,SGD,SWIFT MT103,Metro Water & Waste,***4540,,,False,False,REF-481447,First Continental Bank,***4762,Globex APAC Logistics Pte. Ltd.,SG,8394104.37
2023-10-30,2023-10-30,Supplier Payment - CodeCraft Contractors #11,Supplier Payment,SaaS-GL,13644.64,0.0,SGD,MEPS+,CodeCraft Contractors #11,***7961,,PO-202310-SaaS-GL-0009,False,False,REF-840313,First Continental Bank,***9885,Globex APAC Logistics Pte. Ltd.,SG,8380459.73
2023-10-30,2023-10-30,Supplier Payment - TransAsia Freight #43,Supplier Payment,Logistics-APAC,20351.78,0.0,SGD,SWIFT MT103,TransAsia Freight #43,***1835,,PO-202310-Logistics-APAC-0010,False,False,REF-542645,First Continental Bank,***2073,Globex APAC Logistics Pte. Ltd.,SG,8360107.95
2023-10-30,2023-10-30,Client Receipt - CloudBridge Co. #44,Sales Receipt,SaaS-GL,0.0,6848.04,SGD,SWIFT MT103,CloudBridge Co. #44,***7751,INV-202310-SaaS-GL-0005,,False,False,REF-176765,First Continental Bank,***7905,Globex APAC Logistics Pte. Ltd.,SG,8366955.99
2023-10-30,2023-10-30,Interest Earned,Interest Income,ALL,0.0,9268.41,SGD,SWIFT MT103,First Continental Bank,***3178,,,False,False,REF-470621,First Continental Bank,***8970,Globex APAC Logistics Pte. Ltd.,SG,8376224.4
2023-10-31,2023-10-31,Supplier Payment - ExpertNet Subcontractors #1,Supplier Payment,PS-GL,5378.36,0.0,SGD,FAST Debit,ExpertNet Subcontractors #1,***8016,,PO-202310-PS-GL-0008,False,False,REF-929253,First Continental Bank,***1213,Globex APAC Logistics Pte. Ltd.,SG,8370846.04
2023-10-31,2023-10-31,Supplier Payment - HyperCloud Infra #12,Supplier Payment,SaaS-GL,33599.77,0.0,SGD,MEPS+,HyperCloud Infra #12,***2666,,PO-202310-SaaS-GL-0002,False,False,REF-497654,First Continental Bank,***3213,Globex APAC Logistics Pte. Ltd.,SG,8337246.27
2023-10-31,2023-10-31,Client Receipt - CloudBridge Co. #74,Sales Receipt,SaaS-GL,0.0,2467.42,SGD,SWIFT MT103,CloudBridge Co. #74,***5424,INV-202310-SaaS-GL-0008,,False,False,REF-679683,First Continental Bank,***9415,Globex APAC Logistics Pte. Ltd.,SG,8339713.69
2023-10-31,2023-10-31,Client Receipt - CloudBridge Co. #64,Sales Receipt,SaaS-GL,0.0,2607.08,SGD,SWIFT MT103,CloudBridge Co. #64,***4629,INV-202310-SaaS-GL-0012,,False,False,REF-712263,First Continental Bank,***5165,Globex APAC Logistics Pte. Ltd.,SG,8342320.77
2023-10-31,2023-10-31,Client Receipt - CloudBridge Co. #56,Sales Receipt,SaaS-GL,0.0,14065.76,SGD,SWIFT MT103,CloudBridge Co. #56,***2083,INV-202310-SaaS-GL-0007,,False,False,REF-451461,First Continental Bank,***2073,Globex APAC Logistics Pte. Ltd.,SG,8356386.53
2023-10-31,2023-10-31,Client Receipt - Pacific Trade Co. #59,Sales Receipt,Logistics-APAC,0.0,90858.73,SGD,FAST Credit,Pacific Trade Co. #59,***4879,INV-202310-Logistics-APAC-0010,,False,False,REF-871069,First Continental Bank,***4845,Globex APAC Logistics Pte. Ltd.,SG,8447245.26
2023-11-01,2023-11-01,Merchant Processing Fees,Bank/Merchant Fees,ALL,2282.58,0.0,SGD,MEPS+,First Continental Bank,***6379,,,False,False,REF-504380,First Continental Bank,***3029,Globex APAC Logistics Pte. Ltd.,SG,8444962.68
2023-11-01,2023-11-01,Account Maintenance Fee,Bank/Merchant Fees,ALL,2500.0,0.0,SGD,SWIFT MT103,First Continental Bank,***3524,,,False,False,REF-122346,First Continental Bank,***6993,Globex APAC Logistics Pte. Ltd.,SG,8442462.68
2023-11-01,2023-11-01,Supplier Payment - ExpertNet Subcontractors #1,Supplier Payment,PS-GL,6592.9,0.0,SGD,MEPS+,ExpertNet Subcontractors #1,***1255,,PO-202311-PS-GL-0003,False,False,REF-353783,First Continental Bank,***4950,Globex APAC Logistics Pte. Ltd.,SG,8435869.78
2023-11-01,2023-11-01,Supplier Payment - ExpertNet Subcontractors #7,Supplier Payment,PS-GL,16907.09,0.0,SGD,FAST Debit,ExpertNet Subcontractors #7,***5914,,PO-202311-PS-GL-0002,False,False,REF-465026,First Continental Bank,***6494,Globex APAC Logistics Pte. Ltd.,SG,8418962.69
2023-11-01,2023-11-01,Supplier Payment - CodeCraft Contractors #5,Supplier Payment,SaaS-GL,34975.47,0.0,SGD,MEPS+,CodeCraft Contractors #5,***1805,,PO-202311-SaaS-GL-0004,False,False,REF-455098,First Continental Bank,***4343,Globex APAC Logistics Pte. Ltd.,SG,8383987.22
2023-11-01,2023-11-01,Supplier Payment - Port Services #18,Supplier Payment,Logistics-APAC,65651.15,0.0,SGD,FAST Debit,Port Services #18,***2801,,PO-202311-Logistics-APAC-0003,False,False,REF-698191,First Continental Bank,***6168,Globex APAC Logistics Pte. Ltd.,SG,8318336.07
2023-11-01,2023-11-01,Client Receipt - CloudBridge Co. #7,Sales Receipt,SaaS-GL,0.0,3854.12,SGD,SWIFT MT103,CloudBridge Co. #7,***7010,INV-202311-SaaS-GL-0009,,False,False,REF-142389,First Continental Bank,***3053,Globex APAC Logistics Pte. Ltd.,SG,8322190.19
2023-11-01,2023-11-01,Client Receipt - CloudBridge Co. #74,Sales Receipt,SaaS-GL,0.0,43556.13,SGD,SWIFT MT103,CloudBridge Co. #74,***6233,INV-202311-SaaS-GL-0024,,False,False,REF-505242,First Continental Bank,***3713,Globex APAC Logistics Pte. Ltd.,SG,8365746.32
2023-11-02,2023-11-02,BluePeak Property Mgmt,Rent & Utilities,ALL,6310.82,0.0,SGD,SWIFT MT103,BluePeak Property Mgmt,***7971,,,False,False,REF-450008,First Continental Bank,***5334,Globex APAC Logistics Pte. Ltd.,SG,8359435.5
2023-11-02,2023-11-02,Supplier Payment - HyperCloud Infra #15,Supplier Payment,SaaS-GL,23887.73,0.0,SGD,SWIFT MT103,HyperCloud Infra #15,***5627,,PO-202311-SaaS-GL-0010,False,False,REF-415654,First Continental Bank,***4661,Globex APAC Logistics Pte. Ltd.,SG,8335547.77
2023-11-02,2023-11-02,Client Receipt - Pacific Trade Co. #27,Sales Receipt,Logistics-APAC,0.0,79296.9,SGD,FAST Credit,Pacific Trade Co. #27,***3466,INV-202311-Logistics-APAC-0008,,False,False,REF-389023,First Continental Bank,***9608,Globex APAC Logistics Pte. Ltd.,SG,8414844.67
2023-11-03,2023-11-03,Client Receipt - CloudBridge Co. #25,Sales Receipt,SaaS-GL,0.0,15085.63,SGD,SWIFT MT103,CloudBridge Co. #25,***7471,INV-202311-SaaS-GL-0012,,False,False,REF-206182,First Continental Bank,***1880,Globex APAC Logistics Pte. Ltd.,SG,8429930.3
2023-11-05,2023-11-05,Client Receipt - CloudBridge Co. #56,Sales Receipt,SaaS-GL,0.0,14070.23,SGD,SWIFT MT103,CloudBridge Co. #56,***3691,INV-202311-SaaS-GL-0001,,False,False,REF-630230,First Continental Bank,***3069,Globex APAC Logistics Pte. Ltd.,SG,8444000.53
2023-11-06,2023-11-06,Marketing - Aurelia Media #2,Marketing,ALL,439.02,0.0,SGD,MEPS+,Aurelia Media #2,***8230,,,False,False,REF-102042,First Continental Bank,***3972,Globex APAC Logistics Pte. Ltd.,SG,8443561.51
2023-11-06,2023-11-06,Client Receipt - Vertex Advisory Client #27,Sales Receipt,PS-GL,0.0,59966.55,SGD,FAST Credit,Vertex Advisory Client #27,***8487,INV-202311-PS-GL-0004,,False,False,REF-807141,First Continental Bank,***8434,Globex APAC Logistics Pte. Ltd.,SG,8503528.06
2023-11-07,2023-11-07,Client Receipt - CloudBridge Co. #18,Sales Receipt,SaaS-GL,0.0,4203.03,SGD,SWIFT MT103,CloudBridge Co. #18,***7272,INV-202311-SaaS-GL-0011,,False,False,REF-135610,First Continental Bank,***4115,Globex APAC Logistics Pte. Ltd.,SG,8507731.09
2023-11-08,2023-11-08,Client Receipt - CloudBridge Co. #42,Sales Receipt,SaaS-GL,0.0,17162.2,SGD,FAST Credit,CloudBridge Co. #42,***6969,INV-202311-SaaS-GL-0005,,False,False,REF-280091,First Continental Bank,***4105,Globex APAC Logistics Pte. Ltd.,SG,8524893.29
2023-11-08,2023-11-08,Client Receipt - CloudBridge Co. #48,Sales Receipt,SaaS-GL,0.0,17910.64,SGD,SWIFT MT103,CloudBridge Co. #48,***6063,INV-202311-SaaS-GL-0006,,False,False,REF-558048,First Continental Bank,***5850,Globex APAC Logistics Pte. Ltd.,SG,8542803.93
2023-11-09,2023-11-09,Client Receipt - CloudBridge Co. #76,Sales Receipt,SaaS-GL,0.0,3267.6,SGD,FAST Credit,CloudBridge Co. #76,***3775,INV-202311-SaaS-GL-0016,,False,False,REF-846812,First Continental Bank,***9661,Globex APAC Logistics Pte. Ltd.,SG,8546071.53
2023-11-09,2023-11-09,Client Receipt - CloudBridge Co. #61,Sales Receipt,SaaS-GL,0.0,26588.84,SGD,FAST Credit,CloudBridge Co. #61,***3146,INV-202311-SaaS-GL-0013,,False,False,REF-858685,First Continental Bank,***5400,Globex APAC Logistics Pte. Ltd.,SG,8572660.37
2023-11-09,2023-11-09,Client Receipt - CloudBridge Co. #77,Sales Receipt,SaaS-GL,0.0,62709.04,SGD,SWIFT MT103,CloudBridge Co. #77,***9466,INV-202311-SaaS-GL-0004,,False,False,REF-194761,First Continental Bank,***2428,Globex APAC Logistics Pte. Ltd.,SG,8635369.41
2023-11-10,2023-11-10,Client Receipt - Pacific Trade Co. #37,Sales Receipt,Logistics-APAC,0.0,73096.96,SGD,FAST Credit,Pacific Trade Co. #37,***3951,INV-202311-Logistics-APAC-0001,,False,False,REF-775608,First Continental Bank,***1630,Globex APAC Logistics Pte. Ltd.,SG,8708466.37
2023-11-12,2023-11-12,Intercompany Settlement - Globex Consulting UK Ltd.,Intercompany Transfer,ALL,512820.0,0.0,SGD,Internal Transfer,Globex Consulting UK Ltd.,***2951,,,True,True,REF-922664,First Continental Bank,***4870,Globex APAC Logistics Pte. Ltd.,SG,8195646.37
2023-11-13,2023-11-13,Supplier Payment - ExpertNet Subcontractors #6,Supplier Payment,PS-GL,34883.84,0.0,SGD,MEPS+,ExpertNet Subcontractors #6,***7487,,PO-202311-PS-GL-0004,False,False,REF-167073,First Continental Bank,***9097,Globex APAC Logistics Pte. Ltd.,SG,8160762.53
2023-11-13,2023-11-13,Client Receipt - CloudBridge Co. #8,Sales Receipt,SaaS-GL,0.0,5114.98,SGD,SWIFT MT103,CloudBridge Co. #8,***5942,INV-202311-SaaS-GL-0021,,False,False,REF-877106,First Continental Bank,***5530,Globex APAC Logistics Pte. Ltd.,SG,8165877.51
2023-11-14,2023-11-14,Supplier Payment - TransAsia Freight #24,Supplier Payment,Logistics-APAC,76798.54,0.0,SGD,MEPS+,TransAsia Freight #24,***8703,,PO-202311-Logistics-APAC-0006,False,False,REF-845444,First Continental Bank,***9959,Globex APAC Logistics Pte. Ltd.,SG,8089078.97
2023-11-14,2023-11-14,Client Receipt - Vertex Advisory Client #25,Sales Receipt,PS-GL,0.0,12361.49,SGD,FAST Credit,Vertex Advisory Client #25,***9863,INV-202311-PS-GL-0008,,False,False,REF-221718,First Continental Bank,***7115,Globex APAC Logistics Pte. Ltd.,SG,8101440.46
2023-11-14,2023-11-14,Client Receipt - Vertex Advisory Client #24,Sales Receipt,PS-GL,0.0,50032.11,SGD,SWIFT MT103,Vertex Advisory Client #24,***1695,INV-202311-PS-GL-0005,,False,False,REF-886116,First Continental Bank,***4614,Globex APAC Logistics Pte. Ltd.,SG,8151472.57
2023-11-15,2023-11-15,Supplier Payment - HyperCloud Infra #11,Supplier Payment,SaaS-GL,5505.32,0.0,SGD,FAST Debit,HyperCloud Infra #11,***7452,,PO-202311-SaaS-GL-0005,False,False,REF-497227,First Continental Bank,***1100,Globex APAC Logistics Pte. Ltd.,SG,8145967.25
2023-11-15,2023-11-15,Client Receipt - CloudBridge Co. #59,Sales Receipt,SaaS-GL,0.0,3740.12,SGD,FAST Credit,CloudBridge Co. #59,***1453,INV-202311-SaaS-GL-0007,,False,False,REF-255624,First Continental Bank,***6868,Globex APAC Logistics Pte. Ltd.,SG,8149707.37
2023-11-15,2023-11-15,Client Receipt - Pacific Trade Co. #16,Sales Receipt,Logistics-APAC,0.0,6379.83,SGD,SWIFT MT103,Pacific Trade Co. #16,***4557,INV-202311-Logistics-APAC-0003,,False,False,REF-906287,First Continental Bank,***7097,Globex APAC Logistics Pte. Ltd.,SG,8156087.2
2023-11-15,2023-11-15,Client Receipt - Pacific Trade Co. #51,Sales Receipt,Logistics-APAC,0.0,17068.83,SGD,FAST Credit,Pacific Trade Co. #51,***6600,INV-202311-Logistics-APAC-0007,,False,False,REF-509722,First Continental Bank,***1375,Globex APAC Logistics Pte. Ltd.,SG,8173156.03
2023-11-15,2023-11-15,Client Receipt - CloudBridge Co. #64,Sales Receipt,SaaS-GL,0.0,28037.39,SGD,SWIFT MT103,CloudBridge Co. #64,***6828,INV-202311-SaaS-GL-0026,,False,False,REF-171543,First Continental Bank,***3935,Globex APAC Logistics Pte. Ltd.,SG,8201193.42
2023-11-15,2023-11-15,Client Receipt - CloudBridge Co. #76,Sales Receipt,SaaS-GL,0.0,39335.23,SGD,FAST Credit,CloudBridge Co. #76,***1809,INV-202311-SaaS-GL-0010,,False,False,REF-988406,First Continental Bank,***7435,Globex APAC Logistics Pte. Ltd.,SG,8240528.65
2023-11-15,2023-11-15,Client Receipt - Pacific Trade Co. #44,Sales Receipt,Logistics-APAC,0.0,50010.06,SGD,SWIFT MT103,Pacific Trade Co. #44,***6973,INV-202311-Logistics-APAC-0004,,False,False,REF-983141,First Continental Bank,***6182,Globex APAC Logistics Pte. Ltd.,SG,8290538.71
2023-11-16,2023-11-16,Supplier Payment - Port Services #4,Supplier Payment,Logistics-APAC,1673.03,0.0,SGD,FAST Debit,Port Services #4,***3819,,PO-202311-Logistics-APAC-0007,False,False,REF-770625,First Continental Bank,***5868,Globex APAC Logistics Pte. Ltd.,SG,8288865.68
2023-11-16,2023-11-16,Supplier Payment - ExpertNet Subcontractors #2,Supplier Payment,PS-GL,1793.02,0.0,SGD,MEPS+,ExpertNet Subcontractors #2,***8787,,PO-202311-PS-GL-0006,False,False,REF-231060,First Continental Bank,***9208,Globex APAC Logistics Pte. Ltd.,SG,8287072.66
2023-11-16,2023-11-16,Supplier Payment - HyperCloud Infra #8,Supplier Payment,SaaS-GL,6121.12,0.0,SGD,SWIFT MT103,HyperCloud Infra #8,***6249,,PO-202311-SaaS-GL-0008,False,False,REF-563816,First Continental Bank,***7233,Globex APAC Logistics Pte. Ltd.,SG,8280951.54
2023-11-16,2023-11-16,Supplier Payment - ExpertNet Subcontractors #8,Supplier Payment,PS-GL,24896.78,0.0,SGD,FAST Debit,ExpertNet Subcontractors #8,***6998,,PO-202311-PS-GL-0005,False,False,REF-314746,First Continental Bank,***5283,Globex APAC Logistics Pte. Ltd.,SG,8256054.76
2023-11-16,2023-11-16,Supplier Payment - TransAsia Freight #16,Supplier Payment,Logistics-APAC,33387.16,0.0,SGD,SWIFT MT103,TransAsia Freight #16,***3788,,PO-202311-Logistics-APAC-0002,False,False,REF-652111,First Continental Bank,***8255,Globex APAC Logistics Pte. Ltd.,SG,8222667.6
2023-11-16,2023-11-16,Client Receipt - Pacific Trade Co. #56,Sales Receipt,Logistics-APAC,0.0,21630.21,SGD,FAST Credit,Pacific Trade Co. #56,***3801,INV-202311-Logistics-APAC-0002,,False,False,REF-936058,First Continental Bank,***2692,Globex APAC Logistics Pte. Ltd.,SG,8244297.81
2023-11-17,2023-11-17,Alphagrid Utilities,Rent & Utilities,ALL,5928.73,0.0,SGD,SWIFT MT103,Alphagrid Utilities,***1159,,,False,False,REF-126198,First Continental Bank,***5380,Globex APAC Logistics Pte. Ltd.,SG,8238369.08
2023-11-17,2023-11-17,Supplier Payment - TransAsia Freight #23,Supplier Payment,Logistics-APAC,34086.68,0.0,SGD,FAST Debit,TransAsia Freight #23,***1349,,PO-202311-Logistics-APAC-0005,False,False,REF-895655,First Continental Bank,***1994,Globex APAC Logistics Pte. Ltd.,SG,8204282.4
2023-11-17,2023-11-17,Supplier Payment - TransAsia Freight #24,Supplier Payment,Logistics-APAC,134118.3,0.0,SGD,FAST Debit,TransAsia Freight #24,***2939,,PO-202311-Logistics-APAC-0008,False,False,REF-842978,First Continental Bank,***4714,Globex APAC Logistics Pte. Ltd.,SG,8070164.1
2023-11-17,2023-11-17,Client Receipt - CloudBridge Co. #5,Sales Receipt,SaaS-GL,0.0,519.17,SGD,SWIFT MT103,CloudBridge Co. #5,***9509,INV-202311-SaaS-GL-0019,,False,False,REF-507053,First Continental Bank,***8269,Globex APAC Logistics Pte. Ltd.,SG,8070683.27
2023-11-17,2023-11-17,Client Receipt - CloudBridge Co. #54,Sales Receipt,SaaS-GL,0.0,13393.94,SGD,FAST Credit,CloudBridge Co. #54,***2208,INV-202311-SaaS-GL-0018,,False,False,REF-388962,First Continental Bank,***4084,Globex APAC Logistics Pte. Ltd.,SG,8084077.21
2023-11-17,2023-11-17,Client Receipt - Pacific Trade Co. #2,Sales Receipt,Logistics-APAC,0.0,31307.01,SGD,SWIFT MT103,Pacific Trade Co. #2,***5083,INV-202311-Logistics-APAC-0012,,False,False,REF-825614,First Continental Bank,***6962,Globex APAC Logistics Pte. Ltd.,SG,8115384.22
2023-11-17,2023-11-17,Client Receipt - CloudBridge Co. #45,Sales Receipt,SaaS-GL,0.0,57594.95,SGD,FAST Credit,CloudBridge Co. #45,***5414,INV-202311-SaaS-GL-0014,,False,False,REF-689828,First Continental Bank,***3866,Globex APAC Logistics Pte. Ltd.,SG,8172979.17
2023-11-17,2023-11-17,Client Receipt - Vertex Advisory Client #14,Sales Receipt,PS-GL,0.0,61486.26,SGD,SWIFT MT103,Vertex Advisory Client #14,***1872,INV-202311-PS-GL-0009,,False,False,REF-317406,First Continental Bank,***1090,Globex APAC Logistics Pte. Ltd.,SG,8234465.43
2023-11-18,2023-11-18,Supplier Payment - HyperCloud Infra #16,Supplier Payment,SaaS-GL,13343.74,0.0,SGD,MEPS+,HyperCloud Infra #16,***8478,,PO-202311-SaaS-GL-0003,False,False,REF-572781,First Continental Bank,***6704,Globex APAC Logistics Pte. Ltd.,SG,8221121.69
2023-11-18,2023-11-18,Client Receipt - CloudBridge Co. #52,Sales Receipt,SaaS-GL,0.0,8535.97,SGD,FAST Credit,CloudBridge Co. #52,***3088,INV-202311-SaaS-GL-0020,,False,False,REF-863185,First Continental Bank,***6026,Globex APAC Logistics Pte. Ltd.,SG,8229657.66
2023-11-18,2023-11-18,Client Receipt - Pacific Trade Co. #6,Sales Receipt,Logistics-APAC,0.0,108759.16,SGD,FAST Credit,Pacific Trade Co. #6,***2324,INV-202311-Logistics-APAC-0010,,False,False,REF-575766,First Continental Bank,***1651,Globex APAC Logistics Pte. Ltd.,SG,8338416.82
2023-11-19,2023-11-19,Client Receipt - CloudBridge Co. #35,Sales Receipt,SaaS-GL,0.0,25827.98,SGD,FAST Credit,CloudBridge Co. #35,***3252,INV-202311-SaaS-GL-0017,,False,False,REF-186343,First Continental Bank,***5170,Globex APAC Logistics Pte. Ltd.,SG,8364244.8
2023-11-20,2023-11-20,Merchant Processing Fees,Bank/Merchant Fees,ALL,2188.99,0.0,SGD,MEPS+,First Continental Bank,***3675,,,False,False,REF-895559,First Continental Bank,***5171,Globex APAC Logistics Pte. Ltd.,SG,8362055.81
2023-11-20,2023-11-20,Supplier Payment - ExpertNet Subcontractors #11,Supplier Payment,PS-GL,5074.31,0.0,SGD,SWIFT MT103,ExpertNet Subcontractors #11,***1550,,PO-202311-PS-GL-0008,False,False,REF-133883,First Continental Bank,***4800,Globex APAC Logistics Pte. Ltd.,SG,8356981.5
2023-11-20,2023-11-20,Supplier Payment - CodeCraft Contractors #11,Supplier Payment,SaaS-GL,5103.51,0.0,SGD,SWIFT MT103,CodeCraft Contractors #11,***5571,,PO-202311-SaaS-GL-0011,False,False,REF-374477,First Continental Bank,***6771,Globex APAC Logistics Pte. Ltd.,SG,8351877.99
2023-11-20,2023-11-20,Supplier Payment - TransAsia Freight #1,Supplier Payment,Logistics-APAC,81011.1,0.0,SGD,SWIFT MT103,TransAsia Freight #1,***6622,,PO-202311-Logistics-APAC-0004,False,False,REF-760611,First Continental Bank,***7232,Globex APAC Logistics Pte. Ltd.,SG,8270866.89
2023-11-20,2023-11-20,Client Receipt - CloudBridge Co. #73,Sales Receipt,SaaS-GL,0.0,3136.89,SGD,FAST Credit,CloudBridge Co. #73,***5060,INV-202311-SaaS-GL-0025,,False,False,REF-398752,First Continental Bank,***7906,Globex APAC Logistics Pte. Ltd.,SG,8274003.78
2023-11-20,2023-11-20,Client Receipt - Vertex Advisory Client #24,Sales Receipt,PS-GL,0.0,35937.1,SGD,SWIFT MT103,Vertex Advisory Client #24,***3169,INV-202311-PS-GL-0006,,False,False,REF-355551,First Continental Bank,***3104,Globex APAC Logistics Pte. Ltd.,SG,8309940.88
2023-11-21,2023-11-21,Supplier Payment - CodeCraft Contractors #14,Supplier Payment,SaaS-GL,9248.26,0.0,SGD,SWIFT MT103,CodeCraft Contractors #14,***3298,,PO-202311-SaaS-GL-0009,False,False,REF-282364,First Continental Bank,***3975,Globex APAC Logistics Pte. Ltd.,SG,8300692.62
2023-11-21,2023-11-21,Client Receipt - Vertex Advisory Client #56,Sales Receipt,PS-GL,0.0,26903.17,SGD,SWIFT MT103,Vertex Advisory Client #56,***1061,INV-202311-PS-GL-0002,,False,False,REF-608730,First Continental Bank,***6799,Globex APAC Logistics Pte. Ltd.,SG,8327595.79
2023-11-21,2023-11-21,Client Receipt - Pacific Trade Co. #23,Sales Receipt,Logistics-APAC,0.0,112626.46,SGD,FAST Credit,Pacific Trade Co. #23,***9082,INV-202311-Logistics-APAC-0009,,False,False,REF-334777,First Continental Bank,***2885,Globex APAC Logistics Pte. Ltd.,SG,8440222.25
2023-11-22,2023-11-22,Supplier Payment - CodeCraft Contractors #8,Supplier Payment,SaaS-GL,2020.71,0.0,SGD,MEPS+,CodeCraft Contractors #8,***3847,,PO-202311-SaaS-GL-0002,False,False,REF-314294,First Continental Bank,***3736,Globex APAC Logistics Pte. Ltd.,SG,8438201.54
2023-11-22,2023-11-22,Supplier Payment - ExpertNet Subcontractors #8,Supplier Payment,PS-GL,4925.0,0.0,SGD,FAST Debit,ExpertNet Subcontractors #8,***7829,,PO-202311-PS-GL-0001,False,False,REF-409613,First Continental Bank,***1859,Globex APAC Logistics Pte. Ltd.,SG,8433276.54
2023-11-22,2023-11-22,Supplier Payment - CodeCraft Contractors #2,Supplier Payment,SaaS-GL,9711.29,0.0,SGD,SWIFT MT103,CodeCraft Contractors #2,***1422,,PO-202311-SaaS-GL-0006,False,False,REF-180472,First Continental Bank,***4450,Globex APAC Logistics Pte. Ltd.,SG,8423565.25
2023-11-22,2023-11-22,VAT/GST Remittance - IRAS Singapore,Tax Payment,ALL,93430.57,0.0,SGD,SWIFT MT103,IRAS Singapore,***9378,,,False,False,REF-183978,First Continental Bank,***5065,Globex APAC Logistics Pte. Ltd.,SG,8330134.68
2023-11-22,2023-11-22,Client Receipt - Vertex Advisory Client #52,Sales Receipt,PS-GL,0.0,69165.59,SGD,FAST Credit,Vertex Advisory Client #52,***3343,INV-202311-PS-GL-0003,,False,False,REF-743846,First Continental Bank,***9206,Globex APAC Logistics Pte. Ltd.,SG,8399300.27
2023-11-24,2023-11-24,Supplier Payment - TransAsia Freight #17,Supplier Payment,Logistics-APAC,103.31,0.0,SGD,SWIFT MT103,TransAsia Freight #17,***7967,,PO-202311-Logistics-APAC-0001,False,False,REF-185018,First Continental Bank,***6588,Globex APAC Logistics Pte. Ltd.,SG,8399196.96
2023-11-24,2023-11-24,Client Receipt - CloudBridge Co. #28,Sales Receipt,SaaS-GL,0.0,17648.36,SGD,FAST Credit,CloudBridge Co. #28,***6786,INV-202311-SaaS-GL-0008,,False,False,REF-593041,First Continental Bank,***7580,Globex APAC Logistics Pte. Ltd.,SG,8416845.32
2023-11-24,2023-11-24,Client Receipt - Pacific Trade Co. #3,Sales Receipt,Logistics-APAC,0.0,21994.51,SGD,SWIFT MT103,Pacific Trade Co. #3,***9298,INV-202311-Logistics-APAC-0006,,False,False,REF-577510,First Continental Bank,***3032,Globex APAC Logistics Pte. Ltd.,SG,8438839.83
2023-11-25,2023-11-25,Payroll - GlobalPay Services Ltd,Payroll,ALL,123318.76,0.0,SGD,SWIFT MT103,GlobalPay Services Ltd,***5868,,,False,False,REF-423850,First Continental Bank,***2052,Globex APAC Logistics Pte. Ltd.,SG,8315521.07
2023-11-25,2023-11-25,Payroll - GlobalPay Services Ltd,Payroll,ALL,123318.76,0.0,SGD,FAST Debit,GlobalPay Services Ltd,***2575,,,False,False,REF-610620,First Continental Bank,***8464,Globex APAC Logistics Pte. Ltd.,SG,8192202.31
2023-11-26,2023-11-26,Intercompany Settlement - Globex Consulting UK Ltd.,Intercompany Transfer,ALL,288222.0,0.0,SGD,Internal Transfer,Globex Consulting UK Ltd.,***3168,,,True,True,REF-723768,First Continental Bank,***4121,Globex APAC Logistics Pte. Ltd.,SG,7903980.31
2023-11-26,2023-11-26,Client Receipt - Pacific Trade Co. #44,Sales Receipt,Logistics-APAC,0.0,42870.59,SGD,FAST Credit,Pacific Trade Co. #44,***3966,INV-202311-Logistics-APAC-0011,,False,False,REF-325440,First Continental Bank,***6981,Globex APAC Logistics Pte. Ltd.,SG,7946850.9
2023-11-26,2023-11-26,Intercompany Reimbursement - Globex Consulting UK Ltd.,Intercompany Transfer,ALL,0.0,115288.8,SGD,Internal Transfer,Globex Consulting UK Ltd.,***7149,,,True,True,REF-365684,First Continental Bank,***1432,Globex APAC Logistics Pte. Ltd.,SG,8062139.7
2023-11-27,2023-11-27,Marketing - Beacon Digital #6,Marketing,ALL,37577.1,0.0,SGD,FAST Debit,Beacon Digital #6,***1310,,,False,False,REF-257180,First Continental Bank,***2278,Globex APAC Logistics Pte. Ltd.,SG,8024562.6
2023-11-27,2023-11-27,Client Receipt - CloudBridge Co. #7,Sales Receipt,SaaS-GL,0.0,21587.67,SGD,SWIFT MT103,CloudBridge Co. #7,***9964,INV-202311-SaaS-GL-0015,,False,False,REF-778594,First Continental Bank,***4845,Globex APAC Logistics Pte. Ltd.,SG,8046150.27
2023-11-27,2023-11-27,Client Receipt - CloudBridge Co. #51,Sales Receipt,SaaS-GL,0.0,22512.48,SGD,SWIFT MT103,CloudBridge Co. #51,***7058,INV-202311-SaaS-GL-0003,,False,False,REF-966728,First Continental Bank,***1208,Globex APAC Logistics Pte. Ltd.,SG,8068662.75
2023-11-28,2023-11-28,Supplier Payment - CodeCraft Contractors #11,Supplier Payment,SaaS-GL,1611.2,0.0,SGD,SWIFT MT103,CodeCraft Contractors #11,***3999,,PO-202311-SaaS-GL-0007,False,False,REF-405561,First Continental Bank,***9551,Globex APAC Logistics Pte. Ltd.,SG,8067051.55
2023-11-28,2023-11-28,Supplier Payment - ExpertNet Subcontractors #1,Supplier Payment,PS-GL,14683.16,0.0,SGD,SWIFT MT103,ExpertNet Subcontractors #1,***2865,,PO-202311-PS-GL-0007,False,False,REF-846635,First Continental Bank,***1576,Globex APAC Logistics Pte. Ltd.,SG,8052368.39
2023-11-28,2023-11-28,Client Receipt - Vertex Advisory Client #30,Sales Receipt,PS-GL,0.0,21608.11,SGD,FAST Credit,Vertex Advisory Client #30,***5724,INV-202311-PS-GL-0007,,False,False,REF-439376,First Continental Bank,***1593,Globex APAC Logistics Pte. Ltd.,SG,8073976.5
2023-11-28,2023-11-28,Client Receipt - CloudBridge Co. #62,Sales Receipt,SaaS-GL,0.0,28333.82,SGD,FAST Credit,CloudBridge Co. #62,***4852,INV-202311-SaaS-GL-0002,,False,False,REF-168797,First Continental Bank,***3169,Globex APAC Logistics Pte. Ltd.,SG,8102310.32
2023-11-29,2023-11-29,Client Receipt - CloudBridge Co. #55,Sales Receipt,SaaS-GL,0.0,7771.1,SGD,FAST Credit,CloudBridge Co. #55,***2963,INV-202311-SaaS-GL-0023,,False,False,REF-207067,First Continental Bank,***6883,Globex APAC Logistics Pte. Ltd.,SG,8110081.42
2023-11-29,2023-11-29,Client Receipt - Vertex Advisory Client #34,Sales Receipt,PS-GL,0.0,28393.28,SGD,SWIFT MT103,Vertex Advisory Client #34,***4057,INV-202311-PS-GL-0001,,False,False,REF-398265,First Continental Bank,***4103,Globex APAC Logistics Pte. Ltd.,SG,8138474.7
2023-11-29,2023-11-29,Client Receipt - Pacific Trade Co. #7,Sales Receipt,Logistics-APAC,0.0,44715.58,SGD,FAST Credit,Pacific Trade Co. #7,***2415,INV-202311-Logistics-APAC-0005,,False,False,REF-214987,First Continental Bank,***2036,Globex APAC Logistics Pte. Ltd.,SG,8183190.28
2023-11-29,2023-11-29,Client Receipt - CloudBridge Co. #71,Sales Receipt,SaaS-GL,0.0,57282.98,SGD,SWIFT MT103,CloudBridge Co. #71,***3589,INV-202311-SaaS-GL-0022,,False,False,REF-571193,First Continental Bank,***9384,Globex APAC Logistics Pte. Ltd.,SG,8240473.26
2023-11-30,2023-11-30,Supplier Payment - HyperCloud Infra #7,Supplier Payment,SaaS-GL,9203.36,0.0,SGD,MEPS+,HyperCloud Infra #7,***1919,,PO-202311-SaaS-GL-0001,False,False,REF-135733,First Continental Bank,***7573,Globex APAC Logistics Pte. Ltd.,SG,8231269.9
2023-11-30,2023-11-30,Interest Earned,Interest Income,ALL,0.0,10233.27,SGD,SWIFT MT103,First Continental Bank,***1169,,,False,False,REF-920383,First Continental Bank,***5909,Globex APAC Logistics Pte. Ltd.,SG,8241503.17
2023-12-01,2023-12-01,Supplier Payment - ExpertNet Subcontractors #13,Supplier Payment,PS-GL,1407.14,0.0,SGD,FAST Debit,ExpertNet Subcontractors #13,***2360,,PO-202312-PS-GL-0012,False,False,REF-621264,First Continental Bank,***8600,Globex APAC Logistics Pte. Ltd.,SG,8240096.03
2023-12-01,2023-12-01,Account Maintenance Fee,Bank/Merchant Fees,ALL,2500.0,0.0,SGD,SWIFT MT103,First Continental Bank,***8800,,,False,False,REF-583358,First Continental Bank,***3389,Globex APAC Logistics Pte. Ltd.,SG,8237596.03
2023-12-01,2023-12-01,Supplier Payment - HyperCloud Infra #3,Supplier Payment,SaaS-GL,4735.55,0.0,SGD,MEPS+,HyperCloud Infra #3,***3366,,PO-202312-SaaS-GL-0009,False,False,REF-506435,First Continental Bank,***1124,Globex APAC Logistics Pte. Ltd.,SG,8232860.48
2023-12-02,2023-12-02,Supplier Payment - ExpertNet Subcontractors #10,Supplier Payment,PS-GL,1162.59,0.0,SGD,SWIFT MT103,ExpertNet Subcontractors #10,***6467,,PO-202312-PS-GL-0003,False,False,REF-815739,First Continental Bank,***1931,Globex APAC Logistics Pte. Ltd.,SG,8231697.89
2023-12-02,2023-12-02,Client Receipt - Pacific Trade Co. #30,Sales Receipt,Logistics-APAC,0.0,30509.67,SGD,SWIFT MT103,Pacific Trade Co. #30,***9490,INV-202312-Logistics-APAC-0011,,False,False,REF-479600,First Continental Bank,***2392,Globex APAC Logistics Pte. Ltd.,SG,8262207.56
2023-12-03,2023-12-03,Marketing - Beacon Digital #9,Marketing,ALL,12327.75,0.0,SGD,FAST Debit,Beacon Digital #9,***3907,,,False,False,REF-550210,First Continental Bank,***2742,Globex APAC Logistics Pte. Ltd.,SG,8249879.81
2023-12-03,2023-12-03,Client Receipt - CloudBridge Co. #32,Sales Receipt,SaaS-GL,0.0,13692.84,SGD,SWIFT MT103,CloudBridge Co. #32,***3457,INV-202312-SaaS-GL-0030,,False,False,REF-312992,First Continental Bank,***4210,Globex APAC Logistics Pte. Ltd.,SG,8263572.65
2023-12-03,2023-12-03,Client Receipt - Vertex Advisory Client #47,Sales Receipt,PS-GL,0.0,69752.07,SGD,FAST Credit,Vertex Advisory Client #47,***9532,INV-202312-PS-GL-0011,,False,False,REF-223320,First Continental Bank,***9512,Globex APAC Logistics Pte. Ltd.,SG,8333324.72
2023-12-04,2023-12-04,Supplier Payment - ExpertNet Subcontractors #10,Supplier Payment,PS-GL,3422.78,0.0,SGD,SWIFT MT103,ExpertNet Subcontractors #10,***9515,,PO-202312-PS-GL-0009,False,False,REF-531000,First Continental Bank,***7533,Globex APAC Logistics Pte. Ltd.,SG,8329901.94
2023-12-04,2023-12-04,BluePeak Property Mgmt,Rent & Utilities,ALL,13660.88,0.0,SGD,SWIFT MT103,BluePeak Property Mgmt,***2830,,,False,False,REF-676731,First Continental Bank,***4232,Globex APAC Logistics Pte. Ltd.,SG,8316241.06
2023-12-04,2023-12-04,Supplier Payment - Port Services #3,Supplier Payment,Logistics-APAC,15627.99,0.0,SGD,SWIFT MT103,Port Services #3,***9952,,PO-202312-Logistics-APAC-0001,False,False,REF-811121,First Continental Bank,***1944,Globex APAC Logistics Pte. Ltd.,SG,8300613.07
2023-12-04,2023-12-04,Supplier Payment - Port Services #4,Supplier Payment,Logistics-APAC,16632.1,0.0,SGD,MEPS+,Port Services #4,***3168,,PO-202312-Logistics-APAC-0005,False,False,REF-420518,First Continental Bank,***1837,Globex APAC Logistics Pte. Ltd.,SG,8283980.97
2023-12-05,2023-12-05,Merchant Processing Fees,Bank/Merchant Fees,ALL,3817.52,0.0,SGD,SWIFT MT103,First Continental Bank,***9470,,,False,False,REF-953728,First Continental Bank,***1417,Globex APAC Logistics Pte. Ltd.,SG,8280163.45
2023-12-05,2023-12-05,Client Receipt - CloudBridge Co. #62,Sales Receipt,SaaS-GL,0.0,1434.09,SGD,FAST Credit,CloudBridge Co. #62,***5259,INV-202312-SaaS-GL-0016,,False,False,REF-881892,First Continental Bank,***6868,Globex APAC Logistics Pte. Ltd.,SG,8281597.54
2023-12-06,2023-12-06,Supplier Payment - ExpertNet Subcontractors #9,Supplier Payment,PS-GL,3686.52,0.0,SGD,FAST Debit,ExpertNet Subcontractors #9,***4987,,PO-202312-PS-GL-0006,False,False,REF-869200,First Continental Bank,***1771,Globex APAC Logistics Pte. Ltd.,SG,8277911.02
2023-12-06,2023-12-06,Client Receipt - Pacific Trade Co. #23,Sales Receipt,Logistics-APAC,0.0,67319.27,SGD,FAST Credit,Pacific Trade Co. #23,***7145,INV-202312-Logistics-APAC-0008,,False,False,REF-577104,First Continental Bank,***9954,Globex APAC Logistics Pte. Ltd.,SG,8345230.29
2023-12-07,2023-12-07,Supplier Payment - Port Services #3,Supplier Payment,Logistics-APAC,38387.67,0.0,SGD,FAST Debit,Port Services #3,***3762,,PO-202312-Logistics-APAC-0002,False,False,REF-844662,First Continental Bank,***1376,Globex APAC Logistics Pte. Ltd.,SG,8306842.62
2023-12-07,2023-12-07,Client Receipt - Pacific Trade Co. #68,Sales Receipt,Logistics-APAC,0.0,26321.06,SGD,FAST Credit,Pacific Trade Co. #68,***2627,INV-202312-Logistics-APAC-0004,,False,False,REF-366861,First Continental Bank,***5806,Globex APAC Logistics Pte. Ltd.,SG,8333163.68
2023-12-08,2023-12-08,Supplier Payment - HyperCloud Infra #19,Supplier Payment,SaaS-GL,9669.06,0.0,SGD,FAST Debit,HyperCloud Infra #19,***3669,,PO-202312-SaaS-GL-0008,False,False,REF-449865,First Continental Bank,***5761,Globex APAC Logistics Pte. Ltd.,SG,8323494.62
2023-12-08,2023-12-08,Supplier Payment - ExpertNet Subcontractors #7,Supplier Payment,PS-GL,11009.16,0.0,SGD,MEPS+,ExpertNet Subcontractors #7,***4182,,PO-202312-PS-GL-0007,False,False,REF-491038,First Continental Bank,***1371,Globex APAC Logistics Pte. Ltd.,SG,8312485.46
2023-12-08,2023-12-08,Supplier Payment - HyperCloud Infra #4,Supplier Payment,SaaS-GL,27549.62,0.0,SGD,FAST Debit,HyperCloud Infra #4,***4108,,PO-202312-SaaS-GL-0003,False,False,REF-385418,First Continental Bank,***3099,Globex APAC Logistics Pte. Ltd.,SG,8284935.84
2023-12-08,2023-12-08,Client Receipt - CloudBridge Co. #38,Sales Receipt,SaaS-GL,0.0,3163.91,SGD,FAST Credit,CloudBridge Co. #38,***9945,INV-202312-SaaS-GL-0005,,False,False,REF-287287,First Continental Bank,***4777,Globex APAC Logistics Pte. Ltd.,SG,8288099.75
2023-12-10,2023-12-10,Supplier Payment - HyperCloud Infra #16,Supplier Payment,SaaS-GL,16332.2,0.0,SGD,SWIFT MT103,HyperCloud Infra #16,***7774,,PO-202312-SaaS-GL-0010,False,False,REF-936273,First Continental Bank,***7260,Globex APAC Logistics Pte. Ltd.,SG,8271767.55
2023-12-11,2023-12-11,Supplier Payment - HyperCloud Infra #14,Supplier Payment,SaaS-GL,6467.46,0.0,SGD,FAST Debit,HyperCloud Infra #14,***9488,,PO-202312-SaaS-GL-0001,False,False,REF-635092,First Continental Bank,***7766,Globex APAC Logistics Pte. Ltd.,SG,8265300.09
2023-12-11,2023-12-11,Supplier Payment - ExpertNet Subcontractors #13,Supplier Payment,PS-GL,7588.22,0.0,SGD,SWIFT MT103,ExpertNet Subcontractors #13,***2090,,PO-202312-PS-GL-0001,False,False,REF-560580,First Continental Bank,***9365,Globex APAC Logistics Pte. Ltd.,SG,8257711.87
2023-12-11,2023-12-11,Supplier Payment - ExpertNet Subcontractors #18,Supplier Payment,PS-GL,14747.49,0.0,SGD,MEPS+,ExpertNet Subcontractors #18,***7689,,PO-202312-PS-GL-0004,False,False,REF-195612,First Continental Bank,***8272,Globex APAC Logistics Pte. Ltd.,SG,8242964.38
2023-12-11,2023-12-11,Client Receipt - CloudBridge Co. #70,Sales Receipt,SaaS-GL,0.0,15107.83,SGD,SWIFT MT103,CloudBridge Co. #70,***3609,INV-202312-SaaS-GL-0006,,False,False,REF-747924,First Continental Bank,***9548,Globex APAC Logistics Pte. Ltd.,SG,8258072.21
2023-12-12,2023-12-12,Intercompany Settlement - Globex Consulting UK Ltd.,Intercompany Transfer,ALL,671132.0,0.0,SGD,Internal Transfer,Globex Consulting UK Ltd.,***9964,,,True,True,REF-328992,First Continental Bank,***3351,Globex APAC Logistics Pte. Ltd.,SG,7586940.21
2023-12-12,2023-12-12,Client Receipt - CloudBridge Co. #53,Sales Receipt,SaaS-GL,0.0,38831.02,SGD,FAST Credit,CloudBridge Co. #53,***6096,INV-202312-SaaS-GL-0014,,False,False,REF-732549,First Continental Bank,***5013,Globex APAC Logistics Pte. Ltd.,SG,7625771.23
2023-12-12,2023-12-12,Client Receipt - Pacific Trade Co. #25,Sales Receipt,Logistics-APAC,0.0,40115.57,SGD,FAST Credit,Pacific Trade Co. #25,***9066,INV-202312-Logistics-APAC-0016,,False,False,REF-608031,First Continental Bank,***7101,Globex APAC Logistics Pte. Ltd.,SG,7665886.8
2023-12-12,2023-12-12,Client Receipt - Pacific Trade Co. #52,Sales Receipt,Logistics-APAC,0.0,51323.8,SGD,FAST Credit,Pacific Trade Co. #52,***1808,INV-202312-Logistics-APAC-0013,,False,False,REF-830068,First Continental Bank,***6128,Globex APAC Logistics Pte. Ltd.,SG,7717210.6
2023-12-12,2023-12-12,Intercompany Reimbursement - Globex Consulting UK Ltd.,Intercompany Transfer,ALL,0.0,268452.8,SGD,Internal Transfer,Globex Consulting UK Ltd.,***5259,,,True,True,REF-390968,First Continental Bank,***8432,Globex APAC Logistics Pte. Ltd.,SG,7985663.4
2023-12-13,2023-12-13,Supplier Payment - TransAsia Freight #12,Supplier Payment,Logistics-APAC,46625.08,0.0,SGD,SWIFT MT103,TransAsia Freight #12,***9263,,PO-202312-Logistics-APAC-0004,False,False,REF-195271,First Continental Bank,***1473,Globex APAC Logistics Pte. Ltd.,SG,7939038.32
2023-12-13,2023-12-13,Client Receipt - CloudBridge Co. #79,Sales Receipt,SaaS-GL,0.0,640.94,SGD,SWIFT MT103,CloudBridge Co. #79,***5028,INV-202312-SaaS-GL-0017,,False,False,REF-440380,First Continental Bank,***2873,Globex APAC Logistics Pte. Ltd.,SG,7939679.26
2023-12-13,2023-12-13,Client Receipt - Pacific Trade Co. #11,Sales Receipt,Logistics-APAC,0.0,11839.07,SGD,SWIFT MT103,Pacific Trade Co. #11,***4544,INV-202312-Logistics-APAC-0009,,False,False,REF-588565,First Continental Bank,***1311,Globex APAC Logistics Pte. Ltd.,SG,7951518.33
2023-12-13,2023-12-13,Client Receipt - CloudBridge Co. #56,Sales Receipt,SaaS-GL,0.0,39734.25,SGD,SWIFT MT103,CloudBridge Co. #56,***5399,INV-202312-SaaS-GL-0004,,False,False,REF-363962,First Continental Bank,***6490,Globex APAC Logistics Pte. Ltd.,SG,7991252.58
2023-12-13,2023-12-13,Client Receipt - CloudBridge Co. #26,Sales Receipt,SaaS-GL,0.0,67204.17,SGD,SWIFT MT103,CloudBridge Co. #26,***9185,INV-202312-SaaS-GL-0025,,False,False,REF-154585,First Continental Bank,***4389,Globex APAC Logistics Pte. Ltd.,SG,8058456.75
2023-12-14,2023-12-14,Supplier Payment - TransAsia Freight #4,Supplier Payment,Logistics-APAC,7324.5,0.0,SGD,MEPS+,TransAsia Freight #4,***7432,,PO-202312-Logistics-APAC-0010,False,False,REF-188409,First Continental Bank,***8243,Globex APAC Logistics Pte. Ltd.,SG,8051132.25
2023-12-14,2023-12-14,Client Receipt - CloudBridge Co. #7,Sales Receipt,SaaS-GL,0.0,2522.73,SGD,SWIFT MT103,CloudBridge Co. #7,***6270,INV-202312-SaaS-GL-0033,,False,False,REF-403631,First Continental Bank,***6059,Globex APAC Logistics Pte. Ltd.,SG,8053654.98
2023-12-14,2023-12-14,Client Receipt - Pacific Trade Co. #34,Sales Receipt,Logistics-APAC,0.0,24010.62,SGD,FAST Credit,Pacific Trade Co. #34,***2041,INV-202312-Logistics-APAC-0007,,False,False,REF-677754,First Continental Bank,***1335,Globex APAC Logistics Pte. Ltd.,SG,8077665.6
2023-12-14,2023-12-14,Client Receipt - Pacific Trade Co. #32,Sales Receipt,Logistics-APAC,0.0,37433.39,SGD,SWIFT MT103,Pacific Trade Co. #32,***9076,INV-202312-Logistics-APAC-0010,,False,False,REF-717130,First Continental Bank,***7640,Globex APAC Logistics Pte. Ltd.,SG,8115098.99
2023-12-15,2023-12-15,Supplier Payment - HyperCloud Infra #12,Supplier Payment,SaaS-GL,11051.18,0.0,SGD,SWIFT MT103,HyperCloud Infra #12,***7818,,PO-202312-SaaS-GL-0005,False,False,REF-128018,First Continental Bank,***9705,Globex APAC Logistics Pte. Ltd.,SG,8104047.81
2023-12-15,2023-12-15,Supplier Payment - Port Services #15,Supplier Payment,Logistics-APAC,22041.89,0.0,SGD,MEPS+,Port Services #15,***6783,,PO-202312-Logistics-APAC-0007,False,False,REF-496196,First Continental Bank,***3349,Globex APAC Logistics Pte. Ltd.,SG,8082005.92
2023-12-15,2023-12-15,Client Receipt - CloudBridge Co. #76,Sales Receipt,SaaS-GL,0.0,12958.73,SGD,SWIFT MT103,CloudBridge Co. #76,***8997,INV-202312-SaaS-GL-0008,,False,False,REF-464927,First Continental Bank,***1571,Globex APAC Logistics Pte. Ltd.,SG,8094964.65
2023-12-15,2023-12-15,Client Receipt - Vertex Advisory Client #30,Sales Receipt,PS-GL,0.0,23657.44,SGD,FAST Credit,Vertex Advisory Client #30,***1797,INV-202312-PS-GL-0006,,False,False,REF-666628,First Continental Bank,***2990,Globex APAC Logistics Pte. Ltd.,SG,8118622.09
2023-12-15,2023-12-15,Client Receipt - CloudBridge Co. #41,Sales Receipt,SaaS-GL,0.0,57194.26,SGD,SWIFT MT103,CloudBridge Co. #41,***7065,INV-202312-SaaS-GL-0029,,False,False,REF-712604,First Continental Bank,***8535,Globex APAC Logistics Pte. Ltd.,SG,8175816.35
2023-12-15,2023-12-15,Client Receipt - Vertex Advisory Client #40,Sales Receipt,PS-GL,0.0,59067.34,SGD,FAST Credit,Vertex Advisory Client #40,***2924,INV-202312-PS-GL-0008,,False,False,REF-869355,First Continental Bank,***6815,Globex APAC Logistics Pte. Ltd.,SG,8234883.69
2023-12-16,2023-12-16,Supplier Payment - HyperCloud Infra #15,Supplier Payment,SaaS-GL,461.51,0.0,SGD,FAST Debit,HyperCloud Infra #15,***1855,,PO-202312-SaaS-GL-0011,False,False,REF-677057,First Continental Bank,***3166,Globex APAC Logistics Pte. Ltd.,SG,8234422.18
2023-12-16,2023-12-16,Supplier Payment - CodeCraft Contractors #1,Supplier Payment,SaaS-GL,6704.28,0.0,SGD,MEPS+,CodeCraft Contractors #1,***5318,,PO-202312-SaaS-GL-0006,False,False,REF-194459,First Continental Bank,***5504,Globex APAC Logistics Pte. Ltd.,SG,8227717.9
2023-12-18,2023-12-18,Supplier Payment - ExpertNet Subcontractors #11,Supplier Payment,PS-GL,2543.4,0.0,SGD,FAST Debit,ExpertNet Subcontractors #11,***7146,,PO-202312-PS-GL-0002,False,False,REF-640842,First Continental Bank,***6576,Globex APAC Logistics Pte. Ltd.,SG,8225174.5
2023-12-18,2023-12-18,Supplier Payment - HyperCloud Infra #14,Supplier Payment,SaaS-GL,32947.27,0.0,SGD,MEPS+,HyperCloud Infra #14,***6449,,PO-202312-SaaS-GL-0004,False,False,REF-433932,First Continental Bank,***5451,Globex APAC Logistics Pte. Ltd.,SG,8192227.23
2023-12-18,2023-12-18,Client Receipt - CloudBridge Co. #79,Sales Receipt,SaaS-GL,0.0,6160.72,SGD,SWIFT MT103,CloudBridge Co. #79,***8176,INV-202312-SaaS-GL-0032,,False,False,REF-498616,First Continental Bank,***3528,Globex APAC Logistics Pte. Ltd.,SG,8198387.95
2023-12-18,2023-12-18,Client Receipt - CloudBridge Co. #25,Sales Receipt,SaaS-GL,0.0,9164.95,SGD,SWIFT MT103,CloudBridge Co. #25,***8447,INV-202312-SaaS-GL-0009,,False,False,REF-979685,First Continental Bank,***7064,Globex APAC Logistics Pte. Ltd.,SG,8207552.9
2023-12-18,2023-12-18,Client Receipt - CloudBridge Co. #40,Sales Receipt,SaaS-GL,0.0,29916.31,SGD,FAST Credit,CloudBridge Co. #40,***6621,INV-202312-SaaS-GL-0021,,False,False,REF-939775,First Continental Bank,***3895,Globex APAC Logistics Pte. Ltd.,SG,8237469.21
2023-12-18,2023-12-18,Client Receipt - CloudBridge Co. #53,Sales Receipt,SaaS-GL,0.0,42140.34,SGD,FAST Credit,CloudBridge Co. #53,***4726,INV-202312-SaaS-GL-0020,,False,False,REF-266351,First Continental Bank,***9736,Globex APAC Logistics Pte. Ltd.,SG,8279609.55
2023-12-19,2023-12-19,Supplier Payment - ExpertNet Subcontractors #1,Supplier Payment,PS-GL,21320.09,0.0,SGD,MEPS+,ExpertNet Subcontractors #1,***9891,,PO-202312-PS-GL-0010,False,False,REF-891709,First Continental Bank,***3308,Globex APAC Logistics Pte. Ltd.,SG,8258289.46
2023-12-19,2023-12-19,Marketing - Aurelia Media #2,Marketing,ALL,29858.93,0.0,SGD,MEPS+,Aurelia Media #2,***1556,,,False,False,REF-229875,First Continental Bank,***7157,Globex APAC Logistics Pte. Ltd.,SG,8228430.53
2023-12-19,2023-12-19,Supplier Payment - TransAsia Freight #37,Supplier Payment,Logistics-APAC,34372.94,0.0,SGD,FAST Debit,TransAsia Freight #37,***4319,,PO-202312-Logistics-APAC-0003,False,False,REF-261414,First Continental Bank,***5066,Globex APAC Logistics Pte. Ltd.,SG,8194057.59
2023-12-19,2023-12-19,Client Receipt - CloudBridge Co. #2,Sales Receipt,SaaS-GL,0.0,6645.2,SGD,FAST Credit,CloudBridge Co. #2,***3151,INV-202312-SaaS-GL-0019,,False,False,REF-101906,First Continental Bank,***1208,Globex APAC Logistics Pte. Ltd.,SG,8200702.79
2023-12-19,2023-12-19,Client Receipt - Vertex Advisory Client #21,Sales Receipt,PS-GL,0.0,11049.24,SGD,FAST Credit,Vertex Advisory Client #21,***6055,INV-202312-PS-GL-0003,,False,False,REF-456981,First Continental Bank,***3638,Globex APAC Logistics Pte. Ltd.,SG,8211752.03
2023-12-19,2023-12-19,Client Receipt - Pacific Trade Co. #67,Sales Receipt,Logistics-APAC,0.0,19371.01,SGD,FAST Credit,Pacific Trade Co. #67,***8245,INV-202312-Logistics-APAC-0017,,False,False,REF-593224,First Continental Bank,***9357,Globex APAC Logistics Pte. Ltd.,SG,8231123.04
2023-12-19,2023-12-19,Client Receipt - CloudBridge Co. #70,Sales Receipt,SaaS-GL,0.0,30330.39,SGD,SWIFT MT103,CloudBridge Co. #70,***3526,INV-202312-SaaS-GL-0018,,False,False,REF-263765,First Continental Bank,***4199,Globex APAC Logistics Pte. Ltd.,SG,8261453.43
2023-12-19,2023-12-19,Client Receipt - CloudBridge Co. #75,Sales Receipt,SaaS-GL,0.0,33247.87,SGD,FAST Credit,CloudBridge Co. #75,***3016,INV-202312-SaaS-GL-0028,,False,False,REF-203781,First Continental Bank,***3895,Globex APAC Logistics Pte. Ltd.,SG,8294701.3
2023-12-20,2023-12-20,Supplier Payment - ExpertNet Subcontractors #15,Supplier Payment,PS-GL,11659.4,0.0,SGD,SWIFT MT103,ExpertNet Subcontractors #15,***8570,,PO-202312-PS-GL-0008,False,False,REF-711743,First Continental Bank,***9775,Globex APAC Logistics Pte. Ltd.,SG,8283041.9
2023-12-20,2023-12-20,Client Receipt - CloudBridge Co. #6,Sales Receipt,SaaS-GL,0.0,4271.04,SGD,SWIFT MT103,CloudBridge Co. #6,***9371,INV-202312-SaaS-GL-0027,,False,False,REF-996554,First Continental Bank,***2508,Globex APAC Logistics Pte. Ltd.,SG,8287312.94
2023-12-20,2023-12-20,Client Receipt - Vertex Advisory Client #52,Sales Receipt,PS-GL,0.0,28479.36,SGD,FAST Credit,Vertex Advisory Client #52,***2516,INV-202312-PS-GL-0010,,False,False,REF-233050,First Continental Bank,***3447,Globex APAC Logistics Pte. Ltd.,SG,8315792.3
2023-12-21,2023-12-21,Client Receipt - CloudBridge Co. #21,Sales Receipt,SaaS-GL,0.0,3422.19,SGD,FAST Credit,CloudBridge Co. #21,***6442,INV-202312-SaaS-GL-0013,,False,False,REF-809467,First Continental Bank,***9139,Globex APAC Logistics Pte. Ltd.,SG,8319214.49
2023-12-22,2023-12-22,VAT/GST Remittance - IRAS Singapore,Tax Payment,ALL,103564.93,0.0,SGD,MEPS+,IRAS Singapore,***5787,,,False,False,REF-961075,First Continental Bank,***2860,Globex APAC Logistics Pte. Ltd.,SG,8215649.56
2023-12-22,2023-12-22,Supplier Payment - TransAsia Freight #15,Supplier Payment,Logistics-APAC,113999.63,0.0,SGD,FAST Debit,TransAsia Freight #15,***2887,,PO-202312-Logistics-APAC-0008,False,False,REF-459817,First Continental Bank,***7512,Globex APAC Logistics Pte. Ltd.,SG,8101649.93
2023-12-22,2023-12-22,Client Receipt - Pacific Trade Co. #59,Sales Receipt,Logistics-APAC,0.0,12656.46,SGD,SWIFT MT103,Pacific Trade Co. #59,***5133,INV-202312-Logistics-APAC-0002,,False,False,REF-946486,First Continental Bank,***6130,Globex APAC Logistics Pte. Ltd.,SG,8114306.39
2023-12-22,2023-12-22,Client Receipt - Pacific Trade Co. #28,Sales Receipt,Logistics-APAC,0.0,13534.33,SGD,SWIFT MT103,Pacific Trade Co. #28,***4947,INV-202312-Logistics-APAC-0001,,False,False,REF-958951,First Continental Bank,***7098,Globex APAC Logistics Pte. Ltd.,SG,8127840.72
2023-12-22,2023-12-22,Client Receipt - Pacific Trade Co. #63,Sales Receipt,Logistics-APAC,0.0,68810.46,SGD,SWIFT MT103,Pacific Trade Co. #63,***1996,INV-202312-Logistics-APAC-0015,,False,False,REF-521252,First Continental Bank,***1453,Globex APAC Logistics Pte. Ltd.,SG,8196651.18
2023-12-22,2023-12-22,Client Receipt - Vertex Advisory Client #23,Sales Receipt,PS-GL,0.0,83819.08,SGD,SWIFT MT103,Vertex Advisory Client #23,***4380,INV-202312-PS-GL-0012,,False,False,REF-897457,First Continental Bank,***7542,Globex APAC Logistics Pte. Ltd.,SG,8280470.26
2023-12-25,2023-12-25,Supplier Payment - CodeCraft Contractors #2,Supplier Payment,SaaS-GL,17565.77,0.0,SGD,FAST Debit,CodeCraft Contractors #2,***8614,,PO-202312-SaaS-GL-0007,False,False,REF-176755,First Continental Bank,***3165,Globex APAC Logistics Pte. Ltd.,SG,8262904.49
2023-12-25,2023-12-25,Client Receipt - CloudBridge Co. #56,Sales Receipt,SaaS-GL,0.0,1611.79,SGD,FAST Credit,CloudBridge Co. #56,***5571,INV-202312-SaaS-GL-0001,,False,False,REF-839520,First Continental Bank,***5848,Globex APAC Logistics Pte. Ltd.,SG,8264516.28
2023-12-25,2023-12-25,Client Receipt - Vertex Advisory Client #35,Sales Receipt,PS-GL,0.0,3568.48,SGD,SWIFT MT103,Vertex Advisory Client #35,***9687,INV-202312-PS-GL-0001,,False,False,REF-721118,First Continental Bank,***8566,Globex APAC Logistics Pte. Ltd.,SG,8268084.76
2023-12-25,2023-12-25,Client Receipt - CloudBridge Co. #29,Sales Receipt,SaaS-GL,0.0,20851.08,SGD,FAST Credit,CloudBridge Co. #29,***2780,INV-202312-SaaS-GL-0002,,False,False,REF-331179,First Continental Bank,***4072,Globex APAC Logistics Pte. Ltd.,SG,8288935.84
2023-12-25,2023-12-25,Client Receipt - Pacific Trade Co. #50,Sales Receipt,Logistics-APAC,0.0,50132.82,SGD,FAST Credit,Pacific Trade Co. #50,***3578,INV-202312-Logistics-APAC-0014,,False,False,REF-577539,First Continental Bank,***2804,Globex APAC Logistics Pte. Ltd.,SG,8339068.66
2023-12-25,2023-12-25,Client Receipt - Pacific Trade Co. #41,Sales Receipt,Logistics-APAC,0.0,113637.58,SGD,FAST Credit,Pacific Trade Co. #41,***1733,INV-202312-Logistics-APAC-0005,,False,False,REF-560679,First Continental Bank,***3713,Globex APAC Logistics Pte. Ltd.,SG,8452706.24
2023-12-26,2023-12-26,Supplier Payment - CodeCraft Contractors #12,Supplier Payment,SaaS-GL,1735.61,0.0,SGD,SWIFT MT103,CodeCraft Contractors #12,***2158,,PO-202312-SaaS-GL-0002,False,False,REF-840393,First Continental Bank,***4392,Globex APAC Logistics Pte. Ltd.,SG,8450970.63
2023-12-26,2023-12-26,Supplier Payment - ExpertNet Subcontractors #5,Supplier Payment,PS-GL,8853.06,0.0,SGD,FAST Debit,ExpertNet Subcontractors #5,***6151,,PO-202312-PS-GL-0005,False,False,REF-345429,First Continental Bank,***6780,Globex APAC Logistics Pte. Ltd.,SG,8442117.57
2023-12-26,2023-12-26,Supplier Payment - Port Services #14,Supplier Payment,Logistics-APAC,103639.83,0.0,SGD,FAST Debit,Port Services #14,***7459,,PO-202312-Logistics-APAC-0006,False,False,REF-758170,First Continental Bank,***1598,Globex APAC Logistics Pte. Ltd.,SG,8338477.74
2023-12-26,2023-12-26,"Intercompany Settlement - Globex International Holdings, Inc.",Intercompany Transfer,ALL,157913.0,0.0,SGD,Internal Transfer,"Globex International Holdings, Inc.",***1215,,,True,True,REF-202328,First Continental Bank,***3748,Globex APAC Logistics Pte. Ltd.,SG,8180564.74
2023-12-26,2023-12-26,Client Receipt - CloudBridge Co. #69,Sales Receipt,SaaS-GL,0.0,7818.32,SGD,FAST Credit,CloudBridge Co. #69,***2594,INV-202312-SaaS-GL-0022,,False,False,REF-466782,First Continental Bank,***8714,Globex APAC Logistics Pte. Ltd.,SG,8188383.06
2023-12-26,2023-12-26,Client Receipt - CloudBridge Co. #11,Sales Receipt,SaaS-GL,0.0,11313.82,SGD,FAST Credit,CloudBridge Co. #11,***1444,INV-202312-SaaS-GL-0012,,False,False,REF-954067,First Continental Bank,***9908,Globex APAC Logistics Pte. Ltd.,SG,8199696.88
2023-12-26,2023-12-26,Client Receipt - Vertex Advisory Client #13,Sales Receipt,PS-GL,0.0,17850.73,SGD,FAST Credit,Vertex Advisory Client #13,***3956,INV-202312-PS-GL-0005,,False,False,REF-507767,First Continental Bank,***6817,Globex APAC Logistics Pte. Ltd.,SG,8217547.61
2023-12-26,2023-12-26,Client Receipt - CloudBridge Co. #8,Sales Receipt,SaaS-GL,0.0,19682.41,SGD,FAST Credit,CloudBridge Co. #8,***5965,INV-202312-SaaS-GL-0023,,False,False,REF-128898,First Continental Bank,***6577,Globex APAC Logistics Pte. Ltd.,SG,8237230.02
2023-12-26,2023-12-26,Client Receipt - Vertex Advisory Client #42,Sales Receipt,PS-GL,0.0,22032.38,SGD,SWIFT MT103,Vertex Advisory Client #42,***3447,INV-202312-PS-GL-0002,,False,False,REF-520157,First Continental Bank,***6096,Globex APAC Logistics Pte. Ltd.,SG,8259262.4
2023-12-27,2023-12-27,Client Receipt - Vertex Advisory Client #29,Sales Receipt,PS-GL,0.0,2597.14,SGD,FAST Credit,Vertex Advisory Client #29,***9531,INV-202312-PS-GL-0009,,False,False,REF-159139,First Continental Bank,***5905,Globex APAC Logistics Pte. Ltd.,SG,8261859.54
2023-12-27,2023-12-27,Client Receipt - CloudBridge Co. #46,Sales Receipt,SaaS-GL,0.0,5233.08,SGD,FAST Credit,CloudBridge Co. #46,***7435,INV-202312-SaaS-GL-0011,,False,False,REF-124050,First Continental Bank,***4011,Globex APAC Logistics Pte. Ltd.,SG,8267092.62
2023-12-27,2023-12-27,Client Receipt - CloudBridge Co. #33,Sales Receipt,SaaS-GL,0.0,16402.17,SGD,FAST Credit,CloudBridge Co. #33,***6454,INV-202312-SaaS-GL-0024,,False,False,REF-142230,First Continental Bank,***5071,Globex APAC Logistics Pte. Ltd.,SG,8283494.79
2023-12-27,2023-12-27,Client Receipt - CloudBridge Co. #33,Sales Receipt,SaaS-GL,0.0,33448.91,SGD,FAST Credit,CloudBridge Co. #33,***5671,INV-202312-SaaS-GL-0031,,False,False,REF-892181,First Continental Bank,***4378,Globex APAC Logistics Pte. Ltd.,SG,8316943.7
2023-12-28,2023-12-28,Supplier Payment - ExpertNet Subcontractors #4,Supplier Payment,PS-GL,35526.98,0.0,SGD,FAST Debit,ExpertNet Subcontractors #4,***4720,,PO-202312-PS-GL-0011,False,False,REF-814143,First Continental Bank,***2666,Globex APAC Logistics Pte. Ltd.,SG,8281416.72
2023-12-28,2023-12-28,Supplier Payment - TransAsia Freight #40,Supplier Payment,Logistics-APAC,79397.15,0.0,SGD,SWIFT MT103,TransAsia Freight #40,***3107,,PO-202312-Logistics-APAC-0009,False,False,REF-276410,First Continental Bank,***7071,Globex APAC Logistics Pte. Ltd.,SG,8202019.57
2023-12-28,2023-12-28,Client Receipt - CloudBridge Co. #63,Sales Receipt,SaaS-GL,0.0,4834.4,SGD,FAST Credit,CloudBridge Co. #63,***2532,INV-202312-SaaS-GL-0003,,False,False,REF-239984,First Continental Bank,***6500,Globex APAC Logistics Pte. Ltd.,SG,8206853.97
2023-12-28,2023-12-28,Client Receipt - CloudBridge Co. #53,Sales Receipt,SaaS-GL,0.0,10774.23,SGD,FAST Credit,CloudBridge Co. #53,***1039,INV-202312-SaaS-GL-0015,,False,False,REF-740329,First Continental Bank,***6962,Globex APAC Logistics Pte. Ltd.,SG,8217628.2
2023-12-28,2023-12-28,Client Receipt - Pacific Trade Co. #34,Sales Receipt,Logistics-APAC,0.0,10894.18,SGD,FAST Credit,Pacific Trade Co. #34,***2137,INV-202312-Logistics-APAC-0003,,False,False,REF-539006,First Continental Bank,***4617,Globex APAC Logistics Pte. Ltd.,SG,8228522.38
2023-12-28,2023-12-28,Client Receipt - CloudBridge Co. #56,Sales Receipt,SaaS-GL,0.0,16526.32,SGD,FAST Credit,CloudBridge Co. #56,***3226,INV-202312-SaaS-GL-0010,,False,False,REF-889212,First Continental Bank,***8098,Globex APAC Logistics Pte. Ltd.,SG,8245048.7
2023-12-28,2023-12-28,Client Receipt - Vertex Advisory Client #58,Sales Receipt,PS-GL,0.0,85388.41,SGD,FAST Credit,Vertex Advisory Client #58,***4749,INV-202312-PS-GL-0007,,False,False,REF-361306,First Continental Bank,***6579,Globex APAC Logistics Pte. Ltd.,SG,8330437.11
2023-12-29,2023-12-29,Merchant Processing Fees,Bank/Merchant Fees,ALL,1401.26,0.0,SGD,SWIFT MT103,First Continental Bank,***1255,,,False,False,REF-671963,First Continental Bank,***7266,Globex APAC Logistics Pte. Ltd.,SG,8329035.85
2023-12-29,2023-12-29,Client Receipt - Pacific Trade Co. #17,Sales Receipt,Logistics-APAC,0.0,86468.16,SGD,FAST Credit,Pacific Trade Co. #17,***2082,INV-202312-Logistics-APAC-0006,,False,False,REF-870697,First Continental Bank,***3351,Globex APAC Logistics Pte. Ltd.,SG,8415504.01
2023-12-30,2023-12-30,Marketing - Beacon Digital #7,Marketing,ALL,508.59,0.0,SGD,MEPS+,Beacon Digital #7,***4147,,,False,False,REF-123380,First Continental Bank,***8119,Globex APAC Logistics Pte. Ltd.,SG,8414995.42
2023-12-30,2023-12-30,Payroll - GlobalPay Services Ltd,Payroll,ALL,136846.01,0.0,SGD,FAST Debit,GlobalPay Services Ltd,***6118,,,False,False,REF-346042,First Continental Bank,***4898,Globex APAC Logistics Pte. Ltd.,SG,8278149.41
2023-12-30,2023-12-30,Payroll - GlobalPay Services Ltd,Payroll,ALL,136846.01,0.0,SGD,SWIFT MT103,GlobalPay Services Ltd,***1174,,,False,False,REF-888009,First Continental Bank,***6015,Globex APAC Logistics Pte. Ltd.,SG,8141303.4
2023-12-30,2023-12-30,Client Receipt - Vertex Advisory Client #22,Sales Receipt,PS-GL,0.0,2494.43,SGD,FAST Credit,Vertex Advisory Client #22,***5546,INV-202312-PS-GL-0004,,False,False,REF-157708,First Continental Bank,***3304,Globex APAC Logistics Pte. Ltd.,SG,8143797.83
2023-12-30,2023-12-30,Client Receipt - CloudBridge Co. #52,Sales Receipt,SaaS-GL,0.0,6833.48,SGD,FAST Credit,CloudBridge Co. #52,***8219,INV-202312-SaaS-GL-0034,,False,False,REF-987556,First Continental Bank,***8038,Globex APAC Logistics Pte. Ltd.,SG,8150631.31
2023-12-30,2023-12-30,Interest Earned,Interest Income,ALL,0.0,10398.58,SGD,SWIFT MT103,First Continental Bank,***6189,,,False,False,REF-586136,First Continental Bank,***7825,Globex APAC Logistics Pte. Ltd.,SG,8161029.89
2023-12-30,2023-12-30,Client Receipt - CloudBridge Co. #53,Sales Receipt,SaaS-GL,0.0,18513.85,SGD,FAST Credit,CloudBridge Co. #53,***8634,INV-202312-SaaS-GL-0026,,False,False,REF-676270,First Continental Bank,***2182,Globex APAC Logistics Pte. Ltd.,SG,8179543.74
2023-12-30,2023-12-30,Client Receipt - Pacific Trade Co. #24,Sales Receipt,Logistics-APAC,0.0,18549.38,SGD,FAST Credit,Pacific Trade Co. #24,***9912,INV-202312-Logistics-APAC-0012,,False,False,REF-835294,First Continental Bank,***3580,Globex APAC Logistics Pte. Ltd.,SG,8198093.12
2023-12-31,2023-12-31,Client Receipt - CloudBridge Co. #52,Sales Receipt,SaaS-GL,0.0,23006.51,SGD,SWIFT MT103,CloudBridge Co. #52,***6433,INV-202312-SaaS-GL-0007,,False,False,REF-117558,First Continental Bank,***5207,Globex APAC Logistics Pte. Ltd.,SG,8221099.63
2024-01-01,2024-01-01,Account Maintenance Fee,Bank/Merchant Fees,ALL,2500.0,0.0,SGD,SWIFT MT103,First Continental Bank,***6561,,,False,False,REF-509220,First Continental Bank,***9406,Globex APAC Logistics Pte. Ltd.,SG,8218599.63
2024-01-01,2024-01-01,Client Receipt - Pacific Trade Co. #26,Sales Receipt,Logistics-APAC,0.0,1506.25,SGD,FAST Credit,Pacific Trade Co. #26,***5585,INV-202401-Logistics-APAC-0013,,False,False,REF-583528,First Continental Bank,***1944,Globex APAC Logistics Pte. Ltd.,SG,8220105.88
2024-01-01,2024-01-01,Client Receipt - Pacific Trade Co. #41,Sales Receipt,Logistics-APAC,0.0,22366.58,SGD,SWIFT MT103,Pacific Trade Co. #41,***3233,INV-202401-Logistics-APAC-0006,,False,False,REF-614464,First Continental Bank,***9353,Globex APAC Logistics Pte. Ltd.,SG,8242472.46
2024-01-01,2024-01-01,Client Receipt - Vertex Advisory Client #50,Sales Receipt,PS-GL,0.0,46232.08,SGD,SWIFT MT103,Vertex Advisory Client #50,***6911,INV-202401-PS-GL-0003,,False,False,REF-457691,First Continental Bank,***3501,Globex APAC Logistics Pte. Ltd.,SG,8288704.54
2024-01-02,2024-01-02,Supplier Payment - CodeCraft Contractors #8,Supplier Payment,SaaS-GL,4593.32,0.0,SGD,MEPS+,CodeCraft Contractors #8,***5305,,PO-202401-SaaS-GL-0008,False,False,REF-964980,First Continental Bank,***6033,Globex APAC Logistics Pte. Ltd.,SG,8284111.22
2024-01-02,2024-01-02,Metro Water & Waste,Rent & Utilities,ALL,5560.57,0.0,SGD,SWIFT MT103,Metro Water & Waste,***1581,,,False,False,REF-181221,First Continental Bank,***4324,Globex APAC Logistics Pte. Ltd.,SG,8278550.65
2024-01-02,2024-01-02,Supplier Payment - HyperCloud Infra #1,Supplier Payment,SaaS-GL,8632.23,0.0,SGD,FAST Debit,HyperCloud Infra #1,***3729,,PO-202401-SaaS-GL-0003,False,False,REF-730572,First Continental Bank,***8969,Globex APAC Logistics Pte. Ltd.,SG,8269918.42
2024-01-02,2024-01-02,Supplier Payment - TransAsia Freight #33,Supplier Payment,Logistics-APAC,55653.03,0.0,SGD,SWIFT MT103,TransAsia Freight #33,***9314,,PO-202401-Logistics-APAC-0008,False,False,REF-316682,First Continental Bank,***6066,Globex APAC Logistics Pte. Ltd.,SG,8214265.39
2024-01-02,2024-01-02,Client Receipt - CloudBridge Co. #20,Sales Receipt,SaaS-GL,0.0,4679.33,SGD,SWIFT MT103,CloudBridge Co. #20,***5442,INV-202401-SaaS-GL-0017,,False,False,REF-661950,First Continental Bank,***8215,Globex APAC Logistics Pte. Ltd.,SG,8218944.72
2024-01-02,2024-01-02,Client Receipt - CloudBridge Co. #4,Sales Receipt,SaaS-GL,0.0,10575.57,SGD,SWIFT MT103,CloudBridge Co. #4,***8055,INV-202401-SaaS-GL-0012,,False,False,REF-419946,First Continental Bank,***5559,Globex APAC Logistics Pte. Ltd.,SG,8229520.29
2024-01-02,2024-01-02,Client Receipt - Vertex Advisory Client #15,Sales Receipt,PS-GL,0.0,16172.89,SGD,FAST Credit,Vertex Advisory Client #15,***6733,INV-202401-PS-GL-0005,,False,False,REF-660402,First Continental Bank,***6951,Globex APAC Logistics Pte. Ltd.,SG,8245693.18
2024-01-03,2024-01-03,BluePeak Property Mgmt,Rent & Utilities,ALL,1359.18,0.0,SGD,MEPS+,BluePeak Property Mgmt,***9577,,,False,False,REF-536897,First Continental Bank,***4397,Globex APAC Logistics Pte. Ltd.,SG,8244334.0
2024-01-03,2024-01-03,Supplier Payment - CodeCraft Contractors #1,Supplier Payment,SaaS-GL,14791.78,0.0,SGD,MEPS+,CodeCraft Contractors #1,***8139,,PO-202401-SaaS-GL-0007,False,False,REF-216677,First Continental Bank,***6747,Globex APAC Logistics Pte. Ltd.,SG,8229542.22
2024-01-03,2024-01-03,Client Receipt - Pacific Trade Co. #56,Sales Receipt,Logistics-APAC,0.0,15357.82,SGD,FAST Credit,Pacific Trade Co. #56,***2567,INV-202401-Logistics-APAC-0005,,False,False,REF-410213,First Continental Bank,***8470,Globex APAC Logistics Pte. Ltd.,SG,8244900.04
2024-01-04,2024-01-04,Client Receipt - Pacific Trade Co. #49,Sales Receipt,Logistics-APAC,0.0,33311.13,SGD,SWIFT MT103,Pacific Trade Co. #49,***2392,INV-202401-Logistics-APAC-0015,,False,False,REF-893854,First Continental Bank,***7046,Globex APAC Logistics Pte. Ltd.,SG,8278211.17
2024-01-05,2024-01-05,Supplier Payment - ExpertNet Subcontractors #1,Supplier Payment,PS-GL,1078.88,0.0,SGD,MEPS+,ExpertNet Subcontractors #1,***6682,,PO-202401-PS-GL-0003,False,False,REF-237238,First Continental Bank,***2370,Globex APAC Logistics Pte. Ltd.,SG,8277132.29
2024-01-05,2024-01-05,Marketing - Aurelia Media #8,Marketing,ALL,8913.15,0.0,SGD,MEPS+,Aurelia Media #8,***6731,,,False,False,REF-391799,First Continental Bank,***8396,Globex APAC Logistics Pte. Ltd.,SG,8268219.14
2024-01-05,2024-01-05,Supplier Payment - ExpertNet Subcontractors #19,Supplier Payment,PS-GL,13372.18,0.0,SGD,FAST Debit,ExpertNet Subcontractors #19,***9384,,PO-202401-PS-GL-0009,False,False,REF-867492,First Continental Bank,***7933,Globex APAC Logistics Pte. Ltd.,SG,8254846.96
2024-01-05,2024-01-05,Client Receipt - CloudBridge Co. #25,Sales Receipt,SaaS-GL,0.0,5955.98,SGD,SWIFT MT103,CloudBridge Co. #25,***9852,INV-202401-SaaS-GL-0016,,False,False,REF-245033,First Continental Bank,***2765,Globex APAC Logistics Pte. Ltd.,SG,8260802.94
2024-01-05,2024-01-05,Client Receipt - CloudBridge Co. #44,Sales Receipt,SaaS-GL,0.0,17723.68,SGD,SWIFT MT103,CloudBridge Co. #44,***1582,INV-202401-SaaS-GL-0002,,False,False,REF-569385,First Continental Bank,***1913,Globex APAC Logistics Pte. Ltd.,SG,8278526.62
2024-01-06,2024-01-06,Supplier Payment - Port Services #5,Supplier Payment,Logistics-APAC,1775.73,0.0,SGD,SWIFT MT103,Port Services #5,***1767,,PO-202401-Logistics-APAC-0004,False,False,REF-121291,First Continental Bank,***9557,Globex APAC Logistics Pte. Ltd.,SG,8276750.89
2024-01-09,2024-01-09,Merchant Processing Fees,Bank/Merchant Fees,ALL,286.62,0.0,SGD,FAST Debit,First Continental Bank,***9298,,,False,False,REF-992417,First Continental Bank,***6123,Globex APAC Logistics Pte. Ltd.,SG,8276464.27
2024-01-09,2024-01-09,Supplier Payment - ExpertNet Subcontractors #17,Supplier Payment,PS-GL,813.88,0.0,SGD,FAST Debit,ExpertNet Subcontractors #17,***3769,,PO-202401-PS-GL-0005,False,False,REF-731880,First Continental Bank,***9519,Globex APAC Logistics Pte. Ltd.,SG,8275650.39
2024-01-09,2024-01-09,Supplier Payment - HyperCloud Infra #3,Supplier Payment,SaaS-GL,3624.15,0.0,SGD,MEPS+,HyperCloud Infra #3,***5396,,PO-202401-SaaS-GL-0005,False,False,REF-829275,First Continental Bank,***2061,Globex APAC Logistics Pte. Ltd.,SG,8272026.24
2024-01-09,2024-01-09,Client Receipt - Pacific Trade Co. #44,Sales Receipt,Logistics-APAC,0.0,7176.49,SGD,FAST Credit,Pacific Trade Co. #44,***3892,INV-202401-Logistics-APAC-0001,,False,False,REF-636292,First Continental Bank,***9529,Globex APAC Logistics Pte. Ltd.,SG,8279202.73
2024-01-09,2024-01-09,Client Receipt - Vertex Advisory Client #20,Sales Receipt,PS-GL,0.0,14580.03,SGD,FAST Credit,Vertex Advisory Client #20,***6648,INV-202401-PS-GL-0010,,False,False,REF-780697,First Continental Bank,***8201,Globex APAC Logistics Pte. Ltd.,SG,8293782.76
2024-01-09,2024-01-09,Client Receipt - CloudBridge Co. #6,Sales Receipt,SaaS-GL,0.0,16867.19,SGD,FAST Credit,CloudBridge Co. #6,***5770,INV-202401-SaaS-GL-0014,,False,False,REF-353614,First Continental Bank,***1764,Globex APAC Logistics Pte. Ltd.,SG,8310649.95
2024-01-09,2024-01-09,Client Receipt - Vertex Advisory Client #54,Sales Receipt,PS-GL,0.0,28047.66,SGD,SWIFT MT103,Vertex Advisory Client #54,***5143,INV-202401-PS-GL-0004,,False,False,REF-881864,First Continental Bank,***4642,Globex APAC Logistics Pte. Ltd.,SG,8338697.61
2024-01-09,2024-01-09,Client Receipt - Pacific Trade Co. #25,Sales Receipt,Logistics-APAC,0.0,85026.9,SGD,SWIFT MT103,Pacific Trade Co. #25,***4650,INV-202401-Logistics-APAC-0017,,False,False,REF-312914,First Continental Bank,***7587,Globex APAC Logistics Pte. Ltd.,SG,8423724.51
2024-01-10,2024-01-10,Supplier Payment - HyperCloud Infra #4,Supplier Payment,SaaS-GL,1280.16,0.0,SGD,FAST Debit,HyperCloud Infra #4,***6649,,PO-202401-SaaS-GL-0002,False,False,REF-392862,First Continental Bank,***2410,Globex APAC Logistics Pte. Ltd.,SG,8422444.35
2024-01-10,2024-01-10,Marketing - Beacon Digital #3,Marketing,ALL,3416.17,0.0,SGD,SWIFT MT103,Beacon Digital #3,***6618,,,False,False,REF-218630,First Continental Bank,***8219,Globex APAC Logistics Pte. Ltd.,SG,8419028.18
2024-01-10,2024-01-10,Supplier Payment - HyperCloud Infra #8,Supplier Payment,SaaS-GL,4149.22,0.0,SGD,FAST Debit,HyperCloud Infra #8,***1288,,PO-202401-SaaS-GL-0004,False,False,REF-795190,First Continental Bank,***8407,Globex APAC Logistics Pte. Ltd.,SG,8414878.96
2024-01-10,2024-01-10,Client Receipt - CloudBridge Co. #45,Sales Receipt,SaaS-GL,0.0,5649.64,SGD,SWIFT MT103,CloudBridge Co. #45,***8828,INV-202401-SaaS-GL-0020,,False,False,REF-310620,First Continental Bank,***6489,Globex APAC Logistics Pte. Ltd.,SG,8420528.6
2024-01-10,2024-01-10,Client Receipt - CloudBridge Co. #35,Sales Receipt,SaaS-GL,0.0,7866.49,SGD,SWIFT MT103,CloudBridge Co. #35,***5633,INV-202401-SaaS-GL-0005,,False,False,REF-713921,First Continental Bank,***1491,Globex APAC Logistics Pte. Ltd.,SG,8428395.09
2024-01-10,2024-01-10,Client Receipt - CloudBridge Co. #3,Sales Receipt,SaaS-GL,0.0,19922.18,SGD,FAST Credit,CloudBridge Co. #3,***3870,INV-202401-SaaS-GL-0007,,False,False,REF-128447,First Continental Bank,***7675,Globex APAC Logistics Pte. Ltd.,SG,8448317.27
2024-01-11,2024-01-11,Supplier Payment - ExpertNet Subcontractors #11,Supplier Payment,PS-GL,2755.18,0.0,SGD,MEPS+,ExpertNet Subcontractors #11,***8007,,PO-202401-PS-GL-0008,False,False,REF-726069,First Continental Bank,***7088,Globex APAC Logistics Pte. Ltd.,SG,8445562.09
2024-01-11,2024-01-11,Client Receipt - CloudBridge Co. #71,Sales Receipt,SaaS-GL,0.0,1602.65,SGD,SWIFT MT103,CloudBridge Co. #71,***9268,INV-202401-SaaS-GL-0024,,False,False,REF-738934,First Continental Bank,***3705,Globex APAC Logistics Pte. Ltd.,SG,8447164.74
2024-01-11,2024-01-11,Client Receipt - Vertex Advisory Client #47,Sales Receipt,PS-GL,0.0,5755.47,SGD,FAST Credit,Vertex Advisory Client #47,***1875,INV-202401-PS-GL-0006,,False,False,REF-793043,First Continental Bank,***1057,Globex APAC Logistics Pte. Ltd.,SG,8452920.21
2024-01-11,2024-01-11,Client Receipt - Pacific Trade Co. #38,Sales Receipt,Logistics-APAC,0.0,9495.47,SGD,SWIFT MT103,Pacific Trade Co. #38,***7966,INV-202401-Logistics-APAC-0004,,False,False,REF-838186,First Continental Bank,***2790,Globex APAC Logistics Pte. Ltd.,SG,8462415.68
2024-01-11,2024-01-11,Client Receipt - Pacific Trade Co. #39,Sales Receipt,Logistics-APAC,0.0,11161.31,SGD,SWIFT MT103,Pacific Trade Co. #39,***8266,INV-202401-Logistics-APAC-0012,,False,False,REF-557882,First Continental Bank,***9744,Globex APAC Logistics Pte. Ltd.,SG,8473576.99
2024-01-11,2024-01-11,Client Receipt - CloudBridge Co. #31,Sales Receipt,SaaS-GL,0.0,11666.97,SGD,SWIFT MT103,CloudBridge Co. #31,***6256,INV-202401-SaaS-GL-0019,,False,False,REF-362493,First Continental Bank,***3131,Globex APAC Logistics Pte. Ltd.,SG,8485243.96
2024-01-11,2024-01-11,Client Receipt - CloudBridge Co. #16,Sales Receipt,SaaS-GL,0.0,54421.38,SGD,SWIFT MT103,CloudBridge Co. #16,***6197,INV-202401-SaaS-GL-0009,,False,False,REF-764866,First Continental Bank,***5802,Globex APAC Logistics Pte. Ltd.,SG,8539665.34
2024-01-12,2024-01-12,Intercompany Settlement - Globex Retail NA LLC,Intercompany Transfer,ALL,203747.0,0.0,SGD,Internal Transfer,Globex Retail NA LLC,***6132,,,True,True,REF-991752,First Continental Bank,***3037,Globex APAC Logistics Pte. Ltd.,SG,8335918.34
2024-01-12,2024-01-12,Client Receipt - Pacific Trade Co. #47,Sales Receipt,Logistics-APAC,0.0,6290.67,SGD,FAST Credit,Pacific Trade Co. #47,***4525,INV-202401-Logistics-APAC-0010,,False,False,REF-207031,First Continental Bank,***8093,Globex APAC Logistics Pte. Ltd.,SG,8342209.01
2024-01-12,2024-01-12,Client Receipt - Pacific Trade Co. #32,Sales Receipt,Logistics-APAC,0.0,14182.27,SGD,FAST Credit,Pacific Trade Co. #32,***6347,INV-202401-Logistics-APAC-0008,,False,False,REF-997960,First Continental Bank,***3789,Globex APAC Logistics Pte. Ltd.,SG,8356391.28
2024-01-13,2024-01-13,Client Receipt - Pacific Trade Co. #18,Sales Receipt,Logistics-APAC,0.0,4240.18,SGD,FAST Credit,Pacific Trade Co. #18,***9123,INV-202401-Logistics-APAC-0003,,False,False,REF-232987,First Continental Bank,***8880,Globex APAC Logistics Pte. Ltd.,SG,8360631.46
2024-01-14,2024-01-14,Supplier Payment - TransAsia Freight #9,Supplier Payment,Logistics-APAC,60596.09,0.0,SGD,SWIFT MT103,TransAsia Freight #9,***3251,,PO-202401-Logistics-APAC-0001,False,False,REF-325110,First Continental Bank,***6902,Globex APAC Logistics Pte. Ltd.,SG,8300035.37
2024-01-15,2024-01-15,Supplier Payment - HyperCloud Infra #11,Supplier Payment,SaaS-GL,173.03,0.0,SGD,FAST Debit,HyperCloud Infra #11,***2433,,PO-202401-SaaS-GL-0006,False,False,REF-716494,First Continental Bank,***7711,Globex APAC Logistics Pte. Ltd.,SG,8299862.34
2024-01-15,2024-01-15,Supplier Payment - CodeCraft Contractors #13,Supplier Payment,SaaS-GL,16907.51,0.0,SGD,SWIFT MT103,CodeCraft Contractors #13,***3156,,PO-202401-SaaS-GL-0009,False,False,REF-589408,First Continental Bank,***4091,Globex APAC Logistics Pte. Ltd.,SG,8282954.83
2024-01-15,2024-01-15,Client Receipt - CloudBridge Co. #78,Sales Receipt,SaaS-GL,0.0,2268.03,SGD,SWIFT MT103,CloudBridge Co. #78,***9272,INV-202401-SaaS-GL-0006,,False,False,REF-914178,First Continental Bank,***8795,Globex APAC Logistics Pte. Ltd.,SG,8285222.86
2024-01-15,2024-01-15,Client Receipt - Pacific Trade Co. #1,Sales Receipt,Logistics-APAC,0.0,3877.57,SGD,SWIFT MT103,Pacific Trade Co. #1,***8792,INV-202401-Logistics-APAC-0009,,False,False,REF-439138,First Continental Bank,***6100,Globex APAC Logistics Pte. Ltd.,SG,8289100.43
2024-01-15,2024-01-15,Client Receipt - CloudBridge Co. #62,Sales Receipt,SaaS-GL,0.0,20681.51,SGD,FAST Credit,CloudBridge Co. #62,***1768,INV-202401-SaaS-GL-0023,,False,False,REF-779330,First Continental Bank,***5266,Globex APAC Logistics Pte. Ltd.,SG,8309781.94
2024-01-15,2024-01-15,Client Receipt - CloudBridge Co. #77,Sales Receipt,SaaS-GL,0.0,30652.44,SGD,SWIFT MT103,CloudBridge Co. #77,***3955,INV-202401-SaaS-GL-0018,,False,False,REF-255039,First Continental Bank,***2651,Globex APAC Logistics Pte. Ltd.,SG,8340434.38
2024-01-16,2024-01-16,Client Receipt - CloudBridge Co. #3,Sales Receipt,SaaS-GL,0.0,6240.42,SGD,SWIFT MT103,CloudBridge Co. #3,***6180,INV-202401-SaaS-GL-0021,,False,False,REF-493940,First Continental Bank,***1088,Globex APAC Logistics Pte. Ltd.,SG,8346674.8
2024-01-17,2024-01-17,Supplier Payment - TransAsia Freight #28,Supplier Payment,Logistics-APAC,5769.91,0.0,SGD,SWIFT MT103,TransAsia Freight #28,***5227,,PO-202401-Logistics-APAC-0009,False,False,REF-490932,First Continental Bank,***7149,Globex APAC Logistics Pte. Ltd.,SG,8340904.89
2024-01-17,2024-01-17,Supplier Payment - HyperCloud Infra #13,Supplier Payment,SaaS-GL,11380.0,0.0,SGD,FAST Debit,HyperCloud Infra #13,***5266,,PO-202401-SaaS-GL-0010,False,False,REF-483411,First Continental Bank,***5181,Globex APAC Logistics Pte. Ltd.,SG,8329524.89
2024-01-17,2024-01-17,Client Receipt - CloudBridge Co. #43,Sales Receipt,SaaS-GL,0.0,7795.7,SGD,FAST Credit,CloudBridge Co. #43,***7476,INV-202401-SaaS-GL-0013,,False,False,REF-804794,First Continental Bank,***4893,Globex APAC Logistics Pte. Ltd.,SG,8337320.59
2024-01-17,2024-01-17,Client Receipt - Pacific Trade Co. #20,Sales Receipt,Logistics-APAC,0.0,8320.81,SGD,SWIFT MT103,Pacific Trade Co. #20,***2803,INV-202401-Logistics-APAC-0002,,False,False,REF-119184,First Continental Bank,***8130,Globex APAC Logistics Pte. Ltd.,SG,8345641.4
2024-01-17,2024-01-17,Client Receipt - CloudBridge Co. #61,Sales Receipt,SaaS-GL,0.0,10474.32,SGD,FAST Credit,CloudBridge Co. #61,***2055,INV-202401-SaaS-GL-0003,,False,False,REF-730812,First Continental Bank,***1766,Globex APAC Logistics Pte. Ltd.,SG,8356115.72
2024-01-17,2024-01-17,Client Receipt - Pacific Trade Co. #59,Sales Receipt,Logistics-APAC,0.0,32006.33,SGD,FAST Credit,Pacific Trade Co. #59,***3987,INV-202401-Logistics-APAC-0014,,False,False,REF-450667,First Continental Bank,***4424,Globex APAC Logistics Pte. Ltd.,SG,8388122.05
2024-01-18,2024-01-18,VAT/GST Remittance - IRAS Singapore,Tax Payment,ALL,52398.18,0.0,SGD,SWIFT MT103,IRAS Singapore,***1557,,,False,False,REF-388757,First Continental Bank,***4227,Globex APAC Logistics Pte. Ltd.,SG,8335723.87
2024-01-18,2024-01-18,Client Receipt - Pacific Trade Co. #34,Sales Receipt,Logistics-APAC,0.0,66108.62,SGD,FAST Credit,Pacific Trade Co. #34,***4070,INV-202401-Logistics-APAC-0007,,False,False,REF-278777,First Continental Bank,***4259,Globex APAC Logistics Pte. Ltd.,SG,8401832.49
2024-01-19,2024-01-19,Supplier Payment - TransAsia Freight #33,Supplier Payment,Logistics-APAC,14847.88,0.0,SGD,MEPS+,TransAsia Freight #33,***6323,,PO-202401-Logistics-APAC-0003,False,False,REF-926603,First Continental Bank,***8944,Globex APAC Logistics Pte. Ltd.,SG,8386984.61
2024-01-19,2024-01-19,Client Receipt - Vertex Advisory Client #17,Sales Receipt,PS-GL,0.0,20405.27,SGD,FAST Credit,Vertex Advisory Client #17,***5300,INV-202401-PS-GL-0008,,False,False,REF-628891,First Continental Bank,***9393,Globex APAC Logistics Pte. Ltd.,SG,8407389.88
2024-01-20,2024-01-20,Client Receipt - CloudBridge Co. #33,Sales Receipt,SaaS-GL,0.0,638.91,SGD,FAST Credit,CloudBridge Co. #33,***4675,INV-202401-SaaS-GL-0008,,False,False,REF-387188,First Continental Bank,***1024,Globex APAC Logistics Pte. Ltd.,SG,8408028.79
2024-01-22,2024-01-22,Supplier Payment - Port Services #14,Supplier Payment,Logistics-APAC,29483.42,0.0,SGD,MEPS+,Port Services #14,***2977,,PO-202401-Logistics-APAC-0007,False,False,REF-116236,First Continental Bank,***5988,Globex APAC Logistics Pte. Ltd.,SG,8378545.37
2024-01-22,2024-01-22,Client Receipt - CloudBridge Co. #51,Sales Receipt,SaaS-GL,0.0,808.37,SGD,FAST Credit,CloudBridge Co. #51,***9258,INV-202401-SaaS-GL-0022,,False,False,REF-513669,First Continental Bank,***2516,Globex APAC Logistics Pte. Ltd.,SG,8379353.74
2024-01-22,2024-01-22,Client Receipt - Pacific Trade Co. #63,Sales Receipt,Logistics-APAC,0.0,8900.51,SGD,SWIFT MT103,Pacific Trade Co. #63,***2478,INV-202401-Logistics-APAC-0016,,False,False,REF-820310,First Continental Bank,***8432,Globex APAC Logistics Pte. Ltd.,SG,8388254.25
2024-01-22,2024-01-22,Client Receipt - CloudBridge Co. #2,Sales Receipt,SaaS-GL,0.0,13814.27,SGD,SWIFT MT103,CloudBridge Co. #2,***8376,INV-202401-SaaS-GL-0010,,False,False,REF-558695,First Continental Bank,***2386,Globex APAC Logistics Pte. Ltd.,SG,8402068.52
2024-01-22,2024-01-22,Client Receipt - Vertex Advisory Client #4,Sales Receipt,PS-GL,0.0,33770.38,SGD,FAST Credit,Vertex Advisory Client #4,***4230,INV-202401-PS-GL-0007,,False,False,REF-792009,First Continental Bank,***1281,Globex APAC Logistics Pte. Ltd.,SG,8435838.9
2024-01-23,2024-01-23,Supplier Payment - HyperCloud Infra #12,Supplier Payment,SaaS-GL,2078.36,0.0,SGD,FAST Debit,HyperCloud Infra #12,***3640,,PO-202401-SaaS-GL-0001,False,False,REF-423060,First Continental Bank,***5972,Globex APAC Logistics Pte. Ltd.,SG,8433760.54
2024-01-23,2024-01-23,Supplier Payment - TransAsia Freight #3,Supplier Payment,Logistics-APAC,43566.0,0.0,SGD,MEPS+,TransAsia Freight #3,***2922,,PO-202401-Logistics-APAC-0010,False,False,REF-858376,First Continental Bank,***3860,Globex APAC Logistics Pte. Ltd.,SG,8390194.54
2024-01-23,2024-01-23,Client Receipt - Vertex Advisory Client #23,Sales Receipt,PS-GL,0.0,25390.01,SGD,SWIFT MT103,Vertex Advisory Client #23,***5458,INV-202401-PS-GL-0002,,False,False,REF-472071,First Continental Bank,***2641,Globex APAC Logistics Pte. Ltd.,SG,8415584.55
2024-01-24,2024-01-24,Supplier Payment - TransAsia Freight #2,Supplier Payment,Logistics-APAC,5846.81,0.0,SGD,FAST Debit,TransAsia Freight #2,***7833,,PO-202401-Logistics-APAC-0002,False,False,REF-261104,First Continental Bank,***9773,Globex APAC Logistics Pte. Ltd.,SG,8409737.74
2024-01-25,2024-01-25,Supplier Payment - ExpertNet Subcontractors #2,Supplier Payment,PS-GL,7510.04,0.0,SGD,MEPS+,ExpertNet Subcontractors #2,***5793,,PO-202401-PS-GL-0004,False,False,REF-382490,First Continental Bank,***5506,Globex APAC Logistics Pte. Ltd.,SG,8402227.7
2024-01-25,2024-01-25,Client Receipt - CloudBridge Co. #75,Sales Receipt,SaaS-GL,0.0,13782.98,SGD,SWIFT MT103,CloudBridge Co. #75,***2854,INV-202401-SaaS-GL-0015,,False,False,REF-590954,First Continental Bank,***3000,Globex APAC Logistics Pte. Ltd.,SG,8416010.68
2024-01-25,2024-01-25,Client Receipt - CloudBridge Co. #46,Sales Receipt,SaaS-GL,0.0,15989.77,SGD,FAST Credit,CloudBridge Co. #46,***2039,INV-202401-SaaS-GL-0025,,False,False,REF-643923,First Continental Bank,***4568,Globex APAC Logistics Pte. Ltd.,SG,8432000.45
2024-01-26,2024-01-26,Supplier Payment - ExpertNet Subcontractors #16,Supplier Payment,PS-GL,2706.09,0.0,SGD,MEPS+,ExpertNet Subcontractors #16,***7824,,PO-202401-PS-GL-0001,False,False,REF-395924,First Continental Bank,***3074,Globex APAC Logistics Pte. Ltd.,SG,8429294.36
2024-01-26,2024-01-26,Supplier Payment - ExpertNet Subcontractors #8,Supplier Payment,PS-GL,9061.42,0.0,SGD,SWIFT MT103,ExpertNet Subcontractors #8,***6827,,PO-202401-PS-GL-0010,False,False,REF-182030,First Continental Bank,***5756,Globex APAC Logistics Pte. Ltd.,SG,8420232.94
2024-01-26,2024-01-26,Supplier Payment - Port Services #1,Supplier Payment,Logistics-APAC,19849.74,0.0,SGD,FAST Debit,Port Services #1,***9866,,PO-202401-Logistics-APAC-0005,False,False,REF-137270,First Continental Bank,***8892,Globex APAC Logistics Pte. Ltd.,SG,8400383.2
2024-01-26,2024-01-26,Payroll - GlobalPay Services Ltd,Payroll,ALL,68608.35,0.0,SGD,SWIFT MT103,GlobalPay Services Ltd,***4099,,,False,False,REF-212486,First Continental Bank,***4577,Globex APAC Logistics Pte. Ltd.,SG,8331774.85
2024-01-26,2024-01-26,Intercompany Settlement - Globex Consulting UK Ltd.,Intercompany Transfer,ALL,700679.0,0.0,SGD,Internal Transfer,Globex Consulting UK Ltd.,***1934,,,True,True,REF-701633,First Continental Bank,***2375,Globex APAC Logistics Pte. Ltd.,SG,7631095.85
2024-01-26,2024-01-26,Client Receipt - Vertex Advisory Client #12,Sales Receipt,PS-GL,0.0,2155.84,SGD,SWIFT MT103,Vertex Advisory Client #12,***1030,INV-202401-PS-GL-0009,,False,False,REF-277891,First Continental Bank,***1431,Globex APAC Logistics Pte. Ltd.,SG,7633251.69
2024-01-28,2024-01-28,Corporate Tax Estimate,Tax Payment,ALL,38049.56,0.0,SGD,SWIFT MT103,IRAS Singapore,***9415,,,False,False,REF-680297,First Continental Bank,***3878,Globex APAC Logistics Pte. Ltd.,SG,7595202.13
2024-01-28,2024-01-28,Payroll - GlobalPay Services Ltd,Payroll,ALL,68608.35,0.0,SGD,MEPS+,GlobalPay Services Ltd,***1945,,,False,False,REF-207122,First Continental Bank,***5232,Globex APAC Logistics Pte. Ltd.,SG,7526593.78
2024-01-29,2024-01-29,Supplier Payment - ExpertNet Subcontractors #17,Supplier Payment,PS-GL,1606.36,0.0,SGD,SWIFT MT103,ExpertNet Subcontractors #17,***5242,,PO-202401-PS-GL-0006,False,False,REF-156463,First Continental Bank,***3457,Globex APAC Logistics Pte. Ltd.,SG,7524987.42
2024-01-29,2024-01-29,Supplier Payment - ExpertNet Subcontractors #1,Supplier Payment,PS-GL,19858.17,0.0,SGD,MEPS+,ExpertNet Subcontractors #1,***3265,,PO-202401-PS-GL-0007,False,False,REF-883721,First Continental Bank,***5668,Globex APAC Logistics Pte. Ltd.,SG,7505129.25
2024-01-29,2024-01-29,Client Receipt - CloudBridge Co. #49,Sales Receipt,SaaS-GL,0.0,10966.69,SGD,SWIFT MT103,CloudBridge Co. #49,***2155,INV-202401-SaaS-GL-0001,,False,False,REF-754042,First Continental Bank,***2679,Globex APAC Logistics Pte. Ltd.,SG,7516095.94
2024-01-29,2024-01-29,Client Receipt - Pacific Trade Co. #16,Sales Receipt,Logistics-APAC,0.0,12134.5,SGD,FAST Credit,Pacific Trade Co. #16,***8027,INV-202401-Logistics-APAC-0011,,False,False,REF-188105,First Continental Bank,***1974,Globex APAC Logistics Pte. Ltd.,SG,7528230.44
2024-01-29,2024-01-29,Client Receipt - CloudBridge Co. #28,Sales Receipt,SaaS-GL,0.0,12352.52,SGD,FAST Credit,CloudBridge Co. #28,***9719,INV-202401-SaaS-GL-0011,,False,False,REF-763299,First Continental Bank,***9867,Globex APAC Logistics Pte. Ltd.,SG,7540582.96
2024-01-29,2024-01-29,Client Receipt - Vertex Advisory Client #46,Sales Receipt,PS-GL,0.0,12368.42,SGD,SWIFT MT103,Vertex Advisory Client #46,***8398,INV-202401-PS-GL-0001,,False,False,REF-994106,First Continental Bank,***8226,Globex APAC Logistics Pte. Ltd.,SG,7552951.38
2024-01-30,2024-01-30,Merchant Processing Fees,Bank/Merchant Fees,ALL,2277.54,0.0,SGD,MEPS+,First Continental Bank,***2023,,,False,False,REF-594806,First Continental Bank,***6248,Globex APAC Logistics Pte. Ltd.,SG,7550673.84
2024-01-30,2024-01-30,Marketing - Beacon Digital #8,Marketing,ALL,8986.47,0.0,SGD,MEPS+,Beacon Digital #8,***7870,,,False,False,REF-810346,First Continental Bank,***2286,Globex APAC Logistics Pte. Ltd.,SG,7541687.37
2024-01-30,2024-01-30,Interest Earned,Interest Income,ALL,0.0,9947.84,SGD,FAST Credit,First Continental Bank,***2547,,,False,False,REF-711200,First Continental Bank,***2666,Globex APAC Logistics Pte. Ltd.,SG,7551635.21
2024-01-31,2024-01-31,Supplier Payment - Port Services #3,Supplier Payment,Logistics-APAC,1635.78,0.0,SGD,SWIFT MT103,Port Services #3,***5012,,PO-202401-Logistics-APAC-0006,False,False,REF-988432,First Continental Bank,***6031,Globex APAC Logistics Pte. Ltd.,SG,7549999.43
2024-01-31,2024-01-31,Supplier Payment - ExpertNet Subcontractors #16,Supplier Payment,PS-GL,2701.21,0.0,SGD,FAST Debit,ExpertNet Subcontractors #16,***5529,,PO-202401-PS-GL-0002,False,False,REF-876189,First Continental Bank,***3850,Globex APAC Logistics Pte. Ltd.,SG,7547298.22
2024-01-31,2024-01-31,Client Receipt - CloudBridge Co. #6,Sales Receipt,SaaS-GL,0.0,3920.08,SGD,SWIFT MT103,CloudBridge Co. #6,***1048,INV-202401-SaaS-GL-0004,,False,False,REF-843538,First Continental Bank,***6749,Globex APAC Logistics Pte. Ltd.,SG,7551218.3
2024-02-01,2024-02-01,Account Maintenance Fee,Bank/Merchant Fees,ALL,2500.0,0.0,SGD,MEPS+,First Continental Bank,***6535,,,False,False,REF-431502,First Continental Bank,***4480,Globex APAC Logistics Pte. Ltd.,SG,7548718.3
2024-02-01,2024-02-01,Supplier Payment - HyperCloud Infra #2,Supplier Payment,SaaS-GL,8887.13,0.0,SGD,MEPS+,HyperCloud Infra #2,***4695,,PO-202402-SaaS-GL-0007,False,False,REF-291442,First Continental Bank,***7282,Globex APAC Logistics Pte. Ltd.,SG,7539831.17
2024-02-01,2024-02-01,Client Receipt - Pacific Trade Co. #68,Sales Receipt,Logistics-APAC,0.0,740.32,SGD,FAST Credit,Pacific Trade Co. #68,***7509,INV-202402-Logistics-APAC-0004,,False,False,REF-297519,First Continental Bank,***6034,Globex APAC Logistics Pte. Ltd.,SG,7540571.49
2024-02-01,2024-02-01,Client Receipt - Vertex Advisory Client #20,Sales Receipt,PS-GL,0.0,1789.1,SGD,SWIFT MT103,Vertex Advisory Client #20,***8729,INV-202402-PS-GL-0009,,False,False,REF-124659,First Continental Bank,***2352,Globex APAC Logistics Pte. Ltd.,SG,7542360.59
2024-02-01,2024-02-01,Client Receipt - CloudBridge Co. #27,Sales Receipt,SaaS-GL,0.0,9887.37,SGD,SWIFT MT103,CloudBridge Co. #27,***2240,INV-202402-SaaS-GL-0012,,False,False,REF-959569,First Continental Bank,***6428,Globex APAC Logistics Pte. Ltd.,SG,7552247.96
2024-02-01,2024-02-01,Client Receipt - Pacific Trade Co. #40,Sales Receipt,Logistics-APAC,0.0,11200.43,SGD,SWIFT MT103,Pacific Trade Co. #40,***1695,INV-202402-Logistics-APAC-0007,,False,False,REF-875100,First Continental Bank,***2829,Globex APAC Logistics Pte. Ltd.,SG,7563448.39
2024-02-01,2024-02-01,Client Receipt - Pacific Trade Co. #9,Sales Receipt,Logistics-APAC,0.0,47531.11,SGD,SWIFT MT103,Pacific Trade Co. #9,***9643,INV-202402-Logistics-APAC-0012,,False,False,REF-189657,First Continental Bank,***1099,Globex APAC Logistics Pte. Ltd.,SG,7610979.5
2024-02-02,2024-02-02,Client Receipt - Pacific Trade Co. #34,Sales Receipt,Logistics-APAC,0.0,9197.37,SGD,SWIFT MT103,Pacific Trade Co. #34,***3138,INV-202402-Logistics-APAC-0009,,False,False,REF-127909,First Continental Bank,***1960,Globex APAC Logistics Pte. Ltd.,SG,7620176.87
2024-02-02,2024-02-02,Client Receipt - CloudBridge Co. #41,Sales Receipt,SaaS-GL,0.0,18574.55,SGD,SWIFT MT103,CloudBridge Co. #41,***2162,INV-202402-SaaS-GL-0011,,False,False,REF-252251,First Continental Bank,***3426,Globex APAC Logistics Pte. Ltd.,SG,7638751.42
2024-02-03,2024-02-03,Client Receipt - Pacific Trade Co. #63,Sales Receipt,Logistics-APAC,0.0,31606.76,SGD,FAST Credit,Pacific Trade Co. #63,***1645,INV-202402-Logistics-APAC-0003,,False,False,REF-966445,First Continental Bank,***7085,Globex APAC Logistics Pte. Ltd.,SG,7670358.18
2024-02-04,2024-02-04,Supplier Payment - ExpertNet Subcontractors #19,Supplier Payment,PS-GL,327.24,0.0,SGD,MEPS+,ExpertNet Subcontractors #19,***6769,,PO-202402-PS-GL-0004,False,False,REF-696403,First Continental Bank,***2800,Globex APAC Logistics Pte. Ltd.,SG,7670030.94
2024-02-04,2024-02-04,Supplier Payment - CodeCraft Contractors #11,Supplier Payment,SaaS-GL,6621.98,0.0,SGD,MEPS+,CodeCraft Contractors #11,***5596,,PO-202402-SaaS-GL-0009,False,False,REF-966237,First Continental Bank,***9135,Globex APAC Logistics Pte. Ltd.,SG,7663408.96
2024-02-04,2024-02-04,Supplier Payment - ExpertNet Subcontractors #6,Supplier Payment,PS-GL,15949.86,0.0,SGD,MEPS+,ExpertNet Subcontractors #6,***5742,,PO-202402-PS-GL-0011,False,False,REF-259767,First Continental Bank,***5080,Globex APAC Logistics Pte. Ltd.,SG,7647459.1
2024-02-04,2024-02-04,Supplier Payment - TransAsia Freight #28,Supplier Payment,Logistics-APAC,19615.14,0.0,SGD,SWIFT MT103,TransAsia Freight #28,***1138,,PO-202402-Logistics-APAC-0003,False,False,REF-310780,First Continental Bank,***6582,Globex APAC Logistics Pte. Ltd.,SG,7627843.96
2024-02-05,2024-02-05,Client Receipt - CloudBridge Co. #69,Sales Receipt,SaaS-GL,0.0,713.78,SGD,SWIFT MT103,CloudBridge Co. #69,***5707,INV-202402-SaaS-GL-0005,,False,False,REF-848591,First Continental Bank,***1414,Globex APAC Logistics Pte. Ltd.,SG,7628557.74
2024-02-05,2024-02-05,Client Receipt - Vertex Advisory Client #6,Sales Receipt,PS-GL,0.0,24471.98,SGD,FAST Credit,Vertex Advisory Client #6,***4603,INV-202402-PS-GL-0008,,False,False,REF-182009,First Continental Bank,***5818,Globex APAC Logistics Pte. Ltd.,SG,7653029.72
2024-02-05,2024-02-05,Client Receipt - Vertex Advisory Client #19,Sales Receipt,PS-GL,0.0,30833.01,SGD,SWIFT MT103,Vertex Advisory Client #19,***7836,INV-202402-PS-GL-0001,,False,False,REF-404520,First Continental Bank,***7327,Globex APAC Logistics Pte. Ltd.,SG,7683862.73
2024-02-06,2024-02-06,Supplier Payment - ExpertNet Subcontractors #1,Supplier Payment,PS-GL,9071.17,0.0,SGD,SWIFT MT103,ExpertNet Subcontractors #1,***6980,,PO-202402-PS-GL-0008,False,False,REF-759219,First Continental Bank,***4340,Globex APAC Logistics Pte. Ltd.,SG,7674791.56
2024-02-06,2024-02-06,Supplier Payment - TransAsia Freight #35,Supplier Payment,Logistics-APAC,51909.96,0.0,SGD,SWIFT MT103,TransAsia Freight #35,***9430,,PO-202402-Logistics-APAC-0006,False,False,REF-250187,First Continental Bank,***5314,Globex APAC Logistics Pte. Ltd.,SG,7622881.6
2024-02-06,2024-02-06,Client Receipt - CloudBridge Co. #67,Sales Receipt,SaaS-GL,0.0,1032.25,SGD,FAST Credit,CloudBridge Co. #67,***2983,INV-202402-SaaS-GL-0019,,False,False,REF-728947,First Continental Bank,***7862,Globex APAC Logistics Pte. Ltd.,SG,7623913.85
2024-02-06,2024-02-06,Client Receipt - CloudBridge Co. #14,Sales Receipt,SaaS-GL,0.0,6869.75,SGD,FAST Credit,CloudBridge Co. #14,***7700,INV-202402-SaaS-GL-0021,,False,False,REF-933308,First Continental Bank,***1645,Globex APAC Logistics Pte. Ltd.,SG,7630783.6
2024-02-06,2024-02-06,Client Receipt - CloudBridge Co. #3,Sales Receipt,SaaS-GL,0.0,17842.18,SGD,SWIFT MT103,CloudBridge Co. #3,***4305,INV-202402-SaaS-GL-0026,,False,False,REF-829631,First Continental Bank,***9372,Globex APAC Logistics Pte. Ltd.,SG,7648625.78
2024-02-07,2024-02-07,Supplier Payment - TransAsia Freight #19,Supplier Payment,Logistics-APAC,1737.77,0.0,SGD,SWIFT MT103,TransAsia Freight #19,***5625,,PO-202402-Logistics-APAC-0004,False,False,REF-876571,First Continental Bank,***2954,Globex APAC Logistics Pte. Ltd.,SG,7646888.01
2024-02-07,2024-02-07,Client Receipt - CloudBridge Co. #37,Sales Receipt,SaaS-GL,0.0,22798.43,SGD,FAST Credit,CloudBridge Co. #37,***9482,INV-202402-SaaS-GL-0024,,False,False,REF-595237,First Continental Bank,***2492,Globex APAC Logistics Pte. Ltd.,SG,7669686.44
2024-02-07,2024-02-07,Client Receipt - Vertex Advisory Client #57,Sales Receipt,PS-GL,0.0,35254.65,SGD,FAST Credit,Vertex Advisory Client #57,***1475,INV-202402-PS-GL-0002,,False,False,REF-491273,First Continental Bank,***5401,Globex APAC Logistics Pte. Ltd.,SG,7704941.09
2024-02-07,2024-02-07,Client Receipt - Vertex Advisory Client #7,Sales Receipt,PS-GL,0.0,79394.48,SGD,SWIFT MT103,Vertex Advisory Client #7,***2313,INV-202402-PS-GL-0005,,False,False,REF-319430,First Continental Bank,***6078,Globex APAC Logistics Pte. Ltd.,SG,7784335.57
2024-02-08,2024-02-08,Supplier Payment - CodeCraft Contractors #6,Supplier Payment,SaaS-GL,7974.9,0.0,SGD,SWIFT MT103,CodeCraft Contractors #6,***3607,,PO-202402-SaaS-GL-0008,False,False,REF-272354,First Continental Bank,***2944,Globex APAC Logistics Pte. Ltd.,SG,7776360.67
2024-02-08,2024-02-08,Client Receipt - Pacific Trade Co. #14,Sales Receipt,Logistics-APAC,0.0,10517.35,SGD,SWIFT MT103,Pacific Trade Co. #14,***4860,INV-202402-Logistics-APAC-0002,,False,False,REF-536215,First Continental Bank,***4660,Globex APAC Logistics Pte. Ltd.,SG,7786878.02
2024-02-08,2024-02-08,Client Receipt - CloudBridge Co. #20,Sales Receipt,SaaS-GL,0.0,10922.89,SGD,SWIFT MT103,CloudBridge Co. #20,***5758,INV-202402-SaaS-GL-0010,,False,False,REF-955385,First Continental Bank,***9836,Globex APAC Logistics Pte. Ltd.,SG,7797800.91
2024-02-09,2024-02-09,Supplier Payment - ExpertNet Subcontractors #5,Supplier Payment,PS-GL,3466.05,0.0,SGD,FAST Debit,ExpertNet Subcontractors #5,***1827,,PO-202402-PS-GL-0010,False,False,REF-745582,First Continental Bank,***1923,Globex APAC Logistics Pte. Ltd.,SG,7794334.86
2024-02-09,2024-02-09,Client Receipt - CloudBridge Co. #61,Sales Receipt,SaaS-GL,0.0,18752.76,SGD,SWIFT MT103,CloudBridge Co. #61,***6118,INV-202402-SaaS-GL-0018,,False,False,REF-371174,First Continental Bank,***1799,Globex APAC Logistics Pte. Ltd.,SG,7813087.62
2024-02-09,2024-02-09,Client Receipt - Pacific Trade Co. #19,Sales Receipt,Logistics-APAC,0.0,41877.72,SGD,FAST Credit,Pacific Trade Co. #19,***9851,INV-202402-Logistics-APAC-0006,,False,False,REF-689289,First Continental Bank,***5862,Globex APAC Logistics Pte. Ltd.,SG,7854965.34
2024-02-10,2024-02-10,Supplier Payment - HyperCloud Infra #3,Supplier Payment,SaaS-GL,11141.77,0.0,SGD,SWIFT MT103,HyperCloud Infra #3,***7337,,PO-202402-SaaS-GL-0010,False,False,REF-272322,First Continental Bank,***6810,Globex APAC Logistics Pte. Ltd.,SG,7843823.57
2024-02-11,2024-02-11,Supplier Payment - Port Services #2,Supplier Payment,Logistics-APAC,23781.99,0.0,SGD,MEPS+,Port Services #2,***7429,,PO-202402-Logistics-APAC-0008,False,False,REF-157541,First Continental Bank,***6285,Globex APAC Logistics Pte. Ltd.,SG,7820041.58
2024-02-12,2024-02-12,Supplier Payment - CodeCraft Contractors #13,Supplier Payment,SaaS-GL,1928.53,0.0,SGD,SWIFT MT103,CodeCraft Contractors #13,***3409,,PO-202402-SaaS-GL-0002,False,False,REF-393953,First Continental Bank,***1446,Globex APAC Logistics Pte. Ltd.,SG,7818113.05
2024-02-12,2024-02-12,Intercompany Settlement - Globex EMEA Manufacturing Ltd.,Intercompany Transfer,ALL,332837.0,0.0,SGD,Internal Transfer,Globex EMEA Manufacturing Ltd.,***2029,,,True,True,REF-654244,First Continental Bank,***8149,Globex APAC Logistics Pte. Ltd.,SG,7485276.05
2024-02-13,2024-02-13,Client Receipt - Vertex Advisory Client #55,Sales Receipt,PS-GL,0.0,4584.56,SGD,FAST Credit,Vertex Advisory Client #55,***8039,INV-202402-PS-GL-0006,,False,False,REF-358177,First Continental Bank,***6875,Globex APAC Logistics Pte. Ltd.,SG,7489860.61
2024-02-13,2024-02-13,Client Receipt - CloudBridge Co. #61,Sales Receipt,SaaS-GL,0.0,5797.87,SGD,SWIFT MT103,CloudBridge Co. #61,***4222,INV-202402-SaaS-GL-0020,,False,False,REF-413752,First Continental Bank,***4048,Globex APAC Logistics Pte. Ltd.,SG,7495658.48
2024-02-13,2024-02-13,Client Receipt - Pacific Trade Co. #48,Sales Receipt,Logistics-APAC,0.0,22537.81,SGD,SWIFT MT103,Pacific Trade Co. #48,***4401,INV-202402-Logistics-APAC-0008,,False,False,REF-366624,First Continental Bank,***1890,Globex APAC Logistics Pte. Ltd.,SG,7518196.29
2024-02-13,2024-02-13,Client Receipt - Pacific Trade Co. #33,Sales Receipt,Logistics-APAC,0.0,84219.92,SGD,SWIFT MT103,Pacific Trade Co. #33,***6860,INV-202402-Logistics-APAC-0015,,False,False,REF-160057,First Continental Bank,***1525,Globex APAC Logistics Pte. Ltd.,SG,7602416.21
2024-02-14,2024-02-14,Merchant Processing Fees,Bank/Merchant Fees,ALL,2190.6,0.0,SGD,MEPS+,First Continental Bank,***1175,,,False,False,REF-853908,First Continental Bank,***4954,Globex APAC Logistics Pte. Ltd.,SG,7600225.61
2024-02-14,2024-02-14,Client Receipt - CloudBridge Co. #38,Sales Receipt,SaaS-GL,0.0,2163.96,SGD,SWIFT MT103,CloudBridge Co. #38,***3803,INV-202402-SaaS-GL-0008,,False,False,REF-403891,First Continental Bank,***6812,Globex APAC Logistics Pte. Ltd.,SG,7602389.57
2024-02-14,2024-02-14,Client Receipt - Vertex Advisory Client #15,Sales Receipt,PS-GL,0.0,16280.97,SGD,SWIFT MT103,Vertex Advisory Client #15,***9799,INV-202402-PS-GL-0007,,False,False,REF-262895,First Continental Bank,***9363,Globex APAC Logistics Pte. Ltd.,SG,7618670.54
2024-02-15,2024-02-15,Supplier Payment - ExpertNet Subcontractors #11,Supplier Payment,PS-GL,425.95,0.0,SGD,SWIFT MT103,ExpertNet Subcontractors #11,***7672,,PO-202402-PS-GL-0009,False,False,REF-232310,First Continental Bank,***5991,Globex APAC Logistics Pte. Ltd.,SG,7618244.59
2024-02-15,2024-02-15,Supplier Payment - HyperCloud Infra #12,Supplier Payment,SaaS-GL,7352.94,0.0,SGD,MEPS+,HyperCloud Infra #12,***4824,,PO-202402-SaaS-GL-0004,False,False,REF-544602,First Continental Bank,***9716,Globex APAC Logistics Pte. Ltd.,SG,7610891.65
2024-02-15,2024-02-15,Supplier Payment - ExpertNet Subcontractors #16,Supplier Payment,PS-GL,9379.94,0.0,SGD,FAST Debit,ExpertNet Subcontractors #16,***6094,,PO-202402-PS-GL-0003,False,False,REF-963499,First Continental Bank,***7814,Globex APAC Logistics Pte. Ltd.,SG,7601511.71
2024-02-15,2024-02-15,Supplier Payment - CodeCraft Contractors #2,Supplier Payment,SaaS-GL,11398.04,0.0,SGD,SWIFT MT103,CodeCraft Contractors #2,***8457,,PO-202402-SaaS-GL-0001,False,False,REF-161931,First Continental Bank,***5956,Globex APAC Logistics Pte. Ltd.,SG,7590113.67
2024-02-15,2024-02-15,Supplier Payment - Port Services #16,Supplier Payment,Logistics-APAC,25157.17,0.0,SGD,FAST Debit,Port Services #16,***7498,,PO-202402-Logistics-APAC-0007,False,False,REF-101500,First Continental Bank,***4024,Globex APAC Logistics Pte. Ltd.,SG,7564956.5
2024-02-15,2024-02-15,Client Receipt - CloudBridge Co. #2,Sales Receipt,SaaS-GL,0.0,22590.84,SGD,FAST Credit,CloudBridge Co. #2,***5574,INV-202402-SaaS-GL-0003,,False,False,REF-736504,First Continental Bank,***8143,Globex APAC Logistics Pte. Ltd.,SG,7587547.34
2024-02-15,2024-02-15,Client Receipt - Vertex Advisory Client #44,Sales Receipt,PS-GL,0.0,43048.51,SGD,SWIFT MT103,Vertex Advisory Client #44,***8253,INV-202402-PS-GL-0004,,False,False,REF-274366,First Continental Bank,***1840,Globex APAC Logistics Pte. Ltd.,SG,7630595.85
2024-02-16,2024-02-16,Supplier Payment - ExpertNet Subcontractors #15,Supplier Payment,PS-GL,325.69,0.0,SGD,FAST Debit,ExpertNet Subcontractors #15,***1059,,PO-202402-PS-GL-0007,False,False,REF-947106,First Continental Bank,***7997,Globex APAC Logistics Pte. Ltd.,SG,7630270.16
2024-02-16,2024-02-16,Client Receipt - CloudBridge Co. #71,Sales Receipt,SaaS-GL,0.0,7810.22,SGD,FAST Credit,CloudBridge Co. #71,***7676,INV-202402-SaaS-GL-0007,,False,False,REF-708747,First Continental Bank,***5481,Globex APAC Logistics Pte. Ltd.,SG,7638080.38
2024-02-17,2024-02-17,Marketing - Aurelia Media #7,Marketing,ALL,15949.91,0.0,SGD,SWIFT MT103,Aurelia Media #7,***9092,,,False,False,REF-138014,First Continental Bank,***6837,Globex APAC Logistics Pte. Ltd.,SG,7622130.47
2024-02-18,2024-02-18,Client Receipt - CloudBridge Co. #23,Sales Receipt,SaaS-GL,0.0,7261.43,SGD,SWIFT MT103,CloudBridge Co. #23,***7357,INV-202402-SaaS-GL-0017,,False,False,REF-593806,First Continental Bank,***5036,Globex APAC Logistics Pte. Ltd.,SG,7629391.9
2024-02-18,2024-02-18,Client Receipt - Pacific Trade Co. #35,Sales Receipt,Logistics-APAC,0.0,65769.8,SGD,SWIFT MT103,Pacific Trade Co. #35,***1906,INV-202402-Logistics-APAC-0016,,False,False,REF-931983,First Continental Bank,***8282,Globex APAC Logistics Pte. Ltd.,SG,7695161.7
2024-02-19,2024-02-19,Client Receipt - CloudBridge Co. #53,Sales Receipt,SaaS-GL,0.0,2880.61,SGD,FAST Credit,CloudBridge Co. #53,***6631,INV-202402-SaaS-GL-0006,,False,False,REF-618635,First Continental Bank,***3916,Globex APAC Logistics Pte. Ltd.,SG,7698042.31
2024-02-19,2024-02-19,Client Receipt - Pacific Trade Co. #18,Sales Receipt,Logistics-APAC,0.0,11444.2,SGD,SWIFT MT103,Pacific Trade Co. #18,***3308,INV-202402-Logistics-APAC-0014,,False,False,REF-119329,First Continental Bank,***7926,Globex APAC Logistics Pte. Ltd.,SG,7709486.51
2024-02-20,2024-02-20,Merchant Processing Fees,Bank/Merchant Fees,ALL,939.66,0.0,SGD,FAST Debit,First Continental Bank,***3932,,,False,False,REF-354439,First Continental Bank,***4020,Globex APAC Logistics Pte. Ltd.,SG,7708546.85
2024-02-20,2024-02-20,Supplier Payment - ExpertNet Subcontractors #14,Supplier Payment,PS-GL,10922.51,0.0,SGD,SWIFT MT103,ExpertNet Subcontractors #14,***4137,,PO-202402-PS-GL-0006,False,False,REF-634933,First Continental Bank,***9446,Globex APAC Logistics Pte. Ltd.,SG,7697624.34
2024-02-20,2024-02-20,Supplier Payment - ExpertNet Subcontractors #19,Supplier Payment,PS-GL,17172.16,0.0,SGD,FAST Debit,ExpertNet Subcontractors #19,***1127,,PO-202402-PS-GL-0005,False,False,REF-128518,First Continental Bank,***5354,Globex APAC Logistics Pte. Ltd.,SG,7680452.18
2024-02-20,2024-02-20,Supplier Payment - TransAsia Freight #39,Supplier Payment,Logistics-APAC,37215.81,0.0,SGD,SWIFT MT103,TransAsia Freight #39,***8343,,PO-202402-Logistics-APAC-0005,False,False,REF-605266,First Continental Bank,***9571,Globex APAC Logistics Pte. Ltd.,SG,7643236.37
2024-02-20,2024-02-20,Client Receipt - Pacific Trade Co. #5,Sales Receipt,Logistics-APAC,0.0,61745.9,SGD,SWIFT MT103,Pacific Trade Co. #5,***2816,INV-202402-Logistics-APAC-0001,,False,False,REF-867441,First Continental Bank,***2288,Globex APAC Logistics Pte. Ltd.,SG,7704982.27
2024-02-20,2024-02-20,Client Receipt - CloudBridge Co. #58,Sales Receipt,SaaS-GL,0.0,64857.85,SGD,FAST Credit,CloudBridge Co. #58,***5666,INV-202402-SaaS-GL-0016,,False,False,REF-312912,First Continental Bank,***9258,Globex APAC Logistics Pte. Ltd.,SG,7769840.12
2024-02-21,2024-02-21,VAT/GST Remittance - IRAS Singapore,Tax Payment,ALL,61865.96,0.0,SGD,FAST Debit,IRAS Singapore,***3929,,,False,False,REF-362656,First Continental Bank,***9735,Globex APAC Logistics Pte. Ltd.,SG,7707974.16
2024-02-21,2024-02-21,Client Receipt - Pacific Trade Co. #43,Sales Receipt,Logistics-APAC,0.0,370.02,SGD,SWIFT MT103,Pacific Trade Co. #43,***5120,INV-202402-Logistics-APAC-0010,,False,False,REF-187295,First Continental Bank,***1682,Globex APAC Logistics Pte. Ltd.,SG,7708344.18
2024-02-21,2024-02-21,Client Receipt - CloudBridge Co. #48,Sales Receipt,SaaS-GL,0.0,7354.06,SGD,SWIFT MT103,CloudBridge Co. #48,***8566,INV-202402-SaaS-GL-0025,,False,False,REF-122567,First Continental Bank,***7202,Globex APAC Logistics Pte. Ltd.,SG,7715698.24
2024-02-21,2024-02-21,Client Receipt - Vertex Advisory Client #7,Sales Receipt,PS-GL,0.0,13047.26,SGD,SWIFT MT103,Vertex Advisory Client #7,***3970,INV-202402-PS-GL-0003,,False,False,REF-797634,First Continental Bank,***3373,Globex APAC Logistics Pte. Ltd.,SG,7728745.5
2024-02-21,2024-02-21,Client Receipt - CloudBridge Co. #1,Sales Receipt,SaaS-GL,0.0,26985.52,SGD,SWIFT MT103,CloudBridge Co. #1,***5686,INV-202402-SaaS-GL-0001,,False,False,REF-433764,First Continental Bank,***7567,Globex APAC Logistics Pte. Ltd.,SG,7755731.02
2024-02-22,2024-02-22,Metro Water & Waste,Rent & Utilities,ALL,8188.62,0.0,SGD,SWIFT MT103,Metro Water & Waste,***3461,,,False,False,REF-642366,First Continental Bank,***8576,Globex APAC Logistics Pte. Ltd.,SG,7747542.4
2024-02-23,2024-02-23,Supplier Payment - ExpertNet Subcontractors #10,Supplier Payment,PS-GL,2440.66,0.0,SGD,MEPS+,ExpertNet Subcontractors #10,***2298,,PO-202402-PS-GL-0012,False,False,REF-289889,First Continental Bank,***1465,Globex APAC Logistics Pte. Ltd.,SG,7745101.74
2024-02-23,2024-02-23,Client Receipt - CloudBridge Co. #62,Sales Receipt,SaaS-GL,0.0,6798.99,SGD,FAST Credit,CloudBridge Co. #62,***1933,INV-202402-SaaS-GL-0014,,False,False,REF-349701,First Continental Bank,***5799,Globex APAC Logistics Pte. Ltd.,SG,7751900.73
2024-02-24,2024-02-24,Client Receipt - CloudBridge Co. #29,Sales Receipt,SaaS-GL,0.0,16759.53,SGD,FAST Credit,CloudBridge Co. #29,***2890,INV-202402-SaaS-GL-0028,,False,False,REF-975679,First Continental Bank,***1332,Globex APAC Logistics Pte. Ltd.,SG,7768660.26
2024-02-25,2024-02-25,Client Receipt - Vertex Advisory Client #51,Sales Receipt,PS-GL,0.0,75.97,SGD,FAST Credit,Vertex Advisory Client #51,***2513,INV-202402-PS-GL-0010,,False,False,REF-200560,First Continental Bank,***9285,Globex APAC Logistics Pte. Ltd.,SG,7768736.23
2024-02-26,2024-02-26,Supplier Payment - HyperCloud Infra #4,Supplier Payment,SaaS-GL,10629.63,0.0,SGD,SWIFT MT103,HyperCloud Infra #4,***2461,,PO-202402-SaaS-GL-0005,False,False,REF-763740,First Continental Bank,***6214,Globex APAC Logistics Pte. Ltd.,SG,7758106.6
2024-02-26,2024-02-26,Payroll - GlobalPay Services Ltd,Payroll,ALL,167015.74,0.0,SGD,FAST Debit,GlobalPay Services Ltd,***4575,,,False,False,REF-275633,First Continental Bank,***4174,Globex APAC Logistics Pte. Ltd.,SG,7591090.86
2024-02-26,2024-02-26,Intercompany Settlement - Globex Retail NA LLC,Intercompany Transfer,ALL,562386.0,0.0,SGD,Internal Transfer,Globex Retail NA LLC,***2262,,,True,True,REF-856249,First Continental Bank,***4440,Globex APAC Logistics Pte. Ltd.,SG,7028704.86
2024-02-26,2024-02-26,Client Receipt - Pacific Trade Co. #42,Sales Receipt,Logistics-APAC,0.0,10435.37,SGD,SWIFT MT103,Pacific Trade Co. #42,***4102,INV-202402-Logistics-APAC-0011,,False,False,REF-314367,First Continental Bank,***7385,Globex APAC Logistics Pte. Ltd.,SG,7039140.23
2024-02-26,2024-02-26,Client Receipt - CloudBridge Co. #77,Sales Receipt,SaaS-GL,0.0,20334.73,SGD,FAST Credit,CloudBridge Co. #77,***1684,INV-202402-SaaS-GL-0022,,False,False,REF-376394,First Continental Bank,***2559,Globex APAC Logistics Pte. Ltd.,SG,7059474.96
2024-02-26,2024-02-26,Client Receipt - CloudBridge Co. #47,Sales Receipt,SaaS-GL,0.0,21803.31,SGD,SWIFT MT103,CloudBridge Co. #47,***4449,INV-202402-SaaS-GL-0013,,False,False,REF-240813,First Continental Bank,***3036,Globex APAC Logistics Pte. Ltd.,SG,7081278.27
2024-02-27,2024-02-27,Supplier Payment - ExpertNet Subcontractors #8,Supplier Payment,PS-GL,4399.29,0.0,SGD,MEPS+,ExpertNet Subcontractors #8,***1254,,PO-202402-PS-GL-0002,False,False,REF-300701,First Continental Bank,***1922,Globex APAC Logistics Pte. Ltd.,SG,7076878.98
2024-02-27,2024-02-27,Supplier Payment - HyperCloud Infra #11,Supplier Payment,SaaS-GL,5420.71,0.0,SGD,MEPS+,HyperCloud Infra #11,***1784,,PO-202402-SaaS-GL-0003,False,False,REF-242938,First Continental Bank,***7700,Globex APAC Logistics Pte. Ltd.,SG,7071458.27
2024-02-27,2024-02-27,Client Receipt - Pacific Trade Co. #10,Sales Receipt,Logistics-APAC,0.0,1557.21,SGD,FAST Credit,Pacific Trade Co. #10,***5128,INV-202402-Logistics-APAC-0013,,False,False,REF-586844,First Continental Bank,***9238,Globex APAC Logistics Pte. Ltd.,SG,7073015.48
2024-02-27,2024-02-27,Client Receipt - CloudBridge Co. #39,Sales Receipt,SaaS-GL,0.0,5957.06,SGD,FAST Credit,CloudBridge Co. #39,***1825,INV-202402-SaaS-GL-0023,,False,False,REF-594026,First Continental Bank,***8778,Globex APAC Logistics Pte. Ltd.,SG,7078972.54
2024-02-27,2024-02-27,Client Receipt - CloudBridge Co. #15,Sales Receipt,SaaS-GL,0.0,16937.01,SGD,SWIFT MT103,CloudBridge Co. #15,***8772,INV-202402-SaaS-GL-0002,,False,False,REF-757025,First Continental Bank,***4685,Globex APAC Logistics Pte. Ltd.,SG,7095909.55
2024-02-28,2024-02-28,Supplier Payment - ExpertNet Subcontractors #1,Supplier Payment,PS-GL,753.63,0.0,SGD,FAST Debit,ExpertNet Subcontractors #1,***4473,,PO-202402-PS-GL-0001,False,False,REF-869234,First Continental Bank,***2290,Globex APAC Logistics Pte. Ltd.,SG,7095155.92
2024-02-28,2024-02-28,Marketing - Beacon Digital #9,Marketing,ALL,10350.23,0.0,SGD,SWIFT MT103,Beacon Digital #9,***5020,,,False,False,REF-365161,First Continental Bank,***4925,Globex APAC Logistics Pte. Ltd.,SG,7084805.69
2024-02-28,2024-02-28,Supplier Payment - HyperCloud Infra #9,Supplier Payment,SaaS-GL,10741.93,0.0,SGD,FAST Debit,HyperCloud Infra #9,***7026,,PO-202402-SaaS-GL-0006,False,False,REF-998214,First Continental Bank,***6626,Globex APAC Logistics Pte. Ltd.,SG,7074063.76
2024-02-28,2024-02-28,Supplier Payment - TransAsia Freight #3,Supplier Payment,Logistics-APAC,130332.66,0.0,SGD,FAST Debit,TransAsia Freight #3,***4129,,PO-202402-Logistics-APAC-0001,False,False,REF-945826,First Continental Bank,***4546,Globex APAC Logistics Pte. Ltd.,SG,6943731.1
2024-02-28,2024-02-28,Client Receipt - Pacific Trade Co. #41,Sales Receipt,Logistics-APAC,0.0,3882.86,SGD,FAST Credit,Pacific Trade Co. #41,***3835,INV-202402-Logistics-APAC-0005,,False,False,REF-709976,First Continental Bank,***8935,Globex APAC Logistics Pte. Ltd.,SG,6947613.96
2024-02-28,2024-02-28,Client Receipt - CloudBridge Co. #49,Sales Receipt,SaaS-GL,0.0,9338.49,SGD,FAST Credit,CloudBridge Co. #49,***6829,INV-202402-SaaS-GL-0015,,False,False,REF-869827,First Continental Bank,***6948,Globex APAC Logistics Pte. Ltd.,SG,6956952.45
2024-02-28,2024-02-28,Client Receipt - CloudBridge Co. #4,Sales Receipt,SaaS-GL,0.0,12596.49,SGD,FAST Credit,CloudBridge Co. #4,***4080,INV-202402-SaaS-GL-0009,,False,False,REF-437082,First Continental Bank,***3633,Globex APAC Logistics Pte. Ltd.,SG,6969548.94
2024-02-29,2024-02-29,Supplier Payment - TransAsia Freight #7,Supplier Payment,Logistics-APAC,493.4,0.0,SGD,SWIFT MT103,TransAsia Freight #7,***6628,,PO-202402-Logistics-APAC-0002,False,False,REF-613182,First Continental Bank,***4405,Globex APAC Logistics Pte. Ltd.,SG,6969055.54
2024-02-29,2024-02-29,Client Receipt - CloudBridge Co. #42,Sales Receipt,SaaS-GL,0.0,937.58,SGD,FAST Credit,CloudBridge Co. #42,***8432,INV-202402-SaaS-GL-0004,,False,False,REF-395296,First Continental Bank,***3775,Globex APAC Logistics Pte. Ltd.,SG,6969993.12
2024-02-29,2024-02-29,Client Receipt - CloudBridge Co. #60,Sales Receipt,SaaS-GL,0.0,6611.22,SGD,FAST Credit,CloudBridge Co. #60,***7949,INV-202402-SaaS-GL-0027,,False,False,REF-843504,First Continental Bank,***3698,Globex APAC Logistics Pte. Ltd.,SG,6976604.34
2024-02-29,2024-02-29,Interest Earned,Interest Income,ALL,0.0,12647.25,SGD,SWIFT MT103,First Continental Bank,***9058,,,False,False,REF-381383,First Continental Bank,***7764,Globex APAC Logistics Pte. Ltd.,SG,6989251.59
2024-03-01,2024-03-01,Account Maintenance Fee,Bank/Merchant Fees,ALL,2500.0,0.0,SGD,SWIFT MT103,First Continental Bank,***2853,,,False,False,REF-603010,First Continental Bank,***8929,Globex APAC Logistics Pte. Ltd.,SG,6986751.59
2024-03-01,2024-03-01,Supplier Payment - HyperCloud Infra #2,Supplier Payment,SaaS-GL,8679.67,0.0,SGD,FAST Debit,HyperCloud Infra #2,***7866,,PO-202403-SaaS-GL-0006,False,False,REF-956439,First Continental Bank,***9407,Globex APAC Logistics Pte. Ltd.,SG,6978071.92
2024-03-01,2024-03-01,Supplier Payment - TransAsia Freight #21,Supplier Payment,Logistics-APAC,49159.73,0.0,SGD,FAST Debit,TransAsia Freight #21,***7083,,PO-202403-Logistics-APAC-0010,False,False,REF-158867,First Continental Bank,***2900,Globex APAC Logistics Pte. Ltd.,SG,6928912.19
2024-03-04,2024-03-04,Supplier Payment - TransAsia Freight #28,Supplier Payment,Logistics-APAC,59272.99,0.0,SGD,SWIFT MT103,TransAsia Freight #28,***4093,,PO-202403-Logistics-APAC-0005,False,False,REF-877147,First Continental Bank,***2388,Globex APAC Logistics Pte. Ltd.,SG,6869639.2
2024-03-04,2024-03-04,Client Receipt - Vertex Advisory Client #13,Sales Receipt,PS-GL,0.0,199.12,SGD,SWIFT MT103,Vertex Advisory Client #13,***1474,INV-202403-PS-GL-0008,,False,False,REF-392578,First Continental Bank,***2158,Globex APAC Logistics Pte. Ltd.,SG,6869838.32
2024-03-04,2024-03-04,Client Receipt - Pacific Trade Co. #59,Sales Receipt,Logistics-APAC,0.0,32835.63,SGD,SWIFT MT103,Pacific Trade Co. #59,***1037,INV-202403-Logistics-APAC-0004,,False,False,REF-907347,First Continental Bank,***7838,Globex APAC Logistics Pte. Ltd.,SG,6902673.95
2024-03-04,2024-03-04,Client Receipt - Pacific Trade Co. #23,Sales Receipt,Logistics-APAC,0.0,40158.63,SGD,SWIFT MT103,Pacific Trade Co. #23,***5152,INV-202403-Logistics-APAC-0009,,False,False,REF-149755,First Continental Bank,***8920,Globex APAC Logistics Pte. Ltd.,SG,6942832.58
2024-03-05,2024-03-05,Supplier Payment - ExpertNet Subcontractors #9,Supplier Payment,PS-GL,11367.17,0.0,SGD,FAST Debit,ExpertNet Subcontractors #9,***7193,,PO-202403-PS-GL-0008,False,False,REF-873778,First Continental Bank,***6158,Globex APAC Logistics Pte. Ltd.,SG,6931465.41
2024-03-05,2024-03-05,Supplier Payment - TransAsia Freight #42,Supplier Payment,Logistics-APAC,17938.6,0.0,SGD,SWIFT MT103,TransAsia Freight #42,***7951,,PO-202403-Logistics-APAC-0007,False,False,REF-782763,First Continental Bank,***3524,Globex APAC Logistics Pte. Ltd.,SG,6913526.81
2024-03-05,2024-03-05,Supplier Payment - TransAsia Freight #18,Supplier Payment,Logistics-APAC,23196.69,0.0,SGD,SWIFT MT103,TransAsia Freight #18,***8595,,PO-202403-Logistics-APAC-0011,False,False,REF-549939,First Continental Bank,***4226,Globex APAC Logistics Pte. Ltd.,SG,6890330.12
2024-03-05,2024-03-05,Client Receipt - CloudBridge Co. #58,Sales Receipt,SaaS-GL,0.0,4077.17,SGD,FAST Credit,CloudBridge Co. #58,***7164,INV-202403-SaaS-GL-0014,,False,False,REF-337856,First Continental Bank,***8623,Globex APAC Logistics Pte. Ltd.,SG,6894407.29
2024-03-05,2024-03-05,Client Receipt - CloudBridge Co. #37,Sales Receipt,SaaS-GL,0.0,4176.57,SGD,FAST Credit,CloudBridge Co. #37,***5312,INV-202403-SaaS-GL-0007,,False,False,REF-247641,First Continental Bank,***2980,Globex APAC Logistics Pte. Ltd.,SG,6898583.86
2024-03-05,2024-03-05,Client Receipt - CloudBridge Co. #34,Sales Receipt,SaaS-GL,0.0,13261.86,SGD,SWIFT MT103,CloudBridge Co. #34,***6164,INV-202403-SaaS-GL-0022,,False,False,REF-755814,First Continental Bank,***4014,Globex APAC Logistics Pte. Ltd.,SG,6911845.72
2024-03-05,2024-03-05,Client Receipt - CloudBridge Co. #51,Sales Receipt,SaaS-GL,0.0,45562.16,SGD,SWIFT MT103,CloudBridge Co. #51,***1584,INV-202403-SaaS-GL-0024,,False,False,REF-410361,First Continental Bank,***8926,Globex APAC Logistics Pte. Ltd.,SG,6957407.88
2024-03-05,2024-03-05,Client Receipt - Pacific Trade Co. #20,Sales Receipt,Logistics-APAC,0.0,79652.7,SGD,SWIFT MT103,Pacific Trade Co. #20,***9137,INV-202403-Logistics-APAC-0005,,False,False,REF-599067,First Continental Bank,***2862,Globex APAC Logistics Pte. Ltd.,SG,7037060.58
2024-03-06,2024-03-06,Client Receipt - CloudBridge Co. #46,Sales Receipt,SaaS-GL,0.0,63968.19,SGD,FAST Credit,CloudBridge Co. #46,***9401,INV-202403-SaaS-GL-0015,,False,False,REF-986530,First Continental Bank,***3018,Globex APAC Logistics Pte. Ltd.,SG,7101028.77
2024-03-07,2024-03-07,Supplier Payment - CodeCraft Contractors #5,Supplier Payment,SaaS-GL,439.17,0.0,SGD,SWIFT MT103,CodeCraft Contractors #5,***3324,,PO-202403-SaaS-GL-0001,False,False,REF-913162,First Continental Bank,***1349,Globex APAC Logistics Pte. Ltd.,SG,7100589.6
2024-03-07,2024-03-07,Supplier Payment - HyperCloud Infra #14,Supplier Payment,SaaS-GL,3166.3,0.0,SGD,FAST Debit,HyperCloud Infra #14,***1565,,PO-202403-SaaS-GL-0007,False,False,REF-879489,First Continental Bank,***2235,Globex APAC Logistics Pte. Ltd.,SG,7097423.3
2024-03-07,2024-03-07,Supplier Payment - TransAsia Freight #5,Supplier Payment,Logistics-APAC,34844.67,0.0,SGD,SWIFT MT103,TransAsia Freight #5,***7922,,PO-202403-Logistics-APAC-0001,False,False,REF-211617,First Continental Bank,***5460,Globex APAC Logistics Pte. Ltd.,SG,7062578.63
2024-03-08,2024-03-08,Client Receipt - Vertex Advisory Client #3,Sales Receipt,PS-GL,0.0,21638.36,SGD,FAST Credit,Vertex Advisory Client #3,***7754,INV-202403-PS-GL-0003,,False,False,REF-778106,First Continental Bank,***2313,Globex APAC Logistics Pte. Ltd.,SG,7084216.99
2024-03-09,2024-03-09,Supplier Payment - ExpertNet Subcontractors #10,Supplier Payment,PS-GL,21211.69,0.0,SGD,SWIFT MT103,ExpertNet Subcontractors #10,***7846,,PO-202403-PS-GL-0006,False,False,REF-306931,First Continental Bank,***7023,Globex APAC Logistics Pte. Ltd.,SG,7063005.3
2024-03-09,2024-03-09,Client Receipt - CloudBridge Co. #26,Sales Receipt,SaaS-GL,0.0,846.74,SGD,FAST Credit,CloudBridge Co. #26,***9648,INV-202403-SaaS-GL-0005,,False,False,REF-123718,First Continental Bank,***6040,Globex APAC Logistics Pte. Ltd.,SG,7063852.04
2024-03-09,2024-03-09,Client Receipt - Vertex Advisory Client #20,Sales Receipt,PS-GL,0.0,10182.79,SGD,FAST Credit,Vertex Advisory Client #20,***5982,INV-202403-PS-GL-0004,,False,False,REF-981460,First Continental Bank,***6889,Globex APAC Logistics Pte. Ltd.,SG,7074034.83
2024-03-11,2024-03-11,Supplier Payment - ExpertNet Subcontractors #2,Supplier Payment,PS-GL,6286.31,0.0,SGD,MEPS+,ExpertNet Subcontractors #2,***3808,,PO-202403-PS-GL-0002,False,False,REF-670394,First Continental Bank,***4550,Globex APAC Logistics Pte. Ltd.,SG,7067748.52
2024-03-11,2024-03-11,Supplier Payment - Port Services #12,Supplier Payment,Logistics-APAC,11013.59,0.0,SGD,MEPS+,Port Services #12,***5012,,PO-202403-Logistics-APAC-0006,False,False,REF-661003,First Continental Bank,***4654,Globex APAC Logistics Pte. Ltd.,SG,7056734.93
2024-03-11,2024-03-11,Supplier Payment - HyperCloud Infra #10,Supplier Payment,SaaS-GL,24493.95,0.0,SGD,SWIFT MT103,HyperCloud Infra #10,***4446,,PO-202403-SaaS-GL-0005,False,False,REF-443667,First Continental Bank,***5932,Globex APAC Logistics Pte. Ltd.,SG,7032240.98
2024-03-11,2024-03-11,Client Receipt - Vertex Advisory Client #8,Sales Receipt,PS-GL,0.0,7674.25,SGD,FAST Credit,Vertex Advisory Client #8,***8168,INV-202403-PS-GL-0009,,False,False,REF-940182,First Continental Bank,***2366,Globex APAC Logistics Pte. Ltd.,SG,7039915.23
2024-03-11,2024-03-11,Client Receipt - Vertex Advisory Client #35,Sales Receipt,PS-GL,0.0,17175.47,SGD,FAST Credit,Vertex Advisory Client #35,***9715,INV-202403-PS-GL-0007,,False,False,REF-482743,First Continental Bank,***3189,Globex APAC Logistics Pte. Ltd.,SG,7057090.7
2024-03-12,2024-03-12,Supplier Payment - ExpertNet Subcontractors #4,Supplier Payment,PS-GL,9722.08,0.0,SGD,MEPS+,ExpertNet Subcontractors #4,***7517,,PO-202403-PS-GL-0003,False,False,REF-380983,First Continental Bank,***7556,Globex APAC Logistics Pte. Ltd.,SG,7047368.62
2024-03-12,2024-03-12,Intercompany Settlement - Globex Retail NA LLC,Intercompany Transfer,ALL,678137.0,0.0,SGD,Internal Transfer,Globex Retail NA LLC,***4597,,,True,True,REF-749478,First Continental Bank,***5347,Globex APAC Logistics Pte. Ltd.,SG,6369231.62
2024-03-12,2024-03-12,Client Receipt - CloudBridge Co. #68,Sales Receipt,SaaS-GL,0.0,762.8,SGD,SWIFT MT103,CloudBridge Co. #68,***4074,INV-202403-SaaS-GL-0010,,False,False,REF-940044,First Continental Bank,***8099,Globex APAC Logistics Pte. Ltd.,SG,6369994.42
2024-03-12,2024-03-12,Client Receipt - CloudBridge Co. #12,Sales Receipt,SaaS-GL,0.0,15279.4,SGD,FAST Credit,CloudBridge Co. #12,***8096,INV-202403-SaaS-GL-0019,,False,False,REF-756812,First Continental Bank,***7605,Globex APAC Logistics Pte. Ltd.,SG,6385273.82
2024-03-12,2024-03-12,Client Receipt - Vertex Advisory Client #10,Sales Receipt,PS-GL,0.0,72036.32,SGD,SWIFT MT103,Vertex Advisory Client #10,***2683,INV-202403-PS-GL-0006,,False,False,REF-420509,First Continental Bank,***1028,Globex APAC Logistics Pte. Ltd.,SG,6457310.14
2024-03-13,2024-03-13,Supplier Payment - HyperCloud Infra #10,Supplier Payment,SaaS-GL,4944.2,0.0,SGD,FAST Debit,HyperCloud Infra #10,***7376,,PO-202403-SaaS-GL-0004,False,False,REF-923237,First Continental Bank,***9433,Globex APAC Logistics Pte. Ltd.,SG,6452365.94
2024-03-13,2024-03-13,Marketing - Aurelia Media #10,Marketing,ALL,15355.47,0.0,SGD,MEPS+,Aurelia Media #10,***2975,,,False,False,REF-439976,First Continental Bank,***6823,Globex APAC Logistics Pte. Ltd.,SG,6437010.47
2024-03-13,2024-03-13,Client Receipt - CloudBridge Co. #71,Sales Receipt,SaaS-GL,0.0,1455.31,SGD,FAST Credit,CloudBridge Co. #71,***5649,INV-202403-SaaS-GL-0028,,False,False,REF-484137,First Continental Bank,***3593,Globex APAC Logistics Pte. Ltd.,SG,6438465.78
2024-03-13,2024-03-13,Client Receipt - Pacific Trade Co. #7,Sales Receipt,Logistics-APAC,0.0,20867.37,SGD,SWIFT MT103,Pacific Trade Co. #7,***5177,INV-202403-Logistics-APAC-0007,,False,False,REF-846096,First Continental Bank,***2147,Globex APAC Logistics Pte. Ltd.,SG,6459333.15
2024-03-13,2024-03-13,Client Receipt - CloudBridge Co. #78,Sales Receipt,SaaS-GL,0.0,42045.26,SGD,FAST Credit,CloudBridge Co. #78,***2615,INV-202403-SaaS-GL-0020,,False,False,REF-421068,First Continental Bank,***4605,Globex APAC Logistics Pte. Ltd.,SG,6501378.41
2024-03-13,2024-03-13,Client Receipt - Pacific Trade Co. #63,Sales Receipt,Logistics-APAC,0.0,114866.4,SGD,FAST Credit,Pacific Trade Co. #63,***9203,INV-202403-Logistics-APAC-0008,,False,False,REF-356121,First Continental Bank,***2398,Globex APAC Logistics Pte. Ltd.,SG,6616244.81
2024-03-14,2024-03-14,Client Receipt - CloudBridge Co. #10,Sales Receipt,SaaS-GL,0.0,2222.82,SGD,FAST Credit,CloudBridge Co. #10,***5230,INV-202403-SaaS-GL-0011,,False,False,REF-692014,First Continental Bank,***9622,Globex APAC Logistics Pte. Ltd.,SG,6618467.63
2024-03-14,2024-03-14,Client Receipt - Pacific Trade Co. #19,Sales Receipt,Logistics-APAC,0.0,106355.0,SGD,FAST Credit,Pacific Trade Co. #19,***9365,INV-202403-Logistics-APAC-0011,,False,False,REF-461355,First Continental Bank,***7526,Globex APAC Logistics Pte. Ltd.,SG,6724822.63
2024-03-15,2024-03-15,Merchant Processing Fees,Bank/Merchant Fees,ALL,2549.22,0.0,SGD,MEPS+,First Continental Bank,***6857,,,False,False,REF-472920,First Continental Bank,***2162,Globex APAC Logistics Pte. Ltd.,SG,6722273.41
2024-03-15,2024-03-15,Supplier Payment - ExpertNet Subcontractors #17,Supplier Payment,PS-GL,2686.34,0.0,SGD,MEPS+,ExpertNet Subcontractors #17,***1478,,PO-202403-PS-GL-0005,False,False,REF-921663,First Continental Bank,***1723,Globex APAC Logistics Pte. Ltd.,SG,6719587.07
2024-03-15,2024-03-15,Client Receipt - CloudBridge Co. #20,Sales Receipt,SaaS-GL,0.0,3482.94,SGD,SWIFT MT103,CloudBridge Co. #20,***4759,INV-202403-SaaS-GL-0021,,False,False,REF-833991,First Continental Bank,***9966,Globex APAC Logistics Pte. Ltd.,SG,6723070.01
2024-03-15,2024-03-15,Client Receipt - CloudBridge Co. #55,Sales Receipt,SaaS-GL,0.0,6026.4,SGD,FAST Credit,CloudBridge Co. #55,***4982,INV-202403-SaaS-GL-0018,,False,False,REF-953180,First Continental Bank,***8894,Globex APAC Logistics Pte. Ltd.,SG,6729096.41
2024-03-15,2024-03-15,Client Receipt - Vertex Advisory Client #52,Sales Receipt,PS-GL,0.0,15446.07,SGD,FAST Credit,Vertex Advisory Client #52,***8291,INV-202403-PS-GL-0001,,False,False,REF-872212,First Continental Bank,***8805,Globex APAC Logistics Pte. Ltd.,SG,6744542.48
2024-03-16,2024-03-16,Merchant Processing Fees,Bank/Merchant Fees,ALL,954.31,0.0,SGD,FAST Debit,First Continental Bank,***4684,,,False,False,REF-930179,First Continental Bank,***5082,Globex APAC Logistics Pte. Ltd.,SG,6743588.17
2024-03-16,2024-03-16,Supplier Payment - HyperCloud Infra #15,Supplier Payment,SaaS-GL,4412.36,0.0,SGD,MEPS+,HyperCloud Infra #15,***1399,,PO-202403-SaaS-GL-0003,False,False,REF-579104,First Continental Bank,***4972,Globex APAC Logistics Pte. Ltd.,SG,6739175.81
2024-03-16,2024-03-16,Client Receipt - CloudBridge Co. #3,Sales Receipt,SaaS-GL,0.0,3819.82,SGD,FAST Credit,CloudBridge Co. #3,***7060,INV-202403-SaaS-GL-0013,,False,False,REF-298417,First Continental Bank,***5670,Globex APAC Logistics Pte. Ltd.,SG,6742995.63
2024-03-18,2024-03-18,Supplier Payment - Port Services #5,Supplier Payment,Logistics-APAC,11092.29,0.0,SGD,FAST Debit,Port Services #5,***3601,,PO-202403-Logistics-APAC-0002,False,False,REF-549906,First Continental Bank,***4398,Globex APAC Logistics Pte. Ltd.,SG,6731903.34
2024-03-18,2024-03-18,Client Receipt - CloudBridge Co. #15,Sales Receipt,SaaS-GL,0.0,31243.61,SGD,FAST Credit,CloudBridge Co. #15,***8328,INV-202403-SaaS-GL-0003,,False,False,REF-555455,First Continental Bank,***5201,Globex APAC Logistics Pte. Ltd.,SG,6763146.95
2024-03-19,2024-03-19,Northshore Power,Rent & Utilities,ALL,6451.05,0.0,SGD,MEPS+,Northshore Power,***6556,,,False,False,REF-577167,First Continental Bank,***9650,Globex APAC Logistics Pte. Ltd.,SG,6756695.9
2024-03-19,2024-03-19,Client Receipt - CloudBridge Co. #16,Sales Receipt,SaaS-GL,0.0,6841.63,SGD,FAST Credit,CloudBridge Co. #16,***2504,INV-202403-SaaS-GL-0012,,False,False,REF-250143,First Continental Bank,***1484,Globex APAC Logistics Pte. Ltd.,SG,6763537.53
2024-03-19,2024-03-19,Client Receipt - CloudBridge Co. #25,Sales Receipt,SaaS-GL,0.0,16069.53,SGD,FAST Credit,CloudBridge Co. #25,***5681,INV-202403-SaaS-GL-0006,,False,False,REF-979432,First Continental Bank,***2622,Globex APAC Logistics Pte. Ltd.,SG,6779607.06
2024-03-19,2024-03-19,Client Receipt - Pacific Trade Co. #15,Sales Receipt,Logistics-APAC,0.0,27739.64,SGD,FAST Credit,Pacific Trade Co. #15,***4773,INV-202403-Logistics-APAC-0001,,False,False,REF-340566,First Continental Bank,***4602,Globex APAC Logistics Pte. Ltd.,SG,6807346.7
2024-03-20,2024-03-20,BluePeak Property Mgmt,Rent & Utilities,ALL,2651.05,0.0,SGD,SWIFT MT103,BluePeak Property Mgmt,***6314,,,False,False,REF-550036,First Continental Bank,***6852,Globex APAC Logistics Pte. Ltd.,SG,6804695.65
2024-03-20,2024-03-20,Client Receipt - CloudBridge Co. #46,Sales Receipt,SaaS-GL,0.0,642.68,SGD,SWIFT MT103,CloudBridge Co. #46,***6318,INV-202403-SaaS-GL-0001,,False,False,REF-341924,First Continental Bank,***7108,Globex APAC Logistics Pte. Ltd.,SG,6805338.33
2024-03-21,2024-03-21,Supplier Payment - ExpertNet Subcontractors #1,Supplier Payment,PS-GL,11067.79,0.0,SGD,FAST Debit,ExpertNet Subcontractors #1,***1746,,PO-202403-PS-GL-0007,False,False,REF-659296,First Continental Bank,***1729,Globex APAC Logistics Pte. Ltd.,SG,6794270.54
2024-03-21,2024-03-21,Supplier Payment - Port Services #17,Supplier Payment,Logistics-APAC,21564.53,0.0,SGD,SWIFT MT103,Port Services #17,***1904,,PO-202403-Logistics-APAC-0009,False,False,REF-289107,First Continental Bank,***6192,Globex APAC Logistics Pte. Ltd.,SG,6772706.01
2024-03-21,2024-03-21,Supplier Payment - TransAsia Freight #31,Supplier Payment,Logistics-APAC,26034.3,0.0,SGD,MEPS+,TransAsia Freight #31,***5870,,PO-202403-Logistics-APAC-0003,False,False,REF-861219,First Continental Bank,***1299,Globex APAC Logistics Pte. Ltd.,SG,6746671.71
2024-03-21,2024-03-21,VAT/GST Remittance - IRAS Singapore,Tax Payment,ALL,70702.25,0.0,SGD,FAST Debit,IRAS Singapore,***6006,,,False,False,REF-917487,First Continental Bank,***2747,Globex APAC Logistics Pte. Ltd.,SG,6675969.46
2024-03-21,2024-03-21,Client Receipt - CloudBridge Co. #25,Sales Receipt,SaaS-GL,0.0,1184.57,SGD,SWIFT MT103,CloudBridge Co. #25,***4869,INV-202403-SaaS-GL-0016,,False,False,REF-996040,First Continental Bank,***7891,Globex APAC Logistics Pte. Ltd.,SG,6677154.03
2024-03-21,2024-03-21,Client Receipt - Pacific Trade Co. #15,Sales Receipt,Logistics-APAC,0.0,12907.45,SGD,FAST Credit,Pacific Trade Co. #15,***3739,INV-202403-Logistics-APAC-0006,,False,False,REF-964220,First Continental Bank,***8155,Globex APAC Logistics Pte. Ltd.,SG,6690061.48
2024-03-21,2024-03-21,Client Receipt - Vertex Advisory Client #49,Sales Receipt,PS-GL,0.0,39333.49,SGD,FAST Credit,Vertex Advisory Client #49,***4410,INV-202403-PS-GL-0002,,False,False,REF-628681,First Continental Bank,***8863,Globex APAC Logistics Pte. Ltd.,SG,6729394.97
2024-03-22,2024-03-22,Supplier Payment - CodeCraft Contractors #12,Supplier Payment,SaaS-GL,16082.68,0.0,SGD,SWIFT MT103,CodeCraft Contractors #12,***4019,,PO-202403-SaaS-GL-0008,False,False,REF-683036,First Continental Bank,***6494,Globex APAC Logistics Pte. Ltd.,SG,6713312.29
2024-03-22,2024-03-22,Client Receipt - CloudBridge Co. #12,Sales Receipt,SaaS-GL,0.0,3720.37,SGD,FAST Credit,CloudBridge Co. #12,***6196,INV-202403-SaaS-GL-0023,,False,False,REF-336441,First Continental Bank,***3912,Globex APAC Logistics Pte. Ltd.,SG,6717032.66
2024-03-24,2024-03-24,Client Receipt - CloudBridge Co. #79,Sales Receipt,SaaS-GL,0.0,52027.83,SGD,SWIFT MT103,CloudBridge Co. #79,***3144,INV-202403-SaaS-GL-0008,,False,False,REF-584258,First Continental Bank,***3810,Globex APAC Logistics Pte. Ltd.,SG,6769060.49
2024-03-25,2024-03-25,Supplier Payment - ExpertNet Subcontractors #4,Supplier Payment,PS-GL,5048.91,0.0,SGD,SWIFT MT103,ExpertNet Subcontractors #4,***8730,,PO-202403-PS-GL-0001,False,False,REF-337519,First Continental Bank,***2828,Globex APAC Logistics Pte. Ltd.,SG,6764011.58
2024-03-25,2024-03-25,Client Receipt - CloudBridge Co. #53,Sales Receipt,SaaS-GL,0.0,5221.79,SGD,SWIFT MT103,CloudBridge Co. #53,***1002,INV-202403-SaaS-GL-0026,,False,False,REF-779413,First Continental Bank,***8879,Globex APAC Logistics Pte. Ltd.,SG,6769233.37
2024-03-25,2024-03-25,Client Receipt - CloudBridge Co. #14,Sales Receipt,SaaS-GL,0.0,7448.74,SGD,SWIFT MT103,CloudBridge Co. #14,***4179,INV-202403-SaaS-GL-0027,,False,False,REF-402450,First Continental Bank,***7870,Globex APAC Logistics Pte. Ltd.,SG,6776682.11
2024-03-25,2024-03-25,Client Receipt - CloudBridge Co. #24,Sales Receipt,SaaS-GL,0.0,12487.19,SGD,FAST Credit,CloudBridge Co. #24,***3373,INV-202403-SaaS-GL-0002,,False,False,REF-827499,First Continental Bank,***5554,Globex APAC Logistics Pte. Ltd.,SG,6789169.3
2024-03-25,2024-03-25,Client Receipt - Pacific Trade Co. #35,Sales Receipt,Logistics-APAC,0.0,14636.45,SGD,SWIFT MT103,Pacific Trade Co. #35,***4930,INV-202403-Logistics-APAC-0003,,False,False,REF-784248,First Continental Bank,***6353,Globex APAC Logistics Pte. Ltd.,SG,6803805.75
2024-03-25,2024-03-25,Client Receipt - Vertex Advisory Client #50,Sales Receipt,PS-GL,0.0,94362.91,SGD,SWIFT MT103,Vertex Advisory Client #50,***8032,INV-202403-PS-GL-0005,,False,False,REF-914466,First Continental Bank,***4004,Globex APAC Logistics Pte. Ltd.,SG,6898168.66
2024-03-26,2024-03-26,Marketing - Aurelia Media #6,Marketing,ALL,14264.2,0.0,SGD,MEPS+,Aurelia Media #6,***5509,,,False,False,REF-121293,First Continental Bank,***8190,Globex APAC Logistics Pte. Ltd.,SG,6883904.46
2024-03-26,2024-03-26,Intercompany Settlement - Globex Consulting UK Ltd.,Intercompany Transfer,ALL,447303.0,0.0,SGD,Internal Transfer,Globex Consulting UK Ltd.,***7973,,,True,True,REF-724286,First Continental Bank,***5023,Globex APAC Logistics Pte. Ltd.,SG,6436601.46
2024-03-26,2024-03-26,Client Receipt - Pacific Trade Co. #41,Sales Receipt,Logistics-APAC,0.0,4734.02,SGD,FAST Credit,Pacific Trade Co. #41,***4266,INV-202403-Logistics-APAC-0002,,False,False,REF-855442,First Continental Bank,***3932,Globex APAC Logistics Pte. Ltd.,SG,6441335.48
2024-03-26,2024-03-26,Client Receipt - CloudBridge Co. #19,Sales Receipt,SaaS-GL,0.0,5322.16,SGD,FAST Credit,CloudBridge Co. #19,***5922,INV-202403-SaaS-GL-0025,,False,False,REF-694054,First Continental Bank,***9608,Globex APAC Logistics Pte. Ltd.,SG,6446657.64
2024-03-26,2024-03-26,Client Receipt - Pacific Trade Co. #3,Sales Receipt,Logistics-APAC,0.0,8661.34,SGD,FAST Credit,Pacific Trade Co. #3,***3611,INV-202403-Logistics-APAC-0010,,False,False,REF-670206,First Continental Bank,***9031,Globex APAC Logistics Pte. Ltd.,SG,6455318.98
2024-03-27,2024-03-27,Supplier Payment - TransAsia Freight #23,Supplier Payment,Logistics-APAC,56819.09,0.0,SGD,MEPS+,TransAsia Freight #23,***4883,,PO-202403-Logistics-APAC-0008,False,False,REF-882765,First Continental Bank,***4301,Globex APAC Logistics Pte. Ltd.,SG,6398499.89
2024-03-27,2024-03-27,Payroll - GlobalPay Services Ltd,Payroll,ALL,187738.1,0.0,SGD,SWIFT MT103,GlobalPay Services Ltd,***2992,,,False,False,REF-924519,First Continental Bank,***7217,Globex APAC Logistics Pte. Ltd.,SG,6210761.79
2024-03-27,2024-03-27,Client Receipt - CloudBridge Co. #40,Sales Receipt,SaaS-GL,0.0,2998.88,SGD,SWIFT MT103,CloudBridge Co. #40,***6170,INV-202403-SaaS-GL-0009,,False,False,REF-942449,First Continental Bank,***6500,Globex APAC Logistics Pte. Ltd.,SG,6213760.67
2024-03-28,2024-03-28,Supplier Payment - Port Services #2,Supplier Payment,Logistics-APAC,13453.76,0.0,SGD,MEPS+,Port Services #2,***8623,,PO-202403-Logistics-APAC-0004,False,False,REF-239010,First Continental Bank,***1678,Globex APAC Logistics Pte. Ltd.,SG,6200306.91
2024-03-28,2024-03-28,Supplier Payment - CodeCraft Contractors #8,Supplier Payment,SaaS-GL,29537.77,0.0,SGD,FAST Debit,CodeCraft Contractors #8,***4710,,PO-202403-SaaS-GL-0002,False,False,REF-419750,First Continental Bank,***4257,Globex APAC Logistics Pte. Ltd.,SG,6170769.14
2024-03-28,2024-03-28,Client Receipt - CloudBridge Co. #51,Sales Receipt,SaaS-GL,0.0,32150.57,SGD,SWIFT MT103,CloudBridge Co. #51,***8889,INV-202403-SaaS-GL-0004,,False,False,REF-487199,First Continental Bank,***7028,Globex APAC Logistics Pte. Ltd.,SG,6202919.71
2024-03-28,2024-03-28,Client Receipt - CloudBridge Co. #65,Sales Receipt,SaaS-GL,0.0,32726.18,SGD,FAST Credit,CloudBridge Co. #65,***5906,INV-202403-SaaS-GL-0017,,False,False,REF-299374,First Continental Bank,***2330,Globex APAC Logistics Pte. Ltd.,SG,6235645.89
2024-03-29,2024-03-29,Supplier Payment - ExpertNet Subcontractors #12,Supplier Payment,PS-GL,16024.34,0.0,SGD,MEPS+,ExpertNet Subcontractors #12,***1640,,PO-202403-PS-GL-0004,False,False,REF-216432,First Continental Bank,***1929,Globex APAC Logistics Pte. Ltd.,SG,6219621.55
2024-03-30,2024-03-30,Interest Earned,Interest Income,ALL,0.0,11067.64,SGD,FAST Credit,First Continental Bank,***2984,,,False,False,REF-384353,First Continental Bank,***5690,Globex APAC Logistics Pte. Ltd.,SG,6230689.19
2024-04-01,2024-04-01,Account Maintenance Fee,Bank/Merchant Fees,ALL,2500.0,0.0,SGD,FAST Debit,First Continental Bank,***9173,,,False,False,REF-856068,First Continental Bank,***7618,Globex APAC Logistics Pte. Ltd.,SG,6228189.19
2024-04-01,2024-04-01,Supplier Payment - ExpertNet Subcontractors #6,Supplier Payment,PS-GL,15941.94,0.0,SGD,FAST Debit,ExpertNet Subcontractors #6,***2625,,PO-202404-PS-GL-0004,False,False,REF-783196,First Continental Bank,***4085,Globex APAC Logistics Pte. Ltd.,SG,6212247.25
2024-04-01,2024-04-01,Client Receipt - Vertex Advisory Client #33,Sales Receipt,PS-GL,0.0,6077.51,SGD,FAST Credit,Vertex Advisory Client #33,***6771,INV-202404-PS-GL-0005,,False,False,REF-148261,First Continental Bank,***2018,Globex APAC Logistics Pte. Ltd.,SG,6218324.76
2024-04-01,2024-04-01,Client Receipt - CloudBridge Co. #17,Sales Receipt,SaaS-GL,0.0,9927.91,SGD,FAST Credit,CloudBridge Co. #17,***2595,INV-202404-SaaS-GL-0018,,False,False,REF-568816,First Continental Bank,***2655,Globex APAC Logistics Pte. Ltd.,SG,6228252.67
2024-04-01,2024-04-01,Client Receipt - Pacific Trade Co. #5,Sales Receipt,Logistics-APAC,0.0,36407.85,SGD,SWIFT MT103,Pacific Trade Co. #5,***1537,INV-202404-Logistics-APAC-0007,,False,False,REF-519827,First Continental Bank,***2347,Globex APAC Logistics Pte. Ltd.,SG,6264660.52
2024-04-01,2024-04-01,Client Receipt - Pacific Trade Co. #11,Sales Receipt,Logistics-APAC,0.0,145289.68,SGD,SWIFT MT103,Pacific Trade Co. #11,***9053,INV-202404-Logistics-APAC-0011,,False,False,REF-784994,First Continental Bank,***1404,Globex APAC Logistics Pte. Ltd.,SG,6409950.2
2024-04-02,2024-04-02,Client Receipt - CloudBridge Co. #3,Sales Receipt,SaaS-GL,0.0,21263.28,SGD,FAST Credit,CloudBridge Co. #3,***4508,INV-202404-SaaS-GL-0007,,False,False,REF-417391,First Continental Bank,***8187,Globex APAC Logistics Pte. Ltd.,SG,6431213.48
2024-04-03,2024-04-03,Merchant Processing Fees,Bank/Merchant Fees,ALL,1963.11,0.0,SGD,MEPS+,First Continental Bank,***1639,,,False,False,REF-300876,First Continental Bank,***5997,Globex APAC Logistics Pte. Ltd.,SG,6429250.37
2024-04-03,2024-04-03,Supplier Payment - TransAsia Freight #11,Supplier Payment,Logistics-APAC,92785.07,0.0,SGD,SWIFT MT103,TransAsia Freight #11,***6949,,PO-202404-Logistics-APAC-0003,False,False,REF-363094,First Continental Bank,***8569,Globex APAC Logistics Pte. Ltd.,SG,6336465.3
2024-04-03,2024-04-03,Client Receipt - Pacific Trade Co. #56,Sales Receipt,Logistics-APAC,0.0,3595.65,SGD,FAST Credit,Pacific Trade Co. #56,***7006,INV-202404-Logistics-APAC-0013,,False,False,REF-193511,First Continental Bank,***6120,Globex APAC Logistics Pte. Ltd.,SG,6340060.95
2024-04-04,2024-04-04,Supplier Payment - HyperCloud Infra #7,Supplier Payment,SaaS-GL,2719.72,0.0,SGD,SWIFT MT103,HyperCloud Infra #7,***3239,,PO-202404-SaaS-GL-0004,False,False,REF-710264,First Continental Bank,***9213,Globex APAC Logistics Pte. Ltd.,SG,6337341.23
2024-04-04,2024-04-04,Client Receipt - CloudBridge Co. #32,Sales Receipt,SaaS-GL,0.0,6396.76,SGD,SWIFT MT103,CloudBridge Co. #32,***9627,INV-202404-SaaS-GL-0017,,False,False,REF-533539,First Continental Bank,***7693,Globex APAC Logistics Pte. Ltd.,SG,6343737.99
2024-04-04,2024-04-04,Client Receipt - CloudBridge Co. #20,Sales Receipt,SaaS-GL,0.0,8412.48,SGD,SWIFT MT103,CloudBridge Co. #20,***3496,INV-202404-SaaS-GL-0010,,False,False,REF-255850,First Continental Bank,***1035,Globex APAC Logistics Pte. Ltd.,SG,6352150.47
2024-04-04,2024-04-04,Client Receipt - CloudBridge Co. #53,Sales Receipt,SaaS-GL,0.0,14404.13,SGD,FAST Credit,CloudBridge Co. #53,***1428,INV-202404-SaaS-GL-0008,,False,False,REF-952743,First Continental Bank,***8438,Globex APAC Logistics Pte. Ltd.,SG,6366554.6
2024-04-05,2024-04-05,Supplier Payment - CodeCraft Contractors #9,Supplier Payment,SaaS-GL,12176.13,0.0,SGD,SWIFT MT103,CodeCraft Contractors #9,***1428,,PO-202404-SaaS-GL-0008,False,False,REF-197388,First Continental Bank,***9980,Globex APAC Logistics Pte. Ltd.,SG,6354378.47
2024-04-05,2024-04-05,Client Receipt - CloudBridge Co. #2,Sales Receipt,SaaS-GL,0.0,56863.59,SGD,SWIFT MT103,CloudBridge Co. #2,***5429,INV-202404-SaaS-GL-0003,,False,False,REF-932531,First Continental Bank,***4993,Globex APAC Logistics Pte. Ltd.,SG,6411242.06
2024-04-07,2024-04-07,Client Receipt - Vertex Advisory Client #6,Sales Receipt,PS-GL,0.0,1259.18,SGD,FAST Credit,Vertex Advisory Client #6,***1242,INV-202404-PS-GL-0008,,False,False,REF-800143,First Continental Bank,***6781,Globex APAC Logistics Pte. Ltd.,SG,6412501.24
2024-04-08,2024-04-08,Supplier Payment - HyperCloud Infra #2,Supplier Payment,SaaS-GL,7640.1,0.0,SGD,SWIFT MT103,HyperCloud Infra #2,***9477,,PO-202404-SaaS-GL-0003,False,False,REF-550810,First Continental Bank,***6539,Globex APAC Logistics Pte. Ltd.,SG,6404861.14
2024-04-09,2024-04-09,Supplier Payment - ExpertNet Subcontractors #3,Supplier Payment,PS-GL,1923.21,0.0,SGD,MEPS+,ExpertNet Subcontractors #3,***5105,,PO-202404-PS-GL-0008,False,False,REF-745036,First Continental Bank,***3459,Globex APAC Logistics Pte. Ltd.,SG,6402937.93
2024-04-09,2024-04-09,Supplier Payment - ExpertNet Subcontractors #17,Supplier Payment,PS-GL,10114.44,0.0,SGD,FAST Debit,ExpertNet Subcontractors #17,***5623,,PO-202404-PS-GL-0001,False,False,REF-887458,First Continental Bank,***9484,Globex APAC Logistics Pte. Ltd.,SG,6392823.49
2024-04-09,2024-04-09,Client Receipt - Pacific Trade Co. #16,Sales Receipt,Logistics-APAC,0.0,4973.29,SGD,SWIFT MT103,Pacific Trade Co. #16,***2106,INV-202404-Logistics-APAC-0006,,False,False,REF-272904,First Continental Bank,***1425,Globex APAC Logistics Pte. Ltd.,SG,6397796.78
2024-04-09,2024-04-09,Client Receipt - CloudBridge Co. #11,Sales Receipt,SaaS-GL,0.0,14221.65,SGD,FAST Credit,CloudBridge Co. #11,***9409,INV-202404-SaaS-GL-0011,,False,False,REF-177907,First Continental Bank,***1500,Globex APAC Logistics Pte. Ltd.,SG,6412018.43
2024-04-09,2024-04-09,Client Receipt - Pacific Trade Co. #41,Sales Receipt,Logistics-APAC,0.0,20175.71,SGD,SWIFT MT103,Pacific Trade Co. #41,***9593,INV-202404-Logistics-APAC-0008,,False,False,REF-444072,First Continental Bank,***6383,Globex APAC Logistics Pte. Ltd.,SG,6432194.14
2024-04-09,2024-04-09,Client Receipt - Vertex Advisory Client #1,Sales Receipt,PS-GL,0.0,31651.09,SGD,SWIFT MT103,Vertex Advisory Client #1,***9495,INV-202404-PS-GL-0006,,False,False,REF-716900,First Continental Bank,***3603,Globex APAC Logistics Pte. Ltd.,SG,6463845.23
2024-04-09,2024-04-09,Client Receipt - CloudBridge Co. #65,Sales Receipt,SaaS-GL,0.0,46083.63,SGD,FAST Credit,CloudBridge Co. #65,***7341,INV-202404-SaaS-GL-0002,,False,False,REF-821656,First Continental Bank,***9430,Globex APAC Logistics Pte. Ltd.,SG,6509928.86
2024-04-10,2024-04-10,Client Receipt - Vertex Advisory Client #33,Sales Receipt,PS-GL,0.0,65682.0,SGD,FAST Credit,Vertex Advisory Client #33,***3589,INV-202404-PS-GL-0004,,False,False,REF-120920,First Continental Bank,***7957,Globex APAC Logistics Pte. Ltd.,SG,6575610.86
2024-04-11,2024-04-11,Skyline Internet Services,Rent & Utilities,ALL,9807.38,0.0,SGD,SWIFT MT103,Skyline Internet Services,***7467,,,False,False,REF-399944,First Continental Bank,***4418,Globex APAC Logistics Pte. Ltd.,SG,6565803.48
2024-04-11,2024-04-11,Supplier Payment - CodeCraft Contractors #4,Supplier Payment,SaaS-GL,22811.72,0.0,SGD,SWIFT MT103,CodeCraft Contractors #4,***4699,,PO-202404-SaaS-GL-0006,False,False,REF-237059,First Continental Bank,***3102,Globex APAC Logistics Pte. Ltd.,SG,6542991.76
2024-04-11,2024-04-11,Client Receipt - Vertex Advisory Client #28,Sales Receipt,PS-GL,0.0,5506.47,SGD,SWIFT MT103,Vertex Advisory Client #28,***5580,INV-202404-PS-GL-0009,,False,False,REF-465385,First Continental Bank,***3895,Globex APAC Logistics Pte. Ltd.,SG,6548498.23
2024-04-12,2024-04-12,Intercompany Settlement - Globex Retail NA LLC,Intercompany Transfer,ALL,585710.0,0.0,SGD,Internal Transfer,Globex Retail NA LLC,***2564,,,True,True,REF-643749,First Continental Bank,***6123,Globex APAC Logistics Pte. Ltd.,SG,5962788.23
2024-04-12,2024-04-12,Client Receipt - CloudBridge Co. #25,Sales Receipt,SaaS-GL,0.0,2441.82,SGD,FAST Credit,CloudBridge Co. #25,***9533,INV-202404-SaaS-GL-0016,,False,False,REF-501493,First Continental Bank,***7419,Globex APAC Logistics Pte. Ltd.,SG,5965230.05
2024-04-12,2024-04-12,Client Receipt - CloudBridge Co. #53,Sales Receipt,SaaS-GL,0.0,13373.51,SGD,FAST Credit,CloudBridge Co. #53,***8181,INV-202404-SaaS-GL-0009,,False,False,REF-317435,First Continental Bank,***2317,Globex APAC Logistics Pte. Ltd.,SG,5978603.56
2024-04-12,2024-04-12,Client Receipt - CloudBridge Co. #62,Sales Receipt,SaaS-GL,0.0,25983.13,SGD,SWIFT MT103,CloudBridge Co. #62,***6694,INV-202404-SaaS-GL-0006,,False,False,REF-329814,First Continental Bank,***2010,Globex APAC Logistics Pte. Ltd.,SG,6004586.69
2024-04-13,2024-04-13,Client Receipt - CloudBridge Co. #24,Sales Receipt,SaaS-GL,0.0,1684.62,SGD,SWIFT MT103,CloudBridge Co. #24,***4110,INV-202404-SaaS-GL-0001,,False,False,REF-643177,First Continental Bank,***2042,Globex APAC Logistics Pte. Ltd.,SG,6006271.31
2024-04-14,2024-04-14,Supplier Payment - ExpertNet Subcontractors #14,Supplier Payment,PS-GL,5474.64,0.0,SGD,FAST Debit,ExpertNet Subcontractors #14,***1844,,PO-202404-PS-GL-0002,False,False,REF-340704,First Continental Bank,***5810,Globex APAC Logistics Pte. Ltd.,SG,6000796.67
2024-04-15,2024-04-15,Marketing - Aurelia Media #5,Marketing,ALL,18187.65,0.0,SGD,SWIFT MT103,Aurelia Media #5,***4301,,,False,False,REF-442125,First Continental Bank,***4972,Globex APAC Logistics Pte. Ltd.,SG,5982609.02
2024-04-15,2024-04-15,Client Receipt - CloudBridge Co. #74,Sales Receipt,SaaS-GL,0.0,1438.12,SGD,SWIFT MT103,CloudBridge Co. #74,***1883,INV-202404-SaaS-GL-0013,,False,False,REF-101491,First Continental Bank,***3620,Globex APAC Logistics Pte. Ltd.,SG,5984047.14
2024-04-15,2024-04-15,Client Receipt - CloudBridge Co. #23,Sales Receipt,SaaS-GL,0.0,5784.59,SGD,SWIFT MT103,CloudBridge Co. #23,***1493,INV-202404-SaaS-GL-0020,,False,False,REF-274018,First Continental Bank,***9118,Globex APAC Logistics Pte. Ltd.,SG,5989831.73
2024-04-15,2024-04-15,Client Receipt - Pacific Trade Co. #19,Sales Receipt,Logistics-APAC,0.0,7888.61,SGD,FAST Credit,Pacific Trade Co. #19,***8226,INV-202404-Logistics-APAC-0010,,False,False,REF-860230,First Continental Bank,***5559,Globex APAC Logistics Pte. Ltd.,SG,5997720.34
2024-04-15,2024-04-15,Client Receipt - CloudBridge Co. #10,Sales Receipt,SaaS-GL,0.0,26186.65,SGD,SWIFT MT103,CloudBridge Co. #10,***6443,INV-202404-SaaS-GL-0015,,False,False,REF-726752,First Continental Bank,***9292,Globex APAC Logistics Pte. Ltd.,SG,6023906.99
2024-04-15,2024-04-15,Client Receipt - CloudBridge Co. #35,Sales Receipt,SaaS-GL,0.0,61586.94,SGD,SWIFT MT103,CloudBridge Co. #35,***3790,INV-202404-SaaS-GL-0019,,False,False,REF-236195,First Continental Bank,***8306,Globex APAC Logistics Pte. Ltd.,SG,6085493.93
2024-04-16,2024-04-16,Supplier Payment - TransAsia Freight #15,Supplier Payment,Logistics-APAC,3810.63,0.0,SGD,FAST Debit,TransAsia Freight #15,***2598,,PO-202404-Logistics-APAC-0006,False,False,REF-394239,First Continental Bank,***5592,Globex APAC Logistics Pte. Ltd.,SG,6081683.3
2024-04-16,2024-04-16,Supplier Payment - ExpertNet Subcontractors #9,Supplier Payment,PS-GL,12444.32,0.0,SGD,SWIFT MT103,ExpertNet Subcontractors #9,***1745,,PO-202404-PS-GL-0007,False,False,REF-775832,First Continental Bank,***9993,Globex APAC Logistics Pte. Ltd.,SG,6069238.98
2024-04-16,2024-04-16,Client Receipt - CloudBridge Co. #40,Sales Receipt,SaaS-GL,0.0,10326.37,SGD,SWIFT MT103,CloudBridge Co. #40,***3572,INV-202404-SaaS-GL-0024,,False,False,REF-575173,First Continental Bank,***8023,Globex APAC Logistics Pte. Ltd.,SG,6079565.35
2024-04-16,2024-04-16,Client Receipt - CloudBridge Co. #32,Sales Receipt,SaaS-GL,0.0,15761.6,SGD,FAST Credit,CloudBridge Co. #32,***3777,INV-202404-SaaS-GL-0012,,False,False,REF-718963,First Continental Bank,***8782,Globex APAC Logistics Pte. Ltd.,SG,6095326.95
2024-04-16,2024-04-16,Client Receipt - CloudBridge Co. #16,Sales Receipt,SaaS-GL,0.0,17786.02,SGD,SWIFT MT103,CloudBridge Co. #16,***4269,INV-202404-SaaS-GL-0023,,False,False,REF-453031,First Continental Bank,***5348,Globex APAC Logistics Pte. Ltd.,SG,6113112.97
2024-04-17,2024-04-17,Client Receipt - Vertex Advisory Client #54,Sales Receipt,PS-GL,0.0,4991.16,SGD,SWIFT MT103,Vertex Advisory Client #54,***6523,INV-202404-PS-GL-0003,,False,False,REF-455591,First Continental Bank,***5966,Globex APAC Logistics Pte. Ltd.,SG,6118104.13
2024-04-17,2024-04-17,Client Receipt - Pacific Trade Co. #10,Sales Receipt,Logistics-APAC,0.0,46114.54,SGD,SWIFT MT103,Pacific Trade Co. #10,***5563,INV-202404-Logistics-APAC-0002,,False,False,REF-786401,First Continental Bank,***9284,Globex APAC Logistics Pte. Ltd.,SG,6164218.67
2024-04-17,2024-04-17,Client Receipt - Pacific Trade Co. #41,Sales Receipt,Logistics-APAC,0.0,64170.68,SGD,FAST Credit,Pacific Trade Co. #41,***5768,INV-202404-Logistics-APAC-0005,,False,False,REF-269056,First Continental Bank,***4930,Globex APAC Logistics Pte. Ltd.,SG,6228389.35
2024-04-18,2024-04-18,Supplier Payment - TransAsia Freight #42,Supplier Payment,Logistics-APAC,20070.43,0.0,SGD,SWIFT MT103,TransAsia Freight #42,***9755,,PO-202404-Logistics-APAC-0005,False,False,REF-458864,First Continental Bank,***5049,Globex APAC Logistics Pte. Ltd.,SG,6208318.92
2024-04-18,2024-04-18,Supplier Payment - Port Services #19,Supplier Payment,Logistics-APAC,47613.8,0.0,SGD,SWIFT MT103,Port Services #19,***4602,,PO-202404-Logistics-APAC-0001,False,False,REF-484830,First Continental Bank,***5729,Globex APAC Logistics Pte. Ltd.,SG,6160705.12
2024-04-18,2024-04-18,Supplier Payment - TransAsia Freight #9,Supplier Payment,Logistics-APAC,105115.3,0.0,SGD,FAST Debit,TransAsia Freight #9,***1265,,PO-202404-Logistics-APAC-0007,False,False,REF-698154,First Continental Bank,***6344,Globex APAC Logistics Pte. Ltd.,SG,6055589.82
2024-04-18,2024-04-18,Client Receipt - CloudBridge Co. #77,Sales Receipt,SaaS-GL,0.0,11111.89,SGD,SWIFT MT103,CloudBridge Co. #77,***6118,INV-202404-SaaS-GL-0004,,False,False,REF-117286,First Continental Bank,***6715,Globex APAC Logistics Pte. Ltd.,SG,6066701.71
2024-04-19,2024-04-19,Supplier Payment - HyperCloud Infra #11,Supplier Payment,SaaS-GL,17274.36,0.0,SGD,MEPS+,HyperCloud Infra #11,***3038,,PO-202404-SaaS-GL-0001,False,False,REF-331774,First Continental Bank,***3174,Globex APAC Logistics Pte. Ltd.,SG,6049427.35
2024-04-19,2024-04-19,Client Receipt - CloudBridge Co. #34,Sales Receipt,SaaS-GL,0.0,6522.42,SGD,FAST Credit,CloudBridge Co. #34,***7356,INV-202404-SaaS-GL-0022,,False,False,REF-303949,First Continental Bank,***3738,Globex APAC Logistics Pte. Ltd.,SG,6055949.77
2024-04-19,2024-04-19,Client Receipt - Vertex Advisory Client #15,Sales Receipt,PS-GL,0.0,13818.84,SGD,FAST Credit,Vertex Advisory Client #15,***1726,INV-202404-PS-GL-0002,,False,False,REF-747544,First Continental Bank,***2394,Globex APAC Logistics Pte. Ltd.,SG,6069768.61
2024-04-19,2024-04-19,Client Receipt - Vertex Advisory Client #49,Sales Receipt,PS-GL,0.0,28538.26,SGD,FAST Credit,Vertex Advisory Client #49,***2540,INV-202404-PS-GL-0011,,False,False,REF-590834,First Continental Bank,***1640,Globex APAC Logistics Pte. Ltd.,SG,6098306.87
2024-04-19,2024-04-19,Client Receipt - Pacific Trade Co. #64,Sales Receipt,Logistics-APAC,0.0,40258.15,SGD,FAST Credit,Pacific Trade Co. #64,***2126,INV-202404-Logistics-APAC-0001,,False,False,REF-828952,First Continental Bank,***6457,Globex APAC Logistics Pte. Ltd.,SG,6138565.02
2024-04-20,2024-04-20,Client Receipt - CloudBridge Co. #13,Sales Receipt,SaaS-GL,0.0,2520.89,SGD,SWIFT MT103,CloudBridge Co. #13,***3562,INV-202404-SaaS-GL-0021,,False,False,REF-409222,First Continental Bank,***7630,Globex APAC Logistics Pte. Ltd.,SG,6141085.91
2024-04-20,2024-04-20,Client Receipt - Pacific Trade Co. #17,Sales Receipt,Logistics-APAC,0.0,81357.01,SGD,FAST Credit,Pacific Trade Co. #17,***7555,INV-202404-Logistics-APAC-0004,,False,False,REF-438810,First Continental Bank,***7130,Globex APAC Logistics Pte. Ltd.,SG,6222442.92
2024-04-21,2024-04-21,VAT/GST Remittance - IRAS Singapore,Tax Payment,ALL,76164.84,0.0,SGD,SWIFT MT103,IRAS Singapore,***6429,,,False,False,REF-117768,First Continental Bank,***8458,Globex APAC Logistics Pte. Ltd.,SG,6146278.08
2024-04-22,2024-04-22,Supplier Payment - HyperCloud Infra #4,Supplier Payment,SaaS-GL,1583.42,0.0,SGD,MEPS+,HyperCloud Infra #4,***1283,,PO-202404-SaaS-GL-0007,False,False,REF-128812,First Continental Bank,***2848,Globex APAC Logistics Pte. Ltd.,SG,6144694.66
2024-04-22,2024-04-22,Supplier Payment - CodeCraft Contractors #3,Supplier Payment,SaaS-GL,17108.54,0.0,SGD,MEPS+,CodeCraft Contractors #3,***5476,,PO-202404-SaaS-GL-0002,False,False,REF-282113,First Continental Bank,***6184,Globex APAC Logistics Pte. Ltd.,SG,6127586.12
2024-04-22,2024-04-22,Client Receipt - Pacific Trade Co. #34,Sales Receipt,Logistics-APAC,0.0,9467.57,SGD,FAST Credit,Pacific Trade Co. #34,***6394,INV-202404-Logistics-APAC-0012,,False,False,REF-561730,First Continental Bank,***8338,Globex APAC Logistics Pte. Ltd.,SG,6137053.69
2024-04-22,2024-04-22,Client Receipt - CloudBridge Co. #72,Sales Receipt,SaaS-GL,0.0,21273.84,SGD,SWIFT MT103,CloudBridge Co. #72,***6810,INV-202404-SaaS-GL-0026,,False,False,REF-665812,First Continental Bank,***9001,Globex APAC Logistics Pte. Ltd.,SG,6158327.53
2024-04-23,2024-04-23,Client Receipt - Pacific Trade Co. #58,Sales Receipt,Logistics-APAC,0.0,13470.74,SGD,SWIFT MT103,Pacific Trade Co. #58,***2170,INV-202404-Logistics-APAC-0009,,False,False,REF-471647,First Continental Bank,***5792,Globex APAC Logistics Pte. Ltd.,SG,6171798.27
2024-04-24,2024-04-24,Supplier Payment - ExpertNet Subcontractors #9,Supplier Payment,PS-GL,1775.41,0.0,SGD,SWIFT MT103,ExpertNet Subcontractors #9,***8195,,PO-202404-PS-GL-0003,False,False,REF-804788,First Continental Bank,***6831,Globex APAC Logistics Pte. Ltd.,SG,6170022.86
2024-04-24,2024-04-24,Supplier Payment - ExpertNet Subcontractors #15,Supplier Payment,PS-GL,15180.95,0.0,SGD,MEPS+,ExpertNet Subcontractors #15,***4963,,PO-202404-PS-GL-0009,False,False,REF-647156,First Continental Bank,***4384,Globex APAC Logistics Pte. Ltd.,SG,6154841.91
2024-04-24,2024-04-24,Client Receipt - CloudBridge Co. #15,Sales Receipt,SaaS-GL,0.0,1953.01,SGD,FAST Credit,CloudBridge Co. #15,***7016,INV-202404-SaaS-GL-0014,,False,False,REF-285158,First Continental Bank,***3074,Globex APAC Logistics Pte. Ltd.,SG,6156794.92
2024-04-24,2024-04-24,Client Receipt - Pacific Trade Co. #55,Sales Receipt,Logistics-APAC,0.0,14635.4,SGD,FAST Credit,Pacific Trade Co. #55,***4511,INV-202404-Logistics-APAC-0003,,False,False,REF-979058,First Continental Bank,***2258,Globex APAC Logistics Pte. Ltd.,SG,6171430.32
2024-04-24,2024-04-24,Client Receipt - CloudBridge Co. #36,Sales Receipt,SaaS-GL,0.0,26853.26,SGD,SWIFT MT103,CloudBridge Co. #36,***3885,INV-202404-SaaS-GL-0025,,False,False,REF-571581,First Continental Bank,***6661,Globex APAC Logistics Pte. Ltd.,SG,6198283.58
2024-04-24,2024-04-24,Client Receipt - Vertex Advisory Client #20,Sales Receipt,PS-GL,0.0,27904.59,SGD,SWIFT MT103,Vertex Advisory Client #20,***2733,INV-202404-PS-GL-0001,,False,False,REF-944631,First Continental Bank,***4330,Globex APAC Logistics Pte. Ltd.,SG,6226188.17
2024-04-25,2024-04-25,Supplier Payment - ExpertNet Subcontractors #13,Supplier Payment,PS-GL,21350.25,0.0,SGD,SWIFT MT103,ExpertNet Subcontractors #13,***6755,,PO-202404-PS-GL-0006,False,False,REF-218271,First Continental Bank,***5405,Globex APAC Logistics Pte. Ltd.,SG,6204837.92
2024-04-25,2024-04-25,Supplier Payment - TransAsia Freight #15,Supplier Payment,Logistics-APAC,32668.1,0.0,SGD,SWIFT MT103,TransAsia Freight #15,***2668,,PO-202404-Logistics-APAC-0002,False,False,REF-211522,First Continental Bank,***9025,Globex APAC Logistics Pte. Ltd.,SG,6172169.82
2024-04-25,2024-04-25,Supplier Payment - TransAsia Freight #9,Supplier Payment,Logistics-APAC,38044.01,0.0,SGD,SWIFT MT103,TransAsia Freight #9,***9398,,PO-202404-Logistics-APAC-0008,False,False,REF-402058,First Continental Bank,***8726,Globex APAC Logistics Pte. Ltd.,SG,6134125.81
2024-04-26,2024-04-26,Intercompany Settlement - Globex EMEA Manufacturing Ltd.,Intercompany Transfer,ALL,735450.0,0.0,SGD,Internal Transfer,Globex EMEA Manufacturing Ltd.,***2010,,,True,True,REF-232070,First Continental Bank,***7392,Globex APAC Logistics Pte. Ltd.,SG,5398675.81
2024-04-27,2024-04-27,Payroll - GlobalPay Services Ltd,Payroll,ALL,195752.32,0.0,SGD,SWIFT MT103,GlobalPay Services Ltd,***3976,,,False,False,REF-887730,First Continental Bank,***7818,Globex APAC Logistics Pte. Ltd.,SG,5202923.49
2024-04-28,2024-04-28,Supplier Payment - HyperCloud Infra #10,Supplier Payment,SaaS-GL,15271.38,0.0,SGD,FAST Debit,HyperCloud Infra #10,***2250,,PO-202404-SaaS-GL-0005,False,False,REF-151924,First Continental Bank,***5409,Globex APAC Logistics Pte. Ltd.,SG,5187652.11
2024-04-28,2024-04-28,Corporate Tax Estimate,Tax Payment,ALL,53703.08,0.0,SGD,MEPS+,IRAS Singapore,***3827,,,False,False,REF-335543,First Continental Bank,***2277,Globex APAC Logistics Pte. Ltd.,SG,5133949.03
2024-04-29,2024-04-29,Merchant Processing Fees,Bank/Merchant Fees,ALL,1698.77,0.0,SGD,MEPS+,First Continental Bank,***5330,,,False,False,REF-780786,First Continental Bank,***2465,Globex APAC Logistics Pte. Ltd.,SG,5132250.26
2024-04-29,2024-04-29,Client Receipt - CloudBridge Co. #30,Sales Receipt,SaaS-GL,0.0,8862.28,SGD,FAST Credit,CloudBridge Co. #30,***1788,INV-202404-SaaS-GL-0005,,False,False,REF-296613,First Continental Bank,***1994,Globex APAC Logistics Pte. Ltd.,SG,5141112.54
2024-04-29,2024-04-29,Client Receipt - Vertex Advisory Client #8,Sales Receipt,PS-GL,0.0,63997.17,SGD,FAST Credit,Vertex Advisory Client #8,***6672,INV-202404-PS-GL-0007,,False,False,REF-451605,First Continental Bank,***5071,Globex APAC Logistics Pte. Ltd.,SG,5205109.71
2024-04-30,2024-04-30,Supplier Payment - TransAsia Freight #30,Supplier Payment,Logistics-APAC,1356.07,0.0,SGD,FAST Debit,TransAsia Freight #30,***2583,,PO-202404-Logistics-APAC-0004,False,False,REF-938228,First Continental Bank,***3661,Globex APAC Logistics Pte. Ltd.,SG,5203753.64
2024-04-30,2024-04-30,Supplier Payment - ExpertNet Subcontractors #17,Supplier Payment,PS-GL,3599.72,0.0,SGD,MEPS+,ExpertNet Subcontractors #17,***2408,,PO-202404-PS-GL-0005,False,False,REF-677500,First Continental Bank,***5230,Globex APAC Logistics Pte. Ltd.,SG,5200153.92
2024-04-30,2024-04-30,Marketing - Aurelia Media #6,Marketing,ALL,11183.89,0.0,SGD,SWIFT MT103,Aurelia Media #6,***8312,,,False,False,REF-548506,First Continental Bank,***2937,Globex APAC Logistics Pte. Ltd.,SG,5188970.03
2024-04-30,2024-04-30,Interest Earned,Interest Income,ALL,0.0,9502.4,SGD,FAST Credit,First Continental Bank,***2682,,,False,False,REF-703272,First Continental Bank,***8790,Globex APAC Logistics Pte. Ltd.,SG,5198472.43
2024-04-30,2024-04-30,Client Receipt - Vertex Advisory Client #53,Sales Receipt,PS-GL,0.0,43256.66,SGD,FAST Credit,Vertex Advisory Client #53,***7568,INV-202404-PS-GL-0010,,False,False,REF-678129,First Continental Bank,***3708,Globex APAC Logistics Pte. Ltd.,SG,5241729.09
2024-05-01,2024-05-01,Account Maintenance Fee,Bank/Merchant Fees,ALL,2500.0,0.0,SGD,SWIFT MT103,First Continental Bank,***6546,,,False,False,REF-657974,First Continental Bank,***9418,Globex APAC Logistics Pte. Ltd.,SG,5239229.09
2024-05-01,2024-05-01,Supplier Payment - HyperCloud Infra #19,Supplier Payment,SaaS-GL,4572.28,0.0,SGD,FAST Debit,HyperCloud Infra #19,***7734,,PO-202405-SaaS-GL-0002,False,False,REF-570615,First Continental Bank,***1374,Globex APAC Logistics Pte. Ltd.,SG,5234656.81
2024-05-01,2024-05-01,Supplier Payment - HyperCloud Infra #8,Supplier Payment,SaaS-GL,11287.79,0.0,SGD,MEPS+,HyperCloud Infra #8,***7159,,PO-202405-SaaS-GL-0005,False,False,REF-772555,First Continental Bank,***7385,Globex APAC Logistics Pte. Ltd.,SG,5223369.02
2024-05-01,2024-05-01,Supplier Payment - ExpertNet Subcontractors #6,Supplier Payment,PS-GL,12291.03,0.0,SGD,SWIFT MT103,ExpertNet Subcontractors #6,***2046,,PO-202405-PS-GL-0001,False,False,REF-629991,First Continental Bank,***7547,Globex APAC Logistics Pte. Ltd.,SG,5211077.99
2024-05-02,2024-05-02,Supplier Payment - HyperCloud Infra #11,Supplier Payment,SaaS-GL,10619.8,0.0,SGD,FAST Debit,HyperCloud Infra #11,***4374,,PO-202405-SaaS-GL-0009,False,False,REF-451576,First Continental Bank,***7361,Globex APAC Logistics Pte. Ltd.,SG,5200458.19
2024-05-02,2024-05-02,Supplier Payment - HyperCloud Infra #5,Supplier Payment,SaaS-GL,11067.18,0.0,SGD,SWIFT MT103,HyperCloud Infra #5,***6119,,PO-202405-SaaS-GL-0008,False,False,REF-894558,First Continental Bank,***7454,Globex APAC Logistics Pte. Ltd.,SG,5189391.01
2024-05-02,2024-05-02,Client Receipt - Pacific Trade Co. #69,Sales Receipt,Logistics-APAC,0.0,11910.4,SGD,SWIFT MT103,Pacific Trade Co. #69,***3609,INV-202405-Logistics-APAC-0001,,False,False,REF-443993,First Continental Bank,***4532,Globex APAC Logistics Pte. Ltd.,SG,5201301.41
2024-05-02,2024-05-02,Client Receipt - CloudBridge Co. #12,Sales Receipt,SaaS-GL,0.0,17510.29,SGD,SWIFT MT103,CloudBridge Co. #12,***5674,INV-202405-SaaS-GL-0005,,False,False,REF-899206,First Continental Bank,***1622,Globex APAC Logistics Pte. Ltd.,SG,5218811.7
2024-05-02,2024-05-02,Client Receipt - CloudBridge Co. #64,Sales Receipt,SaaS-GL,0.0,20437.24,SGD,FAST Credit,CloudBridge Co. #64,***8328,INV-202405-SaaS-GL-0017,,False,False,REF-773717,First Continental Bank,***6341,Globex APAC Logistics Pte. Ltd.,SG,5239248.94
2024-05-02,2024-05-02,Client Receipt - Pacific Trade Co. #61,Sales Receipt,Logistics-APAC,0.0,27242.18,SGD,FAST Credit,Pacific Trade Co. #61,***8613,INV-202405-Logistics-APAC-0012,,False,False,REF-669395,First Continental Bank,***9545,Globex APAC Logistics Pte. Ltd.,SG,5266491.12
2024-05-03,2024-05-03,Supplier Payment - Port Services #5,Supplier Payment,Logistics-APAC,84689.16,0.0,SGD,FAST Debit,Port Services #5,***5412,,PO-202405-Logistics-APAC-0008,False,False,REF-868250,First Continental Bank,***1166,Globex APAC Logistics Pte. Ltd.,SG,5181801.96
2024-05-04,2024-05-04,Client Receipt - CloudBridge Co. #25,Sales Receipt,SaaS-GL,0.0,22012.63,SGD,FAST Credit,CloudBridge Co. #25,***1475,INV-202405-SaaS-GL-0004,,False,False,REF-331969,First Continental Bank,***7363,Globex APAC Logistics Pte. Ltd.,SG,5203814.59
2024-05-04,2024-05-04,Client Receipt - CloudBridge Co. #47,Sales Receipt,SaaS-GL,0.0,62487.23,SGD,FAST Credit,CloudBridge Co. #47,***3960,INV-202405-SaaS-GL-0007,,False,False,REF-572143,First Continental Bank,***2288,Globex APAC Logistics Pte. Ltd.,SG,5266301.82
2024-05-05,2024-05-05,Supplier Payment - HyperCloud Infra #16,Supplier Payment,SaaS-GL,7474.33,0.0,SGD,MEPS+,HyperCloud Infra #16,***8605,,PO-202405-SaaS-GL-0010,False,False,REF-234779,First Continental Bank,***5967,Globex APAC Logistics Pte. Ltd.,SG,5258827.49
2024-05-06,2024-05-06,Supplier Payment - ExpertNet Subcontractors #11,Supplier Payment,PS-GL,4326.07,0.0,SGD,MEPS+,ExpertNet Subcontractors #11,***9626,,PO-202405-PS-GL-0005,False,False,REF-391831,First Continental Bank,***4649,Globex APAC Logistics Pte. Ltd.,SG,5254501.42
2024-05-06,2024-05-06,Supplier Payment - TransAsia Freight #40,Supplier Payment,Logistics-APAC,31583.18,0.0,SGD,SWIFT MT103,TransAsia Freight #40,***1381,,PO-202405-Logistics-APAC-0001,False,False,REF-340466,First Continental Bank,***8408,Globex APAC Logistics Pte. Ltd.,SG,5222918.24
2024-05-06,2024-05-06,Client Receipt - CloudBridge Co. #24,Sales Receipt,SaaS-GL,0.0,12851.38,SGD,SWIFT MT103,CloudBridge Co. #24,***5739,INV-202405-SaaS-GL-0020,,False,False,REF-381633,First Continental Bank,***7911,Globex APAC Logistics Pte. Ltd.,SG,5235769.62
2024-05-06,2024-05-06,Client Receipt - Pacific Trade Co. #67,Sales Receipt,Logistics-APAC,0.0,55866.29,SGD,SWIFT MT103,Pacific Trade Co. #67,***9799,INV-202405-Logistics-APAC-0004,,False,False,REF-985357,First Continental Bank,***3134,Globex APAC Logistics Pte. Ltd.,SG,5291635.91
2024-05-07,2024-05-07,Supplier Payment - CodeCraft Contractors #5,Supplier Payment,SaaS-GL,5297.01,0.0,SGD,FAST Debit,CodeCraft Contractors #5,***4925,,PO-202405-SaaS-GL-0007,False,False,REF-463811,First Continental Bank,***8605,Globex APAC Logistics Pte. Ltd.,SG,5286338.9
2024-05-07,2024-05-07,Client Receipt - Vertex Advisory Client #25,Sales Receipt,PS-GL,0.0,6441.57,SGD,SWIFT MT103,Vertex Advisory Client #25,***1164,INV-202405-PS-GL-0002,,False,False,REF-676286,First Continental Bank,***2462,Globex APAC Logistics Pte. Ltd.,SG,5292780.47
2024-05-07,2024-05-07,Client Receipt - Vertex Advisory Client #6,Sales Receipt,PS-GL,0.0,42322.11,SGD,FAST Credit,Vertex Advisory Client #6,***9464,INV-202405-PS-GL-0006,,False,False,REF-615697,First Continental Bank,***3980,Globex APAC Logistics Pte. Ltd.,SG,5335102.58
2024-05-07,2024-05-07,Client Receipt - Pacific Trade Co. #60,Sales Receipt,Logistics-APAC,0.0,47067.46,SGD,SWIFT MT103,Pacific Trade Co. #60,***6937,INV-202405-Logistics-APAC-0013,,False,False,REF-476683,First Continental Bank,***3108,Globex APAC Logistics Pte. Ltd.,SG,5382170.04
2024-05-07,2024-05-07,Client Receipt - Pacific Trade Co. #44,Sales Receipt,Logistics-APAC,0.0,57571.06,SGD,FAST Credit,Pacific Trade Co. #44,***9873,INV-202405-Logistics-APAC-0006,,False,False,REF-445764,First Continental Bank,***9425,Globex APAC Logistics Pte. Ltd.,SG,5439741.1
2024-05-08,2024-05-08,Supplier Payment - TransAsia Freight #15,Supplier Payment,Logistics-APAC,12745.34,0.0,SGD,SWIFT MT103,TransAsia Freight #15,***7718,,PO-202405-Logistics-APAC-0005,False,False,REF-610040,First Continental Bank,***7685,Globex APAC Logistics Pte. Ltd.,SG,5426995.76
2024-05-08,2024-05-08,Client Receipt - Pacific Trade Co. #33,Sales Receipt,Logistics-APAC,0.0,4290.3,SGD,SWIFT MT103,Pacific Trade Co. #33,***5435,INV-202405-Logistics-APAC-0005,,False,False,REF-984324,First Continental Bank,***8593,Globex APAC Logistics Pte. Ltd.,SG,5431286.06
2024-05-08,2024-05-08,Client Receipt - Vertex Advisory Client #27,Sales Receipt,PS-GL,0.0,14474.08,SGD,FAST Credit,Vertex Advisory Client #27,***3513,INV-202405-PS-GL-0010,,False,False,REF-763685,First Continental Bank,***3091,Globex APAC Logistics Pte. Ltd.,SG,5445760.14
2024-05-08,2024-05-08,Client Receipt - Pacific Trade Co. #10,Sales Receipt,Logistics-APAC,0.0,19643.93,SGD,SWIFT MT103,Pacific Trade Co. #10,***1812,INV-202405-Logistics-APAC-0003,,False,False,REF-408473,First Continental Bank,***1927,Globex APAC Logistics Pte. Ltd.,SG,5465404.07
2024-05-08,2024-05-08,Client Receipt - Vertex Advisory Client #6,Sales Receipt,PS-GL,0.0,23222.05,SGD,FAST Credit,Vertex Advisory Client #6,***6278,INV-202405-PS-GL-0011,,False,False,REF-117732,First Continental Bank,***4829,Globex APAC Logistics Pte. Ltd.,SG,5488626.12
2024-05-09,2024-05-09,Client Receipt - Vertex Advisory Client #36,Sales Receipt,PS-GL,0.0,6915.58,SGD,FAST Credit,Vertex Advisory Client #36,***7077,INV-202405-PS-GL-0007,,False,False,REF-491200,First Continental Bank,***8846,Globex APAC Logistics Pte. Ltd.,SG,5495541.7
2024-05-09,2024-05-09,Client Receipt - CloudBridge Co. #8,Sales Receipt,SaaS-GL,0.0,8312.44,SGD,FAST Credit,CloudBridge Co. #8,***7844,INV-202405-SaaS-GL-0002,,False,False,REF-400518,First Continental Bank,***2798,Globex APAC Logistics Pte. Ltd.,SG,5503854.14
2024-05-10,2024-05-10,Client Receipt - Vertex Advisory Client #23,Sales Receipt,PS-GL,0.0,23020.62,SGD,SWIFT MT103,Vertex Advisory Client #23,***5972,INV-202405-PS-GL-0008,,False,False,REF-172552,First Continental Bank,***6660,Globex APAC Logistics Pte. Ltd.,SG,5526874.76
2024-05-11,2024-05-11,Supplier Payment - Port Services #18,Supplier Payment,Logistics-APAC,20007.01,0.0,SGD,SWIFT MT103,Port Services #18,***5916,,PO-202405-Logistics-APAC-0010,False,False,REF-423188,First Continental Bank,***3069,Globex APAC Logistics Pte. Ltd.,SG,5506867.75
2024-05-12,2024-05-12,"Intercompany Settlement - Globex International Holdings, Inc.",Intercompany Transfer,ALL,896360.0,0.0,SGD,Internal Transfer,"Globex International Holdings, Inc.",***1217,,,True,True,REF-307898,First Continental Bank,***7608,Globex APAC Logistics Pte. Ltd.,SG,4610507.75
2024-05-12,2024-05-12,"Intercompany Reimbursement - Globex International Holdings, Inc.",Intercompany Transfer,ALL,0.0,358544.0,SGD,Internal Transfer,"Globex International Holdings, Inc.",***5060,,,True,True,REF-705737,First Continental Bank,***9779,Globex APAC Logistics Pte. Ltd.,SG,4969051.75
2024-05-13,2024-05-13,Supplier Payment - ExpertNet Subcontractors #9,Supplier Payment,PS-GL,18445.53,0.0,SGD,MEPS+,ExpertNet Subcontractors #9,***7984,,PO-202405-PS-GL-0004,False,False,REF-306586,First Continental Bank,***4943,Globex APAC Logistics Pte. Ltd.,SG,4950606.22
2024-05-13,2024-05-13,Supplier Payment - TransAsia Freight #1,Supplier Payment,Logistics-APAC,20560.12,0.0,SGD,MEPS+,TransAsia Freight #1,***1356,,PO-202405-Logistics-APAC-0007,False,False,REF-915905,First Continental Bank,***6787,Globex APAC Logistics Pte. Ltd.,SG,4930046.1
2024-05-13,2024-05-13,Client Receipt - Vertex Advisory Client #52,Sales Receipt,PS-GL,0.0,22444.23,SGD,FAST Credit,Vertex Advisory Client #52,***4018,INV-202405-PS-GL-0005,,False,False,REF-771065,First Continental Bank,***5013,Globex APAC Logistics Pte. Ltd.,SG,4952490.33
2024-05-13,2024-05-13,Client Receipt - Pacific Trade Co. #61,Sales Receipt,Logistics-APAC,0.0,40217.2,SGD,FAST Credit,Pacific Trade Co. #61,***1475,INV-202405-Logistics-APAC-0014,,False,False,REF-577390,First Continental Bank,***6785,Globex APAC Logistics Pte. Ltd.,SG,4992707.53
2024-05-13,2024-05-13,Client Receipt - CloudBridge Co. #62,Sales Receipt,SaaS-GL,0.0,47723.6,SGD,SWIFT MT103,CloudBridge Co. #62,***2589,INV-202405-SaaS-GL-0006,,False,False,REF-654308,First Continental Bank,***3866,Globex APAC Logistics Pte. Ltd.,SG,5040431.13
2024-05-14,2024-05-14,Supplier Payment - TransAsia Freight #31,Supplier Payment,Logistics-APAC,15685.02,0.0,SGD,FAST Debit,TransAsia Freight #31,***6009,,PO-202405-Logistics-APAC-0006,False,False,REF-479939,First Continental Bank,***3299,Globex APAC Logistics Pte. Ltd.,SG,5024746.11
2024-05-14,2024-05-14,Supplier Payment - TransAsia Freight #12,Supplier Payment,Logistics-APAC,41514.82,0.0,SGD,FAST Debit,TransAsia Freight #12,***2730,,PO-202405-Logistics-APAC-0004,False,False,REF-293243,First Continental Bank,***7103,Globex APAC Logistics Pte. Ltd.,SG,4983231.29
2024-05-14,2024-05-14,Client Receipt - Pacific Trade Co. #50,Sales Receipt,Logistics-APAC,0.0,20914.68,SGD,FAST Credit,Pacific Trade Co. #50,***3032,INV-202405-Logistics-APAC-0017,,False,False,REF-362392,First Continental Bank,***8249,Globex APAC Logistics Pte. Ltd.,SG,5004145.97
2024-05-14,2024-05-14,Client Receipt - Vertex Advisory Client #56,Sales Receipt,PS-GL,0.0,30312.97,SGD,SWIFT MT103,Vertex Advisory Client #56,***4055,INV-202405-PS-GL-0009,,False,False,REF-371657,First Continental Bank,***2697,Globex APAC Logistics Pte. Ltd.,SG,5034458.94
2024-05-15,2024-05-15,Supplier Payment - HyperCloud Infra #17,Supplier Payment,SaaS-GL,8060.94,0.0,SGD,SWIFT MT103,HyperCloud Infra #17,***1532,,PO-202405-SaaS-GL-0006,False,False,REF-445946,First Continental Bank,***5105,Globex APAC Logistics Pte. Ltd.,SG,5026398.0
2024-05-15,2024-05-15,Supplier Payment - TransAsia Freight #29,Supplier Payment,Logistics-APAC,40911.91,0.0,SGD,MEPS+,TransAsia Freight #29,***7098,,PO-202405-Logistics-APAC-0011,False,False,REF-436018,First Continental Bank,***1378,Globex APAC Logistics Pte. Ltd.,SG,4985486.09
2024-05-15,2024-05-15,Supplier Payment - TransAsia Freight #19,Supplier Payment,Logistics-APAC,41837.7,0.0,SGD,FAST Debit,TransAsia Freight #19,***4327,,PO-202405-Logistics-APAC-0002,False,False,REF-112876,First Continental Bank,***6823,Globex APAC Logistics Pte. Ltd.,SG,4943648.39
2024-05-15,2024-05-15,Client Receipt - CloudBridge Co. #8,Sales Receipt,SaaS-GL,0.0,10586.68,SGD,SWIFT MT103,CloudBridge Co. #8,***4140,INV-202405-SaaS-GL-0013,,False,False,REF-594918,First Continental Bank,***5315,Globex APAC Logistics Pte. Ltd.,SG,4954235.07
2024-05-15,2024-05-15,Client Receipt - Pacific Trade Co. #51,Sales Receipt,Logistics-APAC,0.0,20661.47,SGD,FAST Credit,Pacific Trade Co. #51,***1258,INV-202405-Logistics-APAC-0008,,False,False,REF-501047,First Continental Bank,***4718,Globex APAC Logistics Pte. Ltd.,SG,4974896.54
2024-05-16,2024-05-16,Client Receipt - CloudBridge Co. #66,Sales Receipt,SaaS-GL,0.0,23795.13,SGD,FAST Credit,CloudBridge Co. #66,***8917,INV-202405-SaaS-GL-0010,,False,False,REF-450709,First Continental Bank,***4265,Globex APAC Logistics Pte. Ltd.,SG,4998691.67
2024-05-17,2024-05-17,Client Receipt - CloudBridge Co. #26,Sales Receipt,SaaS-GL,0.0,25087.95,SGD,SWIFT MT103,CloudBridge Co. #26,***1849,INV-202405-SaaS-GL-0022,,False,False,REF-825356,First Continental Bank,***3500,Globex APAC Logistics Pte. Ltd.,SG,5023779.62
2024-05-19,2024-05-19,VAT/GST Remittance - IRAS Singapore,Tax Payment,ALL,74798.51,0.0,SGD,FAST Debit,IRAS Singapore,***2769,,,False,False,REF-629337,First Continental Bank,***9471,Globex APAC Logistics Pte. Ltd.,SG,4948981.11
2024-05-20,2024-05-20,Supplier Payment - HyperCloud Infra #5,Supplier Payment,SaaS-GL,9182.87,0.0,SGD,SWIFT MT103,HyperCloud Infra #5,***4889,,PO-202405-SaaS-GL-0011,False,False,REF-178269,First Continental Bank,***4888,Globex APAC Logistics Pte. Ltd.,SG,4939798.24
2024-05-20,2024-05-20,Client Receipt - Pacific Trade Co. #30,Sales Receipt,Logistics-APAC,0.0,48121.79,SGD,SWIFT MT103,Pacific Trade Co. #30,***1764,INV-202405-Logistics-APAC-0015,,False,False,REF-528570,First Continental Bank,***9559,Globex APAC Logistics Pte. Ltd.,SG,4987920.03
2024-05-20,2024-05-20,Client Receipt - Vertex Advisory Client #33,Sales Receipt,PS-GL,0.0,71346.18,SGD,FAST Credit,Vertex Advisory Client #33,***4959,INV-202405-PS-GL-0003,,False,False,REF-702751,First Continental Bank,***5767,Globex APAC Logistics Pte. Ltd.,SG,5059266.21
2024-05-21,2024-05-21,Supplier Payment - HyperCloud Infra #5,Supplier Payment,SaaS-GL,7842.91,0.0,SGD,SWIFT MT103,HyperCloud Infra #5,***8716,,PO-202405-SaaS-GL-0012,False,False,REF-434997,First Continental Bank,***9635,Globex APAC Logistics Pte. Ltd.,SG,5051423.3
2024-05-21,2024-05-21,Supplier Payment - TransAsia Freight #24,Supplier Payment,Logistics-APAC,37259.89,0.0,SGD,FAST Debit,TransAsia Freight #24,***3711,,PO-202405-Logistics-APAC-0003,False,False,REF-142232,First Continental Bank,***3349,Globex APAC Logistics Pte. Ltd.,SG,5014163.41
2024-05-21,2024-05-21,Client Receipt - CloudBridge Co. #15,Sales Receipt,SaaS-GL,0.0,5780.02,SGD,FAST Credit,CloudBridge Co. #15,***6510,INV-202405-SaaS-GL-0009,,False,False,REF-284891,First Continental Bank,***1095,Globex APAC Logistics Pte. Ltd.,SG,5019943.43
2024-05-21,2024-05-21,Client Receipt - CloudBridge Co. #53,Sales Receipt,SaaS-GL,0.0,28233.95,SGD,FAST Credit,CloudBridge Co. #53,***4723,INV-202405-SaaS-GL-0019,,False,False,REF-351450,First Continental Bank,***4574,Globex APAC Logistics Pte. Ltd.,SG,5048177.38
2024-05-22,2024-05-22,Supplier Payment - ExpertNet Subcontractors #4,Supplier Payment,PS-GL,20483.47,0.0,SGD,FAST Debit,ExpertNet Subcontractors #4,***9450,,PO-202405-PS-GL-0008,False,False,REF-591245,First Continental Bank,***7945,Globex APAC Logistics Pte. Ltd.,SG,5027693.91
2024-05-22,2024-05-22,Client Receipt - CloudBridge Co. #70,Sales Receipt,SaaS-GL,0.0,2672.07,SGD,FAST Credit,CloudBridge Co. #70,***2632,INV-202405-SaaS-GL-0001,,False,False,REF-278291,First Continental Bank,***2597,Globex APAC Logistics Pte. Ltd.,SG,5030365.98
2024-05-22,2024-05-22,Client Receipt - CloudBridge Co. #11,Sales Receipt,SaaS-GL,0.0,28155.09,SGD,SWIFT MT103,CloudBridge Co. #11,***7296,INV-202405-SaaS-GL-0018,,False,False,REF-156418,First Continental Bank,***8005,Globex APAC Logistics Pte. Ltd.,SG,5058521.07
2024-05-22,2024-05-22,Client Receipt - Vertex Advisory Client #17,Sales Receipt,PS-GL,0.0,66284.87,SGD,FAST Credit,Vertex Advisory Client #17,***6500,INV-202405-PS-GL-0004,,False,False,REF-323583,First Continental Bank,***4765,Globex APAC Logistics Pte. Ltd.,SG,5124805.94
2024-05-23,2024-05-23,Supplier Payment - ExpertNet Subcontractors #8,Supplier Payment,PS-GL,287.38,0.0,SGD,FAST Debit,ExpertNet Subcontractors #8,***2823,,PO-202405-PS-GL-0003,False,False,REF-589279,First Continental Bank,***8025,Globex APAC Logistics Pte. Ltd.,SG,5124518.56
2024-05-23,2024-05-23,Supplier Payment - ExpertNet Subcontractors #1,Supplier Payment,PS-GL,2824.44,0.0,SGD,FAST Debit,ExpertNet Subcontractors #1,***5022,,PO-202405-PS-GL-0007,False,False,REF-504930,First Continental Bank,***9087,Globex APAC Logistics Pte. Ltd.,SG,5121694.12
2024-05-23,2024-05-23,Supplier Payment - CodeCraft Contractors #14,Supplier Payment,SaaS-GL,8394.99,0.0,SGD,SWIFT MT103,CodeCraft Contractors #14,***4875,,PO-202405-SaaS-GL-0003,False,False,REF-888826,First Continental Bank,***7261,Globex APAC Logistics Pte. Ltd.,SG,5113299.13
2024-05-23,2024-05-23,Client Receipt - Pacific Trade Co. #54,Sales Receipt,Logistics-APAC,0.0,28530.19,SGD,SWIFT MT103,Pacific Trade Co. #54,***4353,INV-202405-Logistics-APAC-0016,,False,False,REF-468976,First Continental Bank,***5127,Globex APAC Logistics Pte. Ltd.,SG,5141829.32
2024-05-24,2024-05-24,Merchant Processing Fees,Bank/Merchant Fees,ALL,258.66,0.0,SGD,MEPS+,First Continental Bank,***7185,,,False,False,REF-113806,First Continental Bank,***9704,Globex APAC Logistics Pte. Ltd.,SG,5141570.66
2024-05-24,2024-05-24,Client Receipt - Pacific Trade Co. #15,Sales Receipt,Logistics-APAC,0.0,7322.64,SGD,SWIFT MT103,Pacific Trade Co. #15,***4627,INV-202405-Logistics-APAC-0009,,False,False,REF-598558,First Continental Bank,***3734,Globex APAC Logistics Pte. Ltd.,SG,5148893.3
2024-05-24,2024-05-24,Client Receipt - CloudBridge Co. #68,Sales Receipt,SaaS-GL,0.0,14613.6,SGD,SWIFT MT103,CloudBridge Co. #68,***2846,INV-202405-SaaS-GL-0014,,False,False,REF-214845,First Continental Bank,***4043,Globex APAC Logistics Pte. Ltd.,SG,5163506.9
2024-05-24,2024-05-24,Client Receipt - CloudBridge Co. #56,Sales Receipt,SaaS-GL,0.0,32248.56,SGD,SWIFT MT103,CloudBridge Co. #56,***6883,INV-202405-SaaS-GL-0003,,False,False,REF-726957,First Continental Bank,***1865,Globex APAC Logistics Pte. Ltd.,SG,5195755.46
2024-05-25,2024-05-25,Supplier Payment - ExpertNet Subcontractors #10,Supplier Payment,PS-GL,3929.88,0.0,SGD,MEPS+,ExpertNet Subcontractors #10,***8163,,PO-202405-PS-GL-0006,False,False,REF-494016,First Continental Bank,***3226,Globex APAC Logistics Pte. Ltd.,SG,5191825.58
2024-05-26,2024-05-26,Intercompany Settlement - Globex EMEA Manufacturing Ltd.,Intercompany Transfer,ALL,265273.0,0.0,SGD,Internal Transfer,Globex EMEA Manufacturing Ltd.,***1713,,,True,True,REF-396709,First Continental Bank,***7520,Globex APAC Logistics Pte. Ltd.,SG,4926552.58
2024-05-26,2024-05-26,Client Receipt - CloudBridge Co. #1,Sales Receipt,SaaS-GL,0.0,27561.76,SGD,SWIFT MT103,CloudBridge Co. #1,***5049,INV-202405-SaaS-GL-0015,,False,False,REF-332005,First Continental Bank,***2106,Globex APAC Logistics Pte. Ltd.,SG,4954114.34
2024-05-26,2024-05-26,Client Receipt - CloudBridge Co. #32,Sales Receipt,SaaS-GL,0.0,44605.82,SGD,SWIFT MT103,CloudBridge Co. #32,***3535,INV-202405-SaaS-GL-0016,,False,False,REF-494340,First Continental Bank,***8017,Globex APAC Logistics Pte. Ltd.,SG,4998720.16
2024-05-26,2024-05-26,Intercompany Reimbursement - Globex EMEA Manufacturing Ltd.,Intercompany Transfer,ALL,0.0,106109.2,SGD,Internal Transfer,Globex EMEA Manufacturing Ltd.,***9411,,,True,True,REF-487672,First Continental Bank,***2445,Globex APAC Logistics Pte. Ltd.,SG,5104829.36
2024-05-27,2024-05-27,Supplier Payment - ExpertNet Subcontractors #1,Supplier Payment,PS-GL,14885.23,0.0,SGD,FAST Debit,ExpertNet Subcontractors #1,***3377,,PO-202405-PS-GL-0002,False,False,REF-202617,First Continental Bank,***1649,Globex APAC Logistics Pte. Ltd.,SG,5089944.13
2024-05-28,2024-05-28,Marketing - Beacon Digital #1,Marketing,ALL,13400.7,0.0,SGD,MEPS+,Beacon Digital #1,***9264,,,False,False,REF-772053,First Continental Bank,***5697,Globex APAC Logistics Pte. Ltd.,SG,5076543.43
2024-05-28,2024-05-28,Supplier Payment - HyperCloud Infra #3,Supplier Payment,SaaS-GL,16103.23,0.0,SGD,FAST Debit,HyperCloud Infra #3,***1843,,PO-202405-SaaS-GL-0001,False,False,REF-393696,First Continental Bank,***3351,Globex APAC Logistics Pte. Ltd.,SG,5060440.2
2024-05-28,2024-05-28,Marketing - Aurelia Media #3,Marketing,ALL,18585.85,0.0,SGD,FAST Debit,Aurelia Media #3,***3600,,,False,False,REF-144965,First Continental Bank,***4623,Globex APAC Logistics Pte. Ltd.,SG,5041854.35
2024-05-28,2024-05-28,Client Receipt - Pacific Trade Co. #24,Sales Receipt,Logistics-APAC,0.0,5818.18,SGD,FAST Credit,Pacific Trade Co. #24,***7117,INV-202405-Logistics-APAC-0007,,False,False,REF-311318,First Continental Bank,***1785,Globex APAC Logistics Pte. Ltd.,SG,5047672.53
2024-05-28,2024-05-28,Client Receipt - Pacific Trade Co. #40,Sales Receipt,Logistics-APAC,0.0,66893.13,SGD,FAST Credit,Pacific Trade Co. #40,***3374,INV-202405-Logistics-APAC-0010,,False,False,REF-669362,First Continental Bank,***6208,Globex APAC Logistics Pte. Ltd.,SG,5114565.66
2024-05-29,2024-05-29,Supplier Payment - HyperCloud Infra #8,Supplier Payment,SaaS-GL,1511.3,0.0,SGD,FAST Debit,HyperCloud Infra #8,***1977,,PO-202405-SaaS-GL-0004,False,False,REF-428874,First Continental Bank,***9655,Globex APAC Logistics Pte. Ltd.,SG,5113054.36
2024-05-29,2024-05-29,Payroll - GlobalPay Services Ltd,Payroll,ALL,206068.12,0.0,SGD,MEPS+,GlobalPay Services Ltd,***3967,,,False,False,REF-718460,First Continental Bank,***3350,Globex APAC Logistics Pte. Ltd.,SG,4906986.24
2024-05-29,2024-05-29,Client Receipt - CloudBridge Co. #22,Sales Receipt,SaaS-GL,0.0,3113.49,SGD,FAST Credit,CloudBridge Co. #22,***3310,INV-202405-SaaS-GL-0011,,False,False,REF-241442,First Continental Bank,***4855,Globex APAC Logistics Pte. Ltd.,SG,4910099.73
2024-05-29,2024-05-29,Client Receipt - CloudBridge Co. #64,Sales Receipt,SaaS-GL,0.0,6187.17,SGD,SWIFT MT103,CloudBridge Co. #64,***8057,INV-202405-SaaS-GL-0012,,False,False,REF-558395,First Continental Bank,***3174,Globex APAC Logistics Pte. Ltd.,SG,4916286.9
2024-05-29,2024-05-29,Client Receipt - Pacific Trade Co. #11,Sales Receipt,Logistics-APAC,0.0,27698.31,SGD,FAST Credit,Pacific Trade Co. #11,***7493,INV-202405-Logistics-APAC-0011,,False,False,REF-944618,First Continental Bank,***6904,Globex APAC Logistics Pte. Ltd.,SG,4943985.21
2024-05-30,2024-05-30,Merchant Processing Fees,Bank/Merchant Fees,ALL,3489.53,0.0,SGD,FAST Debit,First Continental Bank,***4382,,,False,False,REF-146590,First Continental Bank,***5724,Globex APAC Logistics Pte. Ltd.,SG,4940495.68
2024-05-30,2024-05-30,Metro Water & Waste,Rent & Utilities,ALL,10353.67,0.0,SGD,FAST Debit,Metro Water & Waste,***6563,,,False,False,REF-162820,First Continental Bank,***1164,Globex APAC Logistics Pte. Ltd.,SG,4930142.01
2024-05-30,2024-05-30,Interest Earned,Interest Income,ALL,0.0,10461.09,SGD,FAST Credit,First Continental Bank,***3794,,,False,False,REF-605422,First Continental Bank,***6263,Globex APAC Logistics Pte. Ltd.,SG,4940603.1
2024-05-31,2024-05-31,Supplier Payment - TransAsia Freight #3,Supplier Payment,Logistics-APAC,11742.44,0.0,SGD,FAST Debit,TransAsia Freight #3,***6430,,PO-202405-Logistics-APAC-0009,False,False,REF-307379,First Continental Bank,***7261,Globex APAC Logistics Pte. Ltd.,SG,4928860.66
2024-05-31,2024-05-31,Supplier Payment - ExpertNet Subcontractors #17,Supplier Payment,PS-GL,14722.09,0.0,SGD,SWIFT MT103,ExpertNet Subcontractors #17,***7821,,PO-202405-PS-GL-0009,False,False,REF-258656,First Continental Bank,***2946,Globex APAC Logistics Pte. Ltd.,SG,4914138.57
2024-05-31,2024-05-31,Client Receipt - Vertex Advisory Client #11,Sales Receipt,PS-GL,0.0,532.81,SGD,SWIFT MT103,Vertex Advisory Client #11,***8757,INV-202405-PS-GL-0001,,False,False,REF-797863,First Continental Bank,***5169,Globex APAC Logistics Pte. Ltd.,SG,4914671.38
2024-05-31,2024-05-31,Client Receipt - CloudBridge Co. #34,Sales Receipt,SaaS-GL,0.0,2071.03,SGD,FAST Credit,CloudBridge Co. #34,***4019,INV-202405-SaaS-GL-0008,,False,False,REF-878824,First Continental Bank,***2737,Globex APAC Logistics Pte. Ltd.,SG,4916742.41
2024-05-31,2024-05-31,Client Receipt - CloudBridge Co. #47,Sales Receipt,SaaS-GL,0.0,14928.48,SGD,FAST Credit,CloudBridge Co. #47,***4049,INV-202405-SaaS-GL-0021,,False,False,REF-291340,First Continental Bank,***1600,Globex APAC Logistics Pte. Ltd.,SG,4931670.89
2024-05-31,2024-05-31,Client Receipt - Pacific Trade Co. #12,Sales Receipt,Logistics-APAC,0.0,22425.91,SGD,FAST Credit,Pacific Trade Co. #12,***8974,INV-202405-Logistics-APAC-0002,,False,False,REF-118687,First Continental Bank,***7519,Globex APAC Logistics Pte. Ltd.,SG,4954096.8
2024-06-01,2024-06-01,Account Maintenance Fee,Bank/Merchant Fees,ALL,2500.0,0.0,SGD,FAST Debit,First Continental Bank,***7920,,,False,False,REF-718302,First Continental Bank,***7900,Globex APAC Logistics Pte. Ltd.,SG,4951596.8
2024-06-02,2024-06-02,Supplier Payment - ExpertNet Subcontractors #17,Supplier Payment,PS-GL,4310.24,0.0,SGD,SWIFT MT103,ExpertNet Subcontractors #17,***1101,,PO-202406-PS-GL-0002,False,False,REF-530045,First Continental Bank,***4854,Globex APAC Logistics Pte. Ltd.,SG,4947286.56
2024-06-03,2024-06-03,Supplier Payment - HyperCloud Infra #3,Supplier Payment,SaaS-GL,2421.36,0.0,SGD,FAST Debit,HyperCloud Infra #3,***2999,,PO-202406-SaaS-GL-0005,False,False,REF-520927,First Continental Bank,***6437,Globex APAC Logistics Pte. Ltd.,SG,4944865.2
2024-06-03,2024-06-03,Client Receipt - CloudBridge Co. #38,Sales Receipt,SaaS-GL,0.0,1913.75,SGD,FAST Credit,CloudBridge Co. #38,***9439,INV-202406-SaaS-GL-0022,,False,False,REF-919728,First Continental Bank,***8954,Globex APAC Logistics Pte. Ltd.,SG,4946778.95
2024-06-03,2024-06-03,Client Receipt - CloudBridge Co. #38,Sales Receipt,SaaS-GL,0.0,8093.02,SGD,FAST Credit,CloudBridge Co. #38,***7889,INV-202406-SaaS-GL-0010,,False,False,REF-352576,First Continental Bank,***5834,Globex APAC Logistics Pte. Ltd.,SG,4954871.97
2024-06-03,2024-06-03,Client Receipt - Vertex Advisory Client #27,Sales Receipt,PS-GL,0.0,32397.78,SGD,SWIFT MT103,Vertex Advisory Client #27,***1813,INV-202406-PS-GL-0003,,False,False,REF-600069,First Continental Bank,***5586,Globex APAC Logistics Pte. Ltd.,SG,4987269.75
2024-06-03,2024-06-03,Client Receipt - CloudBridge Co. #26,Sales Receipt,SaaS-GL,0.0,32480.51,SGD,FAST Credit,CloudBridge Co. #26,***2726,INV-202406-SaaS-GL-0023,,False,False,REF-688864,First Continental Bank,***5037,Globex APAC Logistics Pte. Ltd.,SG,5019750.26
2024-06-03,2024-06-03,Client Receipt - CloudBridge Co. #16,Sales Receipt,SaaS-GL,0.0,57635.97,SGD,SWIFT MT103,CloudBridge Co. #16,***1292,INV-202406-SaaS-GL-0011,,False,False,REF-946075,First Continental Bank,***5628,Globex APAC Logistics Pte. Ltd.,SG,5077386.23
2024-06-04,2024-06-04,Supplier Payment - TransAsia Freight #11,Supplier Payment,Logistics-APAC,15361.29,0.0,SGD,MEPS+,TransAsia Freight #11,***7100,,PO-202406-Logistics-APAC-0010,False,False,REF-259692,First Continental Bank,***8101,Globex APAC Logistics Pte. Ltd.,SG,5062024.94
2024-06-04,2024-06-04,Client Receipt - CloudBridge Co. #13,Sales Receipt,SaaS-GL,0.0,9675.45,SGD,SWIFT MT103,CloudBridge Co. #13,***1742,INV-202406-SaaS-GL-0009,,False,False,REF-269098,First Continental Bank,***7902,Globex APAC Logistics Pte. Ltd.,SG,5071700.39
2024-06-04,2024-06-04,Client Receipt - CloudBridge Co. #77,Sales Receipt,SaaS-GL,0.0,24825.45,SGD,FAST Credit,CloudBridge Co. #77,***7809,INV-202406-SaaS-GL-0005,,False,False,REF-305398,First Continental Bank,***4202,Globex APAC Logistics Pte. Ltd.,SG,5096525.84
2024-06-05,2024-06-05,Supplier Payment - CodeCraft Contractors #13,Supplier Payment,SaaS-GL,2376.69,0.0,SGD,MEPS+,CodeCraft Contractors #13,***1149,,PO-202406-SaaS-GL-0004,False,False,REF-175027,First Continental Bank,***8836,Globex APAC Logistics Pte. Ltd.,SG,5094149.15
2024-06-05,2024-06-05,Supplier Payment - TransAsia Freight #26,Supplier Payment,Logistics-APAC,4773.59,0.0,SGD,MEPS+,TransAsia Freight #26,***8745,,PO-202406-Logistics-APAC-0001,False,False,REF-604988,First Continental Bank,***3455,Globex APAC Logistics Pte. Ltd.,SG,5089375.56
2024-06-05,2024-06-05,Supplier Payment - ExpertNet Subcontractors #11,Supplier Payment,PS-GL,6810.11,0.0,SGD,SWIFT MT103,ExpertNet Subcontractors #11,***2457,,PO-202406-PS-GL-0010,False,False,REF-131109,First Continental Bank,***2372,Globex APAC Logistics Pte. Ltd.,SG,5082565.45
2024-06-06,2024-06-06,Supplier Payment - TransAsia Freight #18,Supplier Payment,Logistics-APAC,22762.59,0.0,SGD,MEPS+,TransAsia Freight #18,***3643,,PO-202406-Logistics-APAC-0009,False,False,REF-899445,First Continental Bank,***4184,Globex APAC Logistics Pte. Ltd.,SG,5059802.86
2024-06-07,2024-06-07,Client Receipt - Pacific Trade Co. #41,Sales Receipt,Logistics-APAC,0.0,27305.21,SGD,FAST Credit,Pacific Trade Co. #41,***7590,INV-202406-Logistics-APAC-0003,,False,False,REF-972997,First Continental Bank,***6149,Globex APAC Logistics Pte. Ltd.,SG,5087108.07
2024-06-07,2024-06-07,Client Receipt - Pacific Trade Co. #56,Sales Receipt,Logistics-APAC,0.0,40478.51,SGD,SWIFT MT103,Pacific Trade Co. #56,***8234,INV-202406-Logistics-APAC-0006,,False,False,REF-208106,First Continental Bank,***3266,Globex APAC Logistics Pte. Ltd.,SG,5127586.58
2024-06-08,2024-06-08,Client Receipt - Vertex Advisory Client #31,Sales Receipt,PS-GL,0.0,14507.94,SGD,SWIFT MT103,Vertex Advisory Client #31,***1056,INV-202406-PS-GL-0004,,False,False,REF-894607,First Continental Bank,***6588,Globex APAC Logistics Pte. Ltd.,SG,5142094.52
2024-06-09,2024-06-09,Supplier Payment - TransAsia Freight #8,Supplier Payment,Logistics-APAC,288.02,0.0,SGD,FAST Debit,TransAsia Freight #8,***8200,,PO-202406-Logistics-APAC-0006,False,False,REF-184233,First Continental Bank,***3515,Globex APAC Logistics Pte. Ltd.,SG,5141806.5
2024-06-09,2024-06-09,Merchant Processing Fees,Bank/Merchant Fees,ALL,2541.23,0.0,SGD,FAST Debit,First Continental Bank,***1616,,,False,False,REF-991724,First Continental Bank,***5985,Globex APAC Logistics Pte. Ltd.,SG,5139265.27
2024-06-10,2024-06-10,Supplier Payment - CodeCraft Contractors #13,Supplier Payment,SaaS-GL,1530.29,0.0,SGD,FAST Debit,CodeCraft Contractors #13,***6876,,PO-202406-SaaS-GL-0010,False,False,REF-760231,First Continental Bank,***9435,Globex APAC Logistics Pte. Ltd.,SG,5137734.98
2024-06-10,2024-06-10,Supplier Payment - CodeCraft Contractors #6,Supplier Payment,SaaS-GL,17631.64,0.0,SGD,SWIFT MT103,CodeCraft Contractors #6,***1955,,PO-202406-SaaS-GL-0007,False,False,REF-866064,First Continental Bank,***4409,Globex APAC Logistics Pte. Ltd.,SG,5120103.34
2024-06-10,2024-06-10,Client Receipt - Vertex Advisory Client #45,Sales Receipt,PS-GL,0.0,4943.99,SGD,FAST Credit,Vertex Advisory Client #45,***8320,INV-202406-PS-GL-0010,,False,False,REF-642060,First Continental Bank,***9427,Globex APAC Logistics Pte. Ltd.,SG,5125047.33
2024-06-10,2024-06-10,Client Receipt - CloudBridge Co. #60,Sales Receipt,SaaS-GL,0.0,9545.06,SGD,SWIFT MT103,CloudBridge Co. #60,***5099,INV-202406-SaaS-GL-0020,,False,False,REF-418785,First Continental Bank,***1210,Globex APAC Logistics Pte. Ltd.,SG,5134592.39
2024-06-11,2024-06-11,Supplier Payment - ExpertNet Subcontractors #9,Supplier Payment,PS-GL,2846.2,0.0,SGD,FAST Debit,ExpertNet Subcontractors #9,***1028,,PO-202406-PS-GL-0007,False,False,REF-816699,First Continental Bank,***3823,Globex APAC Logistics Pte. Ltd.,SG,5131746.19
2024-06-11,2024-06-11,Client Receipt - CloudBridge Co. #12,Sales Receipt,SaaS-GL,0.0,2557.64,SGD,SWIFT MT103,CloudBridge Co. #12,***5287,INV-202406-SaaS-GL-0002,,False,False,REF-262794,First Continental Bank,***8343,Globex APAC Logistics Pte. Ltd.,SG,5134303.83
2024-06-11,2024-06-11,Client Receipt - Pacific Trade Co. #45,Sales Receipt,Logistics-APAC,0.0,3642.82,SGD,SWIFT MT103,Pacific Trade Co. #45,***5779,INV-202406-Logistics-APAC-0009,,False,False,REF-716494,First Continental Bank,***9737,Globex APAC Logistics Pte. Ltd.,SG,5137946.65
2024-06-11,2024-06-11,Client Receipt - CloudBridge Co. #21,Sales Receipt,SaaS-GL,0.0,13415.86,SGD,SWIFT MT103,CloudBridge Co. #21,***4991,INV-202406-SaaS-GL-0012,,False,False,REF-838172,First Continental Bank,***8222,Globex APAC Logistics Pte. Ltd.,SG,5151362.51
2024-06-11,2024-06-11,Client Receipt - Vertex Advisory Client #30,Sales Receipt,PS-GL,0.0,24275.14,SGD,SWIFT MT103,Vertex Advisory Client #30,***2974,INV-202406-PS-GL-0012,,False,False,REF-443044,First Continental Bank,***3359,Globex APAC Logistics Pte. Ltd.,SG,5175637.65
2024-06-11,2024-06-11,Client Receipt - Vertex Advisory Client #25,Sales Receipt,PS-GL,0.0,35278.06,SGD,SWIFT MT103,Vertex Advisory Client #25,***2543,INV-202406-PS-GL-0006,,False,False,REF-338309,First Continental Bank,***1577,Globex APAC Logistics Pte. Ltd.,SG,5210915.71
2024-06-12,2024-06-12,Supplier Payment - CodeCraft Contractors #6,Supplier Payment,SaaS-GL,3519.2,0.0,SGD,MEPS+,CodeCraft Contractors #6,***2186,,PO-202406-SaaS-GL-0001,False,False,REF-669581,First Continental Bank,***3540,Globex APAC Logistics Pte. Ltd.,SG,5207396.51
2024-06-12,2024-06-12,Northshore Power,Rent & Utilities,ALL,3776.14,0.0,SGD,MEPS+,Northshore Power,***7803,,,False,False,REF-532653,First Continental Bank,***6321,Globex APAC Logistics Pte. Ltd.,SG,5203620.37
2024-06-12,2024-06-12,Supplier Payment - HyperCloud Infra #2,Supplier Payment,SaaS-GL,6771.08,0.0,SGD,FAST Debit,HyperCloud Infra #2,***9035,,PO-202406-SaaS-GL-0012,False,False,REF-477766,First Continental Bank,***2725,Globex APAC Logistics Pte. Ltd.,SG,5196849.29
2024-06-12,2024-06-12,Intercompany Settlement - Globex EMEA Manufacturing Ltd.,Intercompany Transfer,ALL,814177.0,0.0,SGD,Internal Transfer,Globex EMEA Manufacturing Ltd.,***6762,,,True,True,REF-844256,First Continental Bank,***5156,Globex APAC Logistics Pte. Ltd.,SG,4382672.29
2024-06-12,2024-06-12,Client Receipt - CloudBridge Co. #3,Sales Receipt,SaaS-GL,0.0,5290.72,SGD,FAST Credit,CloudBridge Co. #3,***7389,INV-202406-SaaS-GL-0018,,False,False,REF-283366,First Continental Bank,***8158,Globex APAC Logistics Pte. Ltd.,SG,4387963.01
2024-06-12,2024-06-12,Client Receipt - Vertex Advisory Client #38,Sales Receipt,PS-GL,0.0,7018.31,SGD,FAST Credit,Vertex Advisory Client #38,***9506,INV-202406-PS-GL-0011,,False,False,REF-867784,First Continental Bank,***7507,Globex APAC Logistics Pte. Ltd.,SG,4394981.32
2024-06-12,2024-06-12,Client Receipt - Pacific Trade Co. #67,Sales Receipt,Logistics-APAC,0.0,32435.54,SGD,SWIFT MT103,Pacific Trade Co. #67,***8597,INV-202406-Logistics-APAC-0004,,False,False,REF-468276,First Continental Bank,***7598,Globex APAC Logistics Pte. Ltd.,SG,4427416.86
2024-06-12,2024-06-12,Intercompany Reimbursement - Globex EMEA Manufacturing Ltd.,Intercompany Transfer,ALL,0.0,325670.8,SGD,Internal Transfer,Globex EMEA Manufacturing Ltd.,***9186,,,True,True,REF-926714,First Continental Bank,***8255,Globex APAC Logistics Pte. Ltd.,SG,4753087.66
2024-06-13,2024-06-13,Supplier Payment - CodeCraft Contractors #8,Supplier Payment,SaaS-GL,11729.55,0.0,SGD,MEPS+,CodeCraft Contractors #8,***2132,,PO-202406-SaaS-GL-0011,False,False,REF-431883,First Continental Bank,***9048,Globex APAC Logistics Pte. Ltd.,SG,4741358.11
2024-06-13,2024-06-13,Supplier Payment - ExpertNet Subcontractors #1,Supplier Payment,PS-GL,22018.36,0.0,SGD,SWIFT MT103,ExpertNet Subcontractors #1,***9008,,PO-202406-PS-GL-0006,False,False,REF-802827,First Continental Bank,***8274,Globex APAC Logistics Pte. Ltd.,SG,4719339.75
2024-06-13,2024-06-13,Client Receipt - Vertex Advisory Client #10,Sales Receipt,PS-GL,0.0,16890.04,SGD,FAST Credit,Vertex Advisory Client #10,***5674,INV-202406-PS-GL-0009,,False,False,REF-927136,First Continental Bank,***3341,Globex APAC Logistics Pte. Ltd.,SG,4736229.79
2024-06-13,2024-06-13,Client Receipt - Vertex Advisory Client #38,Sales Receipt,PS-GL,0.0,23529.25,SGD,FAST Credit,Vertex Advisory Client #38,***2351,INV-202406-PS-GL-0002,,False,False,REF-846095,First Continental Bank,***3903,Globex APAC Logistics Pte. Ltd.,SG,4759759.04
2024-06-13,2024-06-13,Client Receipt - Vertex Advisory Client #33,Sales Receipt,PS-GL,0.0,24260.35,SGD,SWIFT MT103,Vertex Advisory Client #33,***3170,INV-202406-PS-GL-0005,,False,False,REF-480807,First Continental Bank,***4754,Globex APAC Logistics Pte. Ltd.,SG,4784019.39
2024-06-13,2024-06-13,Client Receipt - Vertex Advisory Client #3,Sales Receipt,PS-GL,0.0,46124.14,SGD,SWIFT MT103,Vertex Advisory Client #3,***3879,INV-202406-PS-GL-0007,,False,False,REF-953895,First Continental Bank,***1266,Globex APAC Logistics Pte. Ltd.,SG,4830143.53
2024-06-14,2024-06-14,Marketing - Beacon Digital #8,Marketing,ALL,13776.21,0.0,SGD,SWIFT MT103,Beacon Digital #8,***6044,,,False,False,REF-476076,First Continental Bank,***9463,Globex APAC Logistics Pte. Ltd.,SG,4816367.32
2024-06-14,2024-06-14,Supplier Payment - ExpertNet Subcontractors #18,Supplier Payment,PS-GL,15895.92,0.0,SGD,SWIFT MT103,ExpertNet Subcontractors #18,***2238,,PO-202406-PS-GL-0004,False,False,REF-986610,First Continental Bank,***6149,Globex APAC Logistics Pte. Ltd.,SG,4800471.4
2024-06-14,2024-06-14,Supplier Payment - ExpertNet Subcontractors #4,Supplier Payment,PS-GL,16553.69,0.0,SGD,SWIFT MT103,ExpertNet Subcontractors #4,***3827,,PO-202406-PS-GL-0008,False,False,REF-568314,First Continental Bank,***9119,Globex APAC Logistics Pte. Ltd.,SG,4783917.71
2024-06-14,2024-06-14,Supplier Payment - HyperCloud Infra #9,Supplier Payment,SaaS-GL,22942.28,0.0,SGD,MEPS+,HyperCloud Infra #9,***9232,,PO-202406-SaaS-GL-0008,False,False,REF-767183,First Continental Bank,***2725,Globex APAC Logistics Pte. Ltd.,SG,4760975.43
2024-06-14,2024-06-14,Supplier Payment - TransAsia Freight #15,Supplier Payment,Logistics-APAC,63795.23,0.0,SGD,MEPS+,TransAsia Freight #15,***1849,,PO-202406-Logistics-APAC-0007,False,False,REF-479536,First Continental Bank,***5260,Globex APAC Logistics Pte. Ltd.,SG,4697180.2
2024-06-14,2024-06-14,Supplier Payment - TransAsia Freight #27,Supplier Payment,Logistics-APAC,88514.75,0.0,SGD,MEPS+,TransAsia Freight #27,***1469,,PO-202406-Logistics-APAC-0004,False,False,REF-935253,First Continental Bank,***9916,Globex APAC Logistics Pte. Ltd.,SG,4608665.45
2024-06-14,2024-06-14,Client Receipt - CloudBridge Co. #69,Sales Receipt,SaaS-GL,0.0,11658.34,SGD,SWIFT MT103,CloudBridge Co. #69,***1625,INV-202406-SaaS-GL-0013,,False,False,REF-841388,First Continental Bank,***2062,Globex APAC Logistics Pte. Ltd.,SG,4620323.79
2024-06-14,2024-06-14,Client Receipt - Pacific Trade Co. #27,Sales Receipt,Logistics-APAC,0.0,49539.13,SGD,FAST Credit,Pacific Trade Co. #27,***8508,INV-202406-Logistics-APAC-0002,,False,False,REF-580763,First Continental Bank,***7938,Globex APAC Logistics Pte. Ltd.,SG,4669862.92
2024-06-15,2024-06-15,Client Receipt - CloudBridge Co. #34,Sales Receipt,SaaS-GL,0.0,12293.1,SGD,SWIFT MT103,CloudBridge Co. #34,***7732,INV-202406-SaaS-GL-0001,,False,False,REF-228324,First Continental Bank,***7070,Globex APAC Logistics Pte. Ltd.,SG,4682156.02
2024-06-15,2024-06-15,Client Receipt - CloudBridge Co. #21,Sales Receipt,SaaS-GL,0.0,23137.49,SGD,SWIFT MT103,CloudBridge Co. #21,***6862,INV-202406-SaaS-GL-0019,,False,False,REF-428503,First Continental Bank,***1317,Globex APAC Logistics Pte. Ltd.,SG,4705293.51
2024-06-17,2024-06-17,Supplier Payment - TransAsia Freight #25,Supplier Payment,Logistics-APAC,66714.49,0.0,SGD,FAST Debit,TransAsia Freight #25,***8389,,PO-202406-Logistics-APAC-0008,False,False,REF-304527,First Continental Bank,***7744,Globex APAC Logistics Pte. Ltd.,SG,4638579.02
2024-06-17,2024-06-17,Client Receipt - CloudBridge Co. #57,Sales Receipt,SaaS-GL,0.0,41074.82,SGD,SWIFT MT103,CloudBridge Co. #57,***9835,INV-202406-SaaS-GL-0008,,False,False,REF-773851,First Continental Bank,***9661,Globex APAC Logistics Pte. Ltd.,SG,4679653.84
2024-06-18,2024-06-18,Client Receipt - CloudBridge Co. #51,Sales Receipt,SaaS-GL,0.0,1519.92,SGD,FAST Credit,CloudBridge Co. #51,***4785,INV-202406-SaaS-GL-0003,,False,False,REF-194508,First Continental Bank,***8786,Globex APAC Logistics Pte. Ltd.,SG,4681173.76
2024-06-18,2024-06-18,Client Receipt - CloudBridge Co. #36,Sales Receipt,SaaS-GL,0.0,36432.94,SGD,SWIFT MT103,CloudBridge Co. #36,***2676,INV-202406-SaaS-GL-0021,,False,False,REF-468507,First Continental Bank,***1170,Globex APAC Logistics Pte. Ltd.,SG,4717606.7
2024-06-18,2024-06-18,Client Receipt - Pacific Trade Co. #45,Sales Receipt,Logistics-APAC,0.0,167133.01,SGD,SWIFT MT103,Pacific Trade Co. #45,***3558,INV-202406-Logistics-APAC-0007,,False,False,REF-924037,First Continental Bank,***5085,Globex APAC Logistics Pte. Ltd.,SG,4884739.71
2024-06-19,2024-06-19,VAT/GST Remittance - IRAS Singapore,Tax Payment,ALL,78006.53,0.0,SGD,FAST Debit,IRAS Singapore,***8831,,,False,False,REF-604190,First Continental Bank,***6031,Globex APAC Logistics Pte. Ltd.,SG,4806733.18
2024-06-19,2024-06-19,Client Receipt - CloudBridge Co. #36,Sales Receipt,SaaS-GL,0.0,6210.28,SGD,SWIFT MT103,CloudBridge Co. #36,***9258,INV-202406-SaaS-GL-0006,,False,False,REF-189151,First Continental Bank,***6232,Globex APAC Logistics Pte. Ltd.,SG,4812943.46
2024-06-19,2024-06-19,Client Receipt - CloudBridge Co. #76,Sales Receipt,SaaS-GL,0.0,32042.68,SGD,SWIFT MT103,CloudBridge Co. #76,***5872,INV-202406-SaaS-GL-0004,,False,False,REF-623220,First Continental Bank,***2583,Globex APAC Logistics Pte. Ltd.,SG,4844986.14
2024-06-19,2024-06-19,Client Receipt - Vertex Advisory Client #45,Sales Receipt,PS-GL,0.0,37861.87,SGD,SWIFT MT103,Vertex Advisory Client #45,***2843,INV-202406-PS-GL-0001,,False,False,REF-984367,First Continental Bank,***8366,Globex APAC Logistics Pte. Ltd.,SG,4882848.01
2024-06-20,2024-06-20,Metro Water & Waste,Rent & Utilities,ALL,6557.05,0.0,SGD,SWIFT MT103,Metro Water & Waste,***6881,,,False,False,REF-837175,First Continental Bank,***1690,Globex APAC Logistics Pte. Ltd.,SG,4876290.96
2024-06-20,2024-06-20,Client Receipt - CloudBridge Co. #67,Sales Receipt,SaaS-GL,0.0,21480.48,SGD,SWIFT MT103,CloudBridge Co. #67,***4770,INV-202406-SaaS-GL-0016,,False,False,REF-844462,First Continental Bank,***1297,Globex APAC Logistics Pte. Ltd.,SG,4897771.44
2024-06-21,2024-06-21,Supplier Payment - HyperCloud Infra #9,Supplier Payment,SaaS-GL,801.15,0.0,SGD,FAST Debit,HyperCloud Infra #9,***7191,,PO-202406-SaaS-GL-0006,False,False,REF-489247,First Continental Bank,***4395,Globex APAC Logistics Pte. Ltd.,SG,4896970.29
2024-06-21,2024-06-21,Supplier Payment - ExpertNet Subcontractors #15,Supplier Payment,PS-GL,4719.54,0.0,SGD,FAST Debit,ExpertNet Subcontractors #15,***9729,,PO-202406-PS-GL-0005,False,False,REF-981163,First Continental Bank,***8121,Globex APAC Logistics Pte. Ltd.,SG,4892250.75
2024-06-21,2024-06-21,Supplier Payment - TransAsia Freight #42,Supplier Payment,Logistics-APAC,10853.25,0.0,SGD,MEPS+,TransAsia Freight #42,***6465,,PO-202406-Logistics-APAC-0011,False,False,REF-890597,First Continental Bank,***6944,Globex APAC Logistics Pte. Ltd.,SG,4881397.5
2024-06-21,2024-06-21,Client Receipt - CloudBridge Co. #10,Sales Receipt,SaaS-GL,0.0,40356.0,SGD,SWIFT MT103,CloudBridge Co. #10,***7018,INV-202406-SaaS-GL-0015,,False,False,REF-138595,First Continental Bank,***7720,Globex APAC Logistics Pte. Ltd.,SG,4921753.5
2024-06-22,2024-06-22,Supplier Payment - ExpertNet Subcontractors #4,Supplier Payment,PS-GL,11601.0,0.0,SGD,SWIFT MT103,ExpertNet Subcontractors #4,***8678,,PO-202406-PS-GL-0011,False,False,REF-263628,First Continental Bank,***1170,Globex APAC Logistics Pte. Ltd.,SG,4910152.5
2024-06-22,2024-06-22,Supplier Payment - Port Services #8,Supplier Payment,Logistics-APAC,26283.32,0.0,SGD,SWIFT MT103,Port Services #8,***8141,,PO-202406-Logistics-APAC-0002,False,False,REF-981984,First Continental Bank,***2775,Globex APAC Logistics Pte. Ltd.,SG,4883869.18
2024-06-22,2024-06-22,Supplier Payment - Port Services #13,Supplier Payment,Logistics-APAC,27525.88,0.0,SGD,SWIFT MT103,Port Services #13,***1824,,PO-202406-Logistics-APAC-0005,False,False,REF-609200,First Continental Bank,***3672,Globex APAC Logistics Pte. Ltd.,SG,4856343.3
2024-06-22,2024-06-22,Client Receipt - Pacific Trade Co. #16,Sales Receipt,Logistics-APAC,0.0,27673.76,SGD,SWIFT MT103,Pacific Trade Co. #16,***9780,INV-202406-Logistics-APAC-0008,,False,False,REF-796236,First Continental Bank,***1965,Globex APAC Logistics Pte. Ltd.,SG,4884017.06
2024-06-23,2024-06-23,Client Receipt - Pacific Trade Co. #47,Sales Receipt,Logistics-APAC,0.0,29515.17,SGD,SWIFT MT103,Pacific Trade Co. #47,***5426,INV-202406-Logistics-APAC-0012,,False,False,REF-659329,First Continental Bank,***5149,Globex APAC Logistics Pte. Ltd.,SG,4913532.23
2024-06-23,2024-06-23,Client Receipt - Vertex Advisory Client #19,Sales Receipt,PS-GL,0.0,40230.2,SGD,SWIFT MT103,Vertex Advisory Client #19,***6887,INV-202406-PS-GL-0008,,False,False,REF-710540,First Continental Bank,***7683,Globex APAC Logistics Pte. Ltd.,SG,4953762.43
2024-06-24,2024-06-24,Supplier Payment - ExpertNet Subcontractors #14,Supplier Payment,PS-GL,1482.95,0.0,SGD,FAST Debit,ExpertNet Subcontractors #14,***1038,,PO-202406-PS-GL-0009,False,False,REF-315742,First Continental Bank,***4355,Globex APAC Logistics Pte. Ltd.,SG,4952279.48
2024-06-24,2024-06-24,Supplier Payment - ExpertNet Subcontractors #1,Supplier Payment,PS-GL,3739.83,0.0,SGD,FAST Debit,ExpertNet Subcontractors #1,***7312,,PO-202406-PS-GL-0003,False,False,REF-535528,First Continental Bank,***5427,Globex APAC Logistics Pte. Ltd.,SG,4948539.65
2024-06-24,2024-06-24,Client Receipt - Pacific Trade Co. #48,Sales Receipt,Logistics-APAC,0.0,15102.36,SGD,FAST Credit,Pacific Trade Co. #48,***5942,INV-202406-Logistics-APAC-0011,,False,False,REF-891791,First Continental Bank,***2474,Globex APAC Logistics Pte. Ltd.,SG,4963642.01
2024-06-24,2024-06-24,Client Receipt - Pacific Trade Co. #5,Sales Receipt,Logistics-APAC,0.0,20777.62,SGD,SWIFT MT103,Pacific Trade Co. #5,***3946,INV-202406-Logistics-APAC-0010,,False,False,REF-883018,First Continental Bank,***1496,Globex APAC Logistics Pte. Ltd.,SG,4984419.63
2024-06-24,2024-06-24,Client Receipt - Pacific Trade Co. #32,Sales Receipt,Logistics-APAC,0.0,41754.89,SGD,FAST Credit,Pacific Trade Co. #32,***2079,INV-202406-Logistics-APAC-0005,,False,False,REF-374737,First Continental Bank,***9430,Globex APAC Logistics Pte. Ltd.,SG,5026174.52
2024-06-25,2024-06-25,Supplier Payment - HyperCloud Infra #9,Supplier Payment,SaaS-GL,5152.94,0.0,SGD,MEPS+,HyperCloud Infra #9,***7931,,PO-202406-SaaS-GL-0003,False,False,REF-238399,First Continental Bank,***4618,Globex APAC Logistics Pte. Ltd.,SG,5021021.58
2024-06-25,2024-06-25,Client Receipt - CloudBridge Co. #27,Sales Receipt,SaaS-GL,0.0,2895.77,SGD,SWIFT MT103,CloudBridge Co. #27,***4516,INV-202406-SaaS-GL-0007,,False,False,REF-910073,First Continental Bank,***7742,Globex APAC Logistics Pte. Ltd.,SG,5023917.35
2024-06-25,2024-06-25,Client Receipt - Pacific Trade Co. #55,Sales Receipt,Logistics-APAC,0.0,42381.06,SGD,SWIFT MT103,Pacific Trade Co. #55,***8313,INV-202406-Logistics-APAC-0001,,False,False,REF-177376,First Continental Bank,***6536,Globex APAC Logistics Pte. Ltd.,SG,5066298.41
2024-06-26,2024-06-26,Supplier Payment - HyperCloud Infra #3,Supplier Payment,SaaS-GL,26277.37,0.0,SGD,SWIFT MT103,HyperCloud Infra #3,***4154,,PO-202406-SaaS-GL-0009,False,False,REF-770271,First Continental Bank,***5503,Globex APAC Logistics Pte. Ltd.,SG,5040021.04
2024-06-26,2024-06-26,"Intercompany Settlement - Globex International Holdings, Inc.",Intercompany Transfer,ALL,172153.0,0.0,SGD,Internal Transfer,"Globex International Holdings, Inc.",***7679,,,True,True,REF-757060,First Continental Bank,***1660,Globex APAC Logistics Pte. Ltd.,SG,4867868.04
2024-06-27,2024-06-27,Supplier Payment - HyperCloud Infra #16,Supplier Payment,SaaS-GL,261.08,0.0,SGD,FAST Debit,HyperCloud Infra #16,***8535,,PO-202406-SaaS-GL-0002,False,False,REF-696553,First Continental Bank,***1049,Globex APAC Logistics Pte. Ltd.,SG,4867606.96
2024-06-27,2024-06-27,Supplier Payment - ExpertNet Subcontractors #13,Supplier Payment,PS-GL,2217.28,0.0,SGD,MEPS+,ExpertNet Subcontractors #13,***3992,,PO-202406-PS-GL-0001,False,False,REF-130845,First Continental Bank,***1116,Globex APAC Logistics Pte. Ltd.,SG,4865389.68
2024-06-27,2024-06-27,Marketing - Beacon Digital #9,Marketing,ALL,17856.64,0.0,SGD,SWIFT MT103,Beacon Digital #9,***1316,,,False,False,REF-374510,First Continental Bank,***6670,Globex APAC Logistics Pte. Ltd.,SG,4847533.04
2024-06-27,2024-06-27,Payroll - GlobalPay Services Ltd,Payroll,ALL,103282.19,0.0,SGD,SWIFT MT103,GlobalPay Services Ltd,***1753,,,False,False,REF-198763,First Continental Bank,***9125,Globex APAC Logistics Pte. Ltd.,SG,4744250.85
2024-06-27,2024-06-27,Client Receipt - CloudBridge Co. #65,Sales Receipt,SaaS-GL,0.0,26879.15,SGD,FAST Credit,CloudBridge Co. #65,***7349,INV-202406-SaaS-GL-0014,,False,False,REF-109455,First Continental Bank,***6939,Globex APAC Logistics Pte. Ltd.,SG,4771130.0
2024-06-27,2024-06-27,Client Receipt - CloudBridge Co. #18,Sales Receipt,SaaS-GL,0.0,39561.21,SGD,SWIFT MT103,CloudBridge Co. #18,***3868,INV-202406-SaaS-GL-0017,,False,False,REF-388140,First Continental Bank,***2345,Globex APAC Logistics Pte. Ltd.,SG,4810691.21
2024-06-28,2024-06-28,Merchant Processing Fees,Bank/Merchant Fees,ALL,1255.79,0.0,SGD,MEPS+,First Continental Bank,***4362,,,False,False,REF-141937,First Continental Bank,***7507,Globex APAC Logistics Pte. Ltd.,SG,4809435.42
2024-06-28,2024-06-28,Client Receipt - Pacific Trade Co. #46,Sales Receipt,Logistics-APAC,0.0,14456.04,SGD,SWIFT MT103,Pacific Trade Co. #46,***2567,INV-202406-Logistics-APAC-0013,,False,False,REF-917296,First Continental Bank,***2978,Globex APAC Logistics Pte. Ltd.,SG,4823891.46
2024-06-29,2024-06-29,Payroll - GlobalPay Services Ltd,Payroll,ALL,103282.19,0.0,SGD,MEPS+,GlobalPay Services Ltd,***3822,,,False,False,REF-429362,First Continental Bank,***5696,Globex APAC Logistics Pte. Ltd.,SG,4720609.27
2024-06-30,2024-06-30,Supplier Payment - TransAsia Freight #1,Supplier Payment,Logistics-APAC,13168.16,0.0,SGD,SWIFT MT103,TransAsia Freight #1,***2421,,PO-202406-Logistics-APAC-0003,False,False,REF-996782,First Continental Bank,***1797,Globex APAC Logistics Pte. Ltd.,SG,4707441.11
2024-06-30,2024-06-30,Supplier Payment - TransAsia Freight #31,Supplier Payment,Logistics-APAC,18496.02,0.0,SGD,SWIFT MT103,TransAsia Freight #31,***7869,,PO-202406-Logistics-APAC-0012,False,False,REF-191632,First Continental Bank,***9542,Globex APAC Logistics Pte. Ltd.,SG,4688945.09
2024-06-30,2024-06-30,Interest Earned,Interest Income,ALL,0.0,11365.0,SGD,SWIFT MT103,First Continental Bank,***8695,,,False,False,REF-287544,First Continental Bank,***4844,Globex APAC Logistics Pte. Ltd.,SG,4700310.09
2024-07-01,2024-07-01,Supplier Payment - HyperCloud Infra #7,Supplier Payment,SaaS-GL,1415.02,0.0,SGD,FAST Debit,HyperCloud Infra #7,***3965,,PO-202407-SaaS-GL-0003,False,False,REF-626096,First Continental Bank,***5977,Globex APAC Logistics Pte. Ltd.,SG,4698895.07
2024-07-01,2024-07-01,Account Maintenance Fee,Bank/Merchant Fees,ALL,2500.0,0.0,SGD,FAST Debit,First Continental Bank,***6049,,,False,False,REF-447315,First Continental Bank,***7276,Globex APAC Logistics Pte. Ltd.,SG,4696395.07
2024-07-01,2024-07-01,Supplier Payment - ExpertNet Subcontractors #1,Supplier Payment,PS-GL,3963.29,0.0,SGD,FAST Debit,ExpertNet Subcontractors #1,***2183,,PO-202407-PS-GL-0006,False,False,REF-339749,First Continental Bank,***8168,Globex APAC Logistics Pte. Ltd.,SG,4692431.78
2024-07-01,2024-07-01,Client Receipt - Pacific Trade Co. #58,Sales Receipt,Logistics-APAC,0.0,367.27,SGD,SWIFT MT103,Pacific Trade Co. #58,***5942,INV-202407-Logistics-APAC-0002,,False,False,REF-375140,First Continental Bank,***1772,Globex APAC Logistics Pte. Ltd.,SG,4692799.05
2024-07-02,2024-07-02,Supplier Payment - ExpertNet Subcontractors #9,Supplier Payment,PS-GL,1610.75,0.0,SGD,MEPS+,ExpertNet Subcontractors #9,***1852,,PO-202407-PS-GL-0005,False,False,REF-445035,First Continental Bank,***7573,Globex APAC Logistics Pte. Ltd.,SG,4691188.3
2024-07-02,2024-07-02,Client Receipt - Vertex Advisory Client #36,Sales Receipt,PS-GL,0.0,5732.72,SGD,FAST Credit,Vertex Advisory Client #36,***8082,INV-202407-PS-GL-0001,,False,False,REF-206276,First Continental Bank,***3588,Globex APAC Logistics Pte. Ltd.,SG,4696921.02
2024-07-03,2024-07-03,Supplier Payment - ExpertNet Subcontractors #12,Supplier Payment,PS-GL,8052.11,0.0,SGD,SWIFT MT103,ExpertNet Subcontractors #12,***3468,,PO-202407-PS-GL-0004,False,False,REF-206832,First Continental Bank,***5892,Globex APAC Logistics Pte. Ltd.,SG,4688868.91
2024-07-03,2024-07-03,Client Receipt - Pacific Trade Co. #32,Sales Receipt,Logistics-APAC,0.0,4292.23,SGD,FAST Credit,Pacific Trade Co. #32,***5638,INV-202407-Logistics-APAC-0007,,False,False,REF-295938,First Continental Bank,***6803,Globex APAC Logistics Pte. Ltd.,SG,4693161.14
2024-07-04,2024-07-04,Client Receipt - Pacific Trade Co. #17,Sales Receipt,Logistics-APAC,0.0,85722.9,SGD,SWIFT MT103,Pacific Trade Co. #17,***9194,INV-202407-Logistics-APAC-0009,,False,False,REF-367488,First Continental Bank,***6925,Globex APAC Logistics Pte. Ltd.,SG,4778884.04
2024-07-05,2024-07-05,Supplier Payment - TransAsia Freight #43,Supplier Payment,Logistics-APAC,22278.17,0.0,SGD,MEPS+,TransAsia Freight #43,***5498,,PO-202407-Logistics-APAC-0005,False,False,REF-752827,First Continental Bank,***3496,Globex APAC Logistics Pte. Ltd.,SG,4756605.87
2024-07-06,2024-07-06,Supplier Payment - TransAsia Freight #35,Supplier Payment,Logistics-APAC,3991.44,0.0,SGD,SWIFT MT103,TransAsia Freight #35,***8309,,PO-202407-Logistics-APAC-0002,False,False,REF-863709,First Continental Bank,***7219,Globex APAC Logistics Pte. Ltd.,SG,4752614.43
2024-07-06,2024-07-06,Supplier Payment - CodeCraft Contractors #2,Supplier Payment,SaaS-GL,30187.16,0.0,SGD,MEPS+,CodeCraft Contractors #2,***3731,,PO-202407-SaaS-GL-0008,False,False,REF-337917,First Continental Bank,***2647,Globex APAC Logistics Pte. Ltd.,SG,4722427.27
2024-07-07,2024-07-07,Client Receipt - Pacific Trade Co. #63,Sales Receipt,Logistics-APAC,0.0,7014.22,SGD,SWIFT MT103,Pacific Trade Co. #63,***8168,INV-202407-Logistics-APAC-0011,,False,False,REF-193688,First Continental Bank,***1291,Globex APAC Logistics Pte. Ltd.,SG,4729441.49
2024-07-07,2024-07-07,Client Receipt - CloudBridge Co. #46,Sales Receipt,SaaS-GL,0.0,18857.49,SGD,FAST Credit,CloudBridge Co. #46,***7576,INV-202407-SaaS-GL-0024,,False,False,REF-106401,First Continental Bank,***9693,Globex APAC Logistics Pte. Ltd.,SG,4748298.98
2024-07-08,2024-07-08,Client Receipt - Pacific Trade Co. #17,Sales Receipt,Logistics-APAC,0.0,13324.22,SGD,SWIFT MT103,Pacific Trade Co. #17,***8007,INV-202407-Logistics-APAC-0012,,False,False,REF-444207,First Continental Bank,***7403,Globex APAC Logistics Pte. Ltd.,SG,4761623.2
2024-07-09,2024-07-09,Client Receipt - CloudBridge Co. #73,Sales Receipt,SaaS-GL,0.0,10079.11,SGD,FAST Credit,CloudBridge Co. #73,***1043,INV-202407-SaaS-GL-0008,,False,False,REF-563536,First Continental Bank,***8773,Globex APAC Logistics Pte. Ltd.,SG,4771702.31
2024-07-09,2024-07-09,Client Receipt - CloudBridge Co. #23,Sales Receipt,SaaS-GL,0.0,17030.34,SGD,FAST Credit,CloudBridge Co. #23,***8702,INV-202407-SaaS-GL-0010,,False,False,REF-704868,First Continental Bank,***5144,Globex APAC Logistics Pte. Ltd.,SG,4788732.65
2024-07-09,2024-07-09,Client Receipt - Vertex Advisory Client #12,Sales Receipt,PS-GL,0.0,47192.99,SGD,FAST Credit,Vertex Advisory Client #12,***8810,INV-202407-PS-GL-0002,,False,False,REF-198480,First Continental Bank,***4777,Globex APAC Logistics Pte. Ltd.,SG,4835925.64
2024-07-09,2024-07-09,Client Receipt - Vertex Advisory Client #47,Sales Receipt,PS-GL,0.0,65561.32,SGD,FAST Credit,Vertex Advisory Client #47,***6294,INV-202407-PS-GL-0005,,False,False,REF-754002,First Continental Bank,***7553,Globex APAC Logistics Pte. Ltd.,SG,4901486.96
2024-07-10,2024-07-10,Supplier Payment - ExpertNet Subcontractors #14,Supplier Payment,PS-GL,73.06,0.0,SGD,FAST Debit,ExpertNet Subcontractors #14,***9436,,PO-202407-PS-GL-0007,False,False,REF-515993,First Continental Bank,***4230,Globex APAC Logistics Pte. Ltd.,SG,4901413.9
2024-07-10,2024-07-10,Client Receipt - CloudBridge Co. #19,Sales Receipt,SaaS-GL,0.0,5646.23,SGD,FAST Credit,CloudBridge Co. #19,***7157,INV-202407-SaaS-GL-0025,,False,False,REF-632796,First Continental Bank,***9230,Globex APAC Logistics Pte. Ltd.,SG,4907060.13
2024-07-10,2024-07-10,Client Receipt - CloudBridge Co. #12,Sales Receipt,SaaS-GL,0.0,9883.96,SGD,FAST Credit,CloudBridge Co. #12,***9803,INV-202407-SaaS-GL-0005,,False,False,REF-318197,First Continental Bank,***1078,Globex APAC Logistics Pte. Ltd.,SG,4916944.09
2024-07-10,2024-07-10,Client Receipt - CloudBridge Co. #60,Sales Receipt,SaaS-GL,0.0,10333.93,SGD,FAST Credit,CloudBridge Co. #60,***2372,INV-202407-SaaS-GL-0013,,False,False,REF-660975,First Continental Bank,***2483,Globex APAC Logistics Pte. Ltd.,SG,4927278.02
2024-07-11,2024-07-11,Supplier Payment - HyperCloud Infra #7,Supplier Payment,SaaS-GL,2536.3,0.0,SGD,MEPS+,HyperCloud Infra #7,***2162,,PO-202407-SaaS-GL-0005,False,False,REF-952421,First Continental Bank,***9752,Globex APAC Logistics Pte. Ltd.,SG,4924741.72
2024-07-11,2024-07-11,Metro Water & Waste,Rent & Utilities,ALL,4255.44,0.0,SGD,FAST Debit,Metro Water & Waste,***2090,,,False,False,REF-850124,First Continental Bank,***9045,Globex APAC Logistics Pte. Ltd.,SG,4920486.28
2024-07-11,2024-07-11,Client Receipt - CloudBridge Co. #47,Sales Receipt,SaaS-GL,0.0,9940.61,SGD,SWIFT MT103,CloudBridge Co. #47,***8577,INV-202407-SaaS-GL-0026,,False,False,REF-679562,First Continental Bank,***9152,Globex APAC Logistics Pte. Ltd.,SG,4930426.89
2024-07-11,2024-07-11,Client Receipt - CloudBridge Co. #12,Sales Receipt,SaaS-GL,0.0,10852.91,SGD,SWIFT MT103,CloudBridge Co. #12,***5250,INV-202407-SaaS-GL-0016,,False,False,REF-175207,First Continental Bank,***8693,Globex APAC Logistics Pte. Ltd.,SG,4941279.8
2024-07-11,2024-07-11,Client Receipt - CloudBridge Co. #39,Sales Receipt,SaaS-GL,0.0,11402.44,SGD,SWIFT MT103,CloudBridge Co. #39,***4768,INV-202407-SaaS-GL-0002,,False,False,REF-680243,First Continental Bank,***8983,Globex APAC Logistics Pte. Ltd.,SG,4952682.24
2024-07-11,2024-07-11,Client Receipt - Vertex Advisory Client #10,Sales Receipt,PS-GL,0.0,74755.03,SGD,SWIFT MT103,Vertex Advisory Client #10,***4610,INV-202407-PS-GL-0004,,False,False,REF-569189,First Continental Bank,***5694,Globex APAC Logistics Pte. Ltd.,SG,5027437.27
2024-07-12,2024-07-12,Supplier Payment - TransAsia Freight #12,Supplier Payment,Logistics-APAC,54931.29,0.0,SGD,MEPS+,TransAsia Freight #12,***6921,,PO-202407-Logistics-APAC-0001,False,False,REF-150177,First Continental Bank,***2267,Globex APAC Logistics Pte. Ltd.,SG,4972505.98
2024-07-12,2024-07-12,Intercompany Settlement - Globex Consulting UK Ltd.,Intercompany Transfer,ALL,648437.0,0.0,SGD,Internal Transfer,Globex Consulting UK Ltd.,***4749,,,True,True,REF-879882,First Continental Bank,***9920,Globex APAC Logistics Pte. Ltd.,SG,4324068.98
2024-07-12,2024-07-12,Client Receipt - CloudBridge Co. #72,Sales Receipt,SaaS-GL,0.0,143.58,SGD,SWIFT MT103,CloudBridge Co. #72,***9295,INV-202407-SaaS-GL-0009,,False,False,REF-416883,First Continental Bank,***6147,Globex APAC Logistics Pte. Ltd.,SG,4324212.56
2024-07-12,2024-07-12,Client Receipt - CloudBridge Co. #24,Sales Receipt,SaaS-GL,0.0,5287.86,SGD,FAST Credit,CloudBridge Co. #24,***6256,INV-202407-SaaS-GL-0020,,False,False,REF-327411,First Continental Bank,***6795,Globex APAC Logistics Pte. Ltd.,SG,4329500.42
2024-07-12,2024-07-12,Client Receipt - CloudBridge Co. #17,Sales Receipt,SaaS-GL,0.0,33918.2,SGD,SWIFT MT103,CloudBridge Co. #17,***4504,INV-202407-SaaS-GL-0012,,False,False,REF-742440,First Continental Bank,***2636,Globex APAC Logistics Pte. Ltd.,SG,4363418.62
2024-07-13,2024-07-13,Supplier Payment - ExpertNet Subcontractors #12,Supplier Payment,PS-GL,6329.61,0.0,SGD,MEPS+,ExpertNet Subcontractors #12,***8642,,PO-202407-PS-GL-0009,False,False,REF-888196,First Continental Bank,***9008,Globex APAC Logistics Pte. Ltd.,SG,4357089.01
2024-07-14,2024-07-14,Supplier Payment - CodeCraft Contractors #8,Supplier Payment,SaaS-GL,6598.4,0.0,SGD,FAST Debit,CodeCraft Contractors #8,***6076,,PO-202407-SaaS-GL-0006,False,False,REF-438264,First Continental Bank,***7969,Globex APAC Logistics Pte. Ltd.,SG,4350490.61
2024-07-14,2024-07-14,Client Receipt - Vertex Advisory Client #36,Sales Receipt,PS-GL,0.0,25858.87,SGD,FAST Credit,Vertex Advisory Client #36,***2575,INV-202407-PS-GL-0003,,False,False,REF-363617,First Continental Bank,***9436,Globex APAC Logistics Pte. Ltd.,SG,4376349.48
2024-07-15,2024-07-15,Marketing - Beacon Digital #6,Marketing,ALL,5990.43,0.0,SGD,FAST Debit,Beacon Digital #6,***9036,,,False,False,REF-705645,First Continental Bank,***6547,Globex APAC Logistics Pte. Ltd.,SG,4370359.05
2024-07-15,2024-07-15,Supplier Payment - HyperCloud Infra #9,Supplier Payment,SaaS-GL,12376.16,0.0,SGD,SWIFT MT103,HyperCloud Infra #9,***3919,,PO-202407-SaaS-GL-0004,False,False,REF-884254,First Continental Bank,***8109,Globex APAC Logistics Pte. Ltd.,SG,4357982.89
2024-07-15,2024-07-15,Client Receipt - Pacific Trade Co. #46,Sales Receipt,Logistics-APAC,0.0,78402.73,SGD,SWIFT MT103,Pacific Trade Co. #46,***7624,INV-202407-Logistics-APAC-0010,,False,False,REF-926025,First Continental Bank,***2348,Globex APAC Logistics Pte. Ltd.,SG,4436385.62
2024-07-16,2024-07-16,Supplier Payment - CodeCraft Contractors #1,Supplier Payment,SaaS-GL,8318.45,0.0,SGD,SWIFT MT103,CodeCraft Contractors #1,***2699,,PO-202407-SaaS-GL-0001,False,False,REF-834784,First Continental Bank,***4426,Globex APAC Logistics Pte. Ltd.,SG,4428067.17
2024-07-16,2024-07-16,Client Receipt - CloudBridge Co. #45,Sales Receipt,SaaS-GL,0.0,6485.85,SGD,SWIFT MT103,CloudBridge Co. #45,***5782,INV-202407-SaaS-GL-0023,,False,False,REF-270542,First Continental Bank,***2248,Globex APAC Logistics Pte. Ltd.,SG,4434553.02
2024-07-16,2024-07-16,Client Receipt - CloudBridge Co. #60,Sales Receipt,SaaS-GL,0.0,12732.01,SGD,SWIFT MT103,CloudBridge Co. #60,***3621,INV-202407-SaaS-GL-0021,,False,False,REF-358611,First Continental Bank,***2209,Globex APAC Logistics Pte. Ltd.,SG,4447285.03
2024-07-16,2024-07-16,Client Receipt - CloudBridge Co. #53,Sales Receipt,SaaS-GL,0.0,27867.4,SGD,SWIFT MT103,CloudBridge Co. #53,***6867,INV-202407-SaaS-GL-0015,,False,False,REF-249574,First Continental Bank,***6141,Globex APAC Logistics Pte. Ltd.,SG,4475152.43
2024-07-17,2024-07-17,Supplier Payment - Port Services #3,Supplier Payment,Logistics-APAC,9169.86,0.0,SGD,MEPS+,Port Services #3,***6399,,PO-202407-Logistics-APAC-0007,False,False,REF-997877,First Continental Bank,***8719,Globex APAC Logistics Pte. Ltd.,SG,4465982.57
2024-07-17,2024-07-17,Supplier Payment - Port Services #7,Supplier Payment,Logistics-APAC,12410.12,0.0,SGD,FAST Debit,Port Services #7,***7274,,PO-202407-Logistics-APAC-0010,False,False,REF-397156,First Continental Bank,***6509,Globex APAC Logistics Pte. Ltd.,SG,4453572.45
2024-07-17,2024-07-17,Client Receipt - CloudBridge Co. #75,Sales Receipt,SaaS-GL,0.0,3797.23,SGD,SWIFT MT103,CloudBridge Co. #75,***6145,INV-202407-SaaS-GL-0022,,False,False,REF-816761,First Continental Bank,***3720,Globex APAC Logistics Pte. Ltd.,SG,4457369.68
2024-07-18,2024-07-18,BluePeak Property Mgmt,Rent & Utilities,ALL,5449.79,0.0,SGD,SWIFT MT103,BluePeak Property Mgmt,***5428,,,False,False,REF-410665,First Continental Bank,***4924,Globex APAC Logistics Pte. Ltd.,SG,4451919.89
2024-07-18,2024-07-18,VAT/GST Remittance - IRAS Singapore,Tax Payment,ALL,73867.57,0.0,SGD,FAST Debit,IRAS Singapore,***9090,,,False,False,REF-700726,First Continental Bank,***1877,Globex APAC Logistics Pte. Ltd.,SG,4378052.32
2024-07-18,2024-07-18,Client Receipt - Pacific Trade Co. #41,Sales Receipt,Logistics-APAC,0.0,13439.86,SGD,SWIFT MT103,Pacific Trade Co. #41,***9054,INV-202407-Logistics-APAC-0008,,False,False,REF-277430,First Continental Bank,***7159,Globex APAC Logistics Pte. Ltd.,SG,4391492.18
2024-07-18,2024-07-18,Client Receipt - CloudBridge Co. #10,Sales Receipt,SaaS-GL,0.0,20253.59,SGD,SWIFT MT103,CloudBridge Co. #10,***3045,INV-202407-SaaS-GL-0027,,False,False,REF-798150,First Continental Bank,***7021,Globex APAC Logistics Pte. Ltd.,SG,4411745.77
2024-07-19,2024-07-19,Supplier Payment - CodeCraft Contractors #1,Supplier Payment,SaaS-GL,9455.16,0.0,SGD,SWIFT MT103,CodeCraft Contractors #1,***9141,,PO-202407-SaaS-GL-0007,False,False,REF-938603,First Continental Bank,***1071,Globex APAC Logistics Pte. Ltd.,SG,4402290.61
2024-07-19,2024-07-19,Client Receipt - Pacific Trade Co. #54,Sales Receipt,Logistics-APAC,0.0,4220.97,SGD,FAST Credit,Pacific Trade Co. #54,***6021,INV-202407-Logistics-APAC-0006,,False,False,REF-905713,First Continental Bank,***4768,Globex APAC Logistics Pte. Ltd.,SG,4406511.58
2024-07-21,2024-07-21,Client Receipt - CloudBridge Co. #50,Sales Receipt,SaaS-GL,0.0,7862.46,SGD,SWIFT MT103,CloudBridge Co. #50,***7249,INV-202407-SaaS-GL-0011,,False,False,REF-912606,First Continental Bank,***4676,Globex APAC Logistics Pte. Ltd.,SG,4414374.04
2024-07-21,2024-07-21,Client Receipt - CloudBridge Co. #34,Sales Receipt,SaaS-GL,0.0,10727.45,SGD,SWIFT MT103,CloudBridge Co. #34,***3369,INV-202407-SaaS-GL-0006,,False,False,REF-621051,First Continental Bank,***7291,Globex APAC Logistics Pte. Ltd.,SG,4425101.49
2024-07-22,2024-07-22,Marketing - Aurelia Media #10,Marketing,ALL,12318.56,0.0,SGD,MEPS+,Aurelia Media #10,***7470,,,False,False,REF-152839,First Continental Bank,***6773,Globex APAC Logistics Pte. Ltd.,SG,4412782.93
2024-07-22,2024-07-22,Supplier Payment - Port Services #13,Supplier Payment,Logistics-APAC,28773.24,0.0,SGD,FAST Debit,Port Services #13,***1321,,PO-202407-Logistics-APAC-0008,False,False,REF-682672,First Continental Bank,***6358,Globex APAC Logistics Pte. Ltd.,SG,4384009.69
2024-07-22,2024-07-22,Client Receipt - CloudBridge Co. #12,Sales Receipt,SaaS-GL,0.0,27907.15,SGD,SWIFT MT103,CloudBridge Co. #12,***2535,INV-202407-SaaS-GL-0031,,False,False,REF-595423,First Continental Bank,***6205,Globex APAC Logistics Pte. Ltd.,SG,4411916.84
2024-07-23,2024-07-23,Supplier Payment - ExpertNet Subcontractors #6,Supplier Payment,PS-GL,9410.21,0.0,SGD,MEPS+,ExpertNet Subcontractors #6,***3964,,PO-202407-PS-GL-0010,False,False,REF-509664,First Continental Bank,***1310,Globex APAC Logistics Pte. Ltd.,SG,4402506.63
2024-07-23,2024-07-23,Supplier Payment - TransAsia Freight #12,Supplier Payment,Logistics-APAC,92148.47,0.0,SGD,MEPS+,TransAsia Freight #12,***3720,,PO-202407-Logistics-APAC-0009,False,False,REF-151172,First Continental Bank,***2946,Globex APAC Logistics Pte. Ltd.,SG,4310358.16
2024-07-23,2024-07-23,Client Receipt - CloudBridge Co. #66,Sales Receipt,SaaS-GL,0.0,5431.89,SGD,FAST Credit,CloudBridge Co. #66,***1093,INV-202407-SaaS-GL-0007,,False,False,REF-711092,First Continental Bank,***7217,Globex APAC Logistics Pte. Ltd.,SG,4315790.05
2024-07-23,2024-07-23,Client Receipt - CloudBridge Co. #9,Sales Receipt,SaaS-GL,0.0,18786.12,SGD,SWIFT MT103,CloudBridge Co. #9,***7494,INV-202407-SaaS-GL-0001,,False,False,REF-800666,First Continental Bank,***7668,Globex APAC Logistics Pte. Ltd.,SG,4334576.17
2024-07-23,2024-07-23,Client Receipt - Pacific Trade Co. #25,Sales Receipt,Logistics-APAC,0.0,36193.25,SGD,FAST Credit,Pacific Trade Co. #25,***8410,INV-202407-Logistics-APAC-0001,,False,False,REF-790466,First Continental Bank,***7257,Globex APAC Logistics Pte. Ltd.,SG,4370769.42
2024-07-24,2024-07-24,Supplier Payment - Port Services #12,Supplier Payment,Logistics-APAC,14491.79,0.0,SGD,SWIFT MT103,Port Services #12,***9662,,PO-202407-Logistics-APAC-0006,False,False,REF-268803,First Continental Bank,***4120,Globex APAC Logistics Pte. Ltd.,SG,4356277.63
2024-07-24,2024-07-24,Supplier Payment - TransAsia Freight #5,Supplier Payment,Logistics-APAC,23362.16,0.0,SGD,MEPS+,TransAsia Freight #5,***1252,,PO-202407-Logistics-APAC-0011,False,False,REF-919155,First Continental Bank,***2875,Globex APAC Logistics Pte. Ltd.,SG,4332915.47
2024-07-24,2024-07-24,Client Receipt - CloudBridge Co. #77,Sales Receipt,SaaS-GL,0.0,1080.75,SGD,FAST Credit,CloudBridge Co. #77,***7919,INV-202407-SaaS-GL-0004,,False,False,REF-337699,First Continental Bank,***2649,Globex APAC Logistics Pte. Ltd.,SG,4333996.22
2024-07-24,2024-07-24,Client Receipt - CloudBridge Co. #61,Sales Receipt,SaaS-GL,0.0,10114.84,SGD,SWIFT MT103,CloudBridge Co. #61,***7324,INV-202407-SaaS-GL-0019,,False,False,REF-818191,First Continental Bank,***1371,Globex APAC Logistics Pte. Ltd.,SG,4344111.06
2024-07-24,2024-07-24,Client Receipt - Vertex Advisory Client #7,Sales Receipt,PS-GL,0.0,15052.05,SGD,FAST Credit,Vertex Advisory Client #7,***7826,INV-202407-PS-GL-0007,,False,False,REF-848561,First Continental Bank,***6454,Globex APAC Logistics Pte. Ltd.,SG,4359163.11
2024-07-24,2024-07-24,Client Receipt - Vertex Advisory Client #11,Sales Receipt,PS-GL,0.0,30893.28,SGD,SWIFT MT103,Vertex Advisory Client #11,***4568,INV-202407-PS-GL-0006,,False,False,REF-730731,First Continental Bank,***4601,Globex APAC Logistics Pte. Ltd.,SG,4390056.39
2024-07-25,2024-07-25,Merchant Processing Fees,Bank/Merchant Fees,ALL,2628.85,0.0,SGD,FAST Debit,First Continental Bank,***1443,,,False,False,REF-467036,First Continental Bank,***8574,Globex APAC Logistics Pte. Ltd.,SG,4387427.54
2024-07-25,2024-07-25,Supplier Payment - ExpertNet Subcontractors #14,Supplier Payment,PS-GL,4397.42,0.0,SGD,MEPS+,ExpertNet Subcontractors #14,***7946,,PO-202407-PS-GL-0003,False,False,REF-971021,First Continental Bank,***5480,Globex APAC Logistics Pte. Ltd.,SG,4383030.12
2024-07-25,2024-07-25,Supplier Payment - ExpertNet Subcontractors #2,Supplier Payment,PS-GL,13364.57,0.0,SGD,SWIFT MT103,ExpertNet Subcontractors #2,***4432,,PO-202407-PS-GL-0011,False,False,REF-460721,First Continental Bank,***6876,Globex APAC Logistics Pte. Ltd.,SG,4369665.55
2024-07-26,2024-07-26,Supplier Payment - ExpertNet Subcontractors #18,Supplier Payment,PS-GL,5427.82,0.0,SGD,FAST Debit,ExpertNet Subcontractors #18,***9396,,PO-202407-PS-GL-0002,False,False,REF-787835,First Continental Bank,***5753,Globex APAC Logistics Pte. Ltd.,SG,4364237.73
2024-07-26,2024-07-26,Intercompany Settlement - Globex Retail NA LLC,Intercompany Transfer,ALL,595984.0,0.0,SGD,Internal Transfer,Globex Retail NA LLC,***7658,,,True,True,REF-143843,First Continental Bank,***6801,Globex APAC Logistics Pte. Ltd.,SG,3768253.73
2024-07-26,2024-07-26,Client Receipt - CloudBridge Co. #37,Sales Receipt,SaaS-GL,0.0,2274.8,SGD,FAST Credit,CloudBridge Co. #37,***5055,INV-202407-SaaS-GL-0003,,False,False,REF-146597,First Continental Bank,***8596,Globex APAC Logistics Pte. Ltd.,SG,3770528.53
2024-07-26,2024-07-26,Client Receipt - CloudBridge Co. #23,Sales Receipt,SaaS-GL,0.0,35505.38,SGD,SWIFT MT103,CloudBridge Co. #23,***2653,INV-202407-SaaS-GL-0030,,False,False,REF-962258,First Continental Bank,***7849,Globex APAC Logistics Pte. Ltd.,SG,3806033.91
2024-07-26,2024-07-26,Client Receipt - Pacific Trade Co. #51,Sales Receipt,Logistics-APAC,0.0,130887.25,SGD,FAST Credit,Pacific Trade Co. #51,***2247,INV-202407-Logistics-APAC-0004,,False,False,REF-494715,First Continental Bank,***3008,Globex APAC Logistics Pte. Ltd.,SG,3936921.16
2024-07-27,2024-07-27,Payroll - GlobalPay Services Ltd,Payroll,ALL,191840.81,0.0,SGD,SWIFT MT103,GlobalPay Services Ltd,***6868,,,False,False,REF-286422,First Continental Bank,***6260,Globex APAC Logistics Pte. Ltd.,SG,3745080.35
2024-07-28,2024-07-28,Corporate Tax Estimate,Tax Payment,ALL,53696.57,0.0,SGD,FAST Debit,IRAS Singapore,***7712,,,False,False,REF-383529,First Continental Bank,***7939,Globex APAC Logistics Pte. Ltd.,SG,3691383.78
2024-07-28,2024-07-28,Client Receipt - Vertex Advisory Client #44,Sales Receipt,PS-GL,0.0,27636.67,SGD,FAST Credit,Vertex Advisory Client #44,***1671,INV-202407-PS-GL-0008,,False,False,REF-882668,First Continental Bank,***2134,Globex APAC Logistics Pte. Ltd.,SG,3719020.45
2024-07-28,2024-07-28,Client Receipt - Pacific Trade Co. #3,Sales Receipt,Logistics-APAC,0.0,44145.07,SGD,FAST Credit,Pacific Trade Co. #3,***2608,INV-202407-Logistics-APAC-0005,,False,False,REF-569921,First Continental Bank,***3060,Globex APAC Logistics Pte. Ltd.,SG,3763165.52
2024-07-29,2024-07-29,Supplier Payment - HyperCloud Infra #4,Supplier Payment,SaaS-GL,11403.46,0.0,SGD,SWIFT MT103,HyperCloud Infra #4,***2638,,PO-202407-SaaS-GL-0010,False,False,REF-341829,First Continental Bank,***2461,Globex APAC Logistics Pte. Ltd.,SG,3751762.06
2024-07-29,2024-07-29,Marketing - Aurelia Media #11,Marketing,ALL,12315.54,0.0,SGD,MEPS+,Aurelia Media #11,***4347,,,False,False,REF-107759,First Continental Bank,***4901,Globex APAC Logistics Pte. Ltd.,SG,3739446.52
2024-07-29,2024-07-29,Supplier Payment - TransAsia Freight #16,Supplier Payment,Logistics-APAC,26086.65,0.0,SGD,MEPS+,TransAsia Freight #16,***5273,,PO-202407-Logistics-APAC-0003,False,False,REF-686174,First Continental Bank,***7640,Globex APAC Logistics Pte. Ltd.,SG,3713359.87
2024-07-30,2024-07-30,Supplier Payment - ExpertNet Subcontractors #19,Supplier Payment,PS-GL,2576.06,0.0,SGD,MEPS+,ExpertNet Subcontractors #19,***1329,,PO-202407-PS-GL-0008,False,False,REF-141931,First Continental Bank,***9765,Globex APAC Logistics Pte. Ltd.,SG,3710783.81
2024-07-30,2024-07-30,Supplier Payment - ExpertNet Subcontractors #5,Supplier Payment,PS-GL,10198.89,0.0,SGD,FAST Debit,ExpertNet Subcontractors #5,***3693,,PO-202407-PS-GL-0001,False,False,REF-898591,First Continental Bank,***1052,Globex APAC Logistics Pte. Ltd.,SG,3700584.92
2024-07-30,2024-07-30,Supplier Payment - HyperCloud Infra #7,Supplier Payment,SaaS-GL,12046.99,0.0,SGD,MEPS+,HyperCloud Infra #7,***8211,,PO-202407-SaaS-GL-0009,False,False,REF-633996,First Continental Bank,***8137,Globex APAC Logistics Pte. Ltd.,SG,3688537.93
2024-07-30,2024-07-30,Interest Earned,Interest Income,ALL,0.0,11574.96,SGD,SWIFT MT103,First Continental Bank,***8269,,,False,False,REF-775137,First Continental Bank,***7552,Globex APAC Logistics Pte. Ltd.,SG,3700112.89
2024-07-30,2024-07-30,Client Receipt - CloudBridge Co. #2,Sales Receipt,SaaS-GL,0.0,33511.0,SGD,FAST Credit,CloudBridge Co. #2,***7883,INV-202407-SaaS-GL-0029,,False,False,REF-421517,First Continental Bank,***7319,Globex APAC Logistics Pte. Ltd.,SG,3733623.89
2024-07-30,2024-07-30,Client Receipt - CloudBridge Co. #51,Sales Receipt,SaaS-GL,0.0,34877.53,SGD,FAST Credit,CloudBridge Co. #51,***2954,INV-202407-SaaS-GL-0014,,False,False,REF-132394,First Continental Bank,***6532,Globex APAC Logistics Pte. Ltd.,SG,3768501.42
2024-07-31,2024-07-31,Merchant Processing Fees,Bank/Merchant Fees,ALL,1133.09,0.0,SGD,FAST Debit,First Continental Bank,***7718,,,False,False,REF-951242,First Continental Bank,***8095,Globex APAC Logistics Pte. Ltd.,SG,3767368.33
2024-07-31,2024-07-31,Supplier Payment - HyperCloud Infra #2,Supplier Payment,SaaS-GL,2248.27,0.0,SGD,SWIFT MT103,HyperCloud Infra #2,***3771,,PO-202407-SaaS-GL-0002,False,False,REF-740786,First Continental Bank,***2242,Globex APAC Logistics Pte. Ltd.,SG,3765120.06
2024-07-31,2024-07-31,Supplier Payment - ExpertNet Subcontractors #7,Supplier Payment,PS-GL,22401.09,0.0,SGD,SWIFT MT103,ExpertNet Subcontractors #7,***2723,,PO-202407-PS-GL-0012,False,False,REF-407389,First Continental Bank,***5291,Globex APAC Logistics Pte. Ltd.,SG,3742718.97
2024-07-31,2024-07-31,Supplier Payment - Port Services #7,Supplier Payment,Logistics-APAC,53820.22,0.0,SGD,FAST Debit,Port Services #7,***2733,,PO-202407-Logistics-APAC-0004,False,False,REF-191325,First Continental Bank,***2932,Globex APAC Logistics Pte. Ltd.,SG,3688898.75
2024-07-31,2024-07-31,Client Receipt - CloudBridge Co. #56,Sales Receipt,SaaS-GL,0.0,9329.18,SGD,FAST Credit,CloudBridge Co. #56,***6349,INV-202407-SaaS-GL-0028,,False,False,REF-682532,First Continental Bank,***1573,Globex APAC Logistics Pte. Ltd.,SG,3698227.93
2024-07-31,2024-07-31,Client Receipt - CloudBridge Co. #63,Sales Receipt,SaaS-GL,0.0,13132.09,SGD,FAST Credit,CloudBridge Co. #63,***8020,INV-202407-SaaS-GL-0018,,False,False,REF-835211,First Continental Bank,***6220,Globex APAC Logistics Pte. Ltd.,SG,3711360.02
2024-07-31,2024-07-31,Client Receipt - CloudBridge Co. #22,Sales Receipt,SaaS-GL,0.0,13971.01,SGD,FAST Credit,CloudBridge Co. #22,***5861,INV-202407-SaaS-GL-0017,,False,False,REF-501975,First Continental Bank,***6887,Globex APAC Logistics Pte. Ltd.,SG,3725331.03
2024-07-31,2024-07-31,Client Receipt - Pacific Trade Co. #68,Sales Receipt,Logistics-APAC,0.0,69794.91,SGD,SWIFT MT103,Pacific Trade Co. #68,***2935,INV-202407-Logistics-APAC-0003,,False,False,REF-689480,First Continental Bank,***5442,Globex APAC Logistics Pte. Ltd.,SG,3795125.94
2024-08-01,2024-08-01,Account Maintenance Fee,Bank/Merchant Fees,ALL,2500.0,0.0,SGD,SWIFT MT103,First Continental Bank,***1210,,,False,False,REF-591809,First Continental Bank,***4384,Globex APAC Logistics Pte. Ltd.,SG,3792625.94
2024-08-01,2024-08-01,Supplier Payment - TransAsia Freight #16,Supplier Payment,Logistics-APAC,31070.91,0.0,SGD,SWIFT MT103,TransAsia Freight #16,***9162,,PO-202408-Logistics-APAC-0006,False,False,REF-106359,First Continental Bank,***2966,Globex APAC Logistics Pte. Ltd.,SG,3761555.03
2024-08-01,2024-08-01,Client Receipt - CloudBridge Co. #6,Sales Receipt,SaaS-GL,0.0,9889.87,SGD,FAST Credit,CloudBridge Co. #6,***6185,INV-202408-SaaS-GL-0034,,False,False,REF-271189,First Continental Bank,***2298,Globex APAC Logistics Pte. Ltd.,SG,3771444.9
2024-08-02,2024-08-02,Supplier Payment - ExpertNet Subcontractors #17,Supplier Payment,PS-GL,25643.86,0.0,SGD,MEPS+,ExpertNet Subcontractors #17,***6930,,PO-202408-PS-GL-0001,False,False,REF-204467,First Continental Bank,***5939,Globex APAC Logistics Pte. Ltd.,SG,3745801.04
2024-08-02,2024-08-02,Client Receipt - Vertex Advisory Client #35,Sales Receipt,PS-GL,0.0,22207.76,SGD,SWIFT MT103,Vertex Advisory Client #35,***2104,INV-202408-PS-GL-0009,,False,False,REF-405448,First Continental Bank,***5299,Globex APAC Logistics Pte. Ltd.,SG,3768008.8
2024-08-03,2024-08-03,BluePeak Property Mgmt,Rent & Utilities,ALL,4116.35,0.0,SGD,MEPS+,BluePeak Property Mgmt,***1626,,,False,False,REF-438862,First Continental Bank,***3244,Globex APAC Logistics Pte. Ltd.,SG,3763892.45
2024-08-05,2024-08-05,Supplier Payment - Port Services #2,Supplier Payment,Logistics-APAC,34488.7,0.0,SGD,MEPS+,Port Services #2,***7532,,PO-202408-Logistics-APAC-0003,False,False,REF-833342,First Continental Bank,***4226,Globex APAC Logistics Pte. Ltd.,SG,3729403.75
2024-08-05,2024-08-05,Client Receipt - CloudBridge Co. #38,Sales Receipt,SaaS-GL,0.0,26435.94,SGD,FAST Credit,CloudBridge Co. #38,***5211,INV-202408-SaaS-GL-0002,,False,False,REF-314707,First Continental Bank,***7816,Globex APAC Logistics Pte. Ltd.,SG,3755839.69
2024-08-05,2024-08-05,Client Receipt - Pacific Trade Co. #47,Sales Receipt,Logistics-APAC,0.0,71941.47,SGD,SWIFT MT103,Pacific Trade Co. #47,***5537,INV-202408-Logistics-APAC-0012,,False,False,REF-609586,First Continental Bank,***9354,Globex APAC Logistics Pte. Ltd.,SG,3827781.16
2024-08-06,2024-08-06,Supplier Payment - ExpertNet Subcontractors #11,Supplier Payment,PS-GL,2121.34,0.0,SGD,MEPS+,ExpertNet Subcontractors #11,***6357,,PO-202408-PS-GL-0007,False,False,REF-187063,First Continental Bank,***9412,Globex APAC Logistics Pte. Ltd.,SG,3825659.82
2024-08-06,2024-08-06,Merchant Processing Fees,Bank/Merchant Fees,ALL,2733.5,0.0,SGD,SWIFT MT103,First Continental Bank,***8149,,,False,False,REF-420728,First Continental Bank,***6142,Globex APAC Logistics Pte. Ltd.,SG,3822926.32
2024-08-06,2024-08-06,Client Receipt - CloudBridge Co. #79,Sales Receipt,SaaS-GL,0.0,633.67,SGD,FAST Credit,CloudBridge Co. #79,***4606,INV-202408-SaaS-GL-0012,,False,False,REF-159661,First Continental Bank,***1785,Globex APAC Logistics Pte. Ltd.,SG,3823559.99
2024-08-06,2024-08-06,Client Receipt - CloudBridge Co. #22,Sales Receipt,SaaS-GL,0.0,7759.02,SGD,SWIFT MT103,CloudBridge Co. #22,***5848,INV-202408-SaaS-GL-0006,,False,False,REF-125418,First Continental Bank,***7253,Globex APAC Logistics Pte. Ltd.,SG,3831319.01
2024-08-06,2024-08-06,Client Receipt - Vertex Advisory Client #5,Sales Receipt,PS-GL,0.0,41778.67,SGD,FAST Credit,Vertex Advisory Client #5,***8566,INV-202408-PS-GL-0002,,False,False,REF-766383,First Continental Bank,***8500,Globex APAC Logistics Pte. Ltd.,SG,3873097.68
2024-08-07,2024-08-07,Client Receipt - Pacific Trade Co. #21,Sales Receipt,Logistics-APAC,0.0,31469.05,SGD,SWIFT MT103,Pacific Trade Co. #21,***6934,INV-202408-Logistics-APAC-0007,,False,False,REF-988133,First Continental Bank,***4829,Globex APAC Logistics Pte. Ltd.,SG,3904566.73
2024-08-08,2024-08-08,Client Receipt - CloudBridge Co. #4,Sales Receipt,SaaS-GL,0.0,10494.64,SGD,SWIFT MT103,CloudBridge Co. #4,***4953,INV-202408-SaaS-GL-0001,,False,False,REF-710628,First Continental Bank,***2205,Globex APAC Logistics Pte. Ltd.,SG,3915061.37
2024-08-09,2024-08-09,Supplier Payment - CodeCraft Contractors #13,Supplier Payment,SaaS-GL,5748.19,0.0,SGD,SWIFT MT103,CodeCraft Contractors #13,***6106,,PO-202408-SaaS-GL-0008,False,False,REF-725033,First Continental Bank,***1737,Globex APAC Logistics Pte. Ltd.,SG,3909313.18
2024-08-09,2024-08-09,Client Receipt - CloudBridge Co. #38,Sales Receipt,SaaS-GL,0.0,21458.13,SGD,SWIFT MT103,CloudBridge Co. #38,***8832,INV-202408-SaaS-GL-0022,,False,False,REF-813476,First Continental Bank,***9512,Globex APAC Logistics Pte. Ltd.,SG,3930771.31
2024-08-10,2024-08-10,Supplier Payment - HyperCloud Infra #9,Supplier Payment,SaaS-GL,2725.0,0.0,SGD,SWIFT MT103,HyperCloud Infra #9,***7046,,PO-202408-SaaS-GL-0007,False,False,REF-205766,First Continental Bank,***2168,Globex APAC Logistics Pte. Ltd.,SG,3928046.31
2024-08-10,2024-08-10,Client Receipt - CloudBridge Co. #69,Sales Receipt,SaaS-GL,0.0,23929.18,SGD,FAST Credit,CloudBridge Co. #69,***9016,INV-202408-SaaS-GL-0033,,False,False,REF-648062,First Continental Bank,***1260,Globex APAC Logistics Pte. Ltd.,SG,3951975.49
2024-08-11,2024-08-11,Supplier Payment - ExpertNet Subcontractors #7,Supplier Payment,PS-GL,9224.23,0.0,SGD,MEPS+,ExpertNet Subcontractors #7,***6613,,PO-202408-PS-GL-0006,False,False,REF-708774,First Continental Bank,***5180,Globex APAC Logistics Pte. Ltd.,SG,3942751.26
2024-08-11,2024-08-11,Client Receipt - CloudBridge Co. #75,Sales Receipt,SaaS-GL,0.0,21595.92,SGD,SWIFT MT103,CloudBridge Co. #75,***3436,INV-202408-SaaS-GL-0011,,False,False,REF-435218,First Continental Bank,***7119,Globex APAC Logistics Pte. Ltd.,SG,3964347.18
2024-08-11,2024-08-11,Client Receipt - Pacific Trade Co. #44,Sales Receipt,Logistics-APAC,0.0,54131.85,SGD,FAST Credit,Pacific Trade Co. #44,***6645,INV-202408-Logistics-APAC-0005,,False,False,REF-392337,First Continental Bank,***3807,Globex APAC Logistics Pte. Ltd.,SG,4018479.03
2024-08-12,2024-08-12,Supplier Payment - Port Services #6,Supplier Payment,Logistics-APAC,521.27,0.0,SGD,MEPS+,Port Services #6,***9562,,PO-202408-Logistics-APAC-0005,False,False,REF-835451,First Continental Bank,***9538,Globex APAC Logistics Pte. Ltd.,SG,4017957.76
2024-08-12,2024-08-12,Marketing - Aurelia Media #6,Marketing,ALL,5204.69,0.0,SGD,MEPS+,Aurelia Media #6,***7217,,,False,False,REF-971760,First Continental Bank,***7198,Globex APAC Logistics Pte. Ltd.,SG,4012753.07
2024-08-12,2024-08-12,Supplier Payment - ExpertNet Subcontractors #17,Supplier Payment,PS-GL,12859.71,0.0,SGD,MEPS+,ExpertNet Subcontractors #17,***7075,,PO-202408-PS-GL-0003,False,False,REF-715819,First Continental Bank,***1800,Globex APAC Logistics Pte. Ltd.,SG,3999893.36
2024-08-12,2024-08-12,Intercompany Settlement - Globex EMEA Manufacturing Ltd.,Intercompany Transfer,ALL,868399.0,0.0,SGD,Internal Transfer,Globex EMEA Manufacturing Ltd.,***8792,,,True,True,REF-840370,First Continental Bank,***8379,Globex APAC Logistics Pte. Ltd.,SG,3131494.36
2024-08-12,2024-08-12,Intercompany Reimbursement - Globex EMEA Manufacturing Ltd.,Intercompany Transfer,ALL,0.0,347359.6,SGD,Internal Transfer,Globex EMEA Manufacturing Ltd.,***5989,,,True,True,REF-220603,First Continental Bank,***5413,Globex APAC Logistics Pte. Ltd.,SG,3478853.96
2024-08-13,2024-08-13,Marketing - Aurelia Media #11,Marketing,ALL,4747.63,0.0,SGD,SWIFT MT103,Aurelia Media #11,***5577,,,False,False,REF-142832,First Continental Bank,***2743,Globex APAC Logistics Pte. Ltd.,SG,3474106.33
2024-08-13,2024-08-13,Supplier Payment - Port Services #15,Supplier Payment,Logistics-APAC,6822.43,0.0,SGD,FAST Debit,Port Services #15,***2183,,PO-202408-Logistics-APAC-0004,False,False,REF-594291,First Continental Bank,***9026,Globex APAC Logistics Pte. Ltd.,SG,3467283.9
2024-08-13,2024-08-13,Client Receipt - Vertex Advisory Client #10,Sales Receipt,PS-GL,0.0,1009.94,SGD,SWIFT MT103,Vertex Advisory Client #10,***1743,INV-202408-PS-GL-0005,,False,False,REF-979534,First Continental Bank,***8271,Globex APAC Logistics Pte. Ltd.,SG,3468293.84
2024-08-13,2024-08-13,Client Receipt - CloudBridge Co. #70,Sales Receipt,SaaS-GL,0.0,2405.14,SGD,FAST Credit,CloudBridge Co. #70,***1050,INV-202408-SaaS-GL-0010,,False,False,REF-684878,First Continental Bank,***3756,Globex APAC Logistics Pte. Ltd.,SG,3470698.98
2024-08-13,2024-08-13,Client Receipt - CloudBridge Co. #65,Sales Receipt,SaaS-GL,0.0,12583.0,SGD,FAST Credit,CloudBridge Co. #65,***1436,INV-202408-SaaS-GL-0026,,False,False,REF-733593,First Continental Bank,***9015,Globex APAC Logistics Pte. Ltd.,SG,3483281.98
2024-08-13,2024-08-13,Client Receipt - CloudBridge Co. #77,Sales Receipt,SaaS-GL,0.0,14681.71,SGD,FAST Credit,CloudBridge Co. #77,***3161,INV-202408-SaaS-GL-0014,,False,False,REF-860535,First Continental Bank,***4901,Globex APAC Logistics Pte. Ltd.,SG,3497963.69
2024-08-13,2024-08-13,Client Receipt - CloudBridge Co. #72,Sales Receipt,SaaS-GL,0.0,18680.19,SGD,FAST Credit,CloudBridge Co. #72,***5218,INV-202408-SaaS-GL-0029,,False,False,REF-362218,First Continental Bank,***4017,Globex APAC Logistics Pte. Ltd.,SG,3516643.88
2024-08-14,2024-08-14,Supplier Payment - ExpertNet Subcontractors #2,Supplier Payment,PS-GL,4657.55,0.0,SGD,FAST Debit,ExpertNet Subcontractors #2,***1004,,PO-202408-PS-GL-0008,False,False,REF-537045,First Continental Bank,***5721,Globex APAC Logistics Pte. Ltd.,SG,3511986.33
2024-08-14,2024-08-14,Supplier Payment - ExpertNet Subcontractors #17,Supplier Payment,PS-GL,12144.54,0.0,SGD,SWIFT MT103,ExpertNet Subcontractors #17,***1856,,PO-202408-PS-GL-0005,False,False,REF-756077,First Continental Bank,***2312,Globex APAC Logistics Pte. Ltd.,SG,3499841.79
2024-08-14,2024-08-14,Client Receipt - Pacific Trade Co. #17,Sales Receipt,Logistics-APAC,0.0,35393.87,SGD,FAST Credit,Pacific Trade Co. #17,***6887,INV-202408-Logistics-APAC-0001,,False,False,REF-513327,First Continental Bank,***8921,Globex APAC Logistics Pte. Ltd.,SG,3535235.66
2024-08-14,2024-08-14,Client Receipt - Pacific Trade Co. #25,Sales Receipt,Logistics-APAC,0.0,65738.31,SGD,FAST Credit,Pacific Trade Co. #25,***5950,INV-202408-Logistics-APAC-0011,,False,False,REF-446436,First Continental Bank,***9824,Globex APAC Logistics Pte. Ltd.,SG,3600973.97
2024-08-15,2024-08-15,Client Receipt - CloudBridge Co. #60,Sales Receipt,SaaS-GL,0.0,4554.44,SGD,SWIFT MT103,CloudBridge Co. #60,***4658,INV-202408-SaaS-GL-0030,,False,False,REF-841925,First Continental Bank,***8123,Globex APAC Logistics Pte. Ltd.,SG,3605528.41
2024-08-15,2024-08-15,Client Receipt - CloudBridge Co. #42,Sales Receipt,SaaS-GL,0.0,11441.98,SGD,FAST Credit,CloudBridge Co. #42,***2318,INV-202408-SaaS-GL-0009,,False,False,REF-418358,First Continental Bank,***9682,Globex APAC Logistics Pte. Ltd.,SG,3616970.39
2024-08-15,2024-08-15,Client Receipt - CloudBridge Co. #49,Sales Receipt,SaaS-GL,0.0,39116.84,SGD,SWIFT MT103,CloudBridge Co. #49,***6855,INV-202408-SaaS-GL-0024,,False,False,REF-567863,First Continental Bank,***5499,Globex APAC Logistics Pte. Ltd.,SG,3656087.23
2024-08-16,2024-08-16,Supplier Payment - TransAsia Freight #21,Supplier Payment,Logistics-APAC,10948.2,0.0,SGD,MEPS+,TransAsia Freight #21,***9573,,PO-202408-Logistics-APAC-0007,False,False,REF-504451,First Continental Bank,***6985,Globex APAC Logistics Pte. Ltd.,SG,3645139.03
2024-08-16,2024-08-16,Supplier Payment - CodeCraft Contractors #4,Supplier Payment,SaaS-GL,20182.22,0.0,SGD,SWIFT MT103,CodeCraft Contractors #4,***1003,,PO-202408-SaaS-GL-0002,False,False,REF-833446,First Continental Bank,***5842,Globex APAC Logistics Pte. Ltd.,SG,3624956.81
2024-08-16,2024-08-16,Client Receipt - Pacific Trade Co. #36,Sales Receipt,Logistics-APAC,0.0,33605.99,SGD,FAST Credit,Pacific Trade Co. #36,***6582,INV-202408-Logistics-APAC-0004,,False,False,REF-826557,First Continental Bank,***1628,Globex APAC Logistics Pte. Ltd.,SG,3658562.8
2024-08-17,2024-08-17,Supplier Payment - HyperCloud Infra #9,Supplier Payment,SaaS-GL,1969.46,0.0,SGD,SWIFT MT103,HyperCloud Infra #9,***9232,,PO-202408-SaaS-GL-0012,False,False,REF-392983,First Continental Bank,***4856,Globex APAC Logistics Pte. Ltd.,SG,3656593.34
2024-08-17,2024-08-17,Supplier Payment - HyperCloud Infra #18,Supplier Payment,SaaS-GL,14347.07,0.0,SGD,FAST Debit,HyperCloud Infra #18,***2103,,PO-202408-SaaS-GL-0004,False,False,REF-625496,First Continental Bank,***5743,Globex APAC Logistics Pte. Ltd.,SG,3642246.27
2024-08-18,2024-08-18,BluePeak Property Mgmt,Rent & Utilities,ALL,5265.95,0.0,SGD,SWIFT MT103,BluePeak Property Mgmt,***6050,,,False,False,REF-773953,First Continental Bank,***8630,Globex APAC Logistics Pte. Ltd.,SG,3636980.32
2024-08-18,2024-08-18,Supplier Payment - HyperCloud Infra #15,Supplier Payment,SaaS-GL,10926.92,0.0,SGD,SWIFT MT103,HyperCloud Infra #15,***1651,,PO-202408-SaaS-GL-0009,False,False,REF-272563,First Continental Bank,***5350,Globex APAC Logistics Pte. Ltd.,SG,3626053.4
2024-08-19,2024-08-19,Supplier Payment - TransAsia Freight #28,Supplier Payment,Logistics-APAC,83845.46,0.0,SGD,SWIFT MT103,TransAsia Freight #28,***5181,,PO-202408-Logistics-APAC-0001,False,False,REF-866110,First Continental Bank,***3596,Globex APAC Logistics Pte. Ltd.,SG,3542207.94
2024-08-19,2024-08-19,Client Receipt - CloudBridge Co. #27,Sales Receipt,SaaS-GL,0.0,9288.09,SGD,SWIFT MT103,CloudBridge Co. #27,***9133,INV-202408-SaaS-GL-0013,,False,False,REF-546346,First Continental Bank,***4893,Globex APAC Logistics Pte. Ltd.,SG,3551496.03
2024-08-19,2024-08-19,Client Receipt - Pacific Trade Co. #21,Sales Receipt,Logistics-APAC,0.0,33561.92,SGD,FAST Credit,Pacific Trade Co. #21,***5035,INV-202408-Logistics-APAC-0009,,False,False,REF-985815,First Continental Bank,***2780,Globex APAC Logistics Pte. Ltd.,SG,3585057.95
2024-08-19,2024-08-19,Client Receipt - Pacific Trade Co. #48,Sales Receipt,Logistics-APAC,0.0,42308.23,SGD,SWIFT MT103,Pacific Trade Co. #48,***6564,INV-202408-Logistics-APAC-0003,,False,False,REF-343126,First Continental Bank,***9334,Globex APAC Logistics Pte. Ltd.,SG,3627366.18
2024-08-20,2024-08-20,VAT/GST Remittance - IRAS Singapore,Tax Payment,ALL,71041.07,0.0,SGD,MEPS+,IRAS Singapore,***8864,,,False,False,REF-997934,First Continental Bank,***9744,Globex APAC Logistics Pte. Ltd.,SG,3556325.11
2024-08-20,2024-08-20,Client Receipt - CloudBridge Co. #62,Sales Receipt,SaaS-GL,0.0,1854.65,SGD,SWIFT MT103,CloudBridge Co. #62,***6278,INV-202408-SaaS-GL-0028,,False,False,REF-596840,First Continental Bank,***3434,Globex APAC Logistics Pte. Ltd.,SG,3558179.76
2024-08-20,2024-08-20,Client Receipt - CloudBridge Co. #51,Sales Receipt,SaaS-GL,0.0,13792.04,SGD,FAST Credit,CloudBridge Co. #51,***7770,INV-202408-SaaS-GL-0032,,False,False,REF-563215,First Continental Bank,***2738,Globex APAC Logistics Pte. Ltd.,SG,3571971.8
2024-08-20,2024-08-20,Client Receipt - Pacific Trade Co. #49,Sales Receipt,Logistics-APAC,0.0,21900.78,SGD,FAST Credit,Pacific Trade Co. #49,***3044,INV-202408-Logistics-APAC-0002,,False,False,REF-965779,First Continental Bank,***2671,Globex APAC Logistics Pte. Ltd.,SG,3593872.58
2024-08-21,2024-08-21,Supplier Payment - ExpertNet Subcontractors #16,Supplier Payment,PS-GL,4910.79,0.0,SGD,MEPS+,ExpertNet Subcontractors #16,***2587,,PO-202408-PS-GL-0004,False,False,REF-302023,First Continental Bank,***3504,Globex APAC Logistics Pte. Ltd.,SG,3588961.79
2024-08-21,2024-08-21,Supplier Payment - HyperCloud Infra #16,Supplier Payment,SaaS-GL,8084.42,0.0,SGD,FAST Debit,HyperCloud Infra #16,***8672,,PO-202408-SaaS-GL-0006,False,False,REF-295302,First Continental Bank,***7072,Globex APAC Logistics Pte. Ltd.,SG,3580877.37
2024-08-21,2024-08-21,Supplier Payment - CodeCraft Contractors #3,Supplier Payment,SaaS-GL,13170.62,0.0,SGD,FAST Debit,CodeCraft Contractors #3,***2787,,PO-202408-SaaS-GL-0003,False,False,REF-614055,First Continental Bank,***5695,Globex APAC Logistics Pte. Ltd.,SG,3567706.75
2024-08-21,2024-08-21,Client Receipt - CloudBridge Co. #1,Sales Receipt,SaaS-GL,0.0,917.62,SGD,SWIFT MT103,CloudBridge Co. #1,***3969,INV-202408-SaaS-GL-0031,,False,False,REF-304304,First Continental Bank,***5989,Globex APAC Logistics Pte. Ltd.,SG,3568624.37
2024-08-21,2024-08-21,Client Receipt - Vertex Advisory Client #29,Sales Receipt,PS-GL,0.0,9933.93,SGD,FAST Credit,Vertex Advisory Client #29,***6110,INV-202408-PS-GL-0010,,False,False,REF-293406,First Continental Bank,***4147,Globex APAC Logistics Pte. Ltd.,SG,3578558.3
2024-08-21,2024-08-21,Client Receipt - CloudBridge Co. #58,Sales Receipt,SaaS-GL,0.0,10119.91,SGD,SWIFT MT103,CloudBridge Co. #58,***9633,INV-202408-SaaS-GL-0016,,False,False,REF-498768,First Continental Bank,***8051,Globex APAC Logistics Pte. Ltd.,SG,3588678.21
2024-08-22,2024-08-22,Merchant Processing Fees,Bank/Merchant Fees,ALL,590.13,0.0,SGD,FAST Debit,First Continental Bank,***2725,,,False,False,REF-809827,First Continental Bank,***8199,Globex APAC Logistics Pte. Ltd.,SG,3588088.08
2024-08-22,2024-08-22,Client Receipt - CloudBridge Co. #22,Sales Receipt,SaaS-GL,0.0,37635.49,SGD,FAST Credit,CloudBridge Co. #22,***2739,INV-202408-SaaS-GL-0027,,False,False,REF-334065,First Continental Bank,***9233,Globex APAC Logistics Pte. Ltd.,SG,3625723.57
2024-08-23,2024-08-23,Client Receipt - Vertex Advisory Client #25,Sales Receipt,PS-GL,0.0,47170.44,SGD,SWIFT MT103,Vertex Advisory Client #25,***1711,INV-202408-PS-GL-0004,,False,False,REF-228742,First Continental Bank,***1498,Globex APAC Logistics Pte. Ltd.,SG,3672894.01
2024-08-24,2024-08-24,Supplier Payment - CodeCraft Contractors #5,Supplier Payment,SaaS-GL,10212.59,0.0,SGD,FAST Debit,CodeCraft Contractors #5,***7684,,PO-202408-SaaS-GL-0001,False,False,REF-915700,First Continental Bank,***7197,Globex APAC Logistics Pte. Ltd.,SG,3662681.42
2024-08-24,2024-08-24,Client Receipt - CloudBridge Co. #76,Sales Receipt,SaaS-GL,0.0,2920.91,SGD,SWIFT MT103,CloudBridge Co. #76,***2598,INV-202408-SaaS-GL-0025,,False,False,REF-628878,First Continental Bank,***2410,Globex APAC Logistics Pte. Ltd.,SG,3665602.33
2024-08-24,2024-08-24,Client Receipt - Vertex Advisory Client #52,Sales Receipt,PS-GL,0.0,14672.65,SGD,FAST Credit,Vertex Advisory Client #52,***9671,INV-202408-PS-GL-0003,,False,False,REF-668541,First Continental Bank,***8204,Globex APAC Logistics Pte. Ltd.,SG,3680274.98
2024-08-24,2024-08-24,Client Receipt - Pacific Trade Co. #12,Sales Receipt,Logistics-APAC,0.0,27862.62,SGD,FAST Credit,Pacific Trade Co. #12,***4704,INV-202408-Logistics-APAC-0006,,False,False,REF-695204,First Continental Bank,***4011,Globex APAC Logistics Pte. Ltd.,SG,3708137.6
2024-08-25,2024-08-25,Client Receipt - Vertex Advisory Client #13,Sales Receipt,PS-GL,0.0,37645.58,SGD,SWIFT MT103,Vertex Advisory Client #13,***2432,INV-202408-PS-GL-0008,,False,False,REF-150810,First Continental Bank,***8900,Globex APAC Logistics Pte. Ltd.,SG,3745783.18
2024-08-26,2024-08-26,Supplier Payment - Port Services #8,Supplier Payment,Logistics-APAC,88416.35,0.0,SGD,MEPS+,Port Services #8,***6531,,PO-202408-Logistics-APAC-0008,False,False,REF-534897,First Continental Bank,***3554,Globex APAC Logistics Pte. Ltd.,SG,3657366.83
2024-08-26,2024-08-26,Payroll - GlobalPay Services Ltd,Payroll,ALL,92100.94,0.0,SGD,MEPS+,GlobalPay Services Ltd,***3254,,,False,False,REF-559678,First Continental Bank,***7760,Globex APAC Logistics Pte. Ltd.,SG,3565265.89
2024-08-26,2024-08-26,Intercompany Settlement - Globex Consulting UK Ltd.,Intercompany Transfer,ALL,391495.0,0.0,SGD,Internal Transfer,Globex Consulting UK Ltd.,***5395,,,True,True,REF-772372,First Continental Bank,***1725,Globex APAC Logistics Pte. Ltd.,SG,3173770.89
2024-08-26,2024-08-26,Client Receipt - Vertex Advisory Client #6,Sales Receipt,PS-GL,0.0,22336.46,SGD,FAST Credit,Vertex Advisory Client #6,***2067,INV-202408-PS-GL-0006,,False,False,REF-551302,First Continental Bank,***2873,Globex APAC Logistics Pte. Ltd.,SG,3196107.35
2024-08-26,2024-08-26,Client Receipt - Pacific Trade Co. #50,Sales Receipt,Logistics-APAC,0.0,38273.51,SGD,SWIFT MT103,Pacific Trade Co. #50,***3547,INV-202408-Logistics-APAC-0008,,False,False,REF-227813,First Continental Bank,***7624,Globex APAC Logistics Pte. Ltd.,SG,3234380.86
2024-08-27,2024-08-27,Supplier Payment - HyperCloud Infra #14,Supplier Payment,SaaS-GL,967.05,0.0,SGD,FAST Debit,HyperCloud Infra #14,***8241,,PO-202408-SaaS-GL-0011,False,False,REF-538428,First Continental Bank,***9751,Globex APAC Logistics Pte. Ltd.,SG,3233413.81
2024-08-27,2024-08-27,Marketing - Beacon Digital #7,Marketing,ALL,19319.48,0.0,SGD,FAST Debit,Beacon Digital #7,***8830,,,False,False,REF-636662,First Continental Bank,***3935,Globex APAC Logistics Pte. Ltd.,SG,3214094.33
2024-08-27,2024-08-27,Supplier Payment - TransAsia Freight #19,Supplier Payment,Logistics-APAC,68276.92,0.0,SGD,SWIFT MT103,TransAsia Freight #19,***3351,,PO-202408-Logistics-APAC-0002,False,False,REF-488423,First Continental Bank,***1102,Globex APAC Logistics Pte. Ltd.,SG,3145817.41
2024-08-27,2024-08-27,Client Receipt - CloudBridge Co. #9,Sales Receipt,SaaS-GL,0.0,3530.8,SGD,SWIFT MT103,CloudBridge Co. #9,***2503,INV-202408-SaaS-GL-0003,,False,False,REF-456436,First Continental Bank,***6468,Globex APAC Logistics Pte. Ltd.,SG,3149348.21
2024-08-27,2024-08-27,Client Receipt - CloudBridge Co. #8,Sales Receipt,SaaS-GL,0.0,10025.15,SGD,SWIFT MT103,CloudBridge Co. #8,***4391,INV-202408-SaaS-GL-0007,,False,False,REF-458550,First Continental Bank,***5210,Globex APAC Logistics Pte. Ltd.,SG,3159373.36
2024-08-27,2024-08-27,Client Receipt - CloudBridge Co. #20,Sales Receipt,SaaS-GL,0.0,13167.08,SGD,SWIFT MT103,CloudBridge Co. #20,***6953,INV-202408-SaaS-GL-0015,,False,False,REF-147655,First Continental Bank,***9697,Globex APAC Logistics Pte. Ltd.,SG,3172540.44
2024-08-27,2024-08-27,Client Receipt - Vertex Advisory Client #25,Sales Receipt,PS-GL,0.0,23197.55,SGD,FAST Credit,Vertex Advisory Client #25,***1499,INV-202408-PS-GL-0001,,False,False,REF-864499,First Continental Bank,***5529,Globex APAC Logistics Pte. Ltd.,SG,3195737.99
2024-08-28,2024-08-28,Client Receipt - CloudBridge Co. #38,Sales Receipt,SaaS-GL,0.0,7250.37,SGD,SWIFT MT103,CloudBridge Co. #38,***8478,INV-202408-SaaS-GL-0005,,False,False,REF-533989,First Continental Bank,***5407,Globex APAC Logistics Pte. Ltd.,SG,3202988.36
2024-08-28,2024-08-28,Client Receipt - CloudBridge Co. #37,Sales Receipt,SaaS-GL,0.0,21913.43,SGD,SWIFT MT103,CloudBridge Co. #37,***7694,INV-202408-SaaS-GL-0021,,False,False,REF-818648,First Continental Bank,***5312,Globex APAC Logistics Pte. Ltd.,SG,3224901.79
2024-08-29,2024-08-29,Supplier Payment - HyperCloud Infra #9,Supplier Payment,SaaS-GL,1897.74,0.0,SGD,MEPS+,HyperCloud Infra #9,***6647,,PO-202408-SaaS-GL-0005,False,False,REF-169091,First Continental Bank,***7550,Globex APAC Logistics Pte. Ltd.,SG,3223004.05
2024-08-29,2024-08-29,Client Receipt - CloudBridge Co. #34,Sales Receipt,SaaS-GL,0.0,3388.93,SGD,FAST Credit,CloudBridge Co. #34,***1222,INV-202408-SaaS-GL-0004,,False,False,REF-636523,First Continental Bank,***5115,Globex APAC Logistics Pte. Ltd.,SG,3226392.98
2024-08-29,2024-08-29,Client Receipt - Pacific Trade Co. #10,Sales Receipt,Logistics-APAC,0.0,7227.03,SGD,SWIFT MT103,Pacific Trade Co. #10,***7957,INV-202408-Logistics-APAC-0010,,False,False,REF-377830,First Continental Bank,***7596,Globex APAC Logistics Pte. Ltd.,SG,3233620.01
2024-08-29,2024-08-29,Client Receipt - CloudBridge Co. #1,Sales Receipt,SaaS-GL,0.0,8583.97,SGD,FAST Credit,CloudBridge Co. #1,***3514,INV-202408-SaaS-GL-0018,,False,False,REF-132551,First Continental Bank,***3358,Globex APAC Logistics Pte. Ltd.,SG,3242203.98
2024-08-29,2024-08-29,Client Receipt - CloudBridge Co. #77,Sales Receipt,SaaS-GL,0.0,26551.22,SGD,FAST Credit,CloudBridge Co. #77,***4891,INV-202408-SaaS-GL-0020,,False,False,REF-115990,First Continental Bank,***7313,Globex APAC Logistics Pte. Ltd.,SG,3268755.2
2024-08-30,2024-08-30,Supplier Payment - CodeCraft Contractors #8,Supplier Payment,SaaS-GL,1524.82,0.0,SGD,MEPS+,CodeCraft Contractors #8,***7420,,PO-202408-SaaS-GL-0010,False,False,REF-432131,First Continental Bank,***2374,Globex APAC Logistics Pte. Ltd.,SG,3267230.38
2024-08-30,2024-08-30,Supplier Payment - ExpertNet Subcontractors #19,Supplier Payment,PS-GL,11852.61,0.0,SGD,MEPS+,ExpertNet Subcontractors #19,***4791,,PO-202408-PS-GL-0002,False,False,REF-749763,First Continental Bank,***2853,Globex APAC Logistics Pte. Ltd.,SG,3255377.77
2024-08-30,2024-08-30,Payroll - GlobalPay Services Ltd,Payroll,ALL,92100.94,0.0,SGD,SWIFT MT103,GlobalPay Services Ltd,***4604,,,False,False,REF-659854,First Continental Bank,***8793,Globex APAC Logistics Pte. Ltd.,SG,3163276.83
2024-08-30,2024-08-30,Client Receipt - CloudBridge Co. #50,Sales Receipt,SaaS-GL,0.0,4037.48,SGD,SWIFT MT103,CloudBridge Co. #50,***8948,INV-202408-SaaS-GL-0008,,False,False,REF-843797,First Continental Bank,***4761,Globex APAC Logistics Pte. Ltd.,SG,3167314.31
2024-08-30,2024-08-30,Client Receipt - CloudBridge Co. #15,Sales Receipt,SaaS-GL,0.0,5017.51,SGD,FAST Credit,CloudBridge Co. #15,***9574,INV-202408-SaaS-GL-0019,,False,False,REF-154724,First Continental Bank,***3551,Globex APAC Logistics Pte. Ltd.,SG,3172331.82
2024-08-30,2024-08-30,Client Receipt - CloudBridge Co. #63,Sales Receipt,SaaS-GL,0.0,9130.18,SGD,SWIFT MT103,CloudBridge Co. #63,***8951,INV-202408-SaaS-GL-0023,,False,False,REF-765794,First Continental Bank,***6118,Globex APAC Logistics Pte. Ltd.,SG,3181462.0
2024-08-30,2024-08-30,Interest Earned,Interest Income,ALL,0.0,10705.2,SGD,FAST Credit,First Continental Bank,***7894,,,False,False,REF-995606,First Continental Bank,***4549,Globex APAC Logistics Pte. Ltd.,SG,3192167.2
2024-08-31,2024-08-31,Client Receipt - CloudBridge Co. #41,Sales Receipt,SaaS-GL,0.0,2288.67,SGD,SWIFT MT103,CloudBridge Co. #41,***7443,INV-202408-SaaS-GL-0017,,False,False,REF-253647,First Continental Bank,***4450,Globex APAC Logistics Pte. Ltd.,SG,3194455.87
2024-08-31,2024-08-31,Client Receipt - Vertex Advisory Client #31,Sales Receipt,PS-GL,0.0,58095.8,SGD,FAST Credit,Vertex Advisory Client #31,***1641,INV-202408-PS-GL-0007,,False,False,REF-787864,First Continental Bank,***5988,Globex APAC Logistics Pte. Ltd.,SG,3252551.67
2024-09-01,2024-09-01,Account Maintenance Fee,Bank/Merchant Fees,ALL,2500.0,0.0,SGD,SWIFT MT103,First Continental Bank,***1454,,,False,False,REF-600121,First Continental Bank,***5869,Globex APAC Logistics Pte. Ltd.,SG,3250051.67
2024-09-02,2024-09-02,Supplier Payment - HyperCloud Infra #14,Supplier Payment,SaaS-GL,3202.89,0.0,SGD,FAST Debit,HyperCloud Infra #14,***4515,,PO-202409-SaaS-GL-0004,False,False,REF-117128,First Continental Bank,***1446,Globex APAC Logistics Pte. Ltd.,SG,3246848.78
2024-09-02,2024-09-02,Supplier Payment - ExpertNet Subcontractors #2,Supplier Payment,PS-GL,6352.47,0.0,SGD,SWIFT MT103,ExpertNet Subcontractors #2,***8249,,PO-202409-PS-GL-0003,False,False,REF-342628,First Continental Bank,***3884,Globex APAC Logistics Pte. Ltd.,SG,3240496.31
2024-09-02,2024-09-02,Supplier Payment - TransAsia Freight #22,Supplier Payment,Logistics-APAC,54016.27,0.0,SGD,FAST Debit,TransAsia Freight #22,***4992,,PO-202409-Logistics-APAC-0006,False,False,REF-594155,First Continental Bank,***9762,Globex APAC Logistics Pte. Ltd.,SG,3186480.04
2024-09-02,2024-09-02,Supplier Payment - TransAsia Freight #27,Supplier Payment,Logistics-APAC,101614.24,0.0,SGD,FAST Debit,TransAsia Freight #27,***4398,,PO-202409-Logistics-APAC-0001,False,False,REF-749954,First Continental Bank,***6163,Globex APAC Logistics Pte. Ltd.,SG,3084865.8
2024-09-02,2024-09-02,Client Receipt - CloudBridge Co. #15,Sales Receipt,SaaS-GL,0.0,339.68,SGD,SWIFT MT103,CloudBridge Co. #15,***5843,INV-202409-SaaS-GL-0013,,False,False,REF-696459,First Continental Bank,***2406,Globex APAC Logistics Pte. Ltd.,SG,3085205.48
2024-09-02,2024-09-02,Client Receipt - CloudBridge Co. #79,Sales Receipt,SaaS-GL,0.0,15023.24,SGD,FAST Credit,CloudBridge Co. #79,***2493,INV-202409-SaaS-GL-0024,,False,False,REF-467094,First Continental Bank,***3553,Globex APAC Logistics Pte. Ltd.,SG,3100228.72
2024-09-02,2024-09-02,Client Receipt - CloudBridge Co. #20,Sales Receipt,SaaS-GL,0.0,19450.84,SGD,SWIFT MT103,CloudBridge Co. #20,***3603,INV-202409-SaaS-GL-0007,,False,False,REF-651154,First Continental Bank,***9498,Globex APAC Logistics Pte. Ltd.,SG,3119679.56
2024-09-03,2024-09-03,Supplier Payment - TransAsia Freight #8,Supplier Payment,Logistics-APAC,4731.88,0.0,SGD,FAST Debit,TransAsia Freight #8,***7404,,PO-202409-Logistics-APAC-0009,False,False,REF-700056,First Continental Bank,***3671,Globex APAC Logistics Pte. Ltd.,SG,3114947.68
2024-09-03,2024-09-03,Client Receipt - Pacific Trade Co. #32,Sales Receipt,Logistics-APAC,0.0,10831.3,SGD,FAST Credit,Pacific Trade Co. #32,***9041,INV-202409-Logistics-APAC-0005,,False,False,REF-506377,First Continental Bank,***3744,Globex APAC Logistics Pte. Ltd.,SG,3125778.98
2024-09-03,2024-09-03,Client Receipt - CloudBridge Co. #22,Sales Receipt,SaaS-GL,0.0,30803.04,SGD,FAST Credit,CloudBridge Co. #22,***1566,INV-202409-SaaS-GL-0014,,False,False,REF-219970,First Continental Bank,***6639,Globex APAC Logistics Pte. Ltd.,SG,3156582.02
2024-09-04,2024-09-04,Supplier Payment - CodeCraft Contractors #8,Supplier Payment,SaaS-GL,14812.46,0.0,SGD,SWIFT MT103,CodeCraft Contractors #8,***3685,,PO-202409-SaaS-GL-0003,False,False,REF-205147,First Continental Bank,***8538,Globex APAC Logistics Pte. Ltd.,SG,3141769.56
2024-09-04,2024-09-04,Marketing - Aurelia Media #9,Marketing,ALL,24842.33,0.0,SGD,MEPS+,Aurelia Media #9,***7124,,,False,False,REF-344963,First Continental Bank,***7490,Globex APAC Logistics Pte. Ltd.,SG,3116927.23
2024-09-04,2024-09-04,Client Receipt - CloudBridge Co. #41,Sales Receipt,SaaS-GL,0.0,17905.71,SGD,SWIFT MT103,CloudBridge Co. #41,***4790,INV-202409-SaaS-GL-0009,,False,False,REF-192187,First Continental Bank,***7551,Globex APAC Logistics Pte. Ltd.,SG,3134832.94
2024-09-05,2024-09-05,Supplier Payment - CodeCraft Contractors #12,Supplier Payment,SaaS-GL,643.42,0.0,SGD,SWIFT MT103,CodeCraft Contractors #12,***2662,,PO-202409-SaaS-GL-0011,False,False,REF-988170,First Continental Bank,***1170,Globex APAC Logistics Pte. Ltd.,SG,3134189.52
2024-09-05,2024-09-05,Client Receipt - CloudBridge Co. #9,Sales Receipt,SaaS-GL,0.0,9223.55,SGD,SWIFT MT103,CloudBridge Co. #9,***3218,INV-202409-SaaS-GL-0010,,False,False,REF-129306,First Continental Bank,***5408,Globex APAC Logistics Pte. Ltd.,SG,3143413.07
2024-09-05,2024-09-05,Client Receipt - CloudBridge Co. #79,Sales Receipt,SaaS-GL,0.0,32499.34,SGD,FAST Credit,CloudBridge Co. #79,***4975,INV-202409-SaaS-GL-0025,,False,False,REF-196906,First Continental Bank,***9628,Globex APAC Logistics Pte. Ltd.,SG,3175912.41
2024-09-06,2024-09-06,Supplier Payment - CodeCraft Contractors #9,Supplier Payment,SaaS-GL,4295.03,0.0,SGD,SWIFT MT103,CodeCraft Contractors #9,***9858,,PO-202409-SaaS-GL-0002,False,False,REF-861218,First Continental Bank,***7151,Globex APAC Logistics Pte. Ltd.,SG,3171617.38
2024-09-06,2024-09-06,Client Receipt - Pacific Trade Co. #38,Sales Receipt,Logistics-APAC,0.0,4751.59,SGD,FAST Credit,Pacific Trade Co. #38,***4873,INV-202409-Logistics-APAC-0015,,False,False,REF-750470,First Continental Bank,***6400,Globex APAC Logistics Pte. Ltd.,SG,3176368.97
2024-09-06,2024-09-06,Client Receipt - CloudBridge Co. #47,Sales Receipt,SaaS-GL,0.0,15647.47,SGD,SWIFT MT103,CloudBridge Co. #47,***4685,INV-202409-SaaS-GL-0018,,False,False,REF-813975,First Continental Bank,***4743,Globex APAC Logistics Pte. Ltd.,SG,3192016.44
2024-09-06,2024-09-06,Client Receipt - CloudBridge Co. #39,Sales Receipt,SaaS-GL,0.0,25314.45,SGD,FAST Credit,CloudBridge Co. #39,***7471,INV-202409-SaaS-GL-0008,,False,False,REF-636902,First Continental Bank,***3194,Globex APAC Logistics Pte. Ltd.,SG,3217330.89
2024-09-08,2024-09-08,Client Receipt - Vertex Advisory Client #29,Sales Receipt,PS-GL,0.0,8729.08,SGD,SWIFT MT103,Vertex Advisory Client #29,***6505,INV-202409-PS-GL-0002,,False,False,REF-426812,First Continental Bank,***4778,Globex APAC Logistics Pte. Ltd.,SG,3226059.97
2024-09-08,2024-09-08,Client Receipt - Pacific Trade Co. #46,Sales Receipt,Logistics-APAC,0.0,11326.35,SGD,FAST Credit,Pacific Trade Co. #46,***6369,INV-202409-Logistics-APAC-0013,,False,False,REF-249000,First Continental Bank,***3071,Globex APAC Logistics Pte. Ltd.,SG,3237386.32
2024-09-09,2024-09-09,Alphagrid Utilities,Rent & Utilities,ALL,9720.54,0.0,SGD,MEPS+,Alphagrid Utilities,***7395,,,False,False,REF-854026,First Continental Bank,***4938,Globex APAC Logistics Pte. Ltd.,SG,3227665.78
2024-09-09,2024-09-09,Supplier Payment - ExpertNet Subcontractors #19,Supplier Payment,PS-GL,19490.99,0.0,SGD,MEPS+,ExpertNet Subcontractors #19,***2814,,PO-202409-PS-GL-0004,False,False,REF-671536,First Continental Bank,***7939,Globex APAC Logistics Pte. Ltd.,SG,3208174.79
2024-09-09,2024-09-09,Client Receipt - CloudBridge Co. #19,Sales Receipt,SaaS-GL,0.0,661.62,SGD,FAST Credit,CloudBridge Co. #19,***3794,INV-202409-SaaS-GL-0030,,False,False,REF-273872,First Continental Bank,***2331,Globex APAC Logistics Pte. Ltd.,SG,3208836.41
2024-09-09,2024-09-09,Client Receipt - CloudBridge Co. #47,Sales Receipt,SaaS-GL,0.0,9025.12,SGD,SWIFT MT103,CloudBridge Co. #47,***5470,INV-202409-SaaS-GL-0006,,False,False,REF-882412,First Continental Bank,***6376,Globex APAC Logistics Pte. Ltd.,SG,3217861.53
2024-09-09,2024-09-09,Client Receipt - CloudBridge Co. #65,Sales Receipt,SaaS-GL,0.0,12487.09,SGD,SWIFT MT103,CloudBridge Co. #65,***4056,INV-202409-SaaS-GL-0027,,False,False,REF-686618,First Continental Bank,***5150,Globex APAC Logistics Pte. Ltd.,SG,3230348.62
2024-09-10,2024-09-10,Client Receipt - CloudBridge Co. #71,Sales Receipt,SaaS-GL,0.0,2726.42,SGD,SWIFT MT103,CloudBridge Co. #71,***7341,INV-202409-SaaS-GL-0026,,False,False,REF-610330,First Continental Bank,***9512,Globex APAC Logistics Pte. Ltd.,SG,3233075.04
2024-09-10,2024-09-10,Client Receipt - CloudBridge Co. #1,Sales Receipt,SaaS-GL,0.0,19992.26,SGD,SWIFT MT103,CloudBridge Co. #1,***8881,INV-202409-SaaS-GL-0015,,False,False,REF-905385,First Continental Bank,***7849,Globex APAC Logistics Pte. Ltd.,SG,3253067.3
2024-09-10,2024-09-10,Client Receipt - Pacific Trade Co. #21,Sales Receipt,Logistics-APAC,0.0,20387.3,SGD,FAST Credit,Pacific Trade Co. #21,***9253,INV-202409-Logistics-APAC-0006,,False,False,REF-392038,First Continental Bank,***2514,Globex APAC Logistics Pte. Ltd.,SG,3273454.6
2024-09-10,2024-09-10,Client Receipt - Pacific Trade Co. #5,Sales Receipt,Logistics-APAC,0.0,96206.29,SGD,SWIFT MT103,Pacific Trade Co. #5,***8608,INV-202409-Logistics-APAC-0001,,False,False,REF-369313,First Continental Bank,***1754,Globex APAC Logistics Pte. Ltd.,SG,3369660.89
2024-09-11,2024-09-11,Supplier Payment - TransAsia Freight #35,Supplier Payment,Logistics-APAC,1542.64,0.0,SGD,MEPS+,TransAsia Freight #35,***4462,,PO-202409-Logistics-APAC-0003,False,False,REF-303741,First Continental Bank,***4719,Globex APAC Logistics Pte. Ltd.,SG,3368118.25
2024-09-11,2024-09-11,Client Receipt - CloudBridge Co. #11,Sales Receipt,SaaS-GL,0.0,2441.13,SGD,FAST Credit,CloudBridge Co. #11,***8965,INV-202409-SaaS-GL-0020,,False,False,REF-302167,First Continental Bank,***9160,Globex APAC Logistics Pte. Ltd.,SG,3370559.38
2024-09-11,2024-09-11,Client Receipt - Vertex Advisory Client #16,Sales Receipt,PS-GL,0.0,5491.94,SGD,FAST Credit,Vertex Advisory Client #16,***9048,INV-202409-PS-GL-0006,,False,False,REF-200466,First Continental Bank,***4824,Globex APAC Logistics Pte. Ltd.,SG,3376051.32
2024-09-12,2024-09-12,Supplier Payment - Port Services #18,Supplier Payment,Logistics-APAC,611.01,0.0,SGD,MEPS+,Port Services #18,***2499,,PO-202409-Logistics-APAC-0002,False,False,REF-998678,First Continental Bank,***2054,Globex APAC Logistics Pte. Ltd.,SG,3375440.31
2024-09-12,2024-09-12,Supplier Payment - CodeCraft Contractors #2,Supplier Payment,SaaS-GL,13353.03,0.0,SGD,MEPS+,CodeCraft Contractors #2,***2495,,PO-202409-SaaS-GL-0008,False,False,REF-151032,First Continental Bank,***3458,Globex APAC Logistics Pte. Ltd.,SG,3362087.28
2024-09-12,2024-09-12,Supplier Payment - HyperCloud Infra #3,Supplier Payment,SaaS-GL,17349.47,0.0,SGD,SWIFT MT103,HyperCloud Infra #3,***7320,,PO-202409-SaaS-GL-0012,False,False,REF-479178,First Continental Bank,***8354,Globex APAC Logistics Pte. Ltd.,SG,3344737.81
2024-09-12,2024-09-12,Intercompany Settlement - Globex Consulting UK Ltd.,Intercompany Transfer,ALL,212774.0,0.0,SGD,Internal Transfer,Globex Consulting UK Ltd.,***3938,,,True,True,REF-439735,First Continental Bank,***4765,Globex APAC Logistics Pte. Ltd.,SG,3131963.81
2024-09-12,2024-09-12,Client Receipt - CloudBridge Co. #60,Sales Receipt,SaaS-GL,0.0,6264.59,SGD,SWIFT MT103,CloudBridge Co. #60,***3621,INV-202409-SaaS-GL-0004,,False,False,REF-783658,First Continental Bank,***9684,Globex APAC Logistics Pte. Ltd.,SG,3138228.4
2024-09-13,2024-09-13,Supplier Payment - CodeCraft Contractors #3,Supplier Payment,SaaS-GL,1610.91,0.0,SGD,SWIFT MT103,CodeCraft Contractors #3,***3230,,PO-202409-SaaS-GL-0005,False,False,REF-537603,First Continental Bank,***2813,Globex APAC Logistics Pte. Ltd.,SG,3136617.49
2024-09-13,2024-09-13,Client Receipt - CloudBridge Co. #29,Sales Receipt,SaaS-GL,0.0,668.66,SGD,SWIFT MT103,CloudBridge Co. #29,***9400,INV-202409-SaaS-GL-0017,,False,False,REF-693566,First Continental Bank,***1791,Globex APAC Logistics Pte. Ltd.,SG,3137286.15
2024-09-13,2024-09-13,Client Receipt - Pacific Trade Co. #32,Sales Receipt,Logistics-APAC,0.0,3847.26,SGD,SWIFT MT103,Pacific Trade Co. #32,***1556,INV-202409-Logistics-APAC-0007,,False,False,REF-232595,First Continental Bank,***9245,Globex APAC Logistics Pte. Ltd.,SG,3141133.41
2024-09-13,2024-09-13,Client Receipt - CloudBridge Co. #15,Sales Receipt,SaaS-GL,0.0,15558.89,SGD,FAST Credit,CloudBridge Co. #15,***2307,INV-202409-SaaS-GL-0021,,False,False,REF-802792,First Continental Bank,***9971,Globex APAC Logistics Pte. Ltd.,SG,3156692.3
2024-09-15,2024-09-15,Client Receipt - CloudBridge Co. #40,Sales Receipt,SaaS-GL,0.0,4367.39,SGD,FAST Credit,CloudBridge Co. #40,***2646,INV-202409-SaaS-GL-0005,,False,False,REF-377051,First Continental Bank,***8407,Globex APAC Logistics Pte. Ltd.,SG,3161059.69
2024-09-15,2024-09-15,Client Receipt - Pacific Trade Co. #40,Sales Receipt,Logistics-APAC,0.0,13640.85,SGD,SWIFT MT103,Pacific Trade Co. #40,***3210,INV-202409-Logistics-APAC-0011,,False,False,REF-498058,First Continental Bank,***7388,Globex APAC Logistics Pte. Ltd.,SG,3174700.54
2024-09-16,2024-09-16,Supplier Payment - Port Services #13,Supplier Payment,Logistics-APAC,492.93,0.0,SGD,MEPS+,Port Services #13,***4585,,PO-202409-Logistics-APAC-0012,False,False,REF-389914,First Continental Bank,***9039,Globex APAC Logistics Pte. Ltd.,SG,3174207.61
2024-09-16,2024-09-16,Supplier Payment - ExpertNet Subcontractors #6,Supplier Payment,PS-GL,11699.35,0.0,SGD,SWIFT MT103,ExpertNet Subcontractors #6,***2848,,PO-202409-PS-GL-0009,False,False,REF-849929,First Continental Bank,***1805,Globex APAC Logistics Pte. Ltd.,SG,3162508.26
2024-09-16,2024-09-16,Supplier Payment - TransAsia Freight #15,Supplier Payment,Logistics-APAC,13067.44,0.0,SGD,FAST Debit,TransAsia Freight #15,***5386,,PO-202409-Logistics-APAC-0011,False,False,REF-882764,First Continental Bank,***6159,Globex APAC Logistics Pte. Ltd.,SG,3149440.82
2024-09-16,2024-09-16,Client Receipt - CloudBridge Co. #23,Sales Receipt,SaaS-GL,0.0,1708.49,SGD,SWIFT MT103,CloudBridge Co. #23,***8396,INV-202409-SaaS-GL-0011,,False,False,REF-943840,First Continental Bank,***4783,Globex APAC Logistics Pte. Ltd.,SG,3151149.31
2024-09-16,2024-09-16,Client Receipt - CloudBridge Co. #79,Sales Receipt,SaaS-GL,0.0,1826.59,SGD,SWIFT MT103,CloudBridge Co. #79,***7824,INV-202409-SaaS-GL-0028,,False,False,REF-931349,First Continental Bank,***6302,Globex APAC Logistics Pte. Ltd.,SG,3152975.9
2024-09-16,2024-09-16,Client Receipt - Pacific Trade Co. #23,Sales Receipt,Logistics-APAC,0.0,12368.11,SGD,SWIFT MT103,Pacific Trade Co. #23,***6518,INV-202409-Logistics-APAC-0008,,False,False,REF-525676,First Continental Bank,***1334,Globex APAC Logistics Pte. Ltd.,SG,3165344.01
2024-09-16,2024-09-16,Client Receipt - CloudBridge Co. #77,Sales Receipt,SaaS-GL,0.0,17600.15,SGD,SWIFT MT103,CloudBridge Co. #77,***9419,INV-202409-SaaS-GL-0031,,False,False,REF-107969,First Continental Bank,***7381,Globex APAC Logistics Pte. Ltd.,SG,3182944.16
2024-09-16,2024-09-16,Client Receipt - CloudBridge Co. #44,Sales Receipt,SaaS-GL,0.0,27863.44,SGD,SWIFT MT103,CloudBridge Co. #44,***9526,INV-202409-SaaS-GL-0029,,False,False,REF-293894,First Continental Bank,***4044,Globex APAC Logistics Pte. Ltd.,SG,3210807.6
2024-09-16,2024-09-16,Client Receipt - Pacific Trade Co. #43,Sales Receipt,Logistics-APAC,0.0,55446.26,SGD,FAST Credit,Pacific Trade Co. #43,***6324,INV-202409-Logistics-APAC-0003,,False,False,REF-248250,First Continental Bank,***2891,Globex APAC Logistics Pte. Ltd.,SG,3266253.86
2024-09-17,2024-09-17,Supplier Payment - ExpertNet Subcontractors #8,Supplier Payment,PS-GL,7579.1,0.0,SGD,MEPS+,ExpertNet Subcontractors #8,***5640,,PO-202409-PS-GL-0001,False,False,REF-359257,First Continental Bank,***8308,Globex APAC Logistics Pte. Ltd.,SG,3258674.76
2024-09-17,2024-09-17,Supplier Payment - Port Services #10,Supplier Payment,Logistics-APAC,15861.93,0.0,SGD,FAST Debit,Port Services #10,***4606,,PO-202409-Logistics-APAC-0007,False,False,REF-883821,First Continental Bank,***7345,Globex APAC Logistics Pte. Ltd.,SG,3242812.83
2024-09-17,2024-09-17,Supplier Payment - ExpertNet Subcontractors #13,Supplier Payment,PS-GL,21787.69,0.0,SGD,FAST Debit,ExpertNet Subcontractors #13,***1920,,PO-202409-PS-GL-0002,False,False,REF-689915,First Continental Bank,***8359,Globex APAC Logistics Pte. Ltd.,SG,3221025.14
2024-09-17,2024-09-17,Client Receipt - Pacific Trade Co. #15,Sales Receipt,Logistics-APAC,0.0,525.21,SGD,SWIFT MT103,Pacific Trade Co. #15,***8196,INV-202409-Logistics-APAC-0009,,False,False,REF-651593,First Continental Bank,***2282,Globex APAC Logistics Pte. Ltd.,SG,3221550.35
2024-09-17,2024-09-17,Client Receipt - Pacific Trade Co. #59,Sales Receipt,Logistics-APAC,0.0,586.06,SGD,SWIFT MT103,Pacific Trade Co. #59,***5250,INV-202409-Logistics-APAC-0004,,False,False,REF-780924,First Continental Bank,***5253,Globex APAC Logistics Pte. Ltd.,SG,3222136.41
2024-09-17,2024-09-17,Client Receipt - CloudBridge Co. #59,Sales Receipt,SaaS-GL,0.0,2046.25,SGD,FAST Credit,CloudBridge Co. #59,***9509,INV-202409-SaaS-GL-0003,,False,False,REF-193918,First Continental Bank,***6927,Globex APAC Logistics Pte. Ltd.,SG,3224182.66
2024-09-17,2024-09-17,Client Receipt - Vertex Advisory Client #18,Sales Receipt,PS-GL,0.0,12159.74,SGD,SWIFT MT103,Vertex Advisory Client #18,***1075,INV-202409-PS-GL-0008,,False,False,REF-489233,First Continental Bank,***3133,Globex APAC Logistics Pte. Ltd.,SG,3236342.4
2024-09-17,2024-09-17,Client Receipt - Vertex Advisory Client #18,Sales Receipt,PS-GL,0.0,14807.85,SGD,SWIFT MT103,Vertex Advisory Client #18,***6147,INV-202409-PS-GL-0005,,False,False,REF-429355,First Continental Bank,***2279,Globex APAC Logistics Pte. Ltd.,SG,3251150.25
2024-09-17,2024-09-17,Client Receipt - Vertex Advisory Client #53,Sales Receipt,PS-GL,0.0,20194.37,SGD,SWIFT MT103,Vertex Advisory Client #53,***3130,INV-202409-PS-GL-0001,,False,False,REF-465834,First Continental Bank,***2406,Globex APAC Logistics Pte. Ltd.,SG,3271344.62
2024-09-17,2024-09-17,Client Receipt - Pacific Trade Co. #31,Sales Receipt,Logistics-APAC,0.0,65470.34,SGD,SWIFT MT103,Pacific Trade Co. #31,***6440,INV-202409-Logistics-APAC-0016,,False,False,REF-144777,First Continental Bank,***6924,Globex APAC Logistics Pte. Ltd.,SG,3336814.96
2024-09-18,2024-09-18,Supplier Payment - ExpertNet Subcontractors #19,Supplier Payment,PS-GL,6585.66,0.0,SGD,MEPS+,ExpertNet Subcontractors #19,***8293,,PO-202409-PS-GL-0008,False,False,REF-967204,First Continental Bank,***7553,Globex APAC Logistics Pte. Ltd.,SG,3330229.3
2024-09-18,2024-09-18,Client Receipt - CloudBridge Co. #9,Sales Receipt,SaaS-GL,0.0,5059.62,SGD,SWIFT MT103,CloudBridge Co. #9,***9841,INV-202409-SaaS-GL-0023,,False,False,REF-361584,First Continental Bank,***7107,Globex APAC Logistics Pte. Ltd.,SG,3335288.92
2024-09-18,2024-09-18,Client Receipt - CloudBridge Co. #71,Sales Receipt,SaaS-GL,0.0,19479.4,SGD,SWIFT MT103,CloudBridge Co. #71,***6783,INV-202409-SaaS-GL-0033,,False,False,REF-720812,First Continental Bank,***7453,Globex APAC Logistics Pte. Ltd.,SG,3354768.32
2024-09-18,2024-09-18,Client Receipt - CloudBridge Co. #24,Sales Receipt,SaaS-GL,0.0,22022.16,SGD,FAST Credit,CloudBridge Co. #24,***9821,INV-202409-SaaS-GL-0022,,False,False,REF-376940,First Continental Bank,***2202,Globex APAC Logistics Pte. Ltd.,SG,3376790.48
2024-09-18,2024-09-18,Client Receipt - Vertex Advisory Client #34,Sales Receipt,PS-GL,0.0,32311.41,SGD,SWIFT MT103,Vertex Advisory Client #34,***3098,INV-202409-PS-GL-0010,,False,False,REF-627831,First Continental Bank,***6286,Globex APAC Logistics Pte. Ltd.,SG,3409101.89
2024-09-18,2024-09-18,Client Receipt - Vertex Advisory Client #23,Sales Receipt,PS-GL,0.0,34563.75,SGD,SWIFT MT103,Vertex Advisory Client #23,***2473,INV-202409-PS-GL-0012,,False,False,REF-214180,First Continental Bank,***4888,Globex APAC Logistics Pte. Ltd.,SG,3443665.64
2024-09-19,2024-09-19,Client Receipt - CloudBridge Co. #52,Sales Receipt,SaaS-GL,0.0,10666.1,SGD,FAST Credit,CloudBridge Co. #52,***1368,INV-202409-SaaS-GL-0001,,False,False,REF-461391,First Continental Bank,***5468,Globex APAC Logistics Pte. Ltd.,SG,3454331.74
2024-09-19,2024-09-19,Client Receipt - Pacific Trade Co. #48,Sales Receipt,Logistics-APAC,0.0,67391.28,SGD,FAST Credit,Pacific Trade Co. #48,***6426,INV-202409-Logistics-APAC-0017,,False,False,REF-591513,First Continental Bank,***5217,Globex APAC Logistics Pte. Ltd.,SG,3521723.02
2024-09-20,2024-09-20,Supplier Payment - TransAsia Freight #34,Supplier Payment,Logistics-APAC,2057.9,0.0,SGD,SWIFT MT103,TransAsia Freight #34,***7328,,PO-202409-Logistics-APAC-0008,False,False,REF-727078,First Continental Bank,***4113,Globex APAC Logistics Pte. Ltd.,SG,3519665.12
2024-09-20,2024-09-20,Client Receipt - CloudBridge Co. #46,Sales Receipt,SaaS-GL,0.0,4510.67,SGD,SWIFT MT103,CloudBridge Co. #46,***6286,INV-202409-SaaS-GL-0002,,False,False,REF-235260,First Continental Bank,***2060,Globex APAC Logistics Pte. Ltd.,SG,3524175.79
2024-09-20,2024-09-20,Client Receipt - Pacific Trade Co. #46,Sales Receipt,Logistics-APAC,0.0,15818.15,SGD,SWIFT MT103,Pacific Trade Co. #46,***3367,INV-202409-Logistics-APAC-0012,,False,False,REF-356072,First Continental Bank,***9600,Globex APAC Logistics Pte. Ltd.,SG,3539993.94
2024-09-20,2024-09-20,Client Receipt - Pacific Trade Co. #20,Sales Receipt,Logistics-APAC,0.0,35052.85,SGD,SWIFT MT103,Pacific Trade Co. #20,***7674,INV-202409-Logistics-APAC-0010,,False,False,REF-976344,First Continental Bank,***2044,Globex APAC Logistics Pte. Ltd.,SG,3575046.79
2024-09-21,2024-09-21,Supplier Payment - HyperCloud Infra #6,Supplier Payment,SaaS-GL,23934.37,0.0,SGD,SWIFT MT103,HyperCloud Infra #6,***9527,,PO-202409-SaaS-GL-0007,False,False,REF-757369,First Continental Bank,***4538,Globex APAC Logistics Pte. Ltd.,SG,3551112.42
2024-09-21,2024-09-21,Client Receipt - Pacific Trade Co. #47,Sales Receipt,Logistics-APAC,0.0,10570.25,SGD,FAST Credit,Pacific Trade Co. #47,***7493,INV-202409-Logistics-APAC-0014,,False,False,REF-256472,First Continental Bank,***8566,Globex APAC Logistics Pte. Ltd.,SG,3561682.67
2024-09-22,2024-09-22,VAT/GST Remittance - IRAS Singapore,Tax Payment,ALL,72754.11,0.0,SGD,FAST Debit,IRAS Singapore,***8977,,,False,False,REF-430544,First Continental Bank,***5619,Globex APAC Logistics Pte. Ltd.,SG,3488928.56
2024-09-22,2024-09-22,Client Receipt - Vertex Advisory Client #41,Sales Receipt,PS-GL,0.0,28829.59,SGD,SWIFT MT103,Vertex Advisory Client #41,***2118,INV-202409-PS-GL-0011,,False,False,REF-906348,First Continental Bank,***1026,Globex APAC Logistics Pte. Ltd.,SG,3517758.15
2024-09-22,2024-09-22,Client Receipt - Pacific Trade Co. #13,Sales Receipt,Logistics-APAC,0.0,41858.95,SGD,SWIFT MT103,Pacific Trade Co. #13,***9552,INV-202409-Logistics-APAC-0018,,False,False,REF-278815,First Continental Bank,***7077,Globex APAC Logistics Pte. Ltd.,SG,3559617.1
2024-09-23,2024-09-23,Merchant Processing Fees,Bank/Merchant Fees,ALL,415.63,0.0,SGD,SWIFT MT103,First Continental Bank,***2661,,,False,False,REF-801989,First Continental Bank,***8498,Globex APAC Logistics Pte. Ltd.,SG,3559201.47
2024-09-23,2024-09-23,Supplier Payment - HyperCloud Infra #5,Supplier Payment,SaaS-GL,2491.52,0.0,SGD,SWIFT MT103,HyperCloud Infra #5,***8327,,PO-202409-SaaS-GL-0009,False,False,REF-736406,First Continental Bank,***4577,Globex APAC Logistics Pte. Ltd.,SG,3556709.95
2024-09-23,2024-09-23,Supplier Payment - TransAsia Freight #8,Supplier Payment,Logistics-APAC,3737.28,0.0,SGD,MEPS+,TransAsia Freight #8,***5918,,PO-202409-Logistics-APAC-0010,False,False,REF-447053,First Continental Bank,***5887,Globex APAC Logistics Pte. Ltd.,SG,3552972.67
2024-09-23,2024-09-23,Supplier Payment - HyperCloud Infra #6,Supplier Payment,SaaS-GL,8970.33,0.0,SGD,FAST Debit,HyperCloud Infra #6,***5381,,PO-202409-SaaS-GL-0006,False,False,REF-710321,First Continental Bank,***7804,Globex APAC Logistics Pte. Ltd.,SG,3544002.34
2024-09-24,2024-09-24,Supplier Payment - HyperCloud Infra #14,Supplier Payment,SaaS-GL,4771.25,0.0,SGD,SWIFT MT103,HyperCloud Infra #14,***3397,,PO-202409-SaaS-GL-0001,False,False,REF-925583,First Continental Bank,***2286,Globex APAC Logistics Pte. Ltd.,SG,3539231.09
2024-09-24,2024-09-24,Marketing - Beacon Digital #8,Marketing,ALL,5737.52,0.0,SGD,MEPS+,Beacon Digital #8,***6029,,,False,False,REF-864879,First Continental Bank,***8843,Globex APAC Logistics Pte. Ltd.,SG,3533493.57
2024-09-25,2024-09-25,Supplier Payment - Port Services #1,Supplier Payment,Logistics-APAC,42410.9,0.0,SGD,SWIFT MT103,Port Services #1,***2318,,PO-202409-Logistics-APAC-0005,False,False,REF-483736,First Continental Bank,***5365,Globex APAC Logistics Pte. Ltd.,SG,3491082.67
2024-09-25,2024-09-25,Client Receipt - CloudBridge Co. #36,Sales Receipt,SaaS-GL,0.0,14051.42,SGD,SWIFT MT103,CloudBridge Co. #36,***2001,INV-202409-SaaS-GL-0016,,False,False,REF-712219,First Continental Bank,***5842,Globex APAC Logistics Pte. Ltd.,SG,3505134.09
2024-09-25,2024-09-25,Client Receipt - Pacific Trade Co. #61,Sales Receipt,Logistics-APAC,0.0,21726.48,SGD,SWIFT MT103,Pacific Trade Co. #61,***9771,INV-202409-Logistics-APAC-0002,,False,False,REF-395298,First Continental Bank,***5022,Globex APAC Logistics Pte. Ltd.,SG,3526860.57
2024-09-26,2024-09-26,Intercompany Settlement - Globex Consulting UK Ltd.,Intercompany Transfer,ALL,270922.0,0.0,SGD,Internal Transfer,Globex Consulting UK Ltd.,***4851,,,True,True,REF-774093,First Continental Bank,***2475,Globex APAC Logistics Pte. Ltd.,SG,3255938.57
2024-09-26,2024-09-26,Client Receipt - Vertex Advisory Client #56,Sales Receipt,PS-GL,0.0,4110.87,SGD,SWIFT MT103,Vertex Advisory Client #56,***3978,INV-202409-PS-GL-0009,,False,False,REF-534131,First Continental Bank,***2620,Globex APAC Logistics Pte. Ltd.,SG,3260049.44
2024-09-26,2024-09-26,Client Receipt - Vertex Advisory Client #34,Sales Receipt,PS-GL,0.0,26824.27,SGD,SWIFT MT103,Vertex Advisory Client #34,***6406,INV-202409-PS-GL-0007,,False,False,REF-538983,First Continental Bank,***6548,Globex APAC Logistics Pte. Ltd.,SG,3286873.71
2024-09-26,2024-09-26,Client Receipt - Vertex Advisory Client #7,Sales Receipt,PS-GL,0.0,31372.17,SGD,FAST Credit,Vertex Advisory Client #7,***9792,INV-202409-PS-GL-0004,,False,False,REF-534070,First Continental Bank,***3555,Globex APAC Logistics Pte. Ltd.,SG,3318245.88
2024-09-26,2024-09-26,Intercompany Reimbursement - Globex Consulting UK Ltd.,Intercompany Transfer,ALL,0.0,108368.8,SGD,Internal Transfer,Globex Consulting UK Ltd.,***7520,,,True,True,REF-800524,First Continental Bank,***3201,Globex APAC Logistics Pte. Ltd.,SG,3426614.68
2024-09-27,2024-09-27,Client Receipt - CloudBridge Co. #8,Sales Receipt,SaaS-GL,0.0,29214.75,SGD,FAST Credit,CloudBridge Co. #8,***7163,INV-202409-SaaS-GL-0032,,False,False,REF-218237,First Continental Bank,***1414,Globex APAC Logistics Pte. Ltd.,SG,3455829.43
2024-09-27,2024-09-27,Client Receipt - CloudBridge Co. #25,Sales Receipt,SaaS-GL,0.0,30959.93,SGD,SWIFT MT103,CloudBridge Co. #25,***5412,INV-202409-SaaS-GL-0012,,False,False,REF-863394,First Continental Bank,***3197,Globex APAC Logistics Pte. Ltd.,SG,3486789.36
2024-09-28,2024-09-28,Marketing - Beacon Digital #6,Marketing,ALL,534.1,0.0,SGD,FAST Debit,Beacon Digital #6,***2916,,,False,False,REF-451559,First Continental Bank,***9555,Globex APAC Logistics Pte. Ltd.,SG,3486255.26
2024-09-28,2024-09-28,Payroll - GlobalPay Services Ltd,Payroll,ALL,99770.37,0.0,SGD,MEPS+,GlobalPay Services Ltd,***2617,,,False,False,REF-505768,First Continental Bank,***9227,Globex APAC Logistics Pte. Ltd.,SG,3386484.89
2024-09-29,2024-09-29,Supplier Payment - ExpertNet Subcontractors #5,Supplier Payment,PS-GL,12273.36,0.0,SGD,SWIFT MT103,ExpertNet Subcontractors #5,***6388,,PO-202409-PS-GL-0006,False,False,REF-868269,First Continental Bank,***6207,Globex APAC Logistics Pte. Ltd.,SG,3374211.53
2024-09-29,2024-09-29,Supplier Payment - TransAsia Freight #1,Supplier Payment,Logistics-APAC,101318.99,0.0,SGD,FAST Debit,TransAsia Freight #1,***4614,,PO-202409-Logistics-APAC-0004,False,False,REF-825835,First Continental Bank,***3870,Globex APAC Logistics Pte. Ltd.,SG,3272892.54
2024-09-30,2024-09-30,Supplier Payment - ExpertNet Subcontractors #16,Supplier Payment,PS-GL,235.91,0.0,SGD,MEPS+,ExpertNet Subcontractors #16,***4751,,PO-202409-PS-GL-0005,False,False,REF-303646,First Continental Bank,***6260,Globex APAC Logistics Pte. Ltd.,SG,3272656.63
2024-09-30,2024-09-30,Supplier Payment - HyperCloud Infra #13,Supplier Payment,SaaS-GL,1150.69,0.0,SGD,SWIFT MT103,HyperCloud Infra #13,***7244,,PO-202409-SaaS-GL-0010,False,False,REF-391636,First Continental Bank,***9710,Globex APAC Logistics Pte. Ltd.,SG,3271505.94
2024-09-30,2024-09-30,Supplier Payment - ExpertNet Subcontractors #7,Supplier Payment,PS-GL,1800.35,0.0,SGD,SWIFT MT103,ExpertNet Subcontractors #7,***7860,,PO-202409-PS-GL-0007,False,False,REF-866294,First Continental Bank,***2600,Globex APAC Logistics Pte. Ltd.,SG,3269705.59
2024-09-30,2024-09-30,Merchant Processing Fees,Bank/Merchant Fees,ALL,3233.15,0.0,SGD,SWIFT MT103,First Continental Bank,***3992,,,False,False,REF-113146,First Continental Bank,***5205,Globex APAC Logistics Pte. Ltd.,SG,3266472.44
2024-09-30,2024-09-30,Payroll - GlobalPay Services Ltd,Payroll,ALL,99770.37,0.0,SGD,FAST Debit,GlobalPay Services Ltd,***4227,,,False,False,REF-652959,First Continental Bank,***4982,Globex APAC Logistics Pte. Ltd.,SG,3166702.07
2024-09-30,2024-09-30,Interest Earned,Interest Income,ALL,0.0,11039.63,SGD,SWIFT MT103,First Continental Bank,***1747,,,False,False,REF-239917,First Continental Bank,***9775,Globex APAC Logistics Pte. Ltd.,SG,3177741.7
2024-09-30,2024-09-30,Client Receipt - CloudBridge Co. #63,Sales Receipt,SaaS-GL,0.0,11614.93,SGD,FAST Credit,CloudBridge Co. #63,***2039,INV-202409-SaaS-GL-0019,,False,False,REF-321578,First Continental Bank,***5795,Globex APAC Logistics Pte. Ltd.,SG,3189356.63
2024-09-30,2024-09-30,Client Receipt - Vertex Advisory Client #31,Sales Receipt,PS-GL,0.0,73287.89,SGD,SWIFT MT103,Vertex Advisory Client #31,***7766,INV-202409-PS-GL-0003,,False,False,REF-496767,First Continental Bank,***9475,Globex APAC Logistics Pte. Ltd.,SG,3262644.52
2024-10-01,2024-10-01,Account Maintenance Fee,Bank/Merchant Fees,ALL,2500.0,0.0,SGD,MEPS+,First Continental Bank,***4590,,,False,False,REF-907402,First Continental Bank,***3776,Globex APAC Logistics Pte. Ltd.,SG,3260144.52
2024-10-01,2024-10-01,Client Receipt - Vertex Advisory Client #7,Sales Receipt,PS-GL,0.0,9237.69,SGD,SWIFT MT103,Vertex Advisory Client #7,***3360,INV-202410-PS-GL-0010,,False,False,REF-494218,First Continental Bank,***1886,Globex APAC Logistics Pte. Ltd.,SG,3269382.21
2024-10-02,2024-10-02,Supplier Payment - CodeCraft Contractors #8,Supplier Payment,SaaS-GL,2352.9,0.0,SGD,SWIFT MT103,CodeCraft Contractors #8,***8433,,PO-202410-SaaS-GL-0008,False,False,REF-883231,First Continental Bank,***1872,Globex APAC Logistics Pte. Ltd.,SG,3267029.31
2024-10-02,2024-10-02,Supplier Payment - CodeCraft Contractors #1,Supplier Payment,SaaS-GL,4957.02,0.0,SGD,SWIFT MT103,CodeCraft Contractors #1,***1095,,PO-202410-SaaS-GL-0007,False,False,REF-609896,First Continental Bank,***6076,Globex APAC Logistics Pte. Ltd.,SG,3262072.29
2024-10-02,2024-10-02,Client Receipt - CloudBridge Co. #55,Sales Receipt,SaaS-GL,0.0,14847.77,SGD,FAST Credit,CloudBridge Co. #55,***7677,INV-202410-SaaS-GL-0025,,False,False,REF-566213,First Continental Bank,***5549,Globex APAC Logistics Pte. Ltd.,SG,3276920.06
2024-10-02,2024-10-02,Client Receipt - Pacific Trade Co. #67,Sales Receipt,Logistics-APAC,0.0,146829.76,SGD,FAST Credit,Pacific Trade Co. #67,***7561,INV-202410-Logistics-APAC-0013,,False,False,REF-253547,First Continental Bank,***1241,Globex APAC Logistics Pte. Ltd.,SG,3423749.82
2024-10-03,2024-10-03,Client Receipt - CloudBridge Co. #15,Sales Receipt,SaaS-GL,0.0,3626.03,SGD,SWIFT MT103,CloudBridge Co. #15,***9282,INV-202410-SaaS-GL-0007,,False,False,REF-598311,First Continental Bank,***8285,Globex APAC Logistics Pte. Ltd.,SG,3427375.85
2024-10-03,2024-10-03,Client Receipt - CloudBridge Co. #10,Sales Receipt,SaaS-GL,0.0,4252.38,SGD,SWIFT MT103,CloudBridge Co. #10,***4424,INV-202410-SaaS-GL-0014,,False,False,REF-429768,First Continental Bank,***3539,Globex APAC Logistics Pte. Ltd.,SG,3431628.23
2024-10-03,2024-10-03,Client Receipt - CloudBridge Co. #8,Sales Receipt,SaaS-GL,0.0,15798.34,SGD,FAST Credit,CloudBridge Co. #8,***6158,INV-202410-SaaS-GL-0009,,False,False,REF-593660,First Continental Bank,***7036,Globex APAC Logistics Pte. Ltd.,SG,3447426.57
2024-10-03,2024-10-03,Client Receipt - Pacific Trade Co. #63,Sales Receipt,Logistics-APAC,0.0,27063.61,SGD,SWIFT MT103,Pacific Trade Co. #63,***6556,INV-202410-Logistics-APAC-0010,,False,False,REF-299432,First Continental Bank,***7846,Globex APAC Logistics Pte. Ltd.,SG,3474490.18
2024-10-04,2024-10-04,Supplier Payment - TransAsia Freight #30,Supplier Payment,Logistics-APAC,71040.64,0.0,SGD,MEPS+,TransAsia Freight #30,***8192,,PO-202410-Logistics-APAC-0006,False,False,REF-585762,First Continental Bank,***2830,Globex APAC Logistics Pte. Ltd.,SG,3403449.54
2024-10-04,2024-10-04,Client Receipt - CloudBridge Co. #42,Sales Receipt,SaaS-GL,0.0,19284.76,SGD,SWIFT MT103,CloudBridge Co. #42,***5244,INV-202410-SaaS-GL-0011,,False,False,REF-674238,First Continental Bank,***1287,Globex APAC Logistics Pte. Ltd.,SG,3422734.3
2024-10-04,2024-10-04,Client Receipt - CloudBridge Co. #14,Sales Receipt,SaaS-GL,0.0,19752.02,SGD,SWIFT MT103,CloudBridge Co. #14,***1420,INV-202410-SaaS-GL-0027,,False,False,REF-961292,First Continental Bank,***1084,Globex APAC Logistics Pte. Ltd.,SG,3442486.32
2024-10-05,2024-10-05,Client Receipt - CloudBridge Co. #5,Sales Receipt,SaaS-GL,0.0,5418.3,SGD,FAST Credit,CloudBridge Co. #5,***1544,INV-202410-SaaS-GL-0019,,False,False,REF-401381,First Continental Bank,***2474,Globex APAC Logistics Pte. Ltd.,SG,3447904.62
2024-10-05,2024-10-05,Client Receipt - Pacific Trade Co. #67,Sales Receipt,Logistics-APAC,0.0,19034.72,SGD,FAST Credit,Pacific Trade Co. #67,***9017,INV-202410-Logistics-APAC-0005,,False,False,REF-888635,First Continental Bank,***9617,Globex APAC Logistics Pte. Ltd.,SG,3466939.34
2024-10-06,2024-10-06,Supplier Payment - TransAsia Freight #26,Supplier Payment,Logistics-APAC,1012.87,0.0,SGD,SWIFT MT103,TransAsia Freight #26,***4410,,PO-202410-Logistics-APAC-0007,False,False,REF-567244,First Continental Bank,***3428,Globex APAC Logistics Pte. Ltd.,SG,3465926.47
2024-10-06,2024-10-06,Client Receipt - Vertex Advisory Client #15,Sales Receipt,PS-GL,0.0,52733.11,SGD,SWIFT MT103,Vertex Advisory Client #15,***5759,INV-202410-PS-GL-0005,,False,False,REF-733168,First Continental Bank,***6352,Globex APAC Logistics Pte. Ltd.,SG,3518659.58
2024-10-07,2024-10-07,Supplier Payment - ExpertNet Subcontractors #2,Supplier Payment,PS-GL,345.77,0.0,SGD,MEPS+,ExpertNet Subcontractors #2,***3824,,PO-202410-PS-GL-0005,False,False,REF-619387,First Continental Bank,***7484,Globex APAC Logistics Pte. Ltd.,SG,3518313.81
2024-10-08,2024-10-08,Supplier Payment - ExpertNet Subcontractors #6,Supplier Payment,PS-GL,2718.49,0.0,SGD,MEPS+,ExpertNet Subcontractors #6,***1063,,PO-202410-PS-GL-0003,False,False,REF-126276,First Continental Bank,***2128,Globex APAC Logistics Pte. Ltd.,SG,3515595.32
2024-10-08,2024-10-08,Supplier Payment - TransAsia Freight #34,Supplier Payment,Logistics-APAC,12058.99,0.0,SGD,MEPS+,TransAsia Freight #34,***5764,,PO-202410-Logistics-APAC-0004,False,False,REF-371734,First Continental Bank,***6702,Globex APAC Logistics Pte. Ltd.,SG,3503536.33
2024-10-08,2024-10-08,Client Receipt - CloudBridge Co. #57,Sales Receipt,SaaS-GL,0.0,1353.07,SGD,FAST Credit,CloudBridge Co. #57,***2172,INV-202410-SaaS-GL-0031,,False,False,REF-584999,First Continental Bank,***9121,Globex APAC Logistics Pte. Ltd.,SG,3504889.4
2024-10-08,2024-10-08,Client Receipt - Pacific Trade Co. #22,Sales Receipt,Logistics-APAC,0.0,10979.11,SGD,SWIFT MT103,Pacific Trade Co. #22,***1086,INV-202410-Logistics-APAC-0001,,False,False,REF-887530,First Continental Bank,***9537,Globex APAC Logistics Pte. Ltd.,SG,3515868.51
2024-10-08,2024-10-08,Client Receipt - CloudBridge Co. #39,Sales Receipt,SaaS-GL,0.0,19083.64,SGD,FAST Credit,CloudBridge Co. #39,***8818,INV-202410-SaaS-GL-0001,,False,False,REF-511938,First Continental Bank,***4664,Globex APAC Logistics Pte. Ltd.,SG,3534952.15
2024-10-09,2024-10-09,Supplier Payment - CodeCraft Contractors #5,Supplier Payment,SaaS-GL,12111.99,0.0,SGD,FAST Debit,CodeCraft Contractors #5,***2918,,PO-202410-SaaS-GL-0006,False,False,REF-483721,First Continental Bank,***4376,Globex APAC Logistics Pte. Ltd.,SG,3522840.16
2024-10-09,2024-10-09,Client Receipt - CloudBridge Co. #14,Sales Receipt,SaaS-GL,0.0,2005.35,SGD,FAST Credit,CloudBridge Co. #14,***4706,INV-202410-SaaS-GL-0013,,False,False,REF-562373,First Continental Bank,***2618,Globex APAC Logistics Pte. Ltd.,SG,3524845.51
2024-10-09,2024-10-09,Client Receipt - CloudBridge Co. #48,Sales Receipt,SaaS-GL,0.0,17602.89,SGD,FAST Credit,CloudBridge Co. #48,***3191,INV-202410-SaaS-GL-0026,,False,False,REF-165948,First Continental Bank,***1827,Globex APAC Logistics Pte. Ltd.,SG,3542448.4
2024-10-09,2024-10-09,Client Receipt - CloudBridge Co. #22,Sales Receipt,SaaS-GL,0.0,37651.08,SGD,SWIFT MT103,CloudBridge Co. #22,***1403,INV-202410-SaaS-GL-0028,,False,False,REF-591179,First Continental Bank,***4218,Globex APAC Logistics Pte. Ltd.,SG,3580099.48
2024-10-09,2024-10-09,Client Receipt - Vertex Advisory Client #12,Sales Receipt,PS-GL,0.0,54190.26,SGD,FAST Credit,Vertex Advisory Client #12,***5872,INV-202410-PS-GL-0007,,False,False,REF-415633,First Continental Bank,***4688,Globex APAC Logistics Pte. Ltd.,SG,3634289.74
2024-10-10,2024-10-10,Merchant Processing Fees,Bank/Merchant Fees,ALL,2647.13,0.0,SGD,SWIFT MT103,First Continental Bank,***2220,,,False,False,REF-697669,First Continental Bank,***2985,Globex APAC Logistics Pte. Ltd.,SG,3631642.61
2024-10-10,2024-10-10,Supplier Payment - ExpertNet Subcontractors #14,Supplier Payment,PS-GL,4301.51,0.0,SGD,FAST Debit,ExpertNet Subcontractors #14,***6597,,PO-202410-PS-GL-0008,False,False,REF-862949,First Continental Bank,***2949,Globex APAC Logistics Pte. Ltd.,SG,3627341.1
2024-10-10,2024-10-10,Supplier Payment - ExpertNet Subcontractors #4,Supplier Payment,PS-GL,20637.33,0.0,SGD,FAST Debit,ExpertNet Subcontractors #4,***1264,,PO-202410-PS-GL-0009,False,False,REF-241588,First Continental Bank,***6255,Globex APAC Logistics Pte. Ltd.,SG,3606703.77
2024-10-10,2024-10-10,Supplier Payment - Port Services #18,Supplier Payment,Logistics-APAC,59954.93,0.0,SGD,MEPS+,Port Services #18,***2677,,PO-202410-Logistics-APAC-0010,False,False,REF-345136,First Continental Bank,***1771,Globex APAC Logistics Pte. Ltd.,SG,3546748.84
2024-10-10,2024-10-10,Client Receipt - Pacific Trade Co. #64,Sales Receipt,Logistics-APAC,0.0,23746.89,SGD,SWIFT MT103,Pacific Trade Co. #64,***4734,INV-202410-Logistics-APAC-0012,,False,False,REF-872776,First Continental Bank,***4519,Globex APAC Logistics Pte. Ltd.,SG,3570495.73
2024-10-10,2024-10-10,Client Receipt - Pacific Trade Co. #6,Sales Receipt,Logistics-APAC,0.0,84674.44,SGD,SWIFT MT103,Pacific Trade Co. #6,***8544,INV-202410-Logistics-APAC-0011,,False,False,REF-812122,First Continental Bank,***8360,Globex APAC Logistics Pte. Ltd.,SG,3655170.17
2024-10-11,2024-10-11,Supplier Payment - CodeCraft Contractors #8,Supplier Payment,SaaS-GL,7095.41,0.0,SGD,MEPS+,CodeCraft Contractors #8,***5775,,PO-202410-SaaS-GL-0005,False,False,REF-126053,First Continental Bank,***1091,Globex APAC Logistics Pte. Ltd.,SG,3648074.76
2024-10-11,2024-10-11,Supplier Payment - CodeCraft Contractors #3,Supplier Payment,SaaS-GL,23300.23,0.0,SGD,FAST Debit,CodeCraft Contractors #3,***1625,,PO-202410-SaaS-GL-0004,False,False,REF-749793,First Continental Bank,***9917,Globex APAC Logistics Pte. Ltd.,SG,3624774.53
2024-10-11,2024-10-11,Client Receipt - CloudBridge Co. #17,Sales Receipt,SaaS-GL,0.0,462.0,SGD,FAST Credit,CloudBridge Co. #17,***6762,INV-202410-SaaS-GL-0021,,False,False,REF-355811,First Continental Bank,***9012,Globex APAC Logistics Pte. Ltd.,SG,3625236.53
2024-10-11,2024-10-11,Client Receipt - CloudBridge Co. #17,Sales Receipt,SaaS-GL,0.0,4148.05,SGD,SWIFT MT103,CloudBridge Co. #17,***6677,INV-202410-SaaS-GL-0015,,False,False,REF-734270,First Continental Bank,***6519,Globex APAC Logistics Pte. Ltd.,SG,3629384.58
2024-10-12,2024-10-12,Supplier Payment - ExpertNet Subcontractors #19,Supplier Payment,PS-GL,7789.7,0.0,SGD,SWIFT MT103,ExpertNet Subcontractors #19,***6687,,PO-202410-PS-GL-0002,False,False,REF-752299,First Continental Bank,***1516,Globex APAC Logistics Pte. Ltd.,SG,3621594.88
2024-10-12,2024-10-12,Intercompany Settlement - Globex Consulting UK Ltd.,Intercompany Transfer,ALL,540162.0,0.0,SGD,Internal Transfer,Globex Consulting UK Ltd.,***4727,,,True,True,REF-353205,First Continental Bank,***4815,Globex APAC Logistics Pte. Ltd.,SG,3081432.88
2024-10-13,2024-10-13,Supplier Payment - ExpertNet Subcontractors #14,Supplier Payment,PS-GL,14154.6,0.0,SGD,FAST Debit,ExpertNet Subcontractors #14,***9410,,PO-202410-PS-GL-0006,False,False,REF-325020,First Continental Bank,***8870,Globex APAC Logistics Pte. Ltd.,SG,3067278.28
2024-10-14,2024-10-14,Supplier Payment - ExpertNet Subcontractors #3,Supplier Payment,PS-GL,8611.63,0.0,SGD,FAST Debit,ExpertNet Subcontractors #3,***4682,,PO-202410-PS-GL-0004,False,False,REF-408967,First Continental Bank,***9100,Globex APAC Logistics Pte. Ltd.,SG,3058666.65
2024-10-14,2024-10-14,Supplier Payment - CodeCraft Contractors #8,Supplier Payment,SaaS-GL,34097.89,0.0,SGD,SWIFT MT103,CodeCraft Contractors #8,***1174,,PO-202410-SaaS-GL-0009,False,False,REF-697991,First Continental Bank,***8457,Globex APAC Logistics Pte. Ltd.,SG,3024568.76
2024-10-15,2024-10-15,Supplier Payment - TransAsia Freight #37,Supplier Payment,Logistics-APAC,32304.42,0.0,SGD,MEPS+,TransAsia Freight #37,***7056,,PO-202410-Logistics-APAC-0002,False,False,REF-504152,First Continental Bank,***5814,Globex APAC Logistics Pte. Ltd.,SG,2992264.34
2024-10-15,2024-10-15,Client Receipt - Pacific Trade Co. #15,Sales Receipt,Logistics-APAC,0.0,14400.4,SGD,SWIFT MT103,Pacific Trade Co. #15,***5882,INV-202410-Logistics-APAC-0002,,False,False,REF-566127,First Continental Bank,***8011,Globex APAC Logistics Pte. Ltd.,SG,3006664.74
2024-10-15,2024-10-15,Client Receipt - CloudBridge Co. #22,Sales Receipt,SaaS-GL,0.0,21119.35,SGD,SWIFT MT103,CloudBridge Co. #22,***2528,INV-202410-SaaS-GL-0035,,False,False,REF-845334,First Continental Bank,***7598,Globex APAC Logistics Pte. Ltd.,SG,3027784.09
2024-10-15,2024-10-15,Client Receipt - CloudBridge Co. #69,Sales Receipt,SaaS-GL,0.0,33000.13,SGD,SWIFT MT103,CloudBridge Co. #69,***7786,INV-202410-SaaS-GL-0002,,False,False,REF-265235,First Continental Bank,***5431,Globex APAC Logistics Pte. Ltd.,SG,3060784.22
2024-10-16,2024-10-16,Supplier Payment - ExpertNet Subcontractors #19,Supplier Payment,PS-GL,15515.82,0.0,SGD,SWIFT MT103,ExpertNet Subcontractors #19,***3310,,PO-202410-PS-GL-0007,False,False,REF-809823,First Continental Bank,***8068,Globex APAC Logistics Pte. Ltd.,SG,3045268.4
2024-10-16,2024-10-16,Marketing - Beacon Digital #7,Marketing,ALL,31007.07,0.0,SGD,FAST Debit,Beacon Digital #7,***5137,,,False,False,REF-146652,First Continental Bank,***4916,Globex APAC Logistics Pte. Ltd.,SG,3014261.33
2024-10-16,2024-10-16,Client Receipt - CloudBridge Co. #46,Sales Receipt,SaaS-GL,0.0,559.86,SGD,SWIFT MT103,CloudBridge Co. #46,***6666,INV-202410-SaaS-GL-0005,,False,False,REF-365910,First Continental Bank,***9243,Globex APAC Logistics Pte. Ltd.,SG,3014821.19
2024-10-16,2024-10-16,Client Receipt - Vertex Advisory Client #2,Sales Receipt,PS-GL,0.0,1852.33,SGD,FAST Credit,Vertex Advisory Client #2,***2361,INV-202410-PS-GL-0003,,False,False,REF-453556,First Continental Bank,***2573,Globex APAC Logistics Pte. Ltd.,SG,3016673.52
2024-10-17,2024-10-17,Supplier Payment - CodeCraft Contractors #12,Supplier Payment,SaaS-GL,9067.91,0.0,SGD,FAST Debit,CodeCraft Contractors #12,***8209,,PO-202410-SaaS-GL-0001,False,False,REF-741074,First Continental Bank,***3518,Globex APAC Logistics Pte. Ltd.,SG,3007605.61
2024-10-17,2024-10-17,Client Receipt - CloudBridge Co. #70,Sales Receipt,SaaS-GL,0.0,1469.53,SGD,SWIFT MT103,CloudBridge Co. #70,***5905,INV-202410-SaaS-GL-0018,,False,False,REF-105648,First Continental Bank,***4108,Globex APAC Logistics Pte. Ltd.,SG,3009075.14
2024-10-17,2024-10-17,Client Receipt - CloudBridge Co. #69,Sales Receipt,SaaS-GL,0.0,23209.91,SGD,FAST Credit,CloudBridge Co. #69,***4641,INV-202410-SaaS-GL-0024,,False,False,REF-218495,First Continental Bank,***2218,Globex APAC Logistics Pte. Ltd.,SG,3032285.05
2024-10-17,2024-10-17,Client Receipt - Vertex Advisory Client #53,Sales Receipt,PS-GL,0.0,93524.32,SGD,FAST Credit,Vertex Advisory Client #53,***1951,INV-202410-PS-GL-0004,,False,False,REF-446094,First Continental Bank,***2990,Globex APAC Logistics Pte. Ltd.,SG,3125809.37
2024-10-18,2024-10-18,Supplier Payment - ExpertNet Subcontractors #16,Supplier Payment,PS-GL,2557.88,0.0,SGD,FAST Debit,ExpertNet Subcontractors #16,***3341,,PO-202410-PS-GL-0011,False,False,REF-510569,First Continental Bank,***1548,Globex APAC Logistics Pte. Ltd.,SG,3123251.49
2024-10-18,2024-10-18,Supplier Payment - ExpertNet Subcontractors #8,Supplier Payment,PS-GL,13020.07,0.0,SGD,SWIFT MT103,ExpertNet Subcontractors #8,***3490,,PO-202410-PS-GL-0012,False,False,REF-239505,First Continental Bank,***7526,Globex APAC Logistics Pte. Ltd.,SG,3110231.42
2024-10-18,2024-10-18,Supplier Payment - Port Services #2,Supplier Payment,Logistics-APAC,39947.07,0.0,SGD,SWIFT MT103,Port Services #2,***8020,,PO-202410-Logistics-APAC-0009,False,False,REF-778350,First Continental Bank,***5941,Globex APAC Logistics Pte. Ltd.,SG,3070284.35
2024-10-18,2024-10-18,Client Receipt - CloudBridge Co. #24,Sales Receipt,SaaS-GL,0.0,15279.0,SGD,FAST Credit,CloudBridge Co. #24,***7089,INV-202410-SaaS-GL-0017,,False,False,REF-847340,First Continental Bank,***3274,Globex APAC Logistics Pte. Ltd.,SG,3085563.35
2024-10-18,2024-10-18,Client Receipt - CloudBridge Co. #63,Sales Receipt,SaaS-GL,0.0,15503.35,SGD,FAST Credit,CloudBridge Co. #63,***5903,INV-202410-SaaS-GL-0006,,False,False,REF-525551,First Continental Bank,***1705,Globex APAC Logistics Pte. Ltd.,SG,3101066.7
2024-10-18,2024-10-18,Client Receipt - Vertex Advisory Client #59,Sales Receipt,PS-GL,0.0,38299.89,SGD,SWIFT MT103,Vertex Advisory Client #59,***9054,INV-202410-PS-GL-0009,,False,False,REF-733648,First Continental Bank,***4179,Globex APAC Logistics Pte. Ltd.,SG,3139366.59
2024-10-19,2024-10-19,Client Receipt - CloudBridge Co. #32,Sales Receipt,SaaS-GL,0.0,3094.42,SGD,SWIFT MT103,CloudBridge Co. #32,***1612,INV-202410-SaaS-GL-0008,,False,False,REF-912873,First Continental Bank,***6002,Globex APAC Logistics Pte. Ltd.,SG,3142461.01
2024-10-20,2024-10-20,Supplier Payment - HyperCloud Infra #17,Supplier Payment,SaaS-GL,9622.61,0.0,SGD,MEPS+,HyperCloud Infra #17,***1294,,PO-202410-SaaS-GL-0002,False,False,REF-230965,First Continental Bank,***8374,Globex APAC Logistics Pte. Ltd.,SG,3132838.4
2024-10-21,2024-10-21,VAT/GST Remittance - IRAS Singapore,Tax Payment,ALL,77694.16,0.0,SGD,SWIFT MT103,IRAS Singapore,***2570,,,False,False,REF-645550,First Continental Bank,***8192,Globex APAC Logistics Pte. Ltd.,SG,3055144.24
2024-10-21,2024-10-21,Client Receipt - CloudBridge Co. #67,Sales Receipt,SaaS-GL,0.0,23738.41,SGD,FAST Credit,CloudBridge Co. #67,***4984,INV-202410-SaaS-GL-0016,,False,False,REF-970871,First Continental Bank,***4877,Globex APAC Logistics Pte. Ltd.,SG,3078882.65
2024-10-21,2024-10-21,Client Receipt - Pacific Trade Co. #34,Sales Receipt,Logistics-APAC,0.0,29607.01,SGD,SWIFT MT103,Pacific Trade Co. #34,***5692,INV-202410-Logistics-APAC-0009,,False,False,REF-526966,First Continental Bank,***4046,Globex APAC Logistics Pte. Ltd.,SG,3108489.66
2024-10-21,2024-10-21,Client Receipt - Vertex Advisory Client #56,Sales Receipt,PS-GL,0.0,34695.4,SGD,FAST Credit,Vertex Advisory Client #56,***9417,INV-202410-PS-GL-0008,,False,False,REF-280983,First Continental Bank,***9256,Globex APAC Logistics Pte. Ltd.,SG,3143185.06
2024-10-22,2024-10-22,Merchant Processing Fees,Bank/Merchant Fees,ALL,1311.33,0.0,SGD,MEPS+,First Continental Bank,***9094,,,False,False,REF-641720,First Continental Bank,***3048,Globex APAC Logistics Pte. Ltd.,SG,3141873.73
2024-10-22,2024-10-22,Client Receipt - Vertex Advisory Client #6,Sales Receipt,PS-GL,0.0,916.97,SGD,FAST Credit,Vertex Advisory Client #6,***5305,INV-202410-PS-GL-0006,,False,False,REF-110151,First Continental Bank,***4742,Globex APAC Logistics Pte. Ltd.,SG,3142790.7
2024-10-22,2024-10-22,Client Receipt - CloudBridge Co. #19,Sales Receipt,SaaS-GL,0.0,2695.95,SGD,FAST Credit,CloudBridge Co. #19,***1112,INV-202410-SaaS-GL-0033,,False,False,REF-597453,First Continental Bank,***5731,Globex APAC Logistics Pte. Ltd.,SG,3145486.65
2024-10-22,2024-10-22,Client Receipt - CloudBridge Co. #78,Sales Receipt,SaaS-GL,0.0,7013.72,SGD,SWIFT MT103,CloudBridge Co. #78,***3654,INV-202410-SaaS-GL-0020,,False,False,REF-115442,First Continental Bank,***4138,Globex APAC Logistics Pte. Ltd.,SG,3152500.37
2024-10-22,2024-10-22,Client Receipt - CloudBridge Co. #61,Sales Receipt,SaaS-GL,0.0,7354.96,SGD,SWIFT MT103,CloudBridge Co. #61,***9279,INV-202410-SaaS-GL-0003,,False,False,REF-515329,First Continental Bank,***8018,Globex APAC Logistics Pte. Ltd.,SG,3159855.33
2024-10-22,2024-10-22,Client Receipt - Pacific Trade Co. #59,Sales Receipt,Logistics-APAC,0.0,18472.06,SGD,SWIFT MT103,Pacific Trade Co. #59,***5663,INV-202410-Logistics-APAC-0014,,False,False,REF-905330,First Continental Bank,***4431,Globex APAC Logistics Pte. Ltd.,SG,3178327.39
2024-10-22,2024-10-22,Client Receipt - CloudBridge Co. #31,Sales Receipt,SaaS-GL,0.0,19726.52,SGD,SWIFT MT103,CloudBridge Co. #31,***3977,INV-202410-SaaS-GL-0004,,False,False,REF-226928,First Continental Bank,***3702,Globex APAC Logistics Pte. Ltd.,SG,3198053.91
2024-10-23,2024-10-23,Marketing - Aurelia Media #7,Marketing,ALL,2852.43,0.0,SGD,MEPS+,Aurelia Media #7,***6925,,,False,False,REF-522398,First Continental Bank,***6603,Globex APAC Logistics Pte. Ltd.,SG,3195201.48
2024-10-23,2024-10-23,Client Receipt - CloudBridge Co. #30,Sales Receipt,SaaS-GL,0.0,5622.95,SGD,FAST Credit,CloudBridge Co. #30,***4826,INV-202410-SaaS-GL-0034,,False,False,REF-612013,First Continental Bank,***7022,Globex APAC Logistics Pte. Ltd.,SG,3200824.43
2024-10-23,2024-10-23,Client Receipt - Vertex Advisory Client #11,Sales Receipt,PS-GL,0.0,19378.16,SGD,FAST Credit,Vertex Advisory Client #11,***9991,INV-202410-PS-GL-0001,,False,False,REF-691150,First Continental Bank,***1832,Globex APAC Logistics Pte. Ltd.,SG,3220202.59
2024-10-24,2024-10-24,BluePeak Property Mgmt,Rent & Utilities,ALL,10615.3,0.0,SGD,SWIFT MT103,BluePeak Property Mgmt,***2969,,,False,False,REF-128527,First Continental Bank,***1793,Globex APAC Logistics Pte. Ltd.,SG,3209587.29
2024-10-24,2024-10-24,Client Receipt - CloudBridge Co. #7,Sales Receipt,SaaS-GL,0.0,13815.49,SGD,SWIFT MT103,CloudBridge Co. #7,***6249,INV-202410-SaaS-GL-0029,,False,False,REF-209159,First Continental Bank,***6247,Globex APAC Logistics Pte. Ltd.,SG,3223402.78
2024-10-25,2024-10-25,Supplier Payment - ExpertNet Subcontractors #2,Supplier Payment,PS-GL,1018.91,0.0,SGD,MEPS+,ExpertNet Subcontractors #2,***7520,,PO-202410-PS-GL-0010,False,False,REF-625550,First Continental Bank,***8345,Globex APAC Logistics Pte. Ltd.,SG,3222383.87
2024-10-25,2024-10-25,Client Receipt - CloudBridge Co. #55,Sales Receipt,SaaS-GL,0.0,353.44,SGD,FAST Credit,CloudBridge Co. #55,***9213,INV-202410-SaaS-GL-0010,,False,False,REF-264282,First Continental Bank,***1854,Globex APAC Logistics Pte. Ltd.,SG,3222737.31
2024-10-25,2024-10-25,Client Receipt - Pacific Trade Co. #10,Sales Receipt,Logistics-APAC,0.0,2485.0,SGD,FAST Credit,Pacific Trade Co. #10,***2767,INV-202410-Logistics-APAC-0003,,False,False,REF-805576,First Continental Bank,***5721,Globex APAC Logistics Pte. Ltd.,SG,3225222.31
2024-10-25,2024-10-25,Client Receipt - Vertex Advisory Client #2,Sales Receipt,PS-GL,0.0,4239.65,SGD,FAST Credit,Vertex Advisory Client #2,***7446,INV-202410-PS-GL-0002,,False,False,REF-818243,First Continental Bank,***4418,Globex APAC Logistics Pte. Ltd.,SG,3229461.96
2024-10-25,2024-10-25,Client Receipt - CloudBridge Co. #11,Sales Receipt,SaaS-GL,0.0,8193.57,SGD,FAST Credit,CloudBridge Co. #11,***2937,INV-202410-SaaS-GL-0022,,False,False,REF-177539,First Continental Bank,***2705,Globex APAC Logistics Pte. Ltd.,SG,3237655.53
2024-10-25,2024-10-25,Client Receipt - Pacific Trade Co. #4,Sales Receipt,Logistics-APAC,0.0,34547.58,SGD,SWIFT MT103,Pacific Trade Co. #4,***6066,INV-202410-Logistics-APAC-0008,,False,False,REF-907631,First Continental Bank,***5493,Globex APAC Logistics Pte. Ltd.,SG,3272203.11
2024-10-26,2024-10-26,Supplier Payment - TransAsia Freight #42,Supplier Payment,Logistics-APAC,26843.77,0.0,SGD,FAST Debit,TransAsia Freight #42,***6916,,PO-202410-Logistics-APAC-0008,False,False,REF-673534,First Continental Bank,***4320,Globex APAC Logistics Pte. Ltd.,SG,3245359.34
2024-10-26,2024-10-26,"Intercompany Settlement - Globex International Holdings, Inc.",Intercompany Transfer,ALL,765178.0,0.0,SGD,Internal Transfer,"Globex International Holdings, Inc.",***2411,,,True,True,REF-714192,First Continental Bank,***1452,Globex APAC Logistics Pte. Ltd.,SG,2480181.34
2024-10-26,2024-10-26,Client Receipt - Vertex Advisory Client #35,Sales Receipt,PS-GL,0.0,12883.44,SGD,FAST Credit,Vertex Advisory Client #35,***5740,INV-202410-PS-GL-0011,,False,False,REF-367747,First Continental Bank,***9081,Globex APAC Logistics Pte. Ltd.,SG,2493064.78
2024-10-27,2024-10-27,Supplier Payment - CodeCraft Contractors #7,Supplier Payment,SaaS-GL,3637.94,0.0,SGD,FAST Debit,CodeCraft Contractors #7,***5673,,PO-202410-SaaS-GL-0003,False,False,REF-905746,First Continental Bank,***9991,Globex APAC Logistics Pte. Ltd.,SG,2489426.84
2024-10-28,2024-10-28,Supplier Payment - ExpertNet Subcontractors #5,Supplier Payment,PS-GL,5913.66,0.0,SGD,SWIFT MT103,ExpertNet Subcontractors #5,***6956,,PO-202410-PS-GL-0001,False,False,REF-920491,First Continental Bank,***5000,Globex APAC Logistics Pte. Ltd.,SG,2483513.18
2024-10-28,2024-10-28,Corporate Tax Estimate,Tax Payment,ALL,61156.71,0.0,SGD,SWIFT MT103,IRAS Singapore,***1800,,,False,False,REF-804120,First Continental Bank,***4450,Globex APAC Logistics Pte. Ltd.,SG,2422356.47
2024-10-29,2024-10-29,Supplier Payment - TransAsia Freight #43,Supplier Payment,Logistics-APAC,20822.16,0.0,SGD,SWIFT MT103,TransAsia Freight #43,***7169,,PO-202410-Logistics-APAC-0005,False,False,REF-296692,First Continental Bank,***4761,Globex APAC Logistics Pte. Ltd.,SG,2401534.31
2024-10-29,2024-10-29,Supplier Payment - TransAsia Freight #27,Supplier Payment,Logistics-APAC,25127.46,0.0,SGD,SWIFT MT103,TransAsia Freight #27,***9895,,PO-202410-Logistics-APAC-0003,False,False,REF-891707,First Continental Bank,***1959,Globex APAC Logistics Pte. Ltd.,SG,2376406.85
2024-10-29,2024-10-29,Client Receipt - CloudBridge Co. #2,Sales Receipt,SaaS-GL,0.0,1493.28,SGD,SWIFT MT103,CloudBridge Co. #2,***6535,INV-202410-SaaS-GL-0032,,False,False,REF-759950,First Continental Bank,***6090,Globex APAC Logistics Pte. Ltd.,SG,2377900.13
2024-10-30,2024-10-30,Supplier Payment - Port Services #8,Supplier Payment,Logistics-APAC,63427.62,0.0,SGD,SWIFT MT103,Port Services #8,***3827,,PO-202410-Logistics-APAC-0011,False,False,REF-740869,First Continental Bank,***7311,Globex APAC Logistics Pte. Ltd.,SG,2314472.51
2024-10-30,2024-10-30,Payroll - GlobalPay Services Ltd,Payroll,ALL,106695.19,0.0,SGD,MEPS+,GlobalPay Services Ltd,***6863,,,False,False,REF-406546,First Continental Bank,***1081,Globex APAC Logistics Pte. Ltd.,SG,2207777.32
2024-10-30,2024-10-30,Payroll - GlobalPay Services Ltd,Payroll,ALL,106695.19,0.0,SGD,MEPS+,GlobalPay Services Ltd,***9654,,,False,False,REF-918293,First Continental Bank,***8637,Globex APAC Logistics Pte. Ltd.,SG,2101082.13
2024-10-30,2024-10-30,Interest Earned,Interest Income,ALL,0.0,9541.26,SGD,FAST Credit,First Continental Bank,***1834,,,False,False,REF-602335,First Continental Bank,***3228,Globex APAC Logistics Pte. Ltd.,SG,2110623.39
2024-10-30,2024-10-30,Client Receipt - CloudBridge Co. #63,Sales Receipt,SaaS-GL,0.0,14783.25,SGD,SWIFT MT103,CloudBridge Co. #63,***1767,INV-202410-SaaS-GL-0030,,False,False,REF-947687,First Continental Bank,***1544,Globex APAC Logistics Pte. Ltd.,SG,2125406.64
2024-10-30,2024-10-30,Client Receipt - Pacific Trade Co. #37,Sales Receipt,Logistics-APAC,0.0,22343.08,SGD,SWIFT MT103,Pacific Trade Co. #37,***5145,INV-202410-Logistics-APAC-0007,,False,False,REF-131558,First Continental Bank,***7972,Globex APAC Logistics Pte. Ltd.,SG,2147749.72
2024-10-30,2024-10-30,Client Receipt - Pacific Trade Co. #50,Sales Receipt,Logistics-APAC,0.0,42318.38,SGD,SWIFT MT103,Pacific Trade Co. #50,***1038,INV-202410-Logistics-APAC-0004,,False,False,REF-707126,First Continental Bank,***8097,Globex APAC Logistics Pte. Ltd.,SG,2190068.1
2024-10-30,2024-10-30,Client Receipt - CloudBridge Co. #35,Sales Receipt,SaaS-GL,0.0,64813.64,SGD,SWIFT MT103,CloudBridge Co. #35,***2104,INV-202410-SaaS-GL-0023,,False,False,REF-976514,First Continental Bank,***3073,Globex APAC Logistics Pte. Ltd.,SG,2254881.74
2024-10-31,2024-10-31,Supplier Payment - TransAsia Freight #35,Supplier Payment,Logistics-APAC,23069.83,0.0,SGD,SWIFT MT103,TransAsia Freight #35,***3496,,PO-202410-Logistics-APAC-0001,False,False,REF-994952,First Continental Bank,***9821,Globex APAC Logistics Pte. Ltd.,SG,2231811.91
2024-10-31,2024-10-31,Client Receipt - CloudBridge Co. #46,Sales Receipt,SaaS-GL,0.0,34800.42,SGD,SWIFT MT103,CloudBridge Co. #46,***7223,INV-202410-SaaS-GL-0012,,False,False,REF-324450,First Continental Bank,***7821,Globex APAC Logistics Pte. Ltd.,SG,2266612.33
2024-10-31,2024-10-31,Client Receipt - Pacific Trade Co. #26,Sales Receipt,Logistics-APAC,0.0,60083.33,SGD,SWIFT MT103,Pacific Trade Co. #26,***2284,INV-202410-Logistics-APAC-0006,,False,False,REF-573560,First Continental Bank,***3601,Globex APAC Logistics Pte. Ltd.,SG,2326695.66
2024-11-01,2024-11-01,Merchant Processing Fees,Bank/Merchant Fees,ALL,2464.85,0.0,SGD,MEPS+,First Continental Bank,***7644,,,False,False,REF-282718,First Continental Bank,***5792,Globex APAC Logistics Pte. Ltd.,SG,2324230.81
2024-11-01,2024-11-01,Account Maintenance Fee,Bank/Merchant Fees,ALL,2500.0,0.0,SGD,FAST Debit,First Continental Bank,***6064,,,False,False,REF-105582,First Continental Bank,***5863,Globex APAC Logistics Pte. Ltd.,SG,2321730.81
2024-11-01,2024-11-01,Supplier Payment - ExpertNet Subcontractors #10,Supplier Payment,PS-GL,3309.71,0.0,SGD,MEPS+,ExpertNet Subcontractors #10,***9147,,PO-202411-PS-GL-0004,False,False,REF-106654,First Continental Bank,***3545,Globex APAC Logistics Pte. Ltd.,SG,2318421.1
2024-11-01,2024-11-01,Supplier Payment - Port Services #3,Supplier Payment,Logistics-APAC,74928.54,0.0,SGD,FAST Debit,Port Services #3,***2322,,PO-202411-Logistics-APAC-0007,False,False,REF-970294,First Continental Bank,***2479,Globex APAC Logistics Pte. Ltd.,SG,2243492.56
2024-11-01,2024-11-01,Supplier Payment - Port Services #6,Supplier Payment,Logistics-APAC,112221.97,0.0,SGD,SWIFT MT103,Port Services #6,***7176,,PO-202411-Logistics-APAC-0010,False,False,REF-870172,First Continental Bank,***1687,Globex APAC Logistics Pte. Ltd.,SG,2131270.59
2024-11-01,2024-11-01,Client Receipt - CloudBridge Co. #3,Sales Receipt,SaaS-GL,0.0,19068.74,SGD,SWIFT MT103,CloudBridge Co. #3,***7221,INV-202411-SaaS-GL-0014,,False,False,REF-608992,First Continental Bank,***9863,Globex APAC Logistics Pte. Ltd.,SG,2150339.33
2024-11-01,2024-11-01,Client Receipt - CloudBridge Co. #49,Sales Receipt,SaaS-GL,0.0,23850.21,SGD,SWIFT MT103,CloudBridge Co. #49,***2511,INV-202411-SaaS-GL-0005,,False,False,REF-150288,First Continental Bank,***2570,Globex APAC Logistics Pte. Ltd.,SG,2174189.54
2024-11-01,2024-11-01,Client Receipt - Vertex Advisory Client #29,Sales Receipt,PS-GL,0.0,27363.95,SGD,FAST Credit,Vertex Advisory Client #29,***7304,INV-202411-PS-GL-0010,,False,False,REF-118788,First Continental Bank,***1095,Globex APAC Logistics Pte. Ltd.,SG,2201553.49
2024-11-02,2024-11-02,Merchant Processing Fees,Bank/Merchant Fees,ALL,1958.28,0.0,SGD,SWIFT MT103,First Continental Bank,***4644,,,False,False,REF-604311,First Continental Bank,***3120,Globex APAC Logistics Pte. Ltd.,SG,2199595.21
2024-11-04,2024-11-04,Supplier Payment - HyperCloud Infra #11,Supplier Payment,SaaS-GL,2244.03,0.0,SGD,MEPS+,HyperCloud Infra #11,***4526,,PO-202411-SaaS-GL-0001,False,False,REF-902776,First Continental Bank,***9829,Globex APAC Logistics Pte. Ltd.,SG,2197351.18
2024-11-04,2024-11-04,Client Receipt - Pacific Trade Co. #59,Sales Receipt,Logistics-APAC,0.0,53815.77,SGD,FAST Credit,Pacific Trade Co. #59,***9939,INV-202411-Logistics-APAC-0009,,False,False,REF-602305,First Continental Bank,***2311,Globex APAC Logistics Pte. Ltd.,SG,2251166.95
2024-11-04,2024-11-04,Client Receipt - Pacific Trade Co. #46,Sales Receipt,Logistics-APAC,0.0,114133.41,SGD,SWIFT MT103,Pacific Trade Co. #46,***4189,INV-202411-Logistics-APAC-0011,,False,False,REF-383379,First Continental Bank,***9694,Globex APAC Logistics Pte. Ltd.,SG,2365300.36
2024-11-05,2024-11-05,Supplier Payment - HyperCloud Infra #8,Supplier Payment,SaaS-GL,22229.75,0.0,SGD,FAST Debit,HyperCloud Infra #8,***4998,,PO-202411-SaaS-GL-0002,False,False,REF-121019,First Continental Bank,***8724,Globex APAC Logistics Pte. Ltd.,SG,2343070.61
2024-11-06,2024-11-06,Marketing - Beacon Digital #5,Marketing,ALL,2201.09,0.0,SGD,SWIFT MT103,Beacon Digital #5,***8309,,,False,False,REF-687638,First Continental Bank,***5058,Globex APAC Logistics Pte. Ltd.,SG,2340869.52
2024-11-06,2024-11-06,Client Receipt - Vertex Advisory Client #39,Sales Receipt,PS-GL,0.0,39789.52,SGD,FAST Credit,Vertex Advisory Client #39,***2991,INV-202411-PS-GL-0001,,False,False,REF-507530,First Continental Bank,***5826,Globex APAC Logistics Pte. Ltd.,SG,2380659.04
2024-11-07,2024-11-07,Supplier Payment - CodeCraft Contractors #7,Supplier Payment,SaaS-GL,5384.45,0.0,SGD,MEPS+,CodeCraft Contractors #7,***7487,,PO-202411-SaaS-GL-0006,False,False,REF-339046,First Continental Bank,***7733,Globex APAC Logistics Pte. Ltd.,SG,2375274.59
2024-11-07,2024-11-07,Supplier Payment - CodeCraft Contractors #5,Supplier Payment,SaaS-GL,71245.98,0.0,SGD,MEPS+,CodeCraft Contractors #5,***9072,,PO-202411-SaaS-GL-0005,False,False,REF-277545,First Continental Bank,***2889,Globex APAC Logistics Pte. Ltd.,SG,2304028.61
2024-11-07,2024-11-07,Client Receipt - Vertex Advisory Client #40,Sales Receipt,PS-GL,0.0,49133.0,SGD,FAST Credit,Vertex Advisory Client #40,***3968,INV-202411-PS-GL-0004,,False,False,REF-519848,First Continental Bank,***5961,Globex APAC Logistics Pte. Ltd.,SG,2353161.61
2024-11-08,2024-11-08,Client Receipt - Pacific Trade Co. #15,Sales Receipt,Logistics-APAC,0.0,82404.73,SGD,FAST Credit,Pacific Trade Co. #15,***5008,INV-202411-Logistics-APAC-0004,,False,False,REF-594429,First Continental Bank,***9551,Globex APAC Logistics Pte. Ltd.,SG,2435566.34
2024-11-09,2024-11-09,Client Receipt - CloudBridge Co. #31,Sales Receipt,SaaS-GL,0.0,13661.9,SGD,SWIFT MT103,CloudBridge Co. #31,***7530,INV-202411-SaaS-GL-0016,,False,False,REF-806776,First Continental Bank,***5302,Globex APAC Logistics Pte. Ltd.,SG,2449228.24
2024-11-09,2024-11-09,Client Receipt - CloudBridge Co. #5,Sales Receipt,SaaS-GL,0.0,57483.02,SGD,SWIFT MT103,CloudBridge Co. #5,***8461,INV-202411-SaaS-GL-0009,,False,False,REF-280846,First Continental Bank,***2744,Globex APAC Logistics Pte. Ltd.,SG,2506711.26
2024-11-09,2024-11-09,Client Receipt - Pacific Trade Co. #62,Sales Receipt,Logistics-APAC,0.0,59061.32,SGD,SWIFT MT103,Pacific Trade Co. #62,***9067,INV-202411-Logistics-APAC-0010,,False,False,REF-148869,First Continental Bank,***2409,Globex APAC Logistics Pte. Ltd.,SG,2565772.58
2024-11-10,2024-11-10,Marketing - Beacon Digital #4,Marketing,ALL,37142.26,0.0,SGD,SWIFT MT103,Beacon Digital #4,***3925,,,False,False,REF-279860,First Continental Bank,***7699,Globex APAC Logistics Pte. Ltd.,SG,2528630.32
2024-11-11,2024-11-11,Supplier Payment - CodeCraft Contractors #13,Supplier Payment,SaaS-GL,13715.08,0.0,SGD,MEPS+,CodeCraft Contractors #13,***3813,,PO-202411-SaaS-GL-0003,False,False,REF-608846,First Continental Bank,***6042,Globex APAC Logistics Pte. Ltd.,SG,2514915.24
2024-11-11,2024-11-11,Client Receipt - CloudBridge Co. #52,Sales Receipt,SaaS-GL,0.0,5439.69,SGD,FAST Credit,CloudBridge Co. #52,***3950,INV-202411-SaaS-GL-0015,,False,False,REF-194086,First Continental Bank,***5075,Globex APAC Logistics Pte. Ltd.,SG,2520354.93
2024-11-11,2024-11-11,Client Receipt - CloudBridge Co. #38,Sales Receipt,SaaS-GL,0.0,8546.54,SGD,SWIFT MT103,CloudBridge Co. #38,***2406,INV-202411-SaaS-GL-0003,,False,False,REF-363704,First Continental Bank,***8920,Globex APAC Logistics Pte. Ltd.,SG,2528901.47
2024-11-12,2024-11-12,Supplier Payment - TransAsia Freight #41,Supplier Payment,Logistics-APAC,61132.94,0.0,SGD,SWIFT MT103,TransAsia Freight #41,***1642,,PO-202411-Logistics-APAC-0003,False,False,REF-338376,First Continental Bank,***6796,Globex APAC Logistics Pte. Ltd.,SG,2467768.53
2024-11-12,2024-11-12,Intercompany Settlement - Globex Consulting UK Ltd.,Intercompany Transfer,ALL,812303.0,0.0,SGD,Internal Transfer,Globex Consulting UK Ltd.,***3673,,,True,True,REF-172937,First Continental Bank,***9108,Globex APAC Logistics Pte. Ltd.,SG,1655465.53
2024-11-12,2024-11-12,Client Receipt - CloudBridge Co. #9,Sales Receipt,SaaS-GL,0.0,9028.4,SGD,SWIFT MT103,CloudBridge Co. #9,***8376,INV-202411-SaaS-GL-0007,,False,False,REF-738673,First Continental Bank,***9911,Globex APAC Logistics Pte. Ltd.,SG,1664493.93
2024-11-13,2024-11-13,Client Receipt - Vertex Advisory Client #7,Sales Receipt,PS-GL,0.0,2091.11,SGD,SWIFT MT103,Vertex Advisory Client #7,***8422,INV-202411-PS-GL-0003,,False,False,REF-188062,First Continental Bank,***1050,Globex APAC Logistics Pte. Ltd.,SG,1666585.04
2024-11-13,2024-11-13,Client Receipt - CloudBridge Co. #5,Sales Receipt,SaaS-GL,0.0,30458.57,SGD,SWIFT MT103,CloudBridge Co. #5,***8652,INV-202411-SaaS-GL-0018,,False,False,REF-185068,First Continental Bank,***7468,Globex APAC Logistics Pte. Ltd.,SG,1697043.61
2024-11-13,2024-11-13,Client Receipt - Pacific Trade Co. #22,Sales Receipt,Logistics-APAC,0.0,46617.06,SGD,FAST Credit,Pacific Trade Co. #22,***5435,INV-202411-Logistics-APAC-0002,,False,False,REF-796501,First Continental Bank,***7486,Globex APAC Logistics Pte. Ltd.,SG,1743660.67
2024-11-14,2024-11-14,Client Receipt - Vertex Advisory Client #43,Sales Receipt,PS-GL,0.0,11131.51,SGD,SWIFT MT103,Vertex Advisory Client #43,***6419,INV-202411-PS-GL-0007,,False,False,REF-860585,First Continental Bank,***3505,Globex APAC Logistics Pte. Ltd.,SG,1754792.18
2024-11-14,2024-11-14,Client Receipt - Vertex Advisory Client #12,Sales Receipt,PS-GL,0.0,30135.31,SGD,FAST Credit,Vertex Advisory Client #12,***2142,INV-202411-PS-GL-0008,,False,False,REF-118406,First Continental Bank,***7317,Globex APAC Logistics Pte. Ltd.,SG,1784927.49
2024-11-14,2024-11-14,Client Receipt - Pacific Trade Co. #59,Sales Receipt,Logistics-APAC,0.0,78799.5,SGD,FAST Credit,Pacific Trade Co. #59,***9540,INV-202411-Logistics-APAC-0003,,False,False,REF-529969,First Continental Bank,***5473,Globex APAC Logistics Pte. Ltd.,SG,1863726.99
2024-11-15,2024-11-15,Supplier Payment - ExpertNet Subcontractors #5,Supplier Payment,PS-GL,11404.03,0.0,SGD,MEPS+,ExpertNet Subcontractors #5,***3037,,PO-202411-PS-GL-0010,False,False,REF-717283,First Continental Bank,***8611,Globex APAC Logistics Pte. Ltd.,SG,1852322.96
2024-11-15,2024-11-15,Client Receipt - CloudBridge Co. #47,Sales Receipt,SaaS-GL,0.0,8306.69,SGD,FAST Credit,CloudBridge Co. #47,***1509,INV-202411-SaaS-GL-0022,,False,False,REF-328737,First Continental Bank,***3858,Globex APAC Logistics Pte. Ltd.,SG,1860629.65
2024-11-15,2024-11-15,Client Receipt - CloudBridge Co. #71,Sales Receipt,SaaS-GL,0.0,30409.63,SGD,SWIFT MT103,CloudBridge Co. #71,***7724,INV-202411-SaaS-GL-0023,,False,False,REF-748181,First Continental Bank,***8277,Globex APAC Logistics Pte. Ltd.,SG,1891039.28
2024-11-15,2024-11-15,Client Receipt - CloudBridge Co. #73,Sales Receipt,SaaS-GL,0.0,35119.4,SGD,FAST Credit,CloudBridge Co. #73,***6973,INV-202411-SaaS-GL-0017,,False,False,REF-282760,First Continental Bank,***8926,Globex APAC Logistics Pte. Ltd.,SG,1926158.68
2024-11-15,2024-11-15,Client Receipt - Vertex Advisory Client #40,Sales Receipt,PS-GL,0.0,47769.12,SGD,SWIFT MT103,Vertex Advisory Client #40,***5426,INV-202411-PS-GL-0002,,False,False,REF-531168,First Continental Bank,***2898,Globex APAC Logistics Pte. Ltd.,SG,1973927.8
2024-11-16,2024-11-16,Supplier Payment - ExpertNet Subcontractors #8,Supplier Payment,PS-GL,6783.0,0.0,SGD,FAST Debit,ExpertNet Subcontractors #8,***6882,,PO-202411-PS-GL-0007,False,False,REF-622316,First Continental Bank,***4936,Globex APAC Logistics Pte. Ltd.,SG,1967144.8
2024-11-16,2024-11-16,Client Receipt - Vertex Advisory Client #9,Sales Receipt,PS-GL,0.0,39456.73,SGD,FAST Credit,Vertex Advisory Client #9,***4173,INV-202411-PS-GL-0009,,False,False,REF-748626,First Continental Bank,***5338,Globex APAC Logistics Pte. Ltd.,SG,2006601.53
2024-11-17,2024-11-17,Client Receipt - CloudBridge Co. #68,Sales Receipt,SaaS-GL,0.0,16256.26,SGD,SWIFT MT103,CloudBridge Co. #68,***7157,INV-202411-SaaS-GL-0021,,False,False,REF-953299,First Continental Bank,***3474,Globex APAC Logistics Pte. Ltd.,SG,2022857.79
2024-11-18,2024-11-18,Supplier Payment - ExpertNet Subcontractors #6,Supplier Payment,PS-GL,1762.27,0.0,SGD,FAST Debit,ExpertNet Subcontractors #6,***3984,,PO-202411-PS-GL-0005,False,False,REF-533089,First Continental Bank,***7137,Globex APAC Logistics Pte. Ltd.,SG,2021095.52
2024-11-18,2024-11-18,Supplier Payment - ExpertNet Subcontractors #5,Supplier Payment,PS-GL,15826.35,0.0,SGD,SWIFT MT103,ExpertNet Subcontractors #5,***1399,,PO-202411-PS-GL-0002,False,False,REF-417469,First Continental Bank,***4309,Globex APAC Logistics Pte. Ltd.,SG,2005269.17
2024-11-18,2024-11-18,Supplier Payment - TransAsia Freight #16,Supplier Payment,Logistics-APAC,32710.62,0.0,SGD,FAST Debit,TransAsia Freight #16,***2922,,PO-202411-Logistics-APAC-0005,False,False,REF-159734,First Continental Bank,***5535,Globex APAC Logistics Pte. Ltd.,SG,1972558.55
2024-11-18,2024-11-18,Client Receipt - Pacific Trade Co. #26,Sales Receipt,Logistics-APAC,0.0,19865.14,SGD,SWIFT MT103,Pacific Trade Co. #26,***6829,INV-202411-Logistics-APAC-0006,,False,False,REF-497766,First Continental Bank,***6968,Globex APAC Logistics Pte. Ltd.,SG,1992423.69
2024-11-19,2024-11-19,VAT/GST Remittance - IRAS Singapore,Tax Payment,ALL,96172.16,0.0,SGD,SWIFT MT103,IRAS Singapore,***7611,,,False,False,REF-619899,First Continental Bank,***3300,Globex APAC Logistics Pte. Ltd.,SG,1896251.53
2024-11-19,2024-11-19,Client Receipt - Pacific Trade Co. #14,Sales Receipt,Logistics-APAC,0.0,32691.34,SGD,SWIFT MT103,Pacific Trade Co. #14,***6037,INV-202411-Logistics-APAC-0005,,False,False,REF-924316,First Continental Bank,***7188,Globex APAC Logistics Pte. Ltd.,SG,1928942.87
2024-11-19,2024-11-19,Client Receipt - CloudBridge Co. #9,Sales Receipt,SaaS-GL,0.0,40995.78,SGD,SWIFT MT103,CloudBridge Co. #9,***8209,INV-202411-SaaS-GL-0004,,False,False,REF-255858,First Continental Bank,***8372,Globex APAC Logistics Pte. Ltd.,SG,1969938.65
2024-11-20,2024-11-20,Supplier Payment - Port Services #4,Supplier Payment,Logistics-APAC,4736.31,0.0,SGD,MEPS+,Port Services #4,***6084,,PO-202411-Logistics-APAC-0004,False,False,REF-329816,First Continental Bank,***2215,Globex APAC Logistics Pte. Ltd.,SG,1965202.34
2024-11-20,2024-11-20,Supplier Payment - TransAsia Freight #41,Supplier Payment,Logistics-APAC,6106.53,0.0,SGD,SWIFT MT103,TransAsia Freight #41,***3133,,PO-202411-Logistics-APAC-0008,False,False,REF-259569,First Continental Bank,***4498,Globex APAC Logistics Pte. Ltd.,SG,1959095.81
2024-11-20,2024-11-20,Supplier Payment - ExpertNet Subcontractors #9,Supplier Payment,PS-GL,7246.38,0.0,SGD,MEPS+,ExpertNet Subcontractors #9,***9826,,PO-202411-PS-GL-0006,False,False,REF-425292,First Continental Bank,***1222,Globex APAC Logistics Pte. Ltd.,SG,1951849.43
2024-11-20,2024-11-20,Client Receipt - Pacific Trade Co. #52,Sales Receipt,Logistics-APAC,0.0,14219.76,SGD,SWIFT MT103,Pacific Trade Co. #52,***7158,INV-202411-Logistics-APAC-0001,,False,False,REF-613257,First Continental Bank,***6305,Globex APAC Logistics Pte. Ltd.,SG,1966069.19
2024-11-20,2024-11-20,Client Receipt - Pacific Trade Co. #3,Sales Receipt,Logistics-APAC,0.0,37245.36,SGD,FAST Credit,Pacific Trade Co. #3,***1605,INV-202411-Logistics-APAC-0007,,False,False,REF-987455,First Continental Bank,***8054,Globex APAC Logistics Pte. Ltd.,SG,2003314.55
2024-11-21,2024-11-21,Supplier Payment - CodeCraft Contractors #13,Supplier Payment,SaaS-GL,3308.34,0.0,SGD,FAST Debit,CodeCraft Contractors #13,***8205,,PO-202411-SaaS-GL-0007,False,False,REF-690966,First Continental Bank,***8180,Globex APAC Logistics Pte. Ltd.,SG,2000006.21
2024-11-21,2024-11-21,Alphagrid Utilities,Rent & Utilities,ALL,12125.02,0.0,SGD,MEPS+,Alphagrid Utilities,***2728,,,False,False,REF-167258,First Continental Bank,***1371,Globex APAC Logistics Pte. Ltd.,SG,1987881.19
2024-11-21,2024-11-21,Supplier Payment - TransAsia Freight #4,Supplier Payment,Logistics-APAC,12161.51,0.0,SGD,MEPS+,TransAsia Freight #4,***6009,,PO-202411-Logistics-APAC-0002,False,False,REF-246312,First Continental Bank,***2992,Globex APAC Logistics Pte. Ltd.,SG,1975719.68
2024-11-21,2024-11-21,Supplier Payment - ExpertNet Subcontractors #16,Supplier Payment,PS-GL,12577.87,0.0,SGD,MEPS+,ExpertNet Subcontractors #16,***9609,,PO-202411-PS-GL-0008,False,False,REF-419794,First Continental Bank,***8056,Globex APAC Logistics Pte. Ltd.,SG,1963141.81
2024-11-21,2024-11-21,Supplier Payment - Port Services #16,Supplier Payment,Logistics-APAC,52713.61,0.0,SGD,FAST Debit,Port Services #16,***7514,,PO-202411-Logistics-APAC-0006,False,False,REF-782037,First Continental Bank,***1012,Globex APAC Logistics Pte. Ltd.,SG,1910428.2
2024-11-21,2024-11-21,Client Receipt - CloudBridge Co. #21,Sales Receipt,SaaS-GL,0.0,7138.36,SGD,SWIFT MT103,CloudBridge Co. #21,***7000,INV-202411-SaaS-GL-0001,,False,False,REF-365634,First Continental Bank,***1642,Globex APAC Logistics Pte. Ltd.,SG,1917566.56
2024-11-21,2024-11-21,Client Receipt - CloudBridge Co. #58,Sales Receipt,SaaS-GL,0.0,28759.22,SGD,FAST Credit,CloudBridge Co. #58,***6771,INV-202411-SaaS-GL-0019,,False,False,REF-591230,First Continental Bank,***3283,Globex APAC Logistics Pte. Ltd.,SG,1946325.78
2024-11-21,2024-11-21,Client Receipt - CloudBridge Co. #77,Sales Receipt,SaaS-GL,0.0,30916.24,SGD,FAST Credit,CloudBridge Co. #77,***3131,INV-202411-SaaS-GL-0008,,False,False,REF-608909,First Continental Bank,***5774,Globex APAC Logistics Pte. Ltd.,SG,1977242.02
2024-11-21,2024-11-21,Client Receipt - Pacific Trade Co. #20,Sales Receipt,Logistics-APAC,0.0,70902.71,SGD,SWIFT MT103,Pacific Trade Co. #20,***4726,INV-202411-Logistics-APAC-0008,,False,False,REF-162061,First Continental Bank,***1519,Globex APAC Logistics Pte. Ltd.,SG,2048144.73
2024-11-22,2024-11-22,Supplier Payment - CodeCraft Contractors #10,Supplier Payment,SaaS-GL,1478.13,0.0,SGD,MEPS+,CodeCraft Contractors #10,***3126,,PO-202411-SaaS-GL-0008,False,False,REF-347728,First Continental Bank,***2698,Globex APAC Logistics Pte. Ltd.,SG,2046666.6
2024-11-22,2024-11-22,Supplier Payment - ExpertNet Subcontractors #11,Supplier Payment,PS-GL,2912.1,0.0,SGD,MEPS+,ExpertNet Subcontractors #11,***2858,,PO-202411-PS-GL-0011,False,False,REF-168419,First Continental Bank,***5956,Globex APAC Logistics Pte. Ltd.,SG,2043754.5
2024-11-22,2024-11-22,Supplier Payment - TransAsia Freight #32,Supplier Payment,Logistics-APAC,21451.4,0.0,SGD,FAST Debit,TransAsia Freight #32,***4885,,PO-202411-Logistics-APAC-0001,False,False,REF-342325,First Continental Bank,***4854,Globex APAC Logistics Pte. Ltd.,SG,2022303.1
2024-11-22,2024-11-22,Client Receipt - CloudBridge Co. #7,Sales Receipt,SaaS-GL,0.0,16104.86,SGD,FAST Credit,CloudBridge Co. #7,***9188,INV-202411-SaaS-GL-0020,,False,False,REF-563818,First Continental Bank,***9771,Globex APAC Logistics Pte. Ltd.,SG,2038407.96
2024-11-22,2024-11-22,Client Receipt - CloudBridge Co. #16,Sales Receipt,SaaS-GL,0.0,32638.62,SGD,SWIFT MT103,CloudBridge Co. #16,***6931,INV-202411-SaaS-GL-0011,,False,False,REF-288168,First Continental Bank,***3632,Globex APAC Logistics Pte. Ltd.,SG,2071046.58
2024-11-25,2024-11-25,Client Receipt - CloudBridge Co. #46,Sales Receipt,SaaS-GL,0.0,11407.5,SGD,SWIFT MT103,CloudBridge Co. #46,***3633,INV-202411-SaaS-GL-0012,,False,False,REF-695591,First Continental Bank,***7863,Globex APAC Logistics Pte. Ltd.,SG,2082454.08
2024-11-25,2024-11-25,Client Receipt - Vertex Advisory Client #22,Sales Receipt,PS-GL,0.0,19251.87,SGD,SWIFT MT103,Vertex Advisory Client #22,***4040,INV-202411-PS-GL-0006,,False,False,REF-866587,First Continental Bank,***3069,Globex APAC Logistics Pte. Ltd.,SG,2101705.95
2024-11-26,2024-11-26,Supplier Payment - ExpertNet Subcontractors #8,Supplier Payment,PS-GL,29130.86,0.0,SGD,MEPS+,ExpertNet Subcontractors #8,***2398,,PO-202411-PS-GL-0009,False,False,REF-810896,First Continental Bank,***1103,Globex APAC Logistics Pte. Ltd.,SG,2072575.09
2024-11-26,2024-11-26,Intercompany Settlement - Globex Retail NA LLC,Intercompany Transfer,ALL,643961.0,0.0,SGD,Internal Transfer,Globex Retail NA LLC,***9296,,,True,True,REF-979327,First Continental Bank,***3130,Globex APAC Logistics Pte. Ltd.,SG,1428614.09
2024-11-26,2024-11-26,Client Receipt - Vertex Advisory Client #22,Sales Receipt,PS-GL,0.0,99731.54,SGD,SWIFT MT103,Vertex Advisory Client #22,***3596,INV-202411-PS-GL-0005,,False,False,REF-580989,First Continental Bank,***5680,Globex APAC Logistics Pte. Ltd.,SG,1528345.63
2024-11-26,2024-11-26,Intercompany Reimbursement - Globex Retail NA LLC,Intercompany Transfer,ALL,0.0,257584.4,SGD,Internal Transfer,Globex Retail NA LLC,***7902,,,True,True,REF-989489,First Continental Bank,***4912,Globex APAC Logistics Pte. Ltd.,SG,1785930.03
2024-11-27,2024-11-27,Supplier Payment - ExpertNet Subcontractors #7,Supplier Payment,PS-GL,2563.91,0.0,SGD,FAST Debit,ExpertNet Subcontractors #7,***8903,,PO-202411-PS-GL-0003,False,False,REF-441108,First Continental Bank,***2562,Globex APAC Logistics Pte. Ltd.,SG,1783366.12
2024-11-27,2024-11-27,Client Receipt - CloudBridge Co. #63,Sales Receipt,SaaS-GL,0.0,18219.64,SGD,SWIFT MT103,CloudBridge Co. #63,***8101,INV-202411-SaaS-GL-0002,,False,False,REF-760848,First Continental Bank,***3040,Globex APAC Logistics Pte. Ltd.,SG,1801585.76
2024-11-27,2024-11-27,Client Receipt - CloudBridge Co. #10,Sales Receipt,SaaS-GL,0.0,21831.64,SGD,SWIFT MT103,CloudBridge Co. #10,***7441,INV-202411-SaaS-GL-0013,,False,False,REF-862582,First Continental Bank,***3586,Globex APAC Logistics Pte. Ltd.,SG,1823417.4
2024-11-27,2024-11-27,Client Receipt - CloudBridge Co. #52,Sales Receipt,SaaS-GL,0.0,53015.88,SGD,FAST Credit,CloudBridge Co. #52,***1887,INV-202411-SaaS-GL-0010,,False,False,REF-176379,First Continental Bank,***8153,Globex APAC Logistics Pte. Ltd.,SG,1876433.28
2024-11-28,2024-11-28,Supplier Payment - ExpertNet Subcontractors #3,Supplier Payment,PS-GL,16239.62,0.0,SGD,MEPS+,ExpertNet Subcontractors #3,***3726,,PO-202411-PS-GL-0001,False,False,REF-909259,First Continental Bank,***3066,Globex APAC Logistics Pte. Ltd.,SG,1860193.66
2024-11-28,2024-11-28,Client Receipt - CloudBridge Co. #24,Sales Receipt,SaaS-GL,0.0,30123.7,SGD,SWIFT MT103,CloudBridge Co. #24,***1712,INV-202411-SaaS-GL-0006,,False,False,REF-474011,First Continental Bank,***7138,Globex APAC Logistics Pte. Ltd.,SG,1890317.36
2024-11-29,2024-11-29,Supplier Payment - CodeCraft Contractors #12,Supplier Payment,SaaS-GL,1125.95,0.0,SGD,SWIFT MT103,CodeCraft Contractors #12,***6732,,PO-202411-SaaS-GL-0004,False,False,REF-753113,First Continental Bank,***7311,Globex APAC Logistics Pte. Ltd.,SG,1889191.41
2024-11-29,2024-11-29,Supplier Payment - TransAsia Freight #35,Supplier Payment,Logistics-APAC,48665.84,0.0,SGD,SWIFT MT103,TransAsia Freight #35,***6292,,PO-202411-Logistics-APAC-0009,False,False,REF-562939,First Continental Bank,***2154,Globex APAC Logistics Pte. Ltd.,SG,1840525.57
2024-11-29,2024-11-29,Payroll - GlobalPay Services Ltd,Payroll,ALL,121779.28,0.0,SGD,SWIFT MT103,GlobalPay Services Ltd,***5650,,,False,False,REF-162582,First Continental Bank,***3298,Globex APAC Logistics Pte. Ltd.,SG,1718746.29
2024-11-30,2024-11-30,Payroll - GlobalPay Services Ltd,Payroll,ALL,121779.28,0.0,SGD,FAST Debit,GlobalPay Services Ltd,***9867,,,False,False,REF-397233,First Continental Bank,***9271,Globex APAC Logistics Pte. Ltd.,SG,1596967.01
2024-11-30,2024-11-30,Interest Earned,Interest Income,ALL,0.0,9921.35,SGD,SWIFT MT103,First Continental Bank,***8528,,,False,False,REF-101123,First Continental Bank,***6847,Globex APAC Logistics Pte. Ltd.,SG,1606888.36
2024-12-01,2024-12-01,Account Maintenance Fee,Bank/Merchant Fees,ALL,2500.0,0.0,SGD,FAST Debit,First Continental Bank,***6801,,,False,False,REF-952903,First Continental Bank,***5269,Globex APAC Logistics Pte. Ltd.,SG,1604388.36
2024-12-01,2024-12-01,Client Receipt - CloudBridge Co. #54,Sales Receipt,SaaS-GL,0.0,5339.1,SGD,SWIFT MT103,CloudBridge Co. #54,***1623,INV-202412-SaaS-GL-0024,,False,False,REF-626497,First Continental Bank,***2400,Globex APAC Logistics Pte. Ltd.,SG,1609727.46
2024-12-02,2024-12-02,Supplier Payment - ExpertNet Subcontractors #1,Supplier Payment,PS-GL,3730.46,0.0,SGD,FAST Debit,ExpertNet Subcontractors #1,***8867,,PO-202412-PS-GL-0007,False,False,REF-900871,First Continental Bank,***6545,Globex APAC Logistics Pte. Ltd.,SG,1605997.0
2024-12-02,2024-12-02,Supplier Payment - Port Services #8,Supplier Payment,Logistics-APAC,49153.22,0.0,SGD,MEPS+,Port Services #8,***1898,,PO-202412-Logistics-APAC-0006,False,False,REF-103878,First Continental Bank,***8808,Globex APAC Logistics Pte. Ltd.,SG,1556843.78
2024-12-02,2024-12-02,Client Receipt - Pacific Trade Co. #21,Sales Receipt,Logistics-APAC,0.0,11663.08,SGD,SWIFT MT103,Pacific Trade Co. #21,***4322,INV-202412-Logistics-APAC-0005,,False,False,REF-638539,First Continental Bank,***8039,Globex APAC Logistics Pte. Ltd.,SG,1568506.86
2024-12-02,2024-12-02,Client Receipt - Vertex Advisory Client #51,Sales Receipt,PS-GL,0.0,56144.37,SGD,SWIFT MT103,Vertex Advisory Client #51,***4504,INV-202412-PS-GL-0006,,False,False,REF-560698,First Continental Bank,***2479,Globex APAC Logistics Pte. Ltd.,SG,1624651.23
2024-12-03,2024-12-03,Supplier Payment - ExpertNet Subcontractors #14,Supplier Payment,PS-GL,64499.27,0.0,SGD,FAST Debit,ExpertNet Subcontractors #14,***1644,,PO-202412-PS-GL-0003,False,False,REF-587522,First Continental Bank,***1857,Globex APAC Logistics Pte. Ltd.,SG,1560151.96
2024-12-03,2024-12-03,Client Receipt - CloudBridge Co. #59,Sales Receipt,SaaS-GL,0.0,929.15,SGD,SWIFT MT103,CloudBridge Co. #59,***6159,INV-202412-SaaS-GL-0021,,False,False,REF-127042,First Continental Bank,***3874,Globex APAC Logistics Pte. Ltd.,SG,1561081.11
2024-12-03,2024-12-03,Client Receipt - CloudBridge Co. #25,Sales Receipt,SaaS-GL,0.0,2396.09,SGD,SWIFT MT103,CloudBridge Co. #25,***6339,INV-202412-SaaS-GL-0003,,False,False,REF-596605,First Continental Bank,***7527,Globex APAC Logistics Pte. Ltd.,SG,1563477.2
2024-12-03,2024-12-03,Client Receipt - Vertex Advisory Client #36,Sales Receipt,PS-GL,0.0,117421.05,SGD,FAST Credit,Vertex Advisory Client #36,***1403,INV-202412-PS-GL-0007,,False,False,REF-280758,First Continental Bank,***6332,Globex APAC Logistics Pte. Ltd.,SG,1680898.25
2024-12-04,2024-12-04,Client Receipt - Pacific Trade Co. #56,Sales Receipt,Logistics-APAC,0.0,4128.56,SGD,SWIFT MT103,Pacific Trade Co. #56,***1518,INV-202412-Logistics-APAC-0004,,False,False,REF-272192,First Continental Bank,***5066,Globex APAC Logistics Pte. Ltd.,SG,1685026.81
2024-12-04,2024-12-04,Client Receipt - Vertex Advisory Client #33,Sales Receipt,PS-GL,0.0,4180.29,SGD,FAST Credit,Vertex Advisory Client #33,***1525,INV-202412-PS-GL-0003,,False,False,REF-204399,First Continental Bank,***9780,Globex APAC Logistics Pte. Ltd.,SG,1689207.1
2024-12-04,2024-12-04,Client Receipt - Pacific Trade Co. #5,Sales Receipt,Logistics-APAC,0.0,8153.92,SGD,FAST Credit,Pacific Trade Co. #5,***4461,INV-202412-Logistics-APAC-0008,,False,False,REF-199080,First Continental Bank,***7948,Globex APAC Logistics Pte. Ltd.,SG,1697361.02
2024-12-05,2024-12-05,Supplier Payment - ExpertNet Subcontractors #2,Supplier Payment,PS-GL,1843.21,0.0,SGD,SWIFT MT103,ExpertNet Subcontractors #2,***5277,,PO-202412-PS-GL-0002,False,False,REF-744982,First Continental Bank,***3170,Globex APAC Logistics Pte. Ltd.,SG,1695517.81
2024-12-05,2024-12-05,Northshore Power,Rent & Utilities,ALL,13686.16,0.0,SGD,SWIFT MT103,Northshore Power,***4085,,,False,False,REF-846827,First Continental Bank,***9255,Globex APAC Logistics Pte. Ltd.,SG,1681831.65
2024-12-05,2024-12-05,Client Receipt - Pacific Trade Co. #66,Sales Receipt,Logistics-APAC,0.0,18306.33,SGD,SWIFT MT103,Pacific Trade Co. #66,***4541,INV-202412-Logistics-APAC-0003,,False,False,REF-123447,First Continental Bank,***2074,Globex APAC Logistics Pte. Ltd.,SG,1700137.98
2024-12-05,2024-12-05,Client Receipt - CloudBridge Co. #3,Sales Receipt,SaaS-GL,0.0,33211.68,SGD,FAST Credit,CloudBridge Co. #3,***3208,INV-202412-SaaS-GL-0028,,False,False,REF-437206,First Continental Bank,***3684,Globex APAC Logistics Pte. Ltd.,SG,1733349.66
2024-12-05,2024-12-05,Client Receipt - Pacific Trade Co. #19,Sales Receipt,Logistics-APAC,0.0,91682.99,SGD,SWIFT MT103,Pacific Trade Co. #19,***3850,INV-202412-Logistics-APAC-0009,,False,False,REF-770021,First Continental Bank,***9937,Globex APAC Logistics Pte. Ltd.,SG,1825032.65
2024-12-06,2024-12-06,Supplier Payment - TransAsia Freight #42,Supplier Payment,Logistics-APAC,1432.51,0.0,SGD,MEPS+,TransAsia Freight #42,***9703,,PO-202412-Logistics-APAC-0011,False,False,REF-225011,First Continental Bank,***3710,Globex APAC Logistics Pte. Ltd.,SG,1823600.14
2024-12-06,2024-12-06,Client Receipt - CloudBridge Co. #32,Sales Receipt,SaaS-GL,0.0,13931.53,SGD,SWIFT MT103,CloudBridge Co. #32,***6061,INV-202412-SaaS-GL-0023,,False,False,REF-136631,First Continental Bank,***9798,Globex APAC Logistics Pte. Ltd.,SG,1837531.67
2024-12-06,2024-12-06,Client Receipt - Pacific Trade Co. #55,Sales Receipt,Logistics-APAC,0.0,53632.32,SGD,SWIFT MT103,Pacific Trade Co. #55,***7489,INV-202412-Logistics-APAC-0012,,False,False,REF-993830,First Continental Bank,***5288,Globex APAC Logistics Pte. Ltd.,SG,1891163.99
2024-12-08,2024-12-08,Supplier Payment - ExpertNet Subcontractors #7,Supplier Payment,PS-GL,20958.65,0.0,SGD,MEPS+,ExpertNet Subcontractors #7,***5906,,PO-202412-PS-GL-0010,False,False,REF-120737,First Continental Bank,***7565,Globex APAC Logistics Pte. Ltd.,SG,1870205.34
2024-12-08,2024-12-08,Client Receipt - Pacific Trade Co. #12,Sales Receipt,Logistics-APAC,0.0,37419.7,SGD,SWIFT MT103,Pacific Trade Co. #12,***5005,INV-202412-Logistics-APAC-0002,,False,False,REF-358458,First Continental Bank,***9124,Globex APAC Logistics Pte. Ltd.,SG,1907625.04
2024-12-09,2024-12-09,Client Receipt - CloudBridge Co. #52,Sales Receipt,SaaS-GL,0.0,1781.75,SGD,SWIFT MT103,CloudBridge Co. #52,***4729,INV-202412-SaaS-GL-0002,,False,False,REF-460061,First Continental Bank,***9301,Globex APAC Logistics Pte. Ltd.,SG,1909406.79
2024-12-09,2024-12-09,Client Receipt - CloudBridge Co. #20,Sales Receipt,SaaS-GL,0.0,8794.15,SGD,FAST Credit,CloudBridge Co. #20,***8416,INV-202412-SaaS-GL-0011,,False,False,REF-621785,First Continental Bank,***6811,Globex APAC Logistics Pte. Ltd.,SG,1918200.94
2024-12-10,2024-12-10,Supplier Payment - ExpertNet Subcontractors #17,Supplier Payment,PS-GL,64.91,0.0,SGD,MEPS+,ExpertNet Subcontractors #17,***4612,,PO-202412-PS-GL-0006,False,False,REF-732438,First Continental Bank,***5971,Globex APAC Logistics Pte. Ltd.,SG,1918136.03
2024-12-10,2024-12-10,Supplier Payment - HyperCloud Infra #1,Supplier Payment,SaaS-GL,6019.94,0.0,SGD,SWIFT MT103,HyperCloud Infra #1,***6853,,PO-202412-SaaS-GL-0006,False,False,REF-944897,First Continental Bank,***2108,Globex APAC Logistics Pte. Ltd.,SG,1912116.09
2024-12-10,2024-12-10,Supplier Payment - HyperCloud Infra #10,Supplier Payment,SaaS-GL,24376.38,0.0,SGD,MEPS+,HyperCloud Infra #10,***7031,,PO-202412-SaaS-GL-0002,False,False,REF-276724,First Continental Bank,***7700,Globex APAC Logistics Pte. Ltd.,SG,1887739.71
2024-12-10,2024-12-10,Supplier Payment - CodeCraft Contractors #2,Supplier Payment,SaaS-GL,44557.15,0.0,SGD,FAST Debit,CodeCraft Contractors #2,***4728,,PO-202412-SaaS-GL-0003,False,False,REF-821041,First Continental Bank,***3491,Globex APAC Logistics Pte. Ltd.,SG,1843182.56
2024-12-10,2024-12-10,Client Receipt - CloudBridge Co. #31,Sales Receipt,SaaS-GL,0.0,5181.79,SGD,FAST Credit,CloudBridge Co. #31,***9785,INV-202412-SaaS-GL-0018,,False,False,REF-664737,First Continental Bank,***1266,Globex APAC Logistics Pte. Ltd.,SG,1848364.35
2024-12-10,2024-12-10,Client Receipt - CloudBridge Co. #57,Sales Receipt,SaaS-GL,0.0,6033.56,SGD,FAST Credit,CloudBridge Co. #57,***2050,INV-202412-SaaS-GL-0029,,False,False,REF-969800,First Continental Bank,***8805,Globex APAC Logistics Pte. Ltd.,SG,1854397.91
2024-12-10,2024-12-10,Client Receipt - CloudBridge Co. #68,Sales Receipt,SaaS-GL,0.0,8072.77,SGD,SWIFT MT103,CloudBridge Co. #68,***5140,INV-202412-SaaS-GL-0020,,False,False,REF-395415,First Continental Bank,***3653,Globex APAC Logistics Pte. Ltd.,SG,1862470.68
2024-12-10,2024-12-10,Client Receipt - CloudBridge Co. #61,Sales Receipt,SaaS-GL,0.0,10586.91,SGD,FAST Credit,CloudBridge Co. #61,***1832,INV-202412-SaaS-GL-0026,,False,False,REF-776118,First Continental Bank,***6426,Globex APAC Logistics Pte. Ltd.,SG,1873057.59
2024-12-11,2024-12-11,Supplier Payment - ExpertNet Subcontractors #15,Supplier Payment,PS-GL,3465.62,0.0,SGD,MEPS+,ExpertNet Subcontractors #15,***7878,,PO-202412-PS-GL-0001,False,False,REF-377271,First Continental Bank,***5451,Globex APAC Logistics Pte. Ltd.,SG,1869591.97
2024-12-11,2024-12-11,Supplier Payment - ExpertNet Subcontractors #3,Supplier Payment,PS-GL,11596.59,0.0,SGD,SWIFT MT103,ExpertNet Subcontractors #3,***7311,,PO-202412-PS-GL-0004,False,False,REF-770993,First Continental Bank,***4157,Globex APAC Logistics Pte. Ltd.,SG,1857995.38
2024-12-12,2024-12-12,"Intercompany Settlement - Globex International Holdings, Inc.",Intercompany Transfer,ALL,518988.0,0.0,SGD,Internal Transfer,"Globex International Holdings, Inc.",***2811,,,True,True,REF-120121,First Continental Bank,***4823,Globex APAC Logistics Pte. Ltd.,SG,1339007.38
2024-12-12,2024-12-12,Client Receipt - CloudBridge Co. #36,Sales Receipt,SaaS-GL,0.0,12709.04,SGD,SWIFT MT103,CloudBridge Co. #36,***7915,INV-202412-SaaS-GL-0009,,False,False,REF-554038,First Continental Bank,***1595,Globex APAC Logistics Pte. Ltd.,SG,1351716.42
2024-12-12,2024-12-12,Client Receipt - Pacific Trade Co. #41,Sales Receipt,Logistics-APAC,0.0,110200.29,SGD,SWIFT MT103,Pacific Trade Co. #41,***6669,INV-202412-Logistics-APAC-0013,,False,False,REF-615432,First Continental Bank,***6238,Globex APAC Logistics Pte. Ltd.,SG,1461916.71
2024-12-13,2024-12-13,Supplier Payment - ExpertNet Subcontractors #15,Supplier Payment,PS-GL,4735.4,0.0,SGD,FAST Debit,ExpertNet Subcontractors #15,***6156,,PO-202412-PS-GL-0009,False,False,REF-115632,First Continental Bank,***3054,Globex APAC Logistics Pte. Ltd.,SG,1457181.31
2024-12-13,2024-12-13,Supplier Payment - TransAsia Freight #44,Supplier Payment,Logistics-APAC,71181.66,0.0,SGD,SWIFT MT103,TransAsia Freight #44,***7405,,PO-202412-Logistics-APAC-0005,False,False,REF-368166,First Continental Bank,***8505,Globex APAC Logistics Pte. Ltd.,SG,1385999.65
2024-12-13,2024-12-13,Supplier Payment - TransAsia Freight #8,Supplier Payment,Logistics-APAC,118924.65,0.0,SGD,SWIFT MT103,TransAsia Freight #8,***3613,,PO-202412-Logistics-APAC-0007,False,False,REF-217920,First Continental Bank,***5052,Globex APAC Logistics Pte. Ltd.,SG,1267075.0
2024-12-16,2024-12-16,Supplier Payment - TransAsia Freight #41,Supplier Payment,Logistics-APAC,6363.22,0.0,SGD,SWIFT MT103,TransAsia Freight #41,***1139,,PO-202412-Logistics-APAC-0010,False,False,REF-853180,First Continental Bank,***1914,Globex APAC Logistics Pte. Ltd.,SG,1260711.78
2024-12-16,2024-12-16,Client Receipt - Vertex Advisory Client #48,Sales Receipt,PS-GL,0.0,15262.58,SGD,SWIFT MT103,Vertex Advisory Client #48,***6549,INV-202412-PS-GL-0004,,False,False,REF-534874,First Continental Bank,***5262,Globex APAC Logistics Pte. Ltd.,SG,1275974.36
2024-12-16,2024-12-16,Client Receipt - CloudBridge Co. #20,Sales Receipt,SaaS-GL,0.0,30991.04,SGD,FAST Credit,CloudBridge Co. #20,***8460,INV-202412-SaaS-GL-0022,,False,False,REF-512510,First Continental Bank,***5653,Globex APAC Logistics Pte. Ltd.,SG,1306965.4
2024-12-17,2024-12-17,Supplier Payment - ExpertNet Subcontractors #12,Supplier Payment,PS-GL,6491.24,0.0,SGD,SWIFT MT103,ExpertNet Subcontractors #12,***8011,,PO-202412-PS-GL-0008,False,False,REF-568212,First Continental Bank,***5048,Globex APAC Logistics Pte. Ltd.,SG,1300474.16
2024-12-17,2024-12-17,Supplier Payment - Port Services #1,Supplier Payment,Logistics-APAC,6792.87,0.0,SGD,MEPS+,Port Services #1,***9169,,PO-202412-Logistics-APAC-0012,False,False,REF-254288,First Continental Bank,***7524,Globex APAC Logistics Pte. Ltd.,SG,1293681.29
2024-12-17,2024-12-17,Supplier Payment - Port Services #14,Supplier Payment,Logistics-APAC,16830.73,0.0,SGD,FAST Debit,Port Services #14,***7060,,PO-202412-Logistics-APAC-0004,False,False,REF-678690,First Continental Bank,***6829,Globex APAC Logistics Pte. Ltd.,SG,1276850.56
2024-12-17,2024-12-17,Supplier Payment - TransAsia Freight #44,Supplier Payment,Logistics-APAC,21212.99,0.0,SGD,MEPS+,TransAsia Freight #44,***2655,,PO-202412-Logistics-APAC-0003,False,False,REF-755582,First Continental Bank,***3090,Globex APAC Logistics Pte. Ltd.,SG,1255637.57
2024-12-18,2024-12-18,Supplier Payment - CodeCraft Contractors #3,Supplier Payment,SaaS-GL,10214.54,0.0,SGD,FAST Debit,CodeCraft Contractors #3,***7945,,PO-202412-SaaS-GL-0004,False,False,REF-645162,First Continental Bank,***8464,Globex APAC Logistics Pte. Ltd.,SG,1245423.03
2024-12-18,2024-12-18,Marketing - Beacon Digital #1,Marketing,ALL,38653.56,0.0,SGD,SWIFT MT103,Beacon Digital #1,***5767,,,False,False,REF-410624,First Continental Bank,***2623,Globex APAC Logistics Pte. Ltd.,SG,1206769.47
2024-12-18,2024-12-18,Client Receipt - CloudBridge Co. #47,Sales Receipt,SaaS-GL,0.0,20252.41,SGD,FAST Credit,CloudBridge Co. #47,***2359,INV-202412-SaaS-GL-0014,,False,False,REF-425926,First Continental Bank,***9642,Globex APAC Logistics Pte. Ltd.,SG,1227021.88
2024-12-19,2024-12-19,Merchant Processing Fees,Bank/Merchant Fees,ALL,4034.77,0.0,SGD,MEPS+,First Continental Bank,***5120,,,False,False,REF-177085,First Continental Bank,***4657,Globex APAC Logistics Pte. Ltd.,SG,1222987.11
2024-12-19,2024-12-19,Client Receipt - CloudBridge Co. #6,Sales Receipt,SaaS-GL,0.0,4825.86,SGD,SWIFT MT103,CloudBridge Co. #6,***5548,INV-202412-SaaS-GL-0031,,False,False,REF-315917,First Continental Bank,***6665,Globex APAC Logistics Pte. Ltd.,SG,1227812.97
2024-12-19,2024-12-19,Client Receipt - Vertex Advisory Client #51,Sales Receipt,PS-GL,0.0,14251.87,SGD,SWIFT MT103,Vertex Advisory Client #51,***9612,INV-202412-PS-GL-0008,,False,False,REF-121161,First Continental Bank,***3063,Globex APAC Logistics Pte. Ltd.,SG,1242064.84
2024-12-19,2024-12-19,Client Receipt - CloudBridge Co. #25,Sales Receipt,SaaS-GL,0.0,15710.5,SGD,FAST Credit,CloudBridge Co. #25,***5264,INV-202412-SaaS-GL-0016,,False,False,REF-840195,First Continental Bank,***5558,Globex APAC Logistics Pte. Ltd.,SG,1257775.34
2024-12-19,2024-12-19,Client Receipt - CloudBridge Co. #52,Sales Receipt,SaaS-GL,0.0,46924.6,SGD,SWIFT MT103,CloudBridge Co. #52,***5642,INV-202412-SaaS-GL-0007,,False,False,REF-366606,First Continental Bank,***4704,Globex APAC Logistics Pte. Ltd.,SG,1304699.94
2024-12-20,2024-12-20,Supplier Payment - Port Services #11,Supplier Payment,Logistics-APAC,36554.91,0.0,SGD,FAST Debit,Port Services #11,***7377,,PO-202412-Logistics-APAC-0002,False,False,REF-720771,First Continental Bank,***6609,Globex APAC Logistics Pte. Ltd.,SG,1268145.03
2024-12-20,2024-12-20,Client Receipt - CloudBridge Co. #50,Sales Receipt,SaaS-GL,0.0,12764.75,SGD,SWIFT MT103,CloudBridge Co. #50,***1394,INV-202412-SaaS-GL-0017,,False,False,REF-614379,First Continental Bank,***7232,Globex APAC Logistics Pte. Ltd.,SG,1280909.78
2024-12-20,2024-12-20,Client Receipt - Pacific Trade Co. #39,Sales Receipt,Logistics-APAC,0.0,16198.87,SGD,FAST Credit,Pacific Trade Co. #39,***5088,INV-202412-Logistics-APAC-0007,,False,False,REF-644192,First Continental Bank,***8397,Globex APAC Logistics Pte. Ltd.,SG,1297108.65
2024-12-21,2024-12-21,VAT/GST Remittance - IRAS Singapore,Tax Payment,ALL,105154.03,0.0,SGD,MEPS+,IRAS Singapore,***6443,,,False,False,REF-661653,First Continental Bank,***2436,Globex APAC Logistics Pte. Ltd.,SG,1191954.62
2024-12-22,2024-12-22,Supplier Payment - HyperCloud Infra #12,Supplier Payment,SaaS-GL,28490.67,0.0,SGD,MEPS+,HyperCloud Infra #12,***3175,,PO-202412-SaaS-GL-0007,False,False,REF-314815,First Continental Bank,***6720,Globex APAC Logistics Pte. Ltd.,SG,1163463.95
2024-12-22,2024-12-22,Client Receipt - CloudBridge Co. #60,Sales Receipt,SaaS-GL,0.0,20994.0,SGD,SWIFT MT103,CloudBridge Co. #60,***8529,INV-202412-SaaS-GL-0030,,False,False,REF-631940,First Continental Bank,***4191,Globex APAC Logistics Pte. Ltd.,SG,1184457.95
2024-12-23,2024-12-23,Marketing - Aurelia Media #10,Marketing,ALL,4440.98,0.0,SGD,MEPS+,Aurelia Media #10,***8470,,,False,False,REF-959108,First Continental Bank,***7549,Globex APAC Logistics Pte. Ltd.,SG,1180016.97
2024-12-23,2024-12-23,Supplier Payment - ExpertNet Subcontractors #13,Supplier Payment,PS-GL,5541.48,0.0,SGD,MEPS+,ExpertNet Subcontractors #13,***4610,,PO-202412-PS-GL-0005,False,False,REF-494175,First Continental Bank,***6600,Globex APAC Logistics Pte. Ltd.,SG,1174475.49
2024-12-23,2024-12-23,Client Receipt - CloudBridge Co. #72,Sales Receipt,SaaS-GL,0.0,36880.3,SGD,FAST Credit,CloudBridge Co. #72,***1697,INV-202412-SaaS-GL-0005,,False,False,REF-509007,First Continental Bank,***8636,Globex APAC Logistics Pte. Ltd.,SG,1211355.79
2024-12-24,2024-12-24,Supplier Payment - HyperCloud Infra #1,Supplier Payment,SaaS-GL,4666.27,0.0,SGD,SWIFT MT103,HyperCloud Infra #1,***6285,,PO-202412-SaaS-GL-0001,False,False,REF-267759,First Continental Bank,***9951,Globex APAC Logistics Pte. Ltd.,SG,1206689.52
2024-12-24,2024-12-24,Supplier Payment - TransAsia Freight #21,Supplier Payment,Logistics-APAC,27385.64,0.0,SGD,MEPS+,TransAsia Freight #21,***2101,,PO-202412-Logistics-APAC-0008,False,False,REF-965297,First Continental Bank,***4857,Globex APAC Logistics Pte. Ltd.,SG,1179303.88
2024-12-24,2024-12-24,Client Receipt - Pacific Trade Co. #29,Sales Receipt,Logistics-APAC,0.0,31753.38,SGD,FAST Credit,Pacific Trade Co. #29,***9710,INV-202412-Logistics-APAC-0010,,False,False,REF-606947,First Continental Bank,***4183,Globex APAC Logistics Pte. Ltd.,SG,1211057.26
2024-12-24,2024-12-24,Client Receipt - CloudBridge Co. #72,Sales Receipt,SaaS-GL,0.0,61579.71,SGD,SWIFT MT103,CloudBridge Co. #72,***3777,INV-202412-SaaS-GL-0025,,False,False,REF-976565,First Continental Bank,***8445,Globex APAC Logistics Pte. Ltd.,SG,1272636.97
2024-12-24,2024-12-24,Client Receipt - Vertex Advisory Client #43,Sales Receipt,PS-GL,0.0,119647.92,SGD,FAST Credit,Vertex Advisory Client #43,***5397,INV-202412-PS-GL-0002,,False,False,REF-914353,First Continental Bank,***1943,Globex APAC Logistics Pte. Ltd.,SG,1392284.89
2024-12-24,2024-12-24,Client Receipt - Pacific Trade Co. #68,Sales Receipt,Logistics-APAC,0.0,180207.22,SGD,FAST Credit,Pacific Trade Co. #68,***7701,INV-202412-Logistics-APAC-0001,,False,False,REF-710112,First Continental Bank,***4966,Globex APAC Logistics Pte. Ltd.,SG,1572492.11
2024-12-25,2024-12-25,Supplier Payment - CodeCraft Contractors #3,Supplier Payment,SaaS-GL,1440.49,0.0,SGD,MEPS+,CodeCraft Contractors #3,***5073,,PO-202412-SaaS-GL-0009,False,False,REF-204920,First Continental Bank,***5849,Globex APAC Logistics Pte. Ltd.,SG,1571051.62
2024-12-25,2024-12-25,Supplier Payment - Port Services #8,Supplier Payment,Logistics-APAC,89918.62,0.0,SGD,MEPS+,Port Services #8,***9841,,PO-202412-Logistics-APAC-0009,False,False,REF-560168,First Continental Bank,***9602,Globex APAC Logistics Pte. Ltd.,SG,1481133.0
2024-12-25,2024-12-25,Payroll - GlobalPay Services Ltd,Payroll,ALL,137258.06,0.0,SGD,MEPS+,GlobalPay Services Ltd,***6126,,,False,False,REF-562167,First Continental Bank,***7338,Globex APAC Logistics Pte. Ltd.,SG,1343874.94
2024-12-25,2024-12-25,Client Receipt - CloudBridge Co. #75,Sales Receipt,SaaS-GL,0.0,6378.75,SGD,SWIFT MT103,CloudBridge Co. #75,***4413,INV-202412-SaaS-GL-0013,,False,False,REF-892188,First Continental Bank,***3386,Globex APAC Logistics Pte. Ltd.,SG,1350253.69
2024-12-25,2024-12-25,Client Receipt - CloudBridge Co. #23,Sales Receipt,SaaS-GL,0.0,28244.3,SGD,FAST Credit,CloudBridge Co. #23,***6920,INV-202412-SaaS-GL-0008,,False,False,REF-769033,First Continental Bank,***5035,Globex APAC Logistics Pte. Ltd.,SG,1378497.99
2024-12-25,2024-12-25,Client Receipt - CloudBridge Co. #39,Sales Receipt,SaaS-GL,0.0,32984.76,SGD,SWIFT MT103,CloudBridge Co. #39,***9931,INV-202412-SaaS-GL-0001,,False,False,REF-920540,First Continental Bank,***4637,Globex APAC Logistics Pte. Ltd.,SG,1411482.75
2024-12-25,2024-12-25,Client Receipt - Pacific Trade Co. #24,Sales Receipt,Logistics-APAC,0.0,108308.8,SGD,FAST Credit,Pacific Trade Co. #24,***8144,INV-202412-Logistics-APAC-0011,,False,False,REF-369461,First Continental Bank,***1322,Globex APAC Logistics Pte. Ltd.,SG,1519791.55
2024-12-26,2024-12-26,Supplier Payment - CodeCraft Contractors #9,Supplier Payment,SaaS-GL,9173.9,0.0,SGD,FAST Debit,CodeCraft Contractors #9,***2283,,PO-202412-SaaS-GL-0005,False,False,REF-176587,First Continental Bank,***2530,Globex APAC Logistics Pte. Ltd.,SG,1510617.65
2024-12-26,2024-12-26,Intercompany Settlement - Globex Retail NA LLC,Intercompany Transfer,ALL,471861.0,0.0,SGD,Internal Transfer,Globex Retail NA LLC,***1725,,,True,True,REF-150951,First Continental Bank,***5663,Globex APAC Logistics Pte. Ltd.,SG,1038756.65
2024-12-26,2024-12-26,Client Receipt - CloudBridge Co. #49,Sales Receipt,SaaS-GL,0.0,23133.73,SGD,FAST Credit,CloudBridge Co. #49,***4529,INV-202412-SaaS-GL-0027,,False,False,REF-853527,First Continental Bank,***7053,Globex APAC Logistics Pte. Ltd.,SG,1061890.38
2024-12-26,2024-12-26,Client Receipt - Vertex Advisory Client #40,Sales Receipt,PS-GL,0.0,27570.01,SGD,FAST Credit,Vertex Advisory Client #40,***6182,INV-202412-PS-GL-0001,,False,False,REF-866835,First Continental Bank,***2398,Globex APAC Logistics Pte. Ltd.,SG,1089460.39
2024-12-26,2024-12-26,Client Receipt - CloudBridge Co. #14,Sales Receipt,SaaS-GL,0.0,59585.93,SGD,FAST Credit,CloudBridge Co. #14,***3769,INV-202412-SaaS-GL-0012,,False,False,REF-758626,First Continental Bank,***3730,Globex APAC Logistics Pte. Ltd.,SG,1149046.32
2024-12-27,2024-12-27,Payroll - GlobalPay Services Ltd,Payroll,ALL,137258.06,0.0,SGD,FAST Debit,GlobalPay Services Ltd,***2844,,,False,False,REF-145143,First Continental Bank,***2468,Globex APAC Logistics Pte. Ltd.,SG,1011788.26
2024-12-27,2024-12-27,Client Receipt - CloudBridge Co. #21,Sales Receipt,SaaS-GL,0.0,15836.78,SGD,FAST Credit,CloudBridge Co. #21,***5192,INV-202412-SaaS-GL-0019,,False,False,REF-721277,First Continental Bank,***6885,Globex APAC Logistics Pte. Ltd.,SG,1027625.04
2024-12-27,2024-12-27,Client Receipt - CloudBridge Co. #73,Sales Receipt,SaaS-GL,0.0,22905.37,SGD,SWIFT MT103,CloudBridge Co. #73,***3741,INV-202412-SaaS-GL-0010,,False,False,REF-136673,First Continental Bank,***3958,Globex APAC Logistics Pte. Ltd.,SG,1050530.41
2024-12-27,2024-12-27,Client Receipt - CloudBridge Co. #19,Sales Receipt,SaaS-GL,0.0,41026.48,SGD,FAST Credit,CloudBridge Co. #19,***1819,INV-202412-SaaS-GL-0015,,False,False,REF-566750,First Continental Bank,***6131,Globex APAC Logistics Pte. Ltd.,SG,1091556.89
2024-12-28,2024-12-28,Client Receipt - CloudBridge Co. #41,Sales Receipt,SaaS-GL,0.0,21487.78,SGD,SWIFT MT103,CloudBridge Co. #41,***7528,INV-202412-SaaS-GL-0004,,False,False,REF-290300,First Continental Bank,***7235,Globex APAC Logistics Pte. Ltd.,SG,1113044.67
2024-12-29,2024-12-29,Client Receipt - Vertex Advisory Client #8,Sales Receipt,PS-GL,0.0,55278.01,SGD,FAST Credit,Vertex Advisory Client #8,***7134,INV-202412-PS-GL-0005,,False,False,REF-477685,First Continental Bank,***2639,Globex APAC Logistics Pte. Ltd.,SG,1168322.68
2024-12-30,2024-12-30,Merchant Processing Fees,Bank/Merchant Fees,ALL,1314.65,0.0,SGD,SWIFT MT103,First Continental Bank,***5352,,,False,False,REF-197015,First Continental Bank,***8448,Globex APAC Logistics Pte. Ltd.,SG,1167008.03
2024-12-30,2024-12-30,Supplier Payment - TransAsia Freight #43,Supplier Payment,Logistics-APAC,32297.76,0.0,SGD,MEPS+,TransAsia Freight #43,***2096,,PO-202412-Logistics-APAC-0001,False,False,REF-738335,First Continental Bank,***5521,Globex APAC Logistics Pte. Ltd.,SG,1134710.27
2024-12-30,2024-12-30,Interest Earned,Interest Income,ALL,0.0,11206.8,SGD,SWIFT MT103,First Continental Bank,***9050,,,False,False,REF-785708,First Continental Bank,***9294,Globex APAC Logistics Pte. Ltd.,SG,1145917.07
2024-12-31,2024-12-31,Supplier Payment - HyperCloud Infra #5,Supplier Payment,SaaS-GL,6280.17,0.0,SGD,FAST Debit,HyperCloud Infra #5,***3528,,PO-202412-SaaS-GL-0008,False,False,REF-679205,First Continental Bank,***3371,Globex APAC Logistics Pte. Ltd.,SG,1139636.9
2024-12-31,2024-12-31,Client Receipt - CloudBridge Co. #44,Sales Receipt,SaaS-GL,0.0,3159.58,SGD,FAST Credit,CloudBridge Co. #44,***1376,INV-202412-SaaS-GL-0006,,False,False,REF-667987,First Continental Bank,***9593,Globex APAC Logistics Pte. Ltd.,SG,1142796.48
2024-12-31,2024-12-31,Client Receipt - Pacific Trade Co. #29,Sales Receipt,Logistics-APAC,0.0,11271.37,SGD,FAST Credit,Pacific Trade Co. #29,***1833,INV-202412-Logistics-APAC-0006,,False,False,REF-480216,First Continental Bank,***4475,Globex APAC Logistics Pte. Ltd.,SG,1154067.85
2025-01-01,2025-01-01,Account Maintenance Fee,Bank/Merchant Fees,ALL,2500.0,0.0,SGD,FAST Debit,First Continental Bank,***3702,,,False,False,REF-804286,First Continental Bank,***6867,Globex APAC Logistics Pte. Ltd.,SG,1151567.85
2025-01-01,2025-01-01,Supplier Payment - HyperCloud Infra #15,Supplier Payment,SaaS-GL,6452.99,0.0,SGD,MEPS+,HyperCloud Infra #15,***8843,,PO-202501-SaaS-GL-0003,False,False,REF-288656,First Continental Bank,***2547,Globex APAC Logistics Pte. Ltd.,SG,1145114.86
2025-01-01,2025-01-01,Supplier Payment - Port Services #11,Supplier Payment,Logistics-APAC,38442.94,0.0,SGD,SWIFT MT103,Port Services #11,***1693,,PO-202501-Logistics-APAC-0004,False,False,REF-729506,First Continental Bank,***7108,Globex APAC Logistics Pte. Ltd.,SG,1106671.92
2025-01-01,2025-01-01,Client Receipt - Pacific Trade Co. #55,Sales Receipt,Logistics-APAC,0.0,747.18,SGD,SWIFT MT103,Pacific Trade Co. #55,***8702,INV-202501-Logistics-APAC-0006,,False,False,REF-880334,First Continental Bank,***7321,Globex APAC Logistics Pte. Ltd.,SG,1107419.1
2025-01-01,2025-01-01,Client Receipt - CloudBridge Co. #30,Sales Receipt,SaaS-GL,0.0,3854.98,SGD,FAST Credit,CloudBridge Co. #30,***4097,INV-202501-SaaS-GL-0003,,False,False,REF-775233,First Continental Bank,***7997,Globex APAC Logistics Pte. Ltd.,SG,1111274.08
2025-01-01,2025-01-01,Client Receipt - Pacific Trade Co. #11,Sales Receipt,Logistics-APAC,0.0,18032.27,SGD,FAST Credit,Pacific Trade Co. #11,***5807,INV-202501-Logistics-APAC-0004,,False,False,REF-516546,First Continental Bank,***7392,Globex APAC Logistics Pte. Ltd.,SG,1129306.35
2025-01-02,2025-01-02,Marketing - Aurelia Media #11,Marketing,ALL,1919.42,0.0,SGD,MEPS+,Aurelia Media #11,***4407,,,False,False,REF-395646,First Continental Bank,***8920,Globex APAC Logistics Pte. Ltd.,SG,1127386.93
2025-01-02,2025-01-02,Supplier Payment - TransAsia Freight #15,Supplier Payment,Logistics-APAC,10371.31,0.0,SGD,MEPS+,TransAsia Freight #15,***8788,,PO-202501-Logistics-APAC-0001,False,False,REF-492054,First Continental Bank,***8978,Globex APAC Logistics Pte. Ltd.,SG,1117015.62
2025-01-02,2025-01-02,Supplier Payment - TransAsia Freight #30,Supplier Payment,Logistics-APAC,34026.45,0.0,SGD,FAST Debit,TransAsia Freight #30,***9535,,PO-202501-Logistics-APAC-0006,False,False,REF-153696,First Continental Bank,***9833,Globex APAC Logistics Pte. Ltd.,SG,1082989.17
2025-01-02,2025-01-02,Client Receipt - Pacific Trade Co. #45,Sales Receipt,Logistics-APAC,0.0,12672.2,SGD,SWIFT MT103,Pacific Trade Co. #45,***8983,INV-202501-Logistics-APAC-0007,,False,False,REF-126139,First Continental Bank,***4675,Globex APAC Logistics Pte. Ltd.,SG,1095661.37
2025-01-02,2025-01-02,Client Receipt - Pacific Trade Co. #62,Sales Receipt,Logistics-APAC,0.0,23505.42,SGD,SWIFT MT103,Pacific Trade Co. #62,***7911,INV-202501-Logistics-APAC-0013,,False,False,REF-873086,First Continental Bank,***9001,Globex APAC Logistics Pte. Ltd.,SG,1119166.79
2025-01-03,2025-01-03,Supplier Payment - ExpertNet Subcontractors #14,Supplier Payment,PS-GL,2533.2,0.0,SGD,MEPS+,ExpertNet Subcontractors #14,***1326,,PO-202501-PS-GL-0003,False,False,REF-242050,First Continental Bank,***1271,Globex APAC Logistics Pte. Ltd.,SG,1116633.59
2025-01-03,2025-01-03,Supplier Payment - ExpertNet Subcontractors #8,Supplier Payment,PS-GL,5026.21,0.0,SGD,MEPS+,ExpertNet Subcontractors #8,***1802,,PO-202501-PS-GL-0004,False,False,REF-943745,First Continental Bank,***2623,Globex APAC Logistics Pte. Ltd.,SG,1111607.38
2025-01-03,2025-01-03,Client Receipt - CloudBridge Co. #9,Sales Receipt,SaaS-GL,0.0,18276.37,SGD,SWIFT MT103,CloudBridge Co. #9,***4845,INV-202501-SaaS-GL-0016,,False,False,REF-235560,First Continental Bank,***1404,Globex APAC Logistics Pte. Ltd.,SG,1129883.75
2025-01-03,2025-01-03,Client Receipt - CloudBridge Co. #70,Sales Receipt,SaaS-GL,0.0,19593.51,SGD,FAST Credit,CloudBridge Co. #70,***4119,INV-202501-SaaS-GL-0023,,False,False,REF-335319,First Continental Bank,***5623,Globex APAC Logistics Pte. Ltd.,SG,1149477.26
2025-01-04,2025-01-04,Supplier Payment - HyperCloud Infra #10,Supplier Payment,SaaS-GL,7874.27,0.0,SGD,MEPS+,HyperCloud Infra #10,***8926,,PO-202501-SaaS-GL-0004,False,False,REF-379802,First Continental Bank,***8394,Globex APAC Logistics Pte. Ltd.,SG,1141602.99
2025-01-04,2025-01-04,Client Receipt - CloudBridge Co. #39,Sales Receipt,SaaS-GL,0.0,7657.11,SGD,SWIFT MT103,CloudBridge Co. #39,***9629,INV-202501-SaaS-GL-0026,,False,False,REF-637506,First Continental Bank,***2595,Globex APAC Logistics Pte. Ltd.,SG,1149260.1
2025-01-07,2025-01-07,Supplier Payment - Port Services #10,Supplier Payment,Logistics-APAC,6741.86,0.0,SGD,FAST Debit,Port Services #10,***9483,,PO-202501-Logistics-APAC-0002,False,False,REF-817898,First Continental Bank,***8071,Globex APAC Logistics Pte. Ltd.,SG,1142518.24
2025-01-07,2025-01-07,Supplier Payment - TransAsia Freight #12,Supplier Payment,Logistics-APAC,38370.18,0.0,SGD,SWIFT MT103,TransAsia Freight #12,***2675,,PO-202501-Logistics-APAC-0008,False,False,REF-617617,First Continental Bank,***4428,Globex APAC Logistics Pte. Ltd.,SG,1104148.06
2025-01-07,2025-01-07,Client Receipt - CloudBridge Co. #9,Sales Receipt,SaaS-GL,0.0,1449.65,SGD,FAST Credit,CloudBridge Co. #9,***9387,INV-202501-SaaS-GL-0018,,False,False,REF-241247,First Continental Bank,***6397,Globex APAC Logistics Pte. Ltd.,SG,1105597.71
2025-01-07,2025-01-07,Client Receipt - CloudBridge Co. #27,Sales Receipt,SaaS-GL,0.0,5362.6,SGD,SWIFT MT103,CloudBridge Co. #27,***3213,INV-202501-SaaS-GL-0005,,False,False,REF-431405,First Continental Bank,***7686,Globex APAC Logistics Pte. Ltd.,SG,1110960.31
2025-01-07,2025-01-07,Client Receipt - Vertex Advisory Client #52,Sales Receipt,PS-GL,0.0,25168.88,SGD,SWIFT MT103,Vertex Advisory Client #52,***2748,INV-202501-PS-GL-0003,,False,False,REF-295047,First Continental Bank,***9650,Globex APAC Logistics Pte. Ltd.,SG,1136129.19
2025-01-08,2025-01-08,Supplier Payment - ExpertNet Subcontractors #17,Supplier Payment,PS-GL,1859.62,0.0,SGD,MEPS+,ExpertNet Subcontractors #17,***1406,,PO-202501-PS-GL-0001,False,False,REF-503700,First Continental Bank,***1925,Globex APAC Logistics Pte. Ltd.,SG,1134269.57
2025-01-08,2025-01-08,Client Receipt - Vertex Advisory Client #20,Sales Receipt,PS-GL,0.0,3063.74,SGD,FAST Credit,Vertex Advisory Client #20,***7804,INV-202501-PS-GL-0009,,False,False,REF-836289,First Continental Bank,***4796,Globex APAC Logistics Pte. Ltd.,SG,1137333.31
2025-01-08,2025-01-08,Client Receipt - CloudBridge Co. #59,Sales Receipt,SaaS-GL,0.0,4479.88,SGD,SWIFT MT103,CloudBridge Co. #59,***6456,INV-202501-SaaS-GL-0007,,False,False,REF-201571,First Continental Bank,***8510,Globex APAC Logistics Pte. Ltd.,SG,1141813.19
2025-01-08,2025-01-08,Client Receipt - Pacific Trade Co. #17,Sales Receipt,Logistics-APAC,0.0,7163.63,SGD,FAST Credit,Pacific Trade Co. #17,***9152,INV-202501-Logistics-APAC-0011,,False,False,REF-911407,First Continental Bank,***8245,Globex APAC Logistics Pte. Ltd.,SG,1148976.82
2025-01-08,2025-01-08,Client Receipt - Pacific Trade Co. #65,Sales Receipt,Logistics-APAC,0.0,39981.57,SGD,FAST Credit,Pacific Trade Co. #65,***3580,INV-202501-Logistics-APAC-0010,,False,False,REF-797115,First Continental Bank,***9513,Globex APAC Logistics Pte. Ltd.,SG,1188958.39
2025-01-08,2025-01-08,Client Receipt - CloudBridge Co. #35,Sales Receipt,SaaS-GL,0.0,42514.19,SGD,SWIFT MT103,CloudBridge Co. #35,***2028,INV-202501-SaaS-GL-0029,,False,False,REF-672971,First Continental Bank,***3551,Globex APAC Logistics Pte. Ltd.,SG,1231472.58
2025-01-09,2025-01-09,Northshore Power,Rent & Utilities,ALL,4042.74,0.0,SGD,MEPS+,Northshore Power,***4692,,,False,False,REF-641963,First Continental Bank,***5760,Globex APAC Logistics Pte. Ltd.,SG,1227429.84
2025-01-09,2025-01-09,Client Receipt - CloudBridge Co. #3,Sales Receipt,SaaS-GL,0.0,7660.21,SGD,FAST Credit,CloudBridge Co. #3,***3449,INV-202501-SaaS-GL-0022,,False,False,REF-119552,First Continental Bank,***7124,Globex APAC Logistics Pte. Ltd.,SG,1235090.05
2025-01-09,2025-01-09,Client Receipt - Pacific Trade Co. #8,Sales Receipt,Logistics-APAC,0.0,66523.76,SGD,FAST Credit,Pacific Trade Co. #8,***8658,INV-202501-Logistics-APAC-0001,,False,False,REF-689350,First Continental Bank,***3848,Globex APAC Logistics Pte. Ltd.,SG,1301613.81
2025-01-10,2025-01-10,Merchant Processing Fees,Bank/Merchant Fees,ALL,2379.59,0.0,SGD,FAST Debit,First Continental Bank,***9516,,,False,False,REF-462581,First Continental Bank,***8299,Globex APAC Logistics Pte. Ltd.,SG,1299234.22
2025-01-10,2025-01-10,Supplier Payment - CodeCraft Contractors #3,Supplier Payment,SaaS-GL,2711.11,0.0,SGD,MEPS+,CodeCraft Contractors #3,***5598,,PO-202501-SaaS-GL-0005,False,False,REF-113516,First Continental Bank,***9262,Globex APAC Logistics Pte. Ltd.,SG,1296523.11
2025-01-10,2025-01-10,Client Receipt - CloudBridge Co. #56,Sales Receipt,SaaS-GL,0.0,6359.31,SGD,FAST Credit,CloudBridge Co. #56,***7251,INV-202501-SaaS-GL-0017,,False,False,REF-764443,First Continental Bank,***1388,Globex APAC Logistics Pte. Ltd.,SG,1302882.42
2025-01-10,2025-01-10,Client Receipt - Vertex Advisory Client #25,Sales Receipt,PS-GL,0.0,10451.19,SGD,FAST Credit,Vertex Advisory Client #25,***6862,INV-202501-PS-GL-0001,,False,False,REF-430281,First Continental Bank,***3898,Globex APAC Logistics Pte. Ltd.,SG,1313333.61
2025-01-11,2025-01-11,Supplier Payment - ExpertNet Subcontractors #16,Supplier Payment,PS-GL,8975.59,0.0,SGD,MEPS+,ExpertNet Subcontractors #16,***2751,,PO-202501-PS-GL-0007,False,False,REF-265363,First Continental Bank,***3149,Globex APAC Logistics Pte. Ltd.,SG,1304358.02
2025-01-12,2025-01-12,Intercompany Settlement - Globex EMEA Manufacturing Ltd.,Intercompany Transfer,ALL,185904.0,0.0,SGD,Internal Transfer,Globex EMEA Manufacturing Ltd.,***5140,,,True,True,REF-568650,First Continental Bank,***5530,Globex APAC Logistics Pte. Ltd.,SG,1118454.02
2025-01-12,2025-01-12,Client Receipt - Pacific Trade Co. #5,Sales Receipt,Logistics-APAC,0.0,12088.82,SGD,FAST Credit,Pacific Trade Co. #5,***2736,INV-202501-Logistics-APAC-0009,,False,False,REF-932444,First Continental Bank,***8812,Globex APAC Logistics Pte. Ltd.,SG,1130542.84
2025-01-12,2025-01-12,Client Receipt - Vertex Advisory Client #16,Sales Receipt,PS-GL,0.0,43197.18,SGD,SWIFT MT103,Vertex Advisory Client #16,***8235,INV-202501-PS-GL-0002,,False,False,REF-754527,First Continental Bank,***3413,Globex APAC Logistics Pte. Ltd.,SG,1173740.02
2025-01-13,2025-01-13,Supplier Payment - HyperCloud Infra #6,Supplier Payment,SaaS-GL,4010.78,0.0,SGD,MEPS+,HyperCloud Infra #6,***6714,,PO-202501-SaaS-GL-0006,False,False,REF-578996,First Continental Bank,***6474,Globex APAC Logistics Pte. Ltd.,SG,1169729.24
2025-01-13,2025-01-13,Supplier Payment - HyperCloud Infra #10,Supplier Payment,SaaS-GL,7080.31,0.0,SGD,MEPS+,HyperCloud Infra #10,***3765,,PO-202501-SaaS-GL-0001,False,False,REF-131539,First Continental Bank,***2375,Globex APAC Logistics Pte. Ltd.,SG,1162648.93
2025-01-13,2025-01-13,Supplier Payment - ExpertNet Subcontractors #14,Supplier Payment,PS-GL,28556.27,0.0,SGD,MEPS+,ExpertNet Subcontractors #14,***3067,,PO-202501-PS-GL-0006,False,False,REF-836833,First Continental Bank,***8121,Globex APAC Logistics Pte. Ltd.,SG,1134092.66
2025-01-13,2025-01-13,Client Receipt - CloudBridge Co. #28,Sales Receipt,SaaS-GL,0.0,8426.63,SGD,SWIFT MT103,CloudBridge Co. #28,***3150,INV-202501-SaaS-GL-0006,,False,False,REF-261984,First Continental Bank,***8002,Globex APAC Logistics Pte. Ltd.,SG,1142519.29
2025-01-14,2025-01-14,Client Receipt - Pacific Trade Co. #57,Sales Receipt,Logistics-APAC,0.0,47788.81,SGD,SWIFT MT103,Pacific Trade Co. #57,***8214,INV-202501-Logistics-APAC-0003,,False,False,REF-165093,First Continental Bank,***4847,Globex APAC Logistics Pte. Ltd.,SG,1190308.1
2025-01-15,2025-01-15,Marketing - Beacon Digital #3,Marketing,ALL,1216.75,0.0,SGD,MEPS+,Beacon Digital #3,***8167,,,False,False,REF-923868,First Continental Bank,***5974,Globex APAC Logistics Pte. Ltd.,SG,1189091.35
2025-01-15,2025-01-15,Client Receipt - CloudBridge Co. #73,Sales Receipt,SaaS-GL,0.0,4131.95,SGD,FAST Credit,CloudBridge Co. #73,***8039,INV-202501-SaaS-GL-0021,,False,False,REF-892769,First Continental Bank,***8595,Globex APAC Logistics Pte. Ltd.,SG,1193223.3
2025-01-15,2025-01-15,Client Receipt - CloudBridge Co. #60,Sales Receipt,SaaS-GL,0.0,7584.63,SGD,SWIFT MT103,CloudBridge Co. #60,***7702,INV-202501-SaaS-GL-0011,,False,False,REF-529543,First Continental Bank,***9413,Globex APAC Logistics Pte. Ltd.,SG,1200807.93
2025-01-15,2025-01-15,Client Receipt - CloudBridge Co. #59,Sales Receipt,SaaS-GL,0.0,7636.71,SGD,SWIFT MT103,CloudBridge Co. #59,***8773,INV-202501-SaaS-GL-0014,,False,False,REF-818298,First Continental Bank,***7386,Globex APAC Logistics Pte. Ltd.,SG,1208444.64
2025-01-15,2025-01-15,Client Receipt - Vertex Advisory Client #51,Sales Receipt,PS-GL,0.0,12843.46,SGD,SWIFT MT103,Vertex Advisory Client #51,***3743,INV-202501-PS-GL-0004,,False,False,REF-904114,First Continental Bank,***7153,Globex APAC Logistics Pte. Ltd.,SG,1221288.1
2025-01-15,2025-01-15,Client Receipt - CloudBridge Co. #48,Sales Receipt,SaaS-GL,0.0,22634.9,SGD,FAST Credit,CloudBridge Co. #48,***5410,INV-202501-SaaS-GL-0013,,False,False,REF-515813,First Continental Bank,***9434,Globex APAC Logistics Pte. Ltd.,SG,1243923.0
2025-01-16,2025-01-16,Supplier Payment - HyperCloud Infra #2,Supplier Payment,SaaS-GL,2352.85,0.0,SGD,FAST Debit,HyperCloud Infra #2,***1232,,PO-202501-SaaS-GL-0009,False,False,REF-558800,First Continental Bank,***5521,Globex APAC Logistics Pte. Ltd.,SG,1241570.15
2025-01-16,2025-01-16,Marketing - Aurelia Media #1,Marketing,ALL,18134.89,0.0,SGD,MEPS+,Aurelia Media #1,***5934,,,False,False,REF-498848,First Continental Bank,***3439,Globex APAC Logistics Pte. Ltd.,SG,1223435.26
2025-01-16,2025-01-16,Supplier Payment - CodeCraft Contractors #1,Supplier Payment,SaaS-GL,25399.42,0.0,SGD,FAST Debit,CodeCraft Contractors #1,***3040,,PO-202501-SaaS-GL-0008,False,False,REF-514787,First Continental Bank,***5206,Globex APAC Logistics Pte. Ltd.,SG,1198035.84
2025-01-17,2025-01-17,Supplier Payment - ExpertNet Subcontractors #5,Supplier Payment,PS-GL,2233.86,0.0,SGD,FAST Debit,ExpertNet Subcontractors #5,***2468,,PO-202501-PS-GL-0008,False,False,REF-705300,First Continental Bank,***3779,Globex APAC Logistics Pte. Ltd.,SG,1195801.98
2025-01-17,2025-01-17,Client Receipt - Pacific Trade Co. #43,Sales Receipt,Logistics-APAC,0.0,26346.22,SGD,SWIFT MT103,Pacific Trade Co. #43,***3698,INV-202501-Logistics-APAC-0005,,False,False,REF-573304,First Continental Bank,***8066,Globex APAC Logistics Pte. Ltd.,SG,1222148.2
2025-01-18,2025-01-18,VAT/GST Remittance - IRAS Singapore,Tax Payment,ALL,49898.3,0.0,SGD,SWIFT MT103,IRAS Singapore,***9750,,,False,False,REF-428363,First Continental Bank,***8044,Globex APAC Logistics Pte. Ltd.,SG,1172249.9
2025-01-18,2025-01-18,Client Receipt - Pacific Trade Co. #47,Sales Receipt,Logistics-APAC,0.0,60723.79,SGD,FAST Credit,Pacific Trade Co. #47,***1528,INV-202501-Logistics-APAC-0002,,False,False,REF-963971,First Continental Bank,***8607,Globex APAC Logistics Pte. Ltd.,SG,1232973.69
2025-01-20,2025-01-20,Supplier Payment - HyperCloud Infra #1,Supplier Payment,SaaS-GL,2494.34,0.0,SGD,SWIFT MT103,HyperCloud Infra #1,***3696,,PO-202501-SaaS-GL-0002,False,False,REF-478000,First Continental Bank,***6618,Globex APAC Logistics Pte. Ltd.,SG,1230479.35
2025-01-20,2025-01-20,Supplier Payment - TransAsia Freight #29,Supplier Payment,Logistics-APAC,15537.24,0.0,SGD,FAST Debit,TransAsia Freight #29,***7853,,PO-202501-Logistics-APAC-0009,False,False,REF-768638,First Continental Bank,***3589,Globex APAC Logistics Pte. Ltd.,SG,1214942.11
2025-01-20,2025-01-20,Supplier Payment - TransAsia Freight #3,Supplier Payment,Logistics-APAC,30825.22,0.0,SGD,FAST Debit,TransAsia Freight #3,***7028,,PO-202501-Logistics-APAC-0007,False,False,REF-953480,First Continental Bank,***1348,Globex APAC Logistics Pte. Ltd.,SG,1184116.89
2025-01-20,2025-01-20,Client Receipt - CloudBridge Co. #47,Sales Receipt,SaaS-GL,0.0,13185.45,SGD,FAST Credit,CloudBridge Co. #47,***5816,INV-202501-SaaS-GL-0012,,False,False,REF-517691,First Continental Bank,***5062,Globex APAC Logistics Pte. Ltd.,SG,1197302.34
2025-01-20,2025-01-20,Client Receipt - CloudBridge Co. #53,Sales Receipt,SaaS-GL,0.0,16843.06,SGD,FAST Credit,CloudBridge Co. #53,***9446,INV-202501-SaaS-GL-0027,,False,False,REF-920649,First Continental Bank,***8338,Globex APAC Logistics Pte. Ltd.,SG,1214145.4
2025-01-21,2025-01-21,Supplier Payment - ExpertNet Subcontractors #2,Supplier Payment,PS-GL,2202.53,0.0,SGD,MEPS+,ExpertNet Subcontractors #2,***3631,,PO-202501-PS-GL-0005,False,False,REF-980363,First Continental Bank,***3520,Globex APAC Logistics Pte. Ltd.,SG,1211942.87
2025-01-21,2025-01-21,Supplier Payment - TransAsia Freight #3,Supplier Payment,Logistics-APAC,4530.39,0.0,SGD,SWIFT MT103,TransAsia Freight #3,***3530,,PO-202501-Logistics-APAC-0010,False,False,REF-100622,First Continental Bank,***4066,Globex APAC Logistics Pte. Ltd.,SG,1207412.48
2025-01-21,2025-01-21,Client Receipt - CloudBridge Co. #23,Sales Receipt,SaaS-GL,0.0,908.06,SGD,SWIFT MT103,CloudBridge Co. #23,***7538,INV-202501-SaaS-GL-0028,,False,False,REF-720701,First Continental Bank,***8236,Globex APAC Logistics Pte. Ltd.,SG,1208320.54
2025-01-21,2025-01-21,Client Receipt - CloudBridge Co. #17,Sales Receipt,SaaS-GL,0.0,1050.37,SGD,SWIFT MT103,CloudBridge Co. #17,***3340,INV-202501-SaaS-GL-0004,,False,False,REF-199640,First Continental Bank,***2299,Globex APAC Logistics Pte. Ltd.,SG,1209370.91
2025-01-21,2025-01-21,Client Receipt - CloudBridge Co. #27,Sales Receipt,SaaS-GL,0.0,17028.65,SGD,FAST Credit,CloudBridge Co. #27,***6952,INV-202501-SaaS-GL-0010,,False,False,REF-599178,First Continental Bank,***3384,Globex APAC Logistics Pte. Ltd.,SG,1226399.56
2025-01-21,2025-01-21,Client Receipt - CloudBridge Co. #13,Sales Receipt,SaaS-GL,0.0,18930.38,SGD,FAST Credit,CloudBridge Co. #13,***9744,INV-202501-SaaS-GL-0024,,False,False,REF-761488,First Continental Bank,***9482,Globex APAC Logistics Pte. Ltd.,SG,1245329.94
2025-01-22,2025-01-22,Client Receipt - CloudBridge Co. #4,Sales Receipt,SaaS-GL,0.0,2950.37,SGD,FAST Credit,CloudBridge Co. #4,***1595,INV-202501-SaaS-GL-0001,,False,False,REF-332421,First Continental Bank,***9103,Globex APAC Logistics Pte. Ltd.,SG,1248280.31
2025-01-22,2025-01-22,Client Receipt - CloudBridge Co. #72,Sales Receipt,SaaS-GL,0.0,3987.96,SGD,SWIFT MT103,CloudBridge Co. #72,***3710,INV-202501-SaaS-GL-0015,,False,False,REF-262758,First Continental Bank,***1460,Globex APAC Logistics Pte. Ltd.,SG,1252268.27
2025-01-22,2025-01-22,Client Receipt - CloudBridge Co. #2,Sales Receipt,SaaS-GL,0.0,10643.23,SGD,FAST Credit,CloudBridge Co. #2,***7226,INV-202501-SaaS-GL-0020,,False,False,REF-880867,First Continental Bank,***6739,Globex APAC Logistics Pte. Ltd.,SG,1262911.5
2025-01-23,2025-01-23,Supplier Payment - ExpertNet Subcontractors #11,Supplier Payment,PS-GL,3367.62,0.0,SGD,SWIFT MT103,ExpertNet Subcontractors #11,***2121,,PO-202501-PS-GL-0009,False,False,REF-702260,First Continental Bank,***6661,Globex APAC Logistics Pte. Ltd.,SG,1259543.88
2025-01-24,2025-01-24,Supplier Payment - CodeCraft Contractors #10,Supplier Payment,SaaS-GL,9233.69,0.0,SGD,SWIFT MT103,CodeCraft Contractors #10,***8165,,PO-202501-SaaS-GL-0007,False,False,REF-488264,First Continental Bank,***2188,Globex APAC Logistics Pte. Ltd.,SG,1250310.19
2025-01-25,2025-01-25,Client Receipt - CloudBridge Co. #13,Sales Receipt,SaaS-GL,0.0,18038.4,SGD,SWIFT MT103,CloudBridge Co. #13,***9256,INV-202501-SaaS-GL-0025,,False,False,REF-208411,First Continental Bank,***2809,Globex APAC Logistics Pte. Ltd.,SG,1268348.59
2025-01-26,2025-01-26,"Intercompany Settlement - Globex International Holdings, Inc.",Intercompany Transfer,ALL,720912.0,0.0,SGD,Internal Transfer,"Globex International Holdings, Inc.",***8807,,,True,True,REF-908501,First Continental Bank,***1138,Globex APAC Logistics Pte. Ltd.,SG,547436.59
2025-01-27,2025-01-27,Supplier Payment - ExpertNet Subcontractors #3,Supplier Payment,PS-GL,6708.51,0.0,SGD,MEPS+,ExpertNet Subcontractors #3,***8034,,PO-202501-PS-GL-0002,False,False,REF-655955,First Continental Bank,***2199,Globex APAC Logistics Pte. Ltd.,SG,540728.08
2025-01-27,2025-01-27,Supplier Payment - Port Services #3,Supplier Payment,Logistics-APAC,6973.38,0.0,SGD,MEPS+,Port Services #3,***7444,,PO-202501-Logistics-APAC-0005,False,False,REF-529497,First Continental Bank,***2399,Globex APAC Logistics Pte. Ltd.,SG,533754.7
2025-01-27,2025-01-27,Payroll - GlobalPay Services Ltd,Payroll,ALL,137624.43,0.0,SGD,FAST Debit,GlobalPay Services Ltd,***9622,,,False,False,REF-345531,First Continental Bank,***3163,Globex APAC Logistics Pte. Ltd.,SG,396130.27
2025-01-27,2025-01-27,Client Receipt - CloudBridge Co. #17,Sales Receipt,SaaS-GL,0.0,5469.95,SGD,SWIFT MT103,CloudBridge Co. #17,***5579,INV-202501-SaaS-GL-0019,,False,False,REF-632657,First Continental Bank,***6566,Globex APAC Logistics Pte. Ltd.,SG,401600.22
2025-01-27,2025-01-27,Client Receipt - CloudBridge Co. #7,Sales Receipt,SaaS-GL,0.0,8363.82,SGD,FAST Credit,CloudBridge Co. #7,***2300,INV-202501-SaaS-GL-0002,,False,False,REF-836572,First Continental Bank,***9160,Globex APAC Logistics Pte. Ltd.,SG,409964.04
2025-01-28,2025-01-28,Northshore Power,Rent & Utilities,ALL,2791.84,0.0,SGD,MEPS+,Northshore Power,***4954,,,False,False,REF-975413,First Continental Bank,***4525,Globex APAC Logistics Pte. Ltd.,SG,407172.2
2025-01-28,2025-01-28,Corporate Tax Estimate,Tax Payment,ALL,36975.75,0.0,SGD,SWIFT MT103,IRAS Singapore,***2555,,,False,False,REF-819040,First Continental Bank,***9602,Globex APAC Logistics Pte. Ltd.,SG,370196.45
2025-01-28,2025-01-28,Client Receipt - CloudBridge Co. #48,Sales Receipt,SaaS-GL,0.0,558.63,SGD,FAST Credit,CloudBridge Co. #48,***8137,INV-202501-SaaS-GL-0009,,False,False,REF-414747,First Continental Bank,***7669,Globex APAC Logistics Pte. Ltd.,SG,370755.08
2025-01-28,2025-01-28,Client Receipt - Vertex Advisory Client #34,Sales Receipt,PS-GL,0.0,67636.4,SGD,FAST Credit,Vertex Advisory Client #34,***2338,INV-202501-PS-GL-0006,,False,False,REF-652294,First Continental Bank,***7243,Globex APAC Logistics Pte. Ltd.,SG,438391.48
2025-01-29,2025-01-29,Client Receipt - Pacific Trade Co. #9,Sales Receipt,Logistics-APAC,0.0,5868.21,SGD,FAST Credit,Pacific Trade Co. #9,***6358,INV-202501-Logistics-APAC-0008,,False,False,REF-655219,First Continental Bank,***6485,Globex APAC Logistics Pte. Ltd.,SG,444259.69
2025-01-29,2025-01-29,Client Receipt - Vertex Advisory Client #18,Sales Receipt,PS-GL,0.0,6693.46,SGD,FAST Credit,Vertex Advisory Client #18,***4541,INV-202501-PS-GL-0007,,False,False,REF-863365,First Continental Bank,***8954,Globex APAC Logistics Pte. Ltd.,SG,450953.15
2025-01-29,2025-01-29,Client Receipt - Vertex Advisory Client #19,Sales Receipt,PS-GL,0.0,8761.91,SGD,FAST Credit,Vertex Advisory Client #19,***9425,INV-202501-PS-GL-0010,,False,False,REF-600870,First Continental Bank,***3904,Globex APAC Logistics Pte. Ltd.,SG,459715.06
2025-01-29,2025-01-29,Client Receipt - Pacific Trade Co. #1,Sales Receipt,Logistics-APAC,0.0,20021.53,SGD,FAST Credit,Pacific Trade Co. #1,***6935,INV-202501-Logistics-APAC-0012,,False,False,REF-689599,First Continental Bank,***5432,Globex APAC Logistics Pte. Ltd.,SG,479736.59
2025-01-30,2025-01-30,Interest Earned,Interest Income,ALL,0.0,8274.17,SGD,SWIFT MT103,First Continental Bank,***3218,,,False,False,REF-158268,First Continental Bank,***3899,Globex APAC Logistics Pte. Ltd.,SG,488010.76
2025-01-30,2025-01-30,Client Receipt - Vertex Advisory Client #19,Sales Receipt,PS-GL,0.0,11723.58,SGD,FAST Credit,Vertex Advisory Client #19,***6092,INV-202501-PS-GL-0008,,False,False,REF-681293,First Continental Bank,***1043,Globex APAC Logistics Pte. Ltd.,SG,499734.34
2025-01-30,2025-01-30,Client Receipt - Vertex Advisory Client #17,Sales Receipt,PS-GL,0.0,15338.25,SGD,SWIFT MT103,Vertex Advisory Client #17,***2989,INV-202501-PS-GL-0005,,False,False,REF-786745,First Continental Bank,***8115,Globex APAC Logistics Pte. Ltd.,SG,515072.59
2025-01-31,2025-01-31,Merchant Processing Fees,Bank/Merchant Fees,ALL,179.29,0.0,SGD,FAST Debit,First Continental Bank,***8902,,,False,False,REF-789947,First Continental Bank,***2188,Globex APAC Logistics Pte. Ltd.,SG,514893.3
2025-01-31,2025-01-31,Supplier Payment - TransAsia Freight #30,Supplier Payment,Logistics-APAC,53205.42,0.0,SGD,SWIFT MT103,TransAsia Freight #30,***9581,,PO-202501-Logistics-APAC-0003,False,False,REF-878255,First Continental Bank,***1684,Globex APAC Logistics Pte. Ltd.,SG,461687.88
2025-01-31,2025-01-31,Client Receipt - CloudBridge Co. #32,Sales Receipt,SaaS-GL,0.0,21736.11,SGD,FAST Credit,CloudBridge Co. #32,***4254,INV-202501-SaaS-GL-0008,,False,False,REF-971907,First Continental Bank,***9711,Globex APAC Logistics Pte. Ltd.,SG,483423.99
2025-02-01,2025-02-01,Account Maintenance Fee,Bank/Merchant Fees,ALL,2500.0,0.0,SGD,SWIFT MT103,First Continental Bank,***7775,,,False,False,REF-236765,First Continental Bank,***1940,Globex APAC Logistics Pte. Ltd.,SG,480923.99
2025-02-01,2025-02-01,Client Receipt - Vertex Advisory Client #34,Sales Receipt,PS-GL,0.0,32927.71,SGD,SWIFT MT103,Vertex Advisory Client #34,***7717,INV-202502-PS-GL-0006,,False,False,REF-268102,First Continental Bank,***1996,Globex APAC Logistics Pte. Ltd.,SG,513851.7
2025-02-03,2025-02-03,Marketing - Beacon Digital #1,Marketing,ALL,12669.22,0.0,SGD,SWIFT MT103,Beacon Digital #1,***3199,,,False,False,REF-709383,First Continental Bank,***4003,Globex APAC Logistics Pte. Ltd.,SG,501182.48
2025-02-03,2025-02-03,Client Receipt - CloudBridge Co. #9,Sales Receipt,SaaS-GL,0.0,26906.82,SGD,SWIFT MT103,CloudBridge Co. #9,***4180,INV-202502-SaaS-GL-0009,,False,False,REF-812371,First Continental Bank,***8152,Globex APAC Logistics Pte. Ltd.,SG,528089.3
2025-02-03,2025-02-03,Client Receipt - Vertex Advisory Client #40,Sales Receipt,PS-GL,0.0,51153.64,SGD,SWIFT MT103,Vertex Advisory Client #40,***1375,INV-202502-PS-GL-0003,,False,False,REF-426734,First Continental Bank,***9680,Globex APAC Logistics Pte. Ltd.,SG,579242.94
2025-02-03,2025-02-03,Client Receipt - Pacific Trade Co. #44,Sales Receipt,Logistics-APAC,0.0,52899.11,SGD,FAST Credit,Pacific Trade Co. #44,***8537,INV-202502-Logistics-APAC-0005,,False,False,REF-192896,First Continental Bank,***9126,Globex APAC Logistics Pte. Ltd.,SG,632142.05
2025-02-04,2025-02-04,Supplier Payment - ExpertNet Subcontractors #3,Supplier Payment,PS-GL,12693.49,0.0,SGD,SWIFT MT103,ExpertNet Subcontractors #3,***3576,,PO-202502-PS-GL-0006,False,False,REF-446491,First Continental Bank,***9429,Globex APAC Logistics Pte. Ltd.,SG,619448.56
2025-02-04,2025-02-04,Supplier Payment - HyperCloud Infra #3,Supplier Payment,SaaS-GL,13215.58,0.0,SGD,MEPS+,HyperCloud Infra #3,***7761,,PO-202502-SaaS-GL-0005,False,False,REF-922433,First Continental Bank,***8001,Globex APAC Logistics Pte. Ltd.,SG,606232.98
2025-02-05,2025-02-05,Supplier Payment - CodeCraft Contractors #11,Supplier Payment,SaaS-GL,2980.0,0.0,SGD,FAST Debit,CodeCraft Contractors #11,***2779,,PO-202502-SaaS-GL-0008,False,False,REF-289569,First Continental Bank,***2872,Globex APAC Logistics Pte. Ltd.,SG,603252.98
2025-02-05,2025-02-05,Supplier Payment - TransAsia Freight #32,Supplier Payment,Logistics-APAC,8179.12,0.0,SGD,FAST Debit,TransAsia Freight #32,***1253,,PO-202502-Logistics-APAC-0004,False,False,REF-645244,First Continental Bank,***4910,Globex APAC Logistics Pte. Ltd.,SG,595073.86
2025-02-05,2025-02-05,Supplier Payment - ExpertNet Subcontractors #14,Supplier Payment,PS-GL,9793.37,0.0,SGD,SWIFT MT103,ExpertNet Subcontractors #14,***2843,,PO-202502-PS-GL-0004,False,False,REF-909721,First Continental Bank,***7972,Globex APAC Logistics Pte. Ltd.,SG,585280.49
2025-02-05,2025-02-05,Supplier Payment - TransAsia Freight #14,Supplier Payment,Logistics-APAC,30894.11,0.0,SGD,FAST Debit,TransAsia Freight #14,***7297,,PO-202502-Logistics-APAC-0007,False,False,REF-656069,First Continental Bank,***4904,Globex APAC Logistics Pte. Ltd.,SG,554386.38
2025-02-05,2025-02-05,Client Receipt - Vertex Advisory Client #45,Sales Receipt,PS-GL,0.0,16251.09,SGD,SWIFT MT103,Vertex Advisory Client #45,***7423,INV-202502-PS-GL-0010,,False,False,REF-241251,First Continental Bank,***9539,Globex APAC Logistics Pte. Ltd.,SG,570637.47
2025-02-05,2025-02-05,Client Receipt - Vertex Advisory Client #55,Sales Receipt,PS-GL,0.0,16556.7,SGD,FAST Credit,Vertex Advisory Client #55,***6871,INV-202502-PS-GL-0009,,False,False,REF-107148,First Continental Bank,***8575,Globex APAC Logistics Pte. Ltd.,SG,587194.17
2025-02-05,2025-02-05,Client Receipt - Vertex Advisory Client #49,Sales Receipt,PS-GL,0.0,20252.54,SGD,SWIFT MT103,Vertex Advisory Client #49,***5011,INV-202502-PS-GL-0008,,False,False,REF-321084,First Continental Bank,***6271,Globex APAC Logistics Pte. Ltd.,SG,607446.71
2025-02-06,2025-02-06,Supplier Payment - ExpertNet Subcontractors #10,Supplier Payment,PS-GL,1462.23,0.0,SGD,FAST Debit,ExpertNet Subcontractors #10,***9614,,PO-202502-PS-GL-0002,False,False,REF-913800,First Continental Bank,***7981,Globex APAC Logistics Pte. Ltd.,SG,605984.48
2025-02-06,2025-02-06,Supplier Payment - HyperCloud Infra #17,Supplier Payment,SaaS-GL,7358.14,0.0,SGD,SWIFT MT103,HyperCloud Infra #17,***4310,,PO-202502-SaaS-GL-0003,False,False,REF-365011,First Continental Bank,***8108,Globex APAC Logistics Pte. Ltd.,SG,598626.34
2025-02-06,2025-02-06,Supplier Payment - Port Services #11,Supplier Payment,Logistics-APAC,15723.57,0.0,SGD,MEPS+,Port Services #11,***5737,,PO-202502-Logistics-APAC-0003,False,False,REF-500287,First Continental Bank,***8832,Globex APAC Logistics Pte. Ltd.,SG,582902.77
2025-02-06,2025-02-06,Client Receipt - CloudBridge Co. #5,Sales Receipt,SaaS-GL,0.0,1652.95,SGD,FAST Credit,CloudBridge Co. #5,***7574,INV-202502-SaaS-GL-0024,,False,False,REF-973958,First Continental Bank,***3583,Globex APAC Logistics Pte. Ltd.,SG,584555.72
2025-02-06,2025-02-06,Client Receipt - Pacific Trade Co. #53,Sales Receipt,Logistics-APAC,0.0,65911.61,SGD,SWIFT MT103,Pacific Trade Co. #53,***5425,INV-202502-Logistics-APAC-0003,,False,False,REF-599042,First Continental Bank,***2115,Globex APAC Logistics Pte. Ltd.,SG,650467.33
2025-02-07,2025-02-07,Supplier Payment - TransAsia Freight #3,Supplier Payment,Logistics-APAC,4854.95,0.0,SGD,FAST Debit,TransAsia Freight #3,***8475,,PO-202502-Logistics-APAC-0005,False,False,REF-708310,First Continental Bank,***6969,Globex APAC Logistics Pte. Ltd.,SG,645612.38
2025-02-07,2025-02-07,Supplier Payment - Port Services #19,Supplier Payment,Logistics-APAC,169037.22,0.0,SGD,SWIFT MT103,Port Services #19,***6928,,PO-202502-Logistics-APAC-0006,False,False,REF-343233,First Continental Bank,***7560,Globex APAC Logistics Pte. Ltd.,SG,476575.16
2025-02-08,2025-02-08,Skyline Internet Services,Rent & Utilities,ALL,6494.31,0.0,SGD,FAST Debit,Skyline Internet Services,***3898,,,False,False,REF-886513,First Continental Bank,***9926,Globex APAC Logistics Pte. Ltd.,SG,470080.85
2025-02-10,2025-02-10,Merchant Processing Fees,Bank/Merchant Fees,ALL,1083.18,0.0,SGD,SWIFT MT103,First Continental Bank,***2869,,,False,False,REF-132450,First Continental Bank,***1679,Globex APAC Logistics Pte. Ltd.,SG,468997.67
2025-02-10,2025-02-10,Client Receipt - Vertex Advisory Client #41,Sales Receipt,PS-GL,0.0,3980.02,SGD,SWIFT MT103,Vertex Advisory Client #41,***7995,INV-202502-PS-GL-0004,,False,False,REF-538202,First Continental Bank,***6696,Globex APAC Logistics Pte. Ltd.,SG,472977.69
2025-02-10,2025-02-10,Client Receipt - CloudBridge Co. #41,Sales Receipt,SaaS-GL,0.0,9614.8,SGD,SWIFT MT103,CloudBridge Co. #41,***4819,INV-202502-SaaS-GL-0005,,False,False,REF-263631,First Continental Bank,***7474,Globex APAC Logistics Pte. Ltd.,SG,482592.49
2025-02-10,2025-02-10,Client Receipt - CloudBridge Co. #18,Sales Receipt,SaaS-GL,0.0,12038.63,SGD,FAST Credit,CloudBridge Co. #18,***8370,INV-202502-SaaS-GL-0012,,False,False,REF-350180,First Continental Bank,***8203,Globex APAC Logistics Pte. Ltd.,SG,494631.12
2025-02-10,2025-02-10,Client Receipt - CloudBridge Co. #17,Sales Receipt,SaaS-GL,0.0,35566.76,SGD,FAST Credit,CloudBridge Co. #17,***9987,INV-202502-SaaS-GL-0022,,False,False,REF-521585,First Continental Bank,***4425,Globex APAC Logistics Pte. Ltd.,SG,530197.88
2025-02-10,2025-02-10,Client Receipt - Pacific Trade Co. #32,Sales Receipt,Logistics-APAC,0.0,50619.04,SGD,FAST Credit,Pacific Trade Co. #32,***6175,INV-202502-Logistics-APAC-0008,,False,False,REF-657930,First Continental Bank,***5524,Globex APAC Logistics Pte. Ltd.,SG,580816.92
2025-02-11,2025-02-11,Merchant Processing Fees,Bank/Merchant Fees,ALL,2004.02,0.0,SGD,SWIFT MT103,First Continental Bank,***3461,,,False,False,REF-538092,First Continental Bank,***1809,Globex APAC Logistics Pte. Ltd.,SG,578812.9
2025-02-11,2025-02-11,Client Receipt - CloudBridge Co. #79,Sales Receipt,SaaS-GL,0.0,2057.95,SGD,FAST Credit,CloudBridge Co. #79,***4939,INV-202502-SaaS-GL-0011,,False,False,REF-823989,First Continental Bank,***5882,Globex APAC Logistics Pte. Ltd.,SG,580870.85
2025-02-11,2025-02-11,Client Receipt - CloudBridge Co. #24,Sales Receipt,SaaS-GL,0.0,5926.7,SGD,FAST Credit,CloudBridge Co. #24,***5610,INV-202502-SaaS-GL-0014,,False,False,REF-704482,First Continental Bank,***1000,Globex APAC Logistics Pte. Ltd.,SG,586797.55
2025-02-11,2025-02-11,Client Receipt - CloudBridge Co. #29,Sales Receipt,SaaS-GL,0.0,9411.04,SGD,FAST Credit,CloudBridge Co. #29,***4778,INV-202502-SaaS-GL-0004,,False,False,REF-103362,First Continental Bank,***6458,Globex APAC Logistics Pte. Ltd.,SG,596208.59
2025-02-11,2025-02-11,Client Receipt - Pacific Trade Co. #36,Sales Receipt,Logistics-APAC,0.0,16464.77,SGD,FAST Credit,Pacific Trade Co. #36,***8616,INV-202502-Logistics-APAC-0012,,False,False,REF-212286,First Continental Bank,***8561,Globex APAC Logistics Pte. Ltd.,SG,612673.36
2025-02-11,2025-02-11,Client Receipt - CloudBridge Co. #61,Sales Receipt,SaaS-GL,0.0,32508.97,SGD,SWIFT MT103,CloudBridge Co. #61,***3914,INV-202502-SaaS-GL-0019,,False,False,REF-193026,First Continental Bank,***7376,Globex APAC Logistics Pte. Ltd.,SG,645182.33
2025-02-12,2025-02-12,Supplier Payment - TransAsia Freight #38,Supplier Payment,Logistics-APAC,15182.83,0.0,SGD,MEPS+,TransAsia Freight #38,***9665,,PO-202502-Logistics-APAC-0001,False,False,REF-608423,First Continental Bank,***5555,Globex APAC Logistics Pte. Ltd.,SG,629999.5
2025-02-12,2025-02-12,Supplier Payment - ExpertNet Subcontractors #19,Supplier Payment,PS-GL,17042.82,0.0,SGD,MEPS+,ExpertNet Subcontractors #19,***7268,,PO-202502-PS-GL-0008,False,False,REF-468602,First Continental Bank,***2901,Globex APAC Logistics Pte. Ltd.,SG,612956.68
2025-02-12,2025-02-12,Intercompany Settlement - Globex EMEA Manufacturing Ltd.,Intercompany Transfer,ALL,474059.0,0.0,SGD,Internal Transfer,Globex EMEA Manufacturing Ltd.,***4594,,,True,True,REF-252046,First Continental Bank,***2967,Globex APAC Logistics Pte. Ltd.,SG,138897.68
2025-02-12,2025-02-12,Client Receipt - Vertex Advisory Client #42,Sales Receipt,PS-GL,0.0,13026.3,SGD,FAST Credit,Vertex Advisory Client #42,***1728,INV-202502-PS-GL-0011,,False,False,REF-280327,First Continental Bank,***2955,Globex APAC Logistics Pte. Ltd.,SG,151923.98
2025-02-12,2025-02-12,Client Receipt - Pacific Trade Co. #23,Sales Receipt,Logistics-APAC,0.0,15400.93,SGD,FAST Credit,Pacific Trade Co. #23,***3613,INV-202502-Logistics-APAC-0010,,False,False,REF-381835,First Continental Bank,***8299,Globex APAC Logistics Pte. Ltd.,SG,167324.91
2025-02-13,2025-02-13,Skyline Internet Services,Rent & Utilities,ALL,1793.47,0.0,SGD,FAST Debit,Skyline Internet Services,***1372,,,False,False,REF-106527,First Continental Bank,***9800,Globex APAC Logistics Pte. Ltd.,SG,165531.44
2025-02-13,2025-02-13,Supplier Payment - ExpertNet Subcontractors #9,Supplier Payment,PS-GL,3006.17,0.0,SGD,SWIFT MT103,ExpertNet Subcontractors #9,***4429,,PO-202502-PS-GL-0001,False,False,REF-831042,First Continental Bank,***1475,Globex APAC Logistics Pte. Ltd.,SG,162525.27
2025-02-13,2025-02-13,Client Receipt - CloudBridge Co. #52,Sales Receipt,SaaS-GL,0.0,6279.28,SGD,FAST Credit,CloudBridge Co. #52,***2877,INV-202502-SaaS-GL-0015,,False,False,REF-897350,First Continental Bank,***6044,Globex APAC Logistics Pte. Ltd.,SG,168804.55
2025-02-15,2025-02-15,Client Receipt - CloudBridge Co. #8,Sales Receipt,SaaS-GL,0.0,9749.95,SGD,SWIFT MT103,CloudBridge Co. #8,***1384,INV-202502-SaaS-GL-0001,,False,False,REF-347983,First Continental Bank,***2408,Globex APAC Logistics Pte. Ltd.,SG,178554.5
2025-02-17,2025-02-17,Client Receipt - CloudBridge Co. #59,Sales Receipt,SaaS-GL,0.0,12997.08,SGD,FAST Credit,CloudBridge Co. #59,***8881,INV-202502-SaaS-GL-0007,,False,False,REF-692810,First Continental Bank,***3998,Globex APAC Logistics Pte. Ltd.,SG,191551.58
2025-02-17,2025-02-17,Client Receipt - CloudBridge Co. #45,Sales Receipt,SaaS-GL,0.0,16371.95,SGD,SWIFT MT103,CloudBridge Co. #45,***6339,INV-202502-SaaS-GL-0017,,False,False,REF-703242,First Continental Bank,***9570,Globex APAC Logistics Pte. Ltd.,SG,207923.53
2025-02-17,2025-02-17,Client Receipt - CloudBridge Co. #2,Sales Receipt,SaaS-GL,0.0,24544.08,SGD,FAST Credit,CloudBridge Co. #2,***2313,INV-202502-SaaS-GL-0003,,False,False,REF-178486,First Continental Bank,***7315,Globex APAC Logistics Pte. Ltd.,SG,232467.61
2025-02-17,2025-02-17,Client Receipt - Pacific Trade Co. #2,Sales Receipt,Logistics-APAC,0.0,28849.57,SGD,SWIFT MT103,Pacific Trade Co. #2,***9882,INV-202502-Logistics-APAC-0011,,False,False,REF-416462,First Continental Bank,***2496,Globex APAC Logistics Pte. Ltd.,SG,261317.18
2025-02-18,2025-02-18,Supplier Payment - HyperCloud Infra #4,Supplier Payment,SaaS-GL,3551.86,0.0,SGD,SWIFT MT103,HyperCloud Infra #4,***2622,,PO-202502-SaaS-GL-0011,False,False,REF-360745,First Continental Bank,***2528,Globex APAC Logistics Pte. Ltd.,SG,257765.32
2025-02-18,2025-02-18,Client Receipt - CloudBridge Co. #10,Sales Receipt,SaaS-GL,0.0,2419.18,SGD,FAST Credit,CloudBridge Co. #10,***1554,INV-202502-SaaS-GL-0008,,False,False,REF-656871,First Continental Bank,***8020,Globex APAC Logistics Pte. Ltd.,SG,260184.5
2025-02-18,2025-02-18,Client Receipt - Vertex Advisory Client #1,Sales Receipt,PS-GL,0.0,7072.47,SGD,SWIFT MT103,Vertex Advisory Client #1,***3100,INV-202502-PS-GL-0007,,False,False,REF-387415,First Continental Bank,***3346,Globex APAC Logistics Pte. Ltd.,SG,267256.97
2025-02-19,2025-02-19,Supplier Payment - HyperCloud Infra #11,Supplier Payment,SaaS-GL,22089.35,0.0,SGD,SWIFT MT103,HyperCloud Infra #11,***1794,,PO-202502-SaaS-GL-0009,False,False,REF-428102,First Continental Bank,***9143,Globex APAC Logistics Pte. Ltd.,SG,245167.62
2025-02-19,2025-02-19,Client Receipt - CloudBridge Co. #59,Sales Receipt,SaaS-GL,0.0,1545.17,SGD,SWIFT MT103,CloudBridge Co. #59,***2258,INV-202502-SaaS-GL-0023,,False,False,REF-741356,First Continental Bank,***1992,Globex APAC Logistics Pte. Ltd.,SG,246712.79
2025-02-19,2025-02-19,Client Receipt - CloudBridge Co. #60,Sales Receipt,SaaS-GL,0.0,27729.77,SGD,SWIFT MT103,CloudBridge Co. #60,***2401,INV-202502-SaaS-GL-0013,,False,False,REF-119663,First Continental Bank,***6145,Globex APAC Logistics Pte. Ltd.,SG,274442.56
2025-02-19,2025-02-19,Client Receipt - Pacific Trade Co. #14,Sales Receipt,Logistics-APAC,0.0,29078.4,SGD,SWIFT MT103,Pacific Trade Co. #14,***7254,INV-202502-Logistics-APAC-0004,,False,False,REF-394325,First Continental Bank,***5179,Globex APAC Logistics Pte. Ltd.,SG,303520.96
2025-02-19,2025-02-19,Client Receipt - CloudBridge Co. #6,Sales Receipt,SaaS-GL,0.0,29686.01,SGD,SWIFT MT103,CloudBridge Co. #6,***7251,INV-202502-SaaS-GL-0016,,False,False,REF-782397,First Continental Bank,***3240,Globex APAC Logistics Pte. Ltd.,SG,333206.97
2025-02-19,2025-02-19,Client Receipt - CloudBridge Co. #26,Sales Receipt,SaaS-GL,0.0,30755.37,SGD,FAST Credit,CloudBridge Co. #26,***2782,INV-202502-SaaS-GL-0025,,False,False,REF-118204,First Continental Bank,***4847,Globex APAC Logistics Pte. Ltd.,SG,363962.34
2025-02-20,2025-02-20,Supplier Payment - HyperCloud Infra #10,Supplier Payment,SaaS-GL,2840.97,0.0,SGD,MEPS+,HyperCloud Infra #10,***4797,,PO-202502-SaaS-GL-0002,False,False,REF-417589,First Continental Bank,***5995,Globex APAC Logistics Pte. Ltd.,SG,361121.37
2025-02-20,2025-02-20,Supplier Payment - HyperCloud Infra #10,Supplier Payment,SaaS-GL,3128.0,0.0,SGD,SWIFT MT103,HyperCloud Infra #10,***2803,,PO-202502-SaaS-GL-0010,False,False,REF-142932,First Continental Bank,***8395,Globex APAC Logistics Pte. Ltd.,SG,357993.37
2025-02-20,2025-02-20,Supplier Payment - TransAsia Freight #5,Supplier Payment,Logistics-APAC,4750.52,0.0,SGD,MEPS+,TransAsia Freight #5,***9158,,PO-202502-Logistics-APAC-0008,False,False,REF-731913,First Continental Bank,***4640,Globex APAC Logistics Pte. Ltd.,SG,353242.85
2025-02-20,2025-02-20,Marketing - Beacon Digital #1,Marketing,ALL,8803.13,0.0,SGD,SWIFT MT103,Beacon Digital #1,***4231,,,False,False,REF-576436,First Continental Bank,***4544,Globex APAC Logistics Pte. Ltd.,SG,344439.72
2025-02-20,2025-02-20,Supplier Payment - CodeCraft Contractors #6,Supplier Payment,SaaS-GL,10487.51,0.0,SGD,MEPS+,CodeCraft Contractors #6,***5597,,PO-202502-SaaS-GL-0006,False,False,REF-339690,First Continental Bank,***3257,Globex APAC Logistics Pte. Ltd.,SG,333952.21
2025-02-20,2025-02-20,Supplier Payment - TransAsia Freight #20,Supplier Payment,Logistics-APAC,41621.58,0.0,SGD,FAST Debit,TransAsia Freight #20,***8551,,PO-202502-Logistics-APAC-0002,False,False,REF-692339,First Continental Bank,***5816,Globex APAC Logistics Pte. Ltd.,SG,292330.63
2025-02-20,2025-02-20,Client Receipt - Vertex Advisory Client #52,Sales Receipt,PS-GL,0.0,3017.32,SGD,SWIFT MT103,Vertex Advisory Client #52,***1921,INV-202502-PS-GL-0002,,False,False,REF-316144,First Continental Bank,***3558,Globex APAC Logistics Pte. Ltd.,SG,295347.95
2025-02-20,2025-02-20,Client Receipt - CloudBridge Co. #79,Sales Receipt,SaaS-GL,0.0,8872.98,SGD,SWIFT MT103,CloudBridge Co. #79,***3057,INV-202502-SaaS-GL-0010,,False,False,REF-731306,First Continental Bank,***9909,Globex APAC Logistics Pte. Ltd.,SG,304220.93
2025-02-20,2025-02-20,Client Receipt - Pacific Trade Co. #24,Sales Receipt,Logistics-APAC,0.0,50383.64,SGD,FAST Credit,Pacific Trade Co. #24,***2522,INV-202502-Logistics-APAC-0001,,False,False,REF-211705,First Continental Bank,***4331,Globex APAC Logistics Pte. Ltd.,SG,354604.57
2025-02-21,2025-02-21,Marketing - Aurelia Media #1,Marketing,ALL,4460.23,0.0,SGD,SWIFT MT103,Aurelia Media #1,***1263,,,False,False,REF-610237,First Continental Bank,***7913,Globex APAC Logistics Pte. Ltd.,SG,350144.34
2025-02-21,2025-02-21,Client Receipt - CloudBridge Co. #55,Sales Receipt,SaaS-GL,0.0,2149.94,SGD,SWIFT MT103,CloudBridge Co. #55,***8243,INV-202502-SaaS-GL-0020,,False,False,REF-627365,First Continental Bank,***4665,Globex APAC Logistics Pte. Ltd.,SG,352294.28
2025-02-21,2025-02-21,Client Receipt - CloudBridge Co. #34,Sales Receipt,SaaS-GL,0.0,6922.42,SGD,FAST Credit,CloudBridge Co. #34,***2864,INV-202502-SaaS-GL-0018,,False,False,REF-944344,First Continental Bank,***7430,Globex APAC Logistics Pte. Ltd.,SG,359216.7
2025-02-22,2025-02-22,VAT/GST Remittance - IRAS Singapore,Tax Payment,ALL,59963.66,0.0,SGD,FAST Debit,IRAS Singapore,***2133,,,False,False,REF-803871,First Continental Bank,***7396,Globex APAC Logistics Pte. Ltd.,SG,299253.04
2025-02-22,2025-02-22,Client Receipt - Pacific Trade Co. #17,Sales Receipt,Logistics-APAC,0.0,12148.95,SGD,FAST Credit,Pacific Trade Co. #17,***5143,INV-202502-Logistics-APAC-0007,,False,False,REF-839680,First Continental Bank,***6670,Globex APAC Logistics Pte. Ltd.,SG,311401.99
2025-02-24,2025-02-24,Supplier Payment - CodeCraft Contractors #11,Supplier Payment,SaaS-GL,1486.0,0.0,SGD,MEPS+,CodeCraft Contractors #11,***9347,,PO-202502-SaaS-GL-0007,False,False,REF-322556,First Continental Bank,***1596,Globex APAC Logistics Pte. Ltd.,SG,309915.99
2025-02-24,2025-02-24,Supplier Payment - HyperCloud Infra #14,Supplier Payment,SaaS-GL,11969.31,0.0,SGD,SWIFT MT103,HyperCloud Infra #14,***5345,,PO-202502-SaaS-GL-0004,False,False,REF-807494,First Continental Bank,***3251,Globex APAC Logistics Pte. Ltd.,SG,297946.68
2025-02-25,2025-02-25,Supplier Payment - HyperCloud Infra #19,Supplier Payment,SaaS-GL,2990.84,0.0,SGD,FAST Debit,HyperCloud Infra #19,***3769,,PO-202502-SaaS-GL-0001,False,False,REF-355729,First Continental Bank,***6785,Globex APAC Logistics Pte. Ltd.,SG,294955.84
2025-02-25,2025-02-25,Client Receipt - Pacific Trade Co. #1,Sales Receipt,Logistics-APAC,0.0,10447.76,SGD,SWIFT MT103,Pacific Trade Co. #1,***4584,INV-202502-Logistics-APAC-0009,,False,False,REF-105875,First Continental Bank,***3796,Globex APAC Logistics Pte. Ltd.,SG,305403.6
2025-02-25,2025-02-25,Client Receipt - CloudBridge Co. #11,Sales Receipt,SaaS-GL,0.0,22673.82,SGD,FAST Credit,CloudBridge Co. #11,***4293,INV-202502-SaaS-GL-0006,,False,False,REF-495658,First Continental Bank,***3945,Globex APAC Logistics Pte. Ltd.,SG,328077.42
2025-02-25,2025-02-25,Client Receipt - CloudBridge Co. #20,Sales Receipt,SaaS-GL,0.0,24806.97,SGD,SWIFT MT103,CloudBridge Co. #20,***8113,INV-202502-SaaS-GL-0002,,False,False,REF-728545,First Continental Bank,***4365,Globex APAC Logistics Pte. Ltd.,SG,352884.39
2025-02-25,2025-02-25,Client Receipt - Pacific Trade Co. #16,Sales Receipt,Logistics-APAC,0.0,53450.82,SGD,SWIFT MT103,Pacific Trade Co. #16,***9251,INV-202502-Logistics-APAC-0002,,False,False,REF-588887,First Continental Bank,***3454,Globex APAC Logistics Pte. Ltd.,SG,406335.21
2025-02-26,2025-02-26,Supplier Payment - ExpertNet Subcontractors #6,Supplier Payment,PS-GL,7165.91,0.0,SGD,SWIFT MT103,ExpertNet Subcontractors #6,***5096,,PO-202502-PS-GL-0007,False,False,REF-399280,First Continental Bank,***7514,Globex APAC Logistics Pte. Ltd.,SG,399169.3
2025-02-26,2025-02-26,Payroll - GlobalPay Services Ltd,Payroll,ALL,81446.55,0.0,SGD,MEPS+,GlobalPay Services Ltd,***8861,,,False,False,REF-532570,First Continental Bank,***2070,Globex APAC Logistics Pte. Ltd.,SG,317722.75
2025-02-26,2025-02-26,Intercompany Settlement - Globex Retail NA LLC,Intercompany Transfer,ALL,444477.0,0.0,SGD,Internal Transfer,Globex Retail NA LLC,***9044,,,True,True,REF-933882,First Continental Bank,***5201,Globex APAC Logistics Pte. Ltd.,SG,-126754.25
2025-02-26,2025-02-26,Client Receipt - Vertex Advisory Client #26,Sales Receipt,PS-GL,0.0,8213.97,SGD,FAST Credit,Vertex Advisory Client #26,***6234,INV-202502-PS-GL-0001,,False,False,REF-455692,First Continental Bank,***3731,Globex APAC Logistics Pte. Ltd.,SG,-118540.28
2025-02-26,2025-02-26,Client Receipt - Vertex Advisory Client #43,Sales Receipt,PS-GL,0.0,76328.73,SGD,SWIFT MT103,Vertex Advisory Client #43,***6361,INV-202502-PS-GL-0005,,False,False,REF-176718,First Continental Bank,***1598,Globex APAC Logistics Pte. Ltd.,SG,-42211.55
2025-02-27,2025-02-27,Supplier Payment - ExpertNet Subcontractors #13,Supplier Payment,PS-GL,4013.52,0.0,SGD,FAST Debit,ExpertNet Subcontractors #13,***9503,,PO-202502-PS-GL-0005,False,False,REF-237285,First Continental Bank,***8429,Globex APAC Logistics Pte. Ltd.,SG,-46225.07
2025-02-27,2025-02-27,Supplier Payment - ExpertNet Subcontractors #12,Supplier Payment,PS-GL,19456.64,0.0,SGD,SWIFT MT103,ExpertNet Subcontractors #12,***4942,,PO-202502-PS-GL-0003,False,False,REF-744834,First Continental Bank,***9878,Globex APAC Logistics Pte. Ltd.,SG,-65681.71
2025-02-27,2025-02-27,Payroll - GlobalPay Services Ltd,Payroll,ALL,81446.55,0.0,SGD,MEPS+,GlobalPay Services Ltd,***3918,,,False,False,REF-832565,First Continental Bank,***8715,Globex APAC Logistics Pte. Ltd.,SG,-147128.26
2025-02-27,2025-02-27,Client Receipt - Pacific Trade Co. #55,Sales Receipt,Logistics-APAC,0.0,28979.55,SGD,SWIFT MT103,Pacific Trade Co. #55,***2167,INV-202502-Logistics-APAC-0006,,False,False,REF-249729,First Continental Bank,***5144,Globex APAC Logistics Pte. Ltd.,SG,-118148.71
2025-02-28,2025-02-28,Client Receipt - CloudBridge Co. #55,Sales Receipt,SaaS-GL,0.0,9982.14,SGD,FAST Credit,CloudBridge Co. #55,***6253,INV-202502-SaaS-GL-0021,,False,False,REF-526754,First Continental Bank,***8442,Globex APAC Logistics Pte. Ltd.,SG,-108166.57
2025-02-28,2025-02-28,Interest Earned,Interest Income,ALL,0.0,11764.13,SGD,FAST Credit,First Continental Bank,***3415,,,False,False,REF-862606,First Continental Bank,***5225,Globex APAC Logistics Pte. Ltd.,SG,-96402.44
2025-03-01,2025-03-01,Account Maintenance Fee,Bank/Merchant Fees,ALL,2500.0,0.0,SGD,FAST Debit,First Continental Bank,***9685,,,False,False,REF-429430,First Continental Bank,***6657,Globex APAC Logistics Pte. Ltd.,SG,-98902.44
2025-03-02,2025-03-02,Client Receipt - Pacific Trade Co. #63,Sales Receipt,Logistics-APAC,0.0,2836.24,SGD,FAST Credit,Pacific Trade Co. #63,***9184,INV-202503-Logistics-APAC-0013,,False,False,REF-394178,First Continental Bank,***9672,Globex APAC Logistics Pte. Ltd.,SG,-96066.2
2025-03-02,2025-03-02,Client Receipt - CloudBridge Co. #34,Sales Receipt,SaaS-GL,0.0,4578.24,SGD,SWIFT MT103,CloudBridge Co. #34,***5974,INV-202503-SaaS-GL-0017,,False,False,REF-764284,First Continental Bank,***5435,Globex APAC Logistics Pte. Ltd.,SG,-91487.96
2025-03-03,2025-03-03,Skyline Internet Services,Rent & Utilities,ALL,1421.56,0.0,SGD,MEPS+,Skyline Internet Services,***6770,,,False,False,REF-750772,First Continental Bank,***8654,Globex APAC Logistics Pte. Ltd.,SG,-92909.52
2025-03-03,2025-03-03,Supplier Payment - Port Services #16,Supplier Payment,Logistics-APAC,11979.45,0.0,SGD,FAST Debit,Port Services #16,***7978,,PO-202503-Logistics-APAC-0002,False,False,REF-329478,First Continental Bank,***3904,Globex APAC Logistics Pte. Ltd.,SG,-104888.97
2025-03-04,2025-03-04,Supplier Payment - CodeCraft Contractors #11,Supplier Payment,SaaS-GL,4459.39,0.0,SGD,MEPS+,CodeCraft Contractors #11,***8829,,PO-202503-SaaS-GL-0007,False,False,REF-883742,First Continental Bank,***1432,Globex APAC Logistics Pte. Ltd.,SG,-109348.36
2025-03-04,2025-03-04,Client Receipt - Pacific Trade Co. #59,Sales Receipt,Logistics-APAC,0.0,4787.15,SGD,FAST Credit,Pacific Trade Co. #59,***7926,INV-202503-Logistics-APAC-0016,,False,False,REF-525546,First Continental Bank,***7512,Globex APAC Logistics Pte. Ltd.,SG,-104561.21
2025-03-04,2025-03-04,Client Receipt - Vertex Advisory Client #18,Sales Receipt,PS-GL,0.0,9071.47,SGD,FAST Credit,Vertex Advisory Client #18,***2393,INV-202503-PS-GL-0001,,False,False,REF-569735,First Continental Bank,***8438,Globex APAC Logistics Pte. Ltd.,SG,-95489.74
2025-03-04,2025-03-04,Client Receipt - CloudBridge Co. #63,Sales Receipt,SaaS-GL,0.0,9750.14,SGD,SWIFT MT103,CloudBridge Co. #63,***3742,INV-202503-SaaS-GL-0012,,False,False,REF-756781,First Continental Bank,***3902,Globex APAC Logistics Pte. Ltd.,SG,-85739.6
2025-03-05,2025-03-05,Supplier Payment - CodeCraft Contractors #5,Supplier Payment,SaaS-GL,1414.14,0.0,SGD,FAST Debit,CodeCraft Contractors #5,***6467,,PO-202503-SaaS-GL-0003,False,False,REF-932291,First Continental Bank,***4676,Globex APAC Logistics Pte. Ltd.,SG,-87153.74
2025-03-05,2025-03-05,Supplier Payment - ExpertNet Subcontractors #6,Supplier Payment,PS-GL,12752.94,0.0,SGD,MEPS+,ExpertNet Subcontractors #6,***1858,,PO-202503-PS-GL-0007,False,False,REF-376443,First Continental Bank,***1983,Globex APAC Logistics Pte. Ltd.,SG,-99906.68
2025-03-05,2025-03-05,Supplier Payment - TransAsia Freight #3,Supplier Payment,Logistics-APAC,41926.22,0.0,SGD,SWIFT MT103,TransAsia Freight #3,***8375,,PO-202503-Logistics-APAC-0006,False,False,REF-286025,First Continental Bank,***4395,Globex APAC Logistics Pte. Ltd.,SG,-141832.9
2025-03-05,2025-03-05,Client Receipt - CloudBridge Co. #61,Sales Receipt,SaaS-GL,0.0,5269.5,SGD,FAST Credit,CloudBridge Co. #61,***9057,INV-202503-SaaS-GL-0006,,False,False,REF-768314,First Continental Bank,***6743,Globex APAC Logistics Pte. Ltd.,SG,-136563.4
2025-03-05,2025-03-05,Client Receipt - CloudBridge Co. #60,Sales Receipt,SaaS-GL,0.0,6891.73,SGD,FAST Credit,CloudBridge Co. #60,***8896,INV-202503-SaaS-GL-0018,,False,False,REF-950788,First Continental Bank,***5876,Globex APAC Logistics Pte. Ltd.,SG,-129671.67
2025-03-05,2025-03-05,Client Receipt - CloudBridge Co. #77,Sales Receipt,SaaS-GL,0.0,22799.0,SGD,FAST Credit,CloudBridge Co. #77,***5120,INV-202503-SaaS-GL-0008,,False,False,REF-499010,First Continental Bank,***3187,Globex APAC Logistics Pte. Ltd.,SG,-106872.67
2025-03-05,2025-03-05,Client Receipt - Pacific Trade Co. #41,Sales Receipt,Logistics-APAC,0.0,75944.61,SGD,SWIFT MT103,Pacific Trade Co. #41,***2677,INV-202503-Logistics-APAC-0001,,False,False,REF-652138,First Continental Bank,***3232,Globex APAC Logistics Pte. Ltd.,SG,-30928.06
2025-03-06,2025-03-06,Supplier Payment - HyperCloud Infra #15,Supplier Payment,SaaS-GL,1687.73,0.0,SGD,SWIFT MT103,HyperCloud Infra #15,***7771,,PO-202503-SaaS-GL-0006,False,False,REF-404761,First Continental Bank,***8009,Globex APAC Logistics Pte. Ltd.,SG,-32615.79
2025-03-06,2025-03-06,Supplier Payment - ExpertNet Subcontractors #1,Supplier Payment,PS-GL,20573.85,0.0,SGD,MEPS+,ExpertNet Subcontractors #1,***7846,,PO-202503-PS-GL-0002,False,False,REF-597258,First Continental Bank,***4895,Globex APAC Logistics Pte. Ltd.,SG,-53189.64
2025-03-06,2025-03-06,Client Receipt - Pacific Trade Co. #59,Sales Receipt,Logistics-APAC,0.0,1827.73,SGD,SWIFT MT103,Pacific Trade Co. #59,***1019,INV-202503-Logistics-APAC-0009,,False,False,REF-545041,First Continental Bank,***5130,Globex APAC Logistics Pte. Ltd.,SG,-51361.91
2025-03-07,2025-03-07,Supplier Payment - ExpertNet Subcontractors #10,Supplier Payment,PS-GL,5264.66,0.0,SGD,FAST Debit,ExpertNet Subcontractors #10,***9183,,PO-202503-PS-GL-0005,False,False,REF-295988,First Continental Bank,***1046,Globex APAC Logistics Pte. Ltd.,SG,-56626.57
2025-03-07,2025-03-07,Client Receipt - Pacific Trade Co. #68,Sales Receipt,Logistics-APAC,0.0,15599.69,SGD,SWIFT MT103,Pacific Trade Co. #68,***3412,INV-202503-Logistics-APAC-0007,,False,False,REF-544136,First Continental Bank,***8796,Globex APAC Logistics Pte. Ltd.,SG,-41026.88
2025-03-07,2025-03-07,Client Receipt - CloudBridge Co. #70,Sales Receipt,SaaS-GL,0.0,17538.06,SGD,FAST Credit,CloudBridge Co. #70,***9932,INV-202503-SaaS-GL-0022,,False,False,REF-760949,First Continental Bank,***8247,Globex APAC Logistics Pte. Ltd.,SG,-23488.82
2025-03-10,2025-03-10,Marketing - Aurelia Media #2,Marketing,ALL,11751.01,0.0,SGD,SWIFT MT103,Aurelia Media #2,***8507,,,False,False,REF-492430,First Continental Bank,***8957,Globex APAC Logistics Pte. Ltd.,SG,-35239.83
2025-03-10,2025-03-10,Client Receipt - Pacific Trade Co. #44,Sales Receipt,Logistics-APAC,0.0,6874.73,SGD,SWIFT MT103,Pacific Trade Co. #44,***3984,INV-202503-Logistics-APAC-0014,,False,False,REF-202959,First Continental Bank,***4458,Globex APAC Logistics Pte. Ltd.,SG,-28365.1
2025-03-10,2025-03-10,Client Receipt - CloudBridge Co. #75,Sales Receipt,SaaS-GL,0.0,35242.69,SGD,SWIFT MT103,CloudBridge Co. #75,***7436,INV-202503-SaaS-GL-0002,,False,False,REF-738514,First Continental Bank,***9857,Globex APAC Logistics Pte. Ltd.,SG,6877.59
2025-03-11,2025-03-11,Supplier Payment - ExpertNet Subcontractors #12,Supplier Payment,PS-GL,3974.6,0.0,SGD,MEPS+,ExpertNet Subcontractors #12,***5206,,PO-202503-PS-GL-0006,False,False,REF-741491,First Continental Bank,***2955,Globex APAC Logistics Pte. Ltd.,SG,2902.99
2025-03-11,2025-03-11,Supplier Payment - TransAsia Freight #4,Supplier Payment,Logistics-APAC,32625.33,0.0,SGD,MEPS+,TransAsia Freight #4,***6451,,PO-202503-Logistics-APAC-0008,False,False,REF-743662,First Continental Bank,***8499,Globex APAC Logistics Pte. Ltd.,SG,-29722.34
2025-03-12,2025-03-12,Supplier Payment - CodeCraft Contractors #3,Supplier Payment,SaaS-GL,7948.63,0.0,SGD,MEPS+,CodeCraft Contractors #3,***4424,,PO-202503-SaaS-GL-0012,False,False,REF-169853,First Continental Bank,***2451,Globex APAC Logistics Pte. Ltd.,SG,-37670.97
2025-03-12,2025-03-12,"Intercompany Settlement - Globex International Holdings, Inc.",Intercompany Transfer,ALL,563040.0,0.0,SGD,Internal Transfer,"Globex International Holdings, Inc.",***8386,,,True,True,REF-657204,First Continental Bank,***5321,Globex APAC Logistics Pte. Ltd.,SG,-600710.97
2025-03-12,2025-03-12,Client Receipt - Pacific Trade Co. #45,Sales Receipt,Logistics-APAC,0.0,2638.78,SGD,SWIFT MT103,Pacific Trade Co. #45,***7589,INV-202503-Logistics-APAC-0011,,False,False,REF-629207,First Continental Bank,***5174,Globex APAC Logistics Pte. Ltd.,SG,-598072.19
2025-03-12,2025-03-12,Client Receipt - CloudBridge Co. #72,Sales Receipt,SaaS-GL,0.0,4799.4,SGD,SWIFT MT103,CloudBridge Co. #72,***7410,INV-202503-SaaS-GL-0014,,False,False,REF-269204,First Continental Bank,***6867,Globex APAC Logistics Pte. Ltd.,SG,-593272.79
2025-03-12,2025-03-12,Client Receipt - Vertex Advisory Client #28,Sales Receipt,PS-GL,0.0,39370.75,SGD,SWIFT MT103,Vertex Advisory Client #28,***9173,INV-202503-PS-GL-0008,,False,False,REF-573059,First Continental Bank,***7496,Globex APAC Logistics Pte. Ltd.,SG,-553902.04
2025-03-13,2025-03-13,Supplier Payment - CodeCraft Contractors #12,Supplier Payment,SaaS-GL,330.83,0.0,SGD,MEPS+,CodeCraft Contractors #12,***8622,,PO-202503-SaaS-GL-0011,False,False,REF-288151,First Continental Bank,***2286,Globex APAC Logistics Pte. Ltd.,SG,-554232.87
2025-03-13,2025-03-13,Client Receipt - Pacific Trade Co. #1,Sales Receipt,Logistics-APAC,0.0,5181.63,SGD,SWIFT MT103,Pacific Trade Co. #1,***6589,INV-202503-Logistics-APAC-0002,,False,False,REF-172383,First Continental Bank,***9747,Globex APAC Logistics Pte. Ltd.,SG,-549051.24
2025-03-13,2025-03-13,Client Receipt - CloudBridge Co. #41,Sales Receipt,SaaS-GL,0.0,12176.91,SGD,FAST Credit,CloudBridge Co. #41,***1583,INV-202503-SaaS-GL-0007,,False,False,REF-681094,First Continental Bank,***2011,Globex APAC Logistics Pte. Ltd.,SG,-536874.33
2025-03-13,2025-03-13,Client Receipt - Pacific Trade Co. #24,Sales Receipt,Logistics-APAC,0.0,31210.77,SGD,FAST Credit,Pacific Trade Co. #24,***8914,INV-202503-Logistics-APAC-0017,,False,False,REF-529831,First Continental Bank,***7928,Globex APAC Logistics Pte. Ltd.,SG,-505663.56
2025-03-14,2025-03-14,Supplier Payment - ExpertNet Subcontractors #16,Supplier Payment,PS-GL,6895.5,0.0,SGD,MEPS+,ExpertNet Subcontractors #16,***7807,,PO-202503-PS-GL-0004,False,False,REF-495341,First Continental Bank,***2388,Globex APAC Logistics Pte. Ltd.,SG,-512559.06
2025-03-14,2025-03-14,Client Receipt - Vertex Advisory Client #30,Sales Receipt,PS-GL,0.0,1175.83,SGD,FAST Credit,Vertex Advisory Client #30,***9329,INV-202503-PS-GL-0002,,False,False,REF-880363,First Continental Bank,***6746,Globex APAC Logistics Pte. Ltd.,SG,-511383.23
2025-03-14,2025-03-14,Client Receipt - Pacific Trade Co. #36,Sales Receipt,Logistics-APAC,0.0,19547.67,SGD,SWIFT MT103,Pacific Trade Co. #36,***9798,INV-202503-Logistics-APAC-0008,,False,False,REF-385948,First Continental Bank,***3416,Globex APAC Logistics Pte. Ltd.,SG,-491835.56
2025-03-14,2025-03-14,Client Receipt - Pacific Trade Co. #61,Sales Receipt,Logistics-APAC,0.0,56355.12,SGD,FAST Credit,Pacific Trade Co. #61,***9235,INV-202503-Logistics-APAC-0010,,False,False,REF-384872,First Continental Bank,***2342,Globex APAC Logistics Pte. Ltd.,SG,-435480.44
2025-03-14,2025-03-14,Client Receipt - Pacific Trade Co. #59,Sales Receipt,Logistics-APAC,0.0,81625.63,SGD,FAST Credit,Pacific Trade Co. #59,***5851,INV-202503-Logistics-APAC-0004,,False,False,REF-599156,First Continental Bank,***3916,Globex APAC Logistics Pte. Ltd.,SG,-353854.81
2025-03-15,2025-03-15,Client Receipt - Pacific Trade Co. #16,Sales Receipt,Logistics-APAC,0.0,9865.41,SGD,FAST Credit,Pacific Trade Co. #16,***5748,INV-202503-Logistics-APAC-0005,,False,False,REF-741856,First Continental Bank,***5938,Globex APAC Logistics Pte. Ltd.,SG,-343989.4
2025-03-15,2025-03-15,Client Receipt - Pacific Trade Co. #34,Sales Receipt,Logistics-APAC,0.0,44260.21,SGD,FAST Credit,Pacific Trade Co. #34,***6513,INV-202503-Logistics-APAC-0018,,False,False,REF-306435,First Continental Bank,***2274,Globex APAC Logistics Pte. Ltd.,SG,-299729.19
2025-03-17,2025-03-17,Supplier Payment - ExpertNet Subcontractors #16,Supplier Payment,PS-GL,379.91,0.0,SGD,FAST Debit,ExpertNet Subcontractors #16,***9430,,PO-202503-PS-GL-0009,False,False,REF-247839,First Continental Bank,***9682,Globex APAC Logistics Pte. Ltd.,SG,-300109.1
2025-03-17,2025-03-17,Supplier Payment - HyperCloud Infra #17,Supplier Payment,SaaS-GL,15913.34,0.0,SGD,SWIFT MT103,HyperCloud Infra #17,***8208,,PO-202503-SaaS-GL-0004,False,False,REF-468164,First Continental Bank,***3617,Globex APAC Logistics Pte. Ltd.,SG,-316022.44
2025-03-17,2025-03-17,Client Receipt - CloudBridge Co. #61,Sales Receipt,SaaS-GL,0.0,17641.59,SGD,SWIFT MT103,CloudBridge Co. #61,***2298,INV-202503-SaaS-GL-0005,,False,False,REF-819191,First Continental Bank,***7723,Globex APAC Logistics Pte. Ltd.,SG,-298380.85
2025-03-18,2025-03-18,Merchant Processing Fees,Bank/Merchant Fees,ALL,2653.02,0.0,SGD,SWIFT MT103,First Continental Bank,***4897,,,False,False,REF-431140,First Continental Bank,***7767,Globex APAC Logistics Pte. Ltd.,SG,-301033.87
2025-03-18,2025-03-18,Supplier Payment - CodeCraft Contractors #4,Supplier Payment,SaaS-GL,5763.23,0.0,SGD,FAST Debit,CodeCraft Contractors #4,***7921,,PO-202503-SaaS-GL-0009,False,False,REF-809209,First Continental Bank,***9089,Globex APAC Logistics Pte. Ltd.,SG,-306797.1
2025-03-18,2025-03-18,Supplier Payment - ExpertNet Subcontractors #17,Supplier Payment,PS-GL,6096.01,0.0,SGD,MEPS+,ExpertNet Subcontractors #17,***7864,,PO-202503-PS-GL-0001,False,False,REF-347898,First Continental Bank,***1632,Globex APAC Logistics Pte. Ltd.,SG,-312893.11
2025-03-18,2025-03-18,Supplier Payment - CodeCraft Contractors #4,Supplier Payment,SaaS-GL,23241.16,0.0,SGD,SWIFT MT103,CodeCraft Contractors #4,***6217,,PO-202503-SaaS-GL-0008,False,False,REF-867860,First Continental Bank,***4237,Globex APAC Logistics Pte. Ltd.,SG,-336134.27
2025-03-18,2025-03-18,Client Receipt - Pacific Trade Co. #19,Sales Receipt,Logistics-APAC,0.0,1649.67,SGD,SWIFT MT103,Pacific Trade Co. #19,***9558,INV-202503-Logistics-APAC-0012,,False,False,REF-173770,First Continental Bank,***9360,Globex APAC Logistics Pte. Ltd.,SG,-334484.6
2025-03-19,2025-03-19,Merchant Processing Fees,Bank/Merchant Fees,ALL,829.03,0.0,SGD,MEPS+,First Continental Bank,***6017,,,False,False,REF-906163,First Continental Bank,***8770,Globex APAC Logistics Pte. Ltd.,SG,-335313.63
2025-03-19,2025-03-19,Client Receipt - CloudBridge Co. #73,Sales Receipt,SaaS-GL,0.0,1087.36,SGD,SWIFT MT103,CloudBridge Co. #73,***1045,INV-202503-SaaS-GL-0010,,False,False,REF-872126,First Continental Bank,***1288,Globex APAC Logistics Pte. Ltd.,SG,-334226.27
2025-03-19,2025-03-19,Client Receipt - CloudBridge Co. #39,Sales Receipt,SaaS-GL,0.0,4280.59,SGD,FAST Credit,CloudBridge Co. #39,***1575,INV-202503-SaaS-GL-0003,,False,False,REF-570858,First Continental Bank,***2672,Globex APAC Logistics Pte. Ltd.,SG,-329945.68
2025-03-19,2025-03-19,Client Receipt - Vertex Advisory Client #51,Sales Receipt,PS-GL,0.0,75137.37,SGD,FAST Credit,Vertex Advisory Client #51,***7948,INV-202503-PS-GL-0005,,False,False,REF-362938,First Continental Bank,***6582,Globex APAC Logistics Pte. Ltd.,SG,-254808.31
2025-03-20,2025-03-20,Supplier Payment - TransAsia Freight #16,Supplier Payment,Logistics-APAC,4181.52,0.0,SGD,FAST Debit,TransAsia Freight #16,***6504,,PO-202503-Logistics-APAC-0003,False,False,REF-211321,First Continental Bank,***4335,Globex APAC Logistics Pte. Ltd.,SG,-258989.83
2025-03-20,2025-03-20,Supplier Payment - ExpertNet Subcontractors #4,Supplier Payment,PS-GL,5589.79,0.0,SGD,SWIFT MT103,ExpertNet Subcontractors #4,***1996,,PO-202503-PS-GL-0008,False,False,REF-710431,First Continental Bank,***6649,Globex APAC Logistics Pte. Ltd.,SG,-264579.62
2025-03-20,2025-03-20,Supplier Payment - TransAsia Freight #9,Supplier Payment,Logistics-APAC,17060.74,0.0,SGD,MEPS+,TransAsia Freight #9,***9020,,PO-202503-Logistics-APAC-0007,False,False,REF-164908,First Continental Bank,***6463,Globex APAC Logistics Pte. Ltd.,SG,-281640.36
2025-03-20,2025-03-20,VAT/GST Remittance - IRAS Singapore,Tax Payment,ALL,71904.41,0.0,SGD,SWIFT MT103,IRAS Singapore,***1128,,,False,False,REF-787910,First Continental Bank,***3743,Globex APAC Logistics Pte. Ltd.,SG,-353544.77
2025-03-20,2025-03-20,Client Receipt - CloudBridge Co. #17,Sales Receipt,SaaS-GL,0.0,33112.76,SGD,SWIFT MT103,CloudBridge Co. #17,***2327,INV-202503-SaaS-GL-0015,,False,False,REF-989494,First Continental Bank,***1033,Globex APAC Logistics Pte. Ltd.,SG,-320432.01
2025-03-20,2025-03-20,Client Receipt - Pacific Trade Co. #33,Sales Receipt,Logistics-APAC,0.0,57051.65,SGD,FAST Credit,Pacific Trade Co. #33,***1987,INV-202503-Logistics-APAC-0003,,False,False,REF-217104,First Continental Bank,***4466,Globex APAC Logistics Pte. Ltd.,SG,-263380.36
2025-03-20,2025-03-20,Client Receipt - CloudBridge Co. #60,Sales Receipt,SaaS-GL,0.0,63121.41,SGD,FAST Credit,CloudBridge Co. #60,***6238,INV-202503-SaaS-GL-0016,,False,False,REF-549892,First Continental Bank,***2659,Globex APAC Logistics Pte. Ltd.,SG,-200258.95
2025-03-21,2025-03-21,Supplier Payment - HyperCloud Infra #15,Supplier Payment,SaaS-GL,10017.2,0.0,SGD,MEPS+,HyperCloud Infra #15,***9566,,PO-202503-SaaS-GL-0002,False,False,REF-714329,First Continental Bank,***6620,Globex APAC Logistics Pte. Ltd.,SG,-210276.15
2025-03-21,2025-03-21,Supplier Payment - ExpertNet Subcontractors #3,Supplier Payment,PS-GL,10541.04,0.0,SGD,FAST Debit,ExpertNet Subcontractors #3,***4638,,PO-202503-PS-GL-0011,False,False,REF-104917,First Continental Bank,***6359,Globex APAC Logistics Pte. Ltd.,SG,-220817.19
2025-03-21,2025-03-21,Client Receipt - CloudBridge Co. #25,Sales Receipt,SaaS-GL,0.0,674.05,SGD,FAST Credit,CloudBridge Co. #25,***3228,INV-202503-SaaS-GL-0021,,False,False,REF-860127,First Continental Bank,***2558,Globex APAC Logistics Pte. Ltd.,SG,-220143.14
2025-03-21,2025-03-21,Client Receipt - CloudBridge Co. #52,Sales Receipt,SaaS-GL,0.0,8239.89,SGD,SWIFT MT103,CloudBridge Co. #52,***6065,INV-202503-SaaS-GL-0019,,False,False,REF-106366,First Continental Bank,***2505,Globex APAC Logistics Pte. Ltd.,SG,-211903.25
2025-03-21,2025-03-21,Client Receipt - Vertex Advisory Client #7,Sales Receipt,PS-GL,0.0,29097.13,SGD,FAST Credit,Vertex Advisory Client #7,***6160,INV-202503-PS-GL-0007,,False,False,REF-782710,First Continental Bank,***7988,Globex APAC Logistics Pte. Ltd.,SG,-182806.12
2025-03-22,2025-03-22,Supplier Payment - ExpertNet Subcontractors #5,Supplier Payment,PS-GL,8144.4,0.0,SGD,SWIFT MT103,ExpertNet Subcontractors #5,***8581,,PO-202503-PS-GL-0010,False,False,REF-107944,First Continental Bank,***4439,Globex APAC Logistics Pte. Ltd.,SG,-190950.52
2025-03-23,2025-03-23,Client Receipt - CloudBridge Co. #14,Sales Receipt,SaaS-GL,0.0,3661.83,SGD,SWIFT MT103,CloudBridge Co. #14,***7805,INV-202503-SaaS-GL-0011,,False,False,REF-273419,First Continental Bank,***4845,Globex APAC Logistics Pte. Ltd.,SG,-187288.69
2025-03-23,2025-03-23,Client Receipt - CloudBridge Co. #48,Sales Receipt,SaaS-GL,0.0,49043.75,SGD,SWIFT MT103,CloudBridge Co. #48,***7187,INV-202503-SaaS-GL-0020,,False,False,REF-922996,First Continental Bank,***9046,Globex APAC Logistics Pte. Ltd.,SG,-138244.94
2025-03-24,2025-03-24,Client Receipt - Vertex Advisory Client #20,Sales Receipt,PS-GL,0.0,186.75,SGD,FAST Credit,Vertex Advisory Client #20,***3144,INV-202503-PS-GL-0009,,False,False,REF-141910,First Continental Bank,***7853,Globex APAC Logistics Pte. Ltd.,SG,-138058.19
2025-03-25,2025-03-25,Supplier Payment - HyperCloud Infra #17,Supplier Payment,SaaS-GL,2156.98,0.0,SGD,FAST Debit,HyperCloud Infra #17,***8404,,PO-202503-SaaS-GL-0010,False,False,REF-809334,First Continental Bank,***2178,Globex APAC Logistics Pte. Ltd.,SG,-140215.17
2025-03-25,2025-03-25,Supplier Payment - CodeCraft Contractors #11,Supplier Payment,SaaS-GL,8624.53,0.0,SGD,MEPS+,CodeCraft Contractors #11,***6546,,PO-202503-SaaS-GL-0005,False,False,REF-540511,First Continental Bank,***2789,Globex APAC Logistics Pte. Ltd.,SG,-148839.7
2025-03-25,2025-03-25,Supplier Payment - TransAsia Freight #36,Supplier Payment,Logistics-APAC,48855.36,0.0,SGD,FAST Debit,TransAsia Freight #36,***6590,,PO-202503-Logistics-APAC-0004,False,False,REF-418061,First Continental Bank,***9215,Globex APAC Logistics Pte. Ltd.,SG,-197695.06
2025-03-25,2025-03-25,Payroll - GlobalPay Services Ltd,Payroll,ALL,189329.41,0.0,SGD,SWIFT MT103,GlobalPay Services Ltd,***7487,,,False,False,REF-483249,First Continental Bank,***2101,Globex APAC Logistics Pte. Ltd.,SG,-387024.47
2025-03-25,2025-03-25,Client Receipt - Pacific Trade Co. #46,Sales Receipt,Logistics-APAC,0.0,12155.93,SGD,SWIFT MT103,Pacific Trade Co. #46,***5645,INV-202503-Logistics-APAC-0015,,False,False,REF-799651,First Continental Bank,***4919,Globex APAC Logistics Pte. Ltd.,SG,-374868.54
2025-03-25,2025-03-25,Client Receipt - Vertex Advisory Client #19,Sales Receipt,PS-GL,0.0,93772.0,SGD,SWIFT MT103,Vertex Advisory Client #19,***6753,INV-202503-PS-GL-0004,,False,False,REF-295147,First Continental Bank,***3703,Globex APAC Logistics Pte. Ltd.,SG,-281096.54
2025-03-26,2025-03-26,Northshore Power,Rent & Utilities,ALL,7715.33,0.0,SGD,FAST Debit,Northshore Power,***2010,,,False,False,REF-987758,First Continental Bank,***2475,Globex APAC Logistics Pte. Ltd.,SG,-288811.87
2025-03-26,2025-03-26,Supplier Payment - CodeCraft Contractors #12,Supplier Payment,SaaS-GL,10198.94,0.0,SGD,SWIFT MT103,CodeCraft Contractors #12,***5356,,PO-202503-SaaS-GL-0001,False,False,REF-531190,First Continental Bank,***2487,Globex APAC Logistics Pte. Ltd.,SG,-299010.81
2025-03-26,2025-03-26,Intercompany Settlement - Globex Retail NA LLC,Intercompany Transfer,ALL,786283.0,0.0,SGD,Internal Transfer,Globex Retail NA LLC,***6541,,,True,True,REF-836161,First Continental Bank,***3355,Globex APAC Logistics Pte. Ltd.,SG,-1085293.81
2025-03-26,2025-03-26,Client Receipt - CloudBridge Co. #4,Sales Receipt,SaaS-GL,0.0,5045.96,SGD,SWIFT MT103,CloudBridge Co. #4,***8359,INV-202503-SaaS-GL-0001,,False,False,REF-313692,First Continental Bank,***8063,Globex APAC Logistics Pte. Ltd.,SG,-1080247.85
2025-03-26,2025-03-26,Client Receipt - Vertex Advisory Client #33,Sales Receipt,PS-GL,0.0,24317.3,SGD,FAST Credit,Vertex Advisory Client #33,***7828,INV-202503-PS-GL-0003,,False,False,REF-556163,First Continental Bank,***4382,Globex APAC Logistics Pte. Ltd.,SG,-1055930.55
2025-03-26,2025-03-26,Client Receipt - CloudBridge Co. #71,Sales Receipt,SaaS-GL,0.0,63800.44,SGD,FAST Credit,CloudBridge Co. #71,***4020,INV-202503-SaaS-GL-0004,,False,False,REF-430438,First Continental Bank,***3522,Globex APAC Logistics Pte. Ltd.,SG,-992130.11
2025-03-27,2025-03-27,Supplier Payment - TransAsia Freight #3,Supplier Payment,Logistics-APAC,21290.66,0.0,SGD,FAST Debit,TransAsia Freight #3,***6875,,PO-202503-Logistics-APAC-0005,False,False,REF-936784,First Continental Bank,***3927,Globex APAC Logistics Pte. Ltd.,SG,-1013420.77
2025-03-27,2025-03-27,Supplier Payment - Port Services #14,Supplier Payment,Logistics-APAC,146470.96,0.0,SGD,MEPS+,Port Services #14,***3877,,PO-202503-Logistics-APAC-0001,False,False,REF-197019,First Continental Bank,***7239,Globex APAC Logistics Pte. Ltd.,SG,-1159891.73
2025-03-27,2025-03-27,Client Receipt - Pacific Trade Co. #26,Sales Receipt,Logistics-APAC,0.0,34002.01,SGD,SWIFT MT103,Pacific Trade Co. #26,***1782,INV-202503-Logistics-APAC-0006,,False,False,REF-501618,First Continental Bank,***2680,Globex APAC Logistics Pte. Ltd.,SG,-1125889.72
2025-03-28,2025-03-28,Supplier Payment - ExpertNet Subcontractors #6,Supplier Payment,PS-GL,3201.93,0.0,SGD,SWIFT MT103,ExpertNet Subcontractors #6,***1957,,PO-202503-PS-GL-0003,False,False,REF-157324,First Continental Bank,***5089,Globex APAC Logistics Pte. Ltd.,SG,-1129091.65
2025-03-30,2025-03-30,Interest Earned,Interest Income,ALL,0.0,8168.61,SGD,FAST Credit,First Continental Bank,***8157,,,False,False,REF-638349,First Continental Bank,***2131,Globex APAC Logistics Pte. Ltd.,SG,-1120923.04
2025-03-30,2025-03-30,Client Receipt - CloudBridge Co. #49,Sales Receipt,SaaS-GL,0.0,44210.61,SGD,FAST Credit,CloudBridge Co. #49,***8073,INV-202503-SaaS-GL-0013,,False,False,REF-884971,First Continental Bank,***6399,Globex APAC Logistics Pte. Ltd.,SG,-1076712.43
2025-03-31,2025-03-31,Marketing - Beacon Digital #7,Marketing,ALL,17218.15,0.0,SGD,SWIFT MT103,Beacon Digital #7,***2672,,,False,False,REF-864401,First Continental Bank,***7880,Globex APAC Logistics Pte. Ltd.,SG,-1093930.58
2025-03-31,2025-03-31,Client Receipt - CloudBridge Co. #35,Sales Receipt,SaaS-GL,0.0,4107.26,SGD,FAST Credit,CloudBridge Co. #35,***9824,INV-202503-SaaS-GL-0009,,False,False,REF-454157,First Continental Bank,***5828,Globex APAC Logistics Pte. Ltd.,SG,-1089823.32
2025-03-31,2025-03-31,Client Receipt - Vertex Advisory Client #12,Sales Receipt,PS-GL,0.0,5920.18,SGD,FAST Credit,Vertex Advisory Client #12,***1351,INV-202503-PS-GL-0006,,False,False,REF-496363,First Continental Bank,***3842,Globex APAC Logistics Pte. Ltd.,SG,-1083903.14
2025-04-01,2025-04-01,Account Maintenance Fee,Bank/Merchant Fees,ALL,2500.0,0.0,SGD,FAST Debit,First Continental Bank,***6918,,,False,False,REF-207269,First Continental Bank,***6292,Globex APAC Logistics Pte. Ltd.,SG,-1086403.14
2025-04-01,2025-04-01,Marketing - Beacon Digital #2,Marketing,ALL,3098.71,0.0,SGD,MEPS+,Beacon Digital #2,***9350,,,False,False,REF-401266,First Continental Bank,***6897,Globex APAC Logistics Pte. Ltd.,SG,-1089501.85
2025-04-01,2025-04-01,Supplier Payment - TransAsia Freight #39,Supplier Payment,Logistics-APAC,12043.83,0.0,SGD,FAST Debit,TransAsia Freight #39,***9114,,PO-202504-Logistics-APAC-0009,False,False,REF-284728,First Continental Bank,***1372,Globex APAC Logistics Pte. Ltd.,SG,-1101545.68
2025-04-01,2025-04-01,Client Receipt - CloudBridge Co. #3,Sales Receipt,SaaS-GL,0.0,13652.56,SGD,SWIFT MT103,CloudBridge Co. #3,***4823,INV-202504-SaaS-GL-0001,,False,False,REF-991135,First Continental Bank,***6077,Globex APAC Logistics Pte. Ltd.,SG,-1087893.12
2025-04-02,2025-04-02,Supplier Payment - HyperCloud Infra #2,Supplier Payment,SaaS-GL,4407.95,0.0,SGD,FAST Debit,HyperCloud Infra #2,***6342,,PO-202504-SaaS-GL-0005,False,False,REF-411405,First Continental Bank,***7610,Globex APAC Logistics Pte. Ltd.,SG,-1092301.07
2025-04-02,2025-04-02,Client Receipt - Vertex Advisory Client #31,Sales Receipt,PS-GL,0.0,28055.95,SGD,SWIFT MT103,Vertex Advisory Client #31,***2230,INV-202504-PS-GL-0004,,False,False,REF-349971,First Continental Bank,***3842,Globex APAC Logistics Pte. Ltd.,SG,-1064245.12
2025-04-03,2025-04-03,Supplier Payment - TransAsia Freight #35,Supplier Payment,Logistics-APAC,67960.79,0.0,SGD,SWIFT MT103,TransAsia Freight #35,***2122,,PO-202504-Logistics-APAC-0004,False,False,REF-935704,First Continental Bank,***9590,Globex APAC Logistics Pte. Ltd.,SG,-1132205.91
2025-04-03,2025-04-03,Client Receipt - CloudBridge Co. #52,Sales Receipt,SaaS-GL,0.0,6814.82,SGD,SWIFT MT103,CloudBridge Co. #52,***3658,INV-202504-SaaS-GL-0009,,False,False,REF-953609,First Continental Bank,***3547,Globex APAC Logistics Pte. Ltd.,SG,-1125391.09
2025-04-03,2025-04-03,Client Receipt - CloudBridge Co. #58,Sales Receipt,SaaS-GL,0.0,25441.77,SGD,FAST Credit,CloudBridge Co. #58,***1459,INV-202504-SaaS-GL-0006,,False,False,REF-306192,First Continental Bank,***4021,Globex APAC Logistics Pte. Ltd.,SG,-1099949.32
2025-04-03,2025-04-03,Client Receipt - Pacific Trade Co. #15,Sales Receipt,Logistics-APAC,0.0,64300.98,SGD,SWIFT MT103,Pacific Trade Co. #15,***3098,INV-202504-Logistics-APAC-0012,,False,False,REF-967036,First Continental Bank,***3039,Globex APAC Logistics Pte. Ltd.,SG,-1035648.34
2025-04-04,2025-04-04,Supplier Payment - Port Services #5,Supplier Payment,Logistics-APAC,11844.28,0.0,SGD,MEPS+,Port Services #5,***4684,,PO-202504-Logistics-APAC-0011,False,False,REF-939844,First Continental Bank,***3998,Globex APAC Logistics Pte. Ltd.,SG,-1047492.62
2025-04-04,2025-04-04,Client Receipt - Vertex Advisory Client #16,Sales Receipt,PS-GL,0.0,2610.1,SGD,SWIFT MT103,Vertex Advisory Client #16,***2355,INV-202504-PS-GL-0003,,False,False,REF-757521,First Continental Bank,***5933,Globex APAC Logistics Pte. Ltd.,SG,-1044882.52
2025-04-04,2025-04-04,Client Receipt - CloudBridge Co. #45,Sales Receipt,SaaS-GL,0.0,11405.65,SGD,FAST Credit,CloudBridge Co. #45,***6894,INV-202504-SaaS-GL-0007,,False,False,REF-236440,First Continental Bank,***9226,Globex APAC Logistics Pte. Ltd.,SG,-1033476.87
2025-04-04,2025-04-04,Client Receipt - CloudBridge Co. #58,Sales Receipt,SaaS-GL,0.0,23757.95,SGD,FAST Credit,CloudBridge Co. #58,***3647,INV-202504-SaaS-GL-0026,,False,False,REF-611337,First Continental Bank,***8598,Globex APAC Logistics Pte. Ltd.,SG,-1009718.92
2025-04-04,2025-04-04,Client Receipt - Pacific Trade Co. #45,Sales Receipt,Logistics-APAC,0.0,28291.01,SGD,SWIFT MT103,Pacific Trade Co. #45,***5167,INV-202504-Logistics-APAC-0009,,False,False,REF-737740,First Continental Bank,***9145,Globex APAC Logistics Pte. Ltd.,SG,-981427.91
2025-04-04,2025-04-04,Client Receipt - Pacific Trade Co. #48,Sales Receipt,Logistics-APAC,0.0,42453.37,SGD,FAST Credit,Pacific Trade Co. #48,***8306,INV-202504-Logistics-APAC-0005,,False,False,REF-847603,First Continental Bank,***7649,Globex APAC Logistics Pte. Ltd.,SG,-938974.54
2025-04-05,2025-04-05,Supplier Payment - Port Services #18,Supplier Payment,Logistics-APAC,25967.61,0.0,SGD,SWIFT MT103,Port Services #18,***2947,,PO-202504-Logistics-APAC-0003,False,False,REF-941251,First Continental Bank,***8122,Globex APAC Logistics Pte. Ltd.,SG,-964942.15
2025-04-07,2025-04-07,Merchant Processing Fees,Bank/Merchant Fees,ALL,3497.04,0.0,SGD,SWIFT MT103,First Continental Bank,***9201,,,False,False,REF-560105,First Continental Bank,***7060,Globex APAC Logistics Pte. Ltd.,SG,-968439.19
2025-04-07,2025-04-07,Client Receipt - Vertex Advisory Client #7,Sales Receipt,PS-GL,0.0,20495.52,SGD,FAST Credit,Vertex Advisory Client #7,***8776,INV-202504-PS-GL-0009,,False,False,REF-519289,First Continental Bank,***2654,Globex APAC Logistics Pte. Ltd.,SG,-947943.67
2025-04-08,2025-04-08,Supplier Payment - HyperCloud Infra #7,Supplier Payment,SaaS-GL,5566.27,0.0,SGD,SWIFT MT103,HyperCloud Infra #7,***8122,,PO-202504-SaaS-GL-0001,False,False,REF-910519,First Continental Bank,***6800,Globex APAC Logistics Pte. Ltd.,SG,-953509.94
2025-04-08,2025-04-08,Supplier Payment - TransAsia Freight #4,Supplier Payment,Logistics-APAC,30435.62,0.0,SGD,MEPS+,TransAsia Freight #4,***5721,,PO-202504-Logistics-APAC-0007,False,False,REF-727136,First Continental Bank,***6670,Globex APAC Logistics Pte. Ltd.,SG,-983945.56
2025-04-08,2025-04-08,Client Receipt - CloudBridge Co. #68,Sales Receipt,SaaS-GL,0.0,930.1,SGD,SWIFT MT103,CloudBridge Co. #68,***7312,INV-202504-SaaS-GL-0015,,False,False,REF-962767,First Continental Bank,***2481,Globex APAC Logistics Pte. Ltd.,SG,-983015.46
2025-04-08,2025-04-08,Client Receipt - Vertex Advisory Client #39,Sales Receipt,PS-GL,0.0,21226.23,SGD,FAST Credit,Vertex Advisory Client #39,***7164,INV-202504-PS-GL-0006,,False,False,REF-916660,First Continental Bank,***1484,Globex APAC Logistics Pte. Ltd.,SG,-961789.23
2025-04-09,2025-04-09,Supplier Payment - Port Services #18,Supplier Payment,Logistics-APAC,11744.98,0.0,SGD,MEPS+,Port Services #18,***1831,,PO-202504-Logistics-APAC-0010,False,False,REF-715314,First Continental Bank,***9487,Globex APAC Logistics Pte. Ltd.,SG,-973534.21
2025-04-09,2025-04-09,Supplier Payment - TransAsia Freight #21,Supplier Payment,Logistics-APAC,97904.69,0.0,SGD,FAST Debit,TransAsia Freight #21,***7756,,PO-202504-Logistics-APAC-0001,False,False,REF-737610,First Continental Bank,***6955,Globex APAC Logistics Pte. Ltd.,SG,-1071438.9
2025-04-09,2025-04-09,Client Receipt - CloudBridge Co. #61,Sales Receipt,SaaS-GL,0.0,11572.41,SGD,SWIFT MT103,CloudBridge Co. #61,***3861,INV-202504-SaaS-GL-0021,,False,False,REF-985379,First Continental Bank,***2637,Globex APAC Logistics Pte. Ltd.,SG,-1059866.49
2025-04-10,2025-04-10,Supplier Payment - HyperCloud Infra #18,Supplier Payment,SaaS-GL,19305.41,0.0,SGD,FAST Debit,HyperCloud Infra #18,***6650,,PO-202504-SaaS-GL-0010,False,False,REF-517081,First Continental Bank,***1562,Globex APAC Logistics Pte. Ltd.,SG,-1079171.9
2025-04-10,2025-04-10,Client Receipt - CloudBridge Co. #61,Sales Receipt,SaaS-GL,0.0,5085.62,SGD,SWIFT MT103,CloudBridge Co. #61,***5946,INV-202504-SaaS-GL-0024,,False,False,REF-803070,First Continental Bank,***9982,Globex APAC Logistics Pte. Ltd.,SG,-1074086.28
2025-04-10,2025-04-10,Client Receipt - Pacific Trade Co. #43,Sales Receipt,Logistics-APAC,0.0,16109.5,SGD,FAST Credit,Pacific Trade Co. #43,***1123,INV-202504-Logistics-APAC-0006,,False,False,REF-674416,First Continental Bank,***8321,Globex APAC Logistics Pte. Ltd.,SG,-1057976.78
2025-04-10,2025-04-10,Client Receipt - CloudBridge Co. #14,Sales Receipt,SaaS-GL,0.0,43906.52,SGD,SWIFT MT103,CloudBridge Co. #14,***1510,INV-202504-SaaS-GL-0002,,False,False,REF-500387,First Continental Bank,***9926,Globex APAC Logistics Pte. Ltd.,SG,-1014070.26
2025-04-11,2025-04-11,Supplier Payment - ExpertNet Subcontractors #19,Supplier Payment,PS-GL,27683.74,0.0,SGD,SWIFT MT103,ExpertNet Subcontractors #19,***9880,,PO-202504-PS-GL-0004,False,False,REF-817949,First Continental Bank,***1653,Globex APAC Logistics Pte. Ltd.,SG,-1041754.0
2025-04-11,2025-04-11,Client Receipt - CloudBridge Co. #70,Sales Receipt,SaaS-GL,0.0,6876.83,SGD,SWIFT MT103,CloudBridge Co. #70,***6322,INV-202504-SaaS-GL-0016,,False,False,REF-438917,First Continental Bank,***9862,Globex APAC Logistics Pte. Ltd.,SG,-1034877.17
2025-04-11,2025-04-11,Client Receipt - CloudBridge Co. #51,Sales Receipt,SaaS-GL,0.0,7724.96,SGD,FAST Credit,CloudBridge Co. #51,***4511,INV-202504-SaaS-GL-0012,,False,False,REF-621807,First Continental Bank,***5729,Globex APAC Logistics Pte. Ltd.,SG,-1027152.21
2025-04-12,2025-04-12,Intercompany Settlement - Globex Retail NA LLC,Intercompany Transfer,ALL,387016.0,0.0,SGD,Internal Transfer,Globex Retail NA LLC,***4968,,,True,True,REF-240711,First Continental Bank,***6086,Globex APAC Logistics Pte. Ltd.,SG,-1414168.21
2025-04-13,2025-04-13,Client Receipt - Pacific Trade Co. #55,Sales Receipt,Logistics-APAC,0.0,11479.72,SGD,SWIFT MT103,Pacific Trade Co. #55,***3395,INV-202504-Logistics-APAC-0008,,False,False,REF-382588,First Continental Bank,***9900,Globex APAC Logistics Pte. Ltd.,SG,-1402688.49
2025-04-14,2025-04-14,Supplier Payment - ExpertNet Subcontractors #17,Supplier Payment,PS-GL,20849.27,0.0,SGD,MEPS+,ExpertNet Subcontractors #17,***7920,,PO-202504-PS-GL-0008,False,False,REF-801349,First Continental Bank,***1764,Globex APAC Logistics Pte. Ltd.,SG,-1423537.76
2025-04-14,2025-04-14,Client Receipt - CloudBridge Co. #16,Sales Receipt,SaaS-GL,0.0,41182.6,SGD,FAST Credit,CloudBridge Co. #16,***4373,INV-202504-SaaS-GL-0020,,False,False,REF-715677,First Continental Bank,***3603,Globex APAC Logistics Pte. Ltd.,SG,-1382355.16
2025-04-15,2025-04-15,Supplier Payment - CodeCraft Contractors #7,Supplier Payment,SaaS-GL,449.86,0.0,SGD,FAST Debit,CodeCraft Contractors #7,***5210,,PO-202504-SaaS-GL-0008,False,False,REF-809916,First Continental Bank,***3161,Globex APAC Logistics Pte. Ltd.,SG,-1382805.02
2025-04-15,2025-04-15,Supplier Payment - ExpertNet Subcontractors #2,Supplier Payment,PS-GL,8066.59,0.0,SGD,MEPS+,ExpertNet Subcontractors #2,***5906,,PO-202504-PS-GL-0002,False,False,REF-149668,First Continental Bank,***8192,Globex APAC Logistics Pte. Ltd.,SG,-1390871.61
2025-04-15,2025-04-15,Client Receipt - Pacific Trade Co. #27,Sales Receipt,Logistics-APAC,0.0,37508.41,SGD,FAST Credit,Pacific Trade Co. #27,***7407,INV-202504-Logistics-APAC-0013,,False,False,REF-256732,First Continental Bank,***3897,Globex APAC Logistics Pte. Ltd.,SG,-1353363.2
2025-04-16,2025-04-16,Client Receipt - CloudBridge Co. #57,Sales Receipt,SaaS-GL,0.0,12209.33,SGD,FAST Credit,CloudBridge Co. #57,***7080,INV-202504-SaaS-GL-0003,,False,False,REF-646700,First Continental Bank,***3545,Globex APAC Logistics Pte. Ltd.,SG,-1341153.87
2025-04-16,2025-04-16,Client Receipt - Vertex Advisory Client #34,Sales Receipt,PS-GL,0.0,13022.6,SGD,FAST Credit,Vertex Advisory Client #34,***2847,INV-202504-PS-GL-0007,,False,False,REF-274863,First Continental Bank,***9878,Globex APAC Logistics Pte. Ltd.,SG,-1328131.27
2025-04-16,2025-04-16,Client Receipt - Pacific Trade Co. #37,Sales Receipt,Logistics-APAC,0.0,44258.57,SGD,SWIFT MT103,Pacific Trade Co. #37,***2042,INV-202504-Logistics-APAC-0010,,False,False,REF-743927,First Continental Bank,***3808,Globex APAC Logistics Pte. Ltd.,SG,-1283872.7
2025-04-16,2025-04-16,Client Receipt - Vertex Advisory Client #3,Sales Receipt,PS-GL,0.0,60798.91,SGD,FAST Credit,Vertex Advisory Client #3,***4458,INV-202504-PS-GL-0001,,False,False,REF-487722,First Continental Bank,***4254,Globex APAC Logistics Pte. Ltd.,SG,-1223073.79
2025-04-17,2025-04-17,Supplier Payment - ExpertNet Subcontractors #12,Supplier Payment,PS-GL,1244.44,0.0,SGD,FAST Debit,ExpertNet Subcontractors #12,***7777,,PO-202504-PS-GL-0011,False,False,REF-328811,First Continental Bank,***7623,Globex APAC Logistics Pte. Ltd.,SG,-1224318.23
2025-04-17,2025-04-17,Supplier Payment - ExpertNet Subcontractors #17,Supplier Payment,PS-GL,10543.76,0.0,SGD,FAST Debit,ExpertNet Subcontractors #17,***4581,,PO-202504-PS-GL-0009,False,False,REF-383012,First Continental Bank,***2024,Globex APAC Logistics Pte. Ltd.,SG,-1234861.99
2025-04-17,2025-04-17,Marketing - Aurelia Media #9,Marketing,ALL,26785.04,0.0,SGD,SWIFT MT103,Aurelia Media #9,***1975,,,False,False,REF-933145,First Continental Bank,***1237,Globex APAC Logistics Pte. Ltd.,SG,-1261647.03
2025-04-17,2025-04-17,Client Receipt - CloudBridge Co. #21,Sales Receipt,SaaS-GL,0.0,9759.16,SGD,SWIFT MT103,CloudBridge Co. #21,***7615,INV-202504-SaaS-GL-0027,,False,False,REF-926253,First Continental Bank,***6820,Globex APAC Logistics Pte. Ltd.,SG,-1251887.87
2025-04-17,2025-04-17,Client Receipt - Pacific Trade Co. #66,Sales Receipt,Logistics-APAC,0.0,32899.39,SGD,SWIFT MT103,Pacific Trade Co. #66,***1882,INV-202504-Logistics-APAC-0007,,False,False,REF-319836,First Continental Bank,***4367,Globex APAC Logistics Pte. Ltd.,SG,-1218988.48
2025-04-17,2025-04-17,Client Receipt - Pacific Trade Co. #1,Sales Receipt,Logistics-APAC,0.0,81448.98,SGD,SWIFT MT103,Pacific Trade Co. #1,***2722,INV-202504-Logistics-APAC-0011,,False,False,REF-957384,First Continental Bank,***7676,Globex APAC Logistics Pte. Ltd.,SG,-1137539.5
2025-04-18,2025-04-18,Supplier Payment - CodeCraft Contractors #11,Supplier Payment,SaaS-GL,2747.59,0.0,SGD,FAST Debit,CodeCraft Contractors #11,***1633,,PO-202504-SaaS-GL-0004,False,False,REF-693136,First Continental Bank,***4230,Globex APAC Logistics Pte. Ltd.,SG,-1140287.09
2025-04-18,2025-04-18,Supplier Payment - ExpertNet Subcontractors #5,Supplier Payment,PS-GL,3492.64,0.0,SGD,FAST Debit,ExpertNet Subcontractors #5,***3817,,PO-202504-PS-GL-0007,False,False,REF-822032,First Continental Bank,***2036,Globex APAC Logistics Pte. Ltd.,SG,-1143779.73
2025-04-18,2025-04-18,Supplier Payment - ExpertNet Subcontractors #12,Supplier Payment,PS-GL,4698.93,0.0,SGD,SWIFT MT103,ExpertNet Subcontractors #12,***2949,,PO-202504-PS-GL-0006,False,False,REF-668146,First Continental Bank,***6644,Globex APAC Logistics Pte. Ltd.,SG,-1148478.66
2025-04-18,2025-04-18,Client Receipt - Vertex Advisory Client #41,Sales Receipt,PS-GL,0.0,15300.65,SGD,FAST Credit,Vertex Advisory Client #41,***2798,INV-202504-PS-GL-0010,,False,False,REF-162235,First Continental Bank,***3054,Globex APAC Logistics Pte. Ltd.,SG,-1133178.01
2025-04-18,2025-04-18,Client Receipt - Vertex Advisory Client #25,Sales Receipt,PS-GL,0.0,25809.85,SGD,FAST Credit,Vertex Advisory Client #25,***1807,INV-202504-PS-GL-0002,,False,False,REF-858316,First Continental Bank,***4436,Globex APAC Logistics Pte. Ltd.,SG,-1107368.16
2025-04-19,2025-04-19,Client Receipt - CloudBridge Co. #5,Sales Receipt,SaaS-GL,0.0,14502.51,SGD,SWIFT MT103,CloudBridge Co. #5,***2667,INV-202504-SaaS-GL-0017,,False,False,REF-332925,First Continental Bank,***8323,Globex APAC Logistics Pte. Ltd.,SG,-1092865.65
2025-04-19,2025-04-19,Client Receipt - CloudBridge Co. #24,Sales Receipt,SaaS-GL,0.0,17163.19,SGD,FAST Credit,CloudBridge Co. #24,***4994,INV-202504-SaaS-GL-0005,,False,False,REF-761946,First Continental Bank,***8479,Globex APAC Logistics Pte. Ltd.,SG,-1075702.46
2025-04-20,2025-04-20,VAT/GST Remittance - IRAS Singapore,Tax Payment,ALL,71303.91,0.0,SGD,SWIFT MT103,IRAS Singapore,***9708,,,False,False,REF-623562,First Continental Bank,***6561,Globex APAC Logistics Pte. Ltd.,SG,-1147006.37
2025-04-20,2025-04-20,Client Receipt - Pacific Trade Co. #20,Sales Receipt,Logistics-APAC,0.0,32078.88,SGD,SWIFT MT103,Pacific Trade Co. #20,***9147,INV-202504-Logistics-APAC-0014,,False,False,REF-780769,First Continental Bank,***5782,Globex APAC Logistics Pte. Ltd.,SG,-1114927.49
2025-04-21,2025-04-21,Client Receipt - CloudBridge Co. #31,Sales Receipt,SaaS-GL,0.0,8582.44,SGD,FAST Credit,CloudBridge Co. #31,***4656,INV-202504-SaaS-GL-0008,,False,False,REF-403991,First Continental Bank,***5514,Globex APAC Logistics Pte. Ltd.,SG,-1106345.05
2025-04-21,2025-04-21,Client Receipt - CloudBridge Co. #17,Sales Receipt,SaaS-GL,0.0,11153.83,SGD,SWIFT MT103,CloudBridge Co. #17,***5592,INV-202504-SaaS-GL-0025,,False,False,REF-202468,First Continental Bank,***8156,Globex APAC Logistics Pte. Ltd.,SG,-1095191.22
2025-04-21,2025-04-21,Client Receipt - CloudBridge Co. #39,Sales Receipt,SaaS-GL,0.0,13330.83,SGD,FAST Credit,CloudBridge Co. #39,***2305,INV-202504-SaaS-GL-0010,,False,False,REF-493753,First Continental Bank,***2792,Globex APAC Logistics Pte. Ltd.,SG,-1081860.39
2025-04-22,2025-04-22,Supplier Payment - Port Services #15,Supplier Payment,Logistics-APAC,6575.73,0.0,SGD,MEPS+,Port Services #15,***9970,,PO-202504-Logistics-APAC-0002,False,False,REF-790986,First Continental Bank,***7470,Globex APAC Logistics Pte. Ltd.,SG,-1088436.12
2025-04-22,2025-04-22,Client Receipt - CloudBridge Co. #59,Sales Receipt,SaaS-GL,0.0,3652.47,SGD,SWIFT MT103,CloudBridge Co. #59,***1845,INV-202504-SaaS-GL-0022,,False,False,REF-562532,First Continental Bank,***3911,Globex APAC Logistics Pte. Ltd.,SG,-1084783.65
2025-04-22,2025-04-22,Client Receipt - CloudBridge Co. #36,Sales Receipt,SaaS-GL,0.0,26403.66,SGD,SWIFT MT103,CloudBridge Co. #36,***8191,INV-202504-SaaS-GL-0028,,False,False,REF-636132,First Continental Bank,***2304,Globex APAC Logistics Pte. Ltd.,SG,-1058379.99
2025-04-23,2025-04-23,Supplier Payment - ExpertNet Subcontractors #11,Supplier Payment,PS-GL,11.12,0.0,SGD,MEPS+,ExpertNet Subcontractors #11,***7798,,PO-202504-PS-GL-0003,False,False,REF-433159,First Continental Bank,***9449,Globex APAC Logistics Pte. Ltd.,SG,-1058391.11
2025-04-23,2025-04-23,Merchant Processing Fees,Bank/Merchant Fees,ALL,204.91,0.0,SGD,SWIFT MT103,First Continental Bank,***9906,,,False,False,REF-746549,First Continental Bank,***2109,Globex APAC Logistics Pte. Ltd.,SG,-1058596.02
2025-04-23,2025-04-23,Supplier Payment - ExpertNet Subcontractors #6,Supplier Payment,PS-GL,1977.22,0.0,SGD,MEPS+,ExpertNet Subcontractors #6,***8792,,PO-202504-PS-GL-0001,False,False,REF-990669,First Continental Bank,***5542,Globex APAC Logistics Pte. Ltd.,SG,-1060573.24
2025-04-23,2025-04-23,Client Receipt - CloudBridge Co. #67,Sales Receipt,SaaS-GL,0.0,96.54,SGD,SWIFT MT103,CloudBridge Co. #67,***3918,INV-202504-SaaS-GL-0019,,False,False,REF-463062,First Continental Bank,***8219,Globex APAC Logistics Pte. Ltd.,SG,-1060476.7
2025-04-23,2025-04-23,Client Receipt - Pacific Trade Co. #64,Sales Receipt,Logistics-APAC,0.0,6644.74,SGD,SWIFT MT103,Pacific Trade Co. #64,***4963,INV-202504-Logistics-APAC-0003,,False,False,REF-207737,First Continental Bank,***6639,Globex APAC Logistics Pte. Ltd.,SG,-1053831.96
2025-04-23,2025-04-23,Client Receipt - Vertex Advisory Client #54,Sales Receipt,PS-GL,0.0,8309.44,SGD,SWIFT MT103,Vertex Advisory Client #54,***8163,INV-202504-PS-GL-0011,,False,False,REF-229537,First Continental Bank,***5948,Globex APAC Logistics Pte. Ltd.,SG,-1045522.52
2025-04-23,2025-04-23,Client Receipt - CloudBridge Co. #19,Sales Receipt,SaaS-GL,0.0,9740.98,SGD,FAST Credit,CloudBridge Co. #19,***5398,INV-202504-SaaS-GL-0013,,False,False,REF-129894,First Continental Bank,***2522,Globex APAC Logistics Pte. Ltd.,SG,-1035781.54
2025-04-24,2025-04-24,Supplier Payment - CodeCraft Contractors #4,Supplier Payment,SaaS-GL,14481.91,0.0,SGD,FAST Debit,CodeCraft Contractors #4,***3637,,PO-202504-SaaS-GL-0002,False,False,REF-591138,First Continental Bank,***6591,Globex APAC Logistics Pte. Ltd.,SG,-1050263.45
2025-04-24,2025-04-24,Supplier Payment - CodeCraft Contractors #2,Supplier Payment,SaaS-GL,19540.63,0.0,SGD,MEPS+,CodeCraft Contractors #2,***2941,,PO-202504-SaaS-GL-0009,False,False,REF-692695,First Continental Bank,***2586,Globex APAC Logistics Pte. Ltd.,SG,-1069804.08
2025-04-24,2025-04-24,Supplier Payment - Port Services #4,Supplier Payment,Logistics-APAC,37405.55,0.0,SGD,MEPS+,Port Services #4,***7878,,PO-202504-Logistics-APAC-0005,False,False,REF-412913,First Continental Bank,***5893,Globex APAC Logistics Pte. Ltd.,SG,-1107209.63
2025-04-24,2025-04-24,Client Receipt - Pacific Trade Co. #23,Sales Receipt,Logistics-APAC,0.0,11146.91,SGD,FAST Credit,Pacific Trade Co. #23,***6697,INV-202504-Logistics-APAC-0004,,False,False,REF-757386,First Continental Bank,***9519,Globex APAC Logistics Pte. Ltd.,SG,-1096062.72
2025-04-24,2025-04-24,Client Receipt - CloudBridge Co. #4,Sales Receipt,SaaS-GL,0.0,43110.73,SGD,SWIFT MT103,CloudBridge Co. #4,***2679,INV-202504-SaaS-GL-0018,,False,False,REF-944338,First Continental Bank,***1262,Globex APAC Logistics Pte. Ltd.,SG,-1052951.99
2025-04-25,2025-04-25,Supplier Payment - HyperCloud Infra #6,Supplier Payment,SaaS-GL,10611.95,0.0,SGD,MEPS+,HyperCloud Infra #6,***6776,,PO-202504-SaaS-GL-0006,False,False,REF-710988,First Continental Bank,***1312,Globex APAC Logistics Pte. Ltd.,SG,-1063563.94
2025-04-25,2025-04-25,Supplier Payment - CodeCraft Contractors #4,Supplier Payment,SaaS-GL,17434.69,0.0,SGD,FAST Debit,CodeCraft Contractors #4,***3575,,PO-202504-SaaS-GL-0007,False,False,REF-983620,First Continental Bank,***3459,Globex APAC Logistics Pte. Ltd.,SG,-1080998.63
2025-04-25,2025-04-25,Payroll - GlobalPay Services Ltd,Payroll,ALL,193076.26,0.0,SGD,FAST Debit,GlobalPay Services Ltd,***1050,,,False,False,REF-499740,First Continental Bank,***9119,Globex APAC Logistics Pte. Ltd.,SG,-1274074.89
2025-04-25,2025-04-25,Client Receipt - Vertex Advisory Client #5,Sales Receipt,PS-GL,0.0,29206.64,SGD,FAST Credit,Vertex Advisory Client #5,***6942,INV-202504-PS-GL-0008,,False,False,REF-199491,First Continental Bank,***3840,Globex APAC Logistics Pte. Ltd.,SG,-1244868.25
2025-04-25,2025-04-25,Client Receipt - CloudBridge Co. #14,Sales Receipt,SaaS-GL,0.0,42822.44,SGD,FAST Credit,CloudBridge Co. #14,***3332,INV-202504-SaaS-GL-0004,,False,False,REF-147320,First Continental Bank,***6289,Globex APAC Logistics Pte. Ltd.,SG,-1202045.81
2025-04-26,2025-04-26,Supplier Payment - ExpertNet Subcontractors #7,Supplier Payment,PS-GL,2546.37,0.0,SGD,SWIFT MT103,ExpertNet Subcontractors #7,***3720,,PO-202504-PS-GL-0005,False,False,REF-704128,First Continental Bank,***1676,Globex APAC Logistics Pte. Ltd.,SG,-1204592.18
2025-04-26,2025-04-26,Alphagrid Utilities,Rent & Utilities,ALL,9675.99,0.0,SGD,MEPS+,Alphagrid Utilities,***4791,,,False,False,REF-548832,First Continental Bank,***3683,Globex APAC Logistics Pte. Ltd.,SG,-1214268.17
2025-04-26,2025-04-26,"Intercompany Settlement - Globex International Holdings, Inc.",Intercompany Transfer,ALL,736554.0,0.0,SGD,Internal Transfer,"Globex International Holdings, Inc.",***6086,,,True,True,REF-539261,First Continental Bank,***3010,Globex APAC Logistics Pte. Ltd.,SG,-1950822.17
2025-04-26,2025-04-26,Client Receipt - Vertex Advisory Client #51,Sales Receipt,PS-GL,0.0,67847.04,SGD,SWIFT MT103,Vertex Advisory Client #51,***7033,INV-202504-PS-GL-0005,,False,False,REF-695703,First Continental Bank,***9190,Globex APAC Logistics Pte. Ltd.,SG,-1882975.13
2025-04-26,2025-04-26,"Intercompany Reimbursement - Globex International Holdings, Inc.",Intercompany Transfer,ALL,0.0,294621.6,SGD,Internal Transfer,"Globex International Holdings, Inc.",***9694,,,True,True,REF-712786,First Continental Bank,***5622,Globex APAC Logistics Pte. Ltd.,SG,-1588353.53
2025-04-27,2025-04-27,Supplier Payment - TransAsia Freight #11,Supplier Payment,Logistics-APAC,2557.98,0.0,SGD,SWIFT MT103,TransAsia Freight #11,***5358,,PO-202504-Logistics-APAC-0006,False,False,REF-566150,First Continental Bank,***9725,Globex APAC Logistics Pte. Ltd.,SG,-1590911.51
2025-04-28,2025-04-28,Supplier Payment - ExpertNet Subcontractors #7,Supplier Payment,PS-GL,6690.8,0.0,SGD,MEPS+,ExpertNet Subcontractors #7,***2980,,PO-202504-PS-GL-0010,False,False,REF-427908,First Continental Bank,***7087,Globex APAC Logistics Pte. Ltd.,SG,-1597602.31
2025-04-28,2025-04-28,Corporate Tax Estimate,Tax Payment,ALL,52386.8,0.0,SGD,SWIFT MT103,IRAS Singapore,***7695,,,False,False,REF-653916,First Continental Bank,***2679,Globex APAC Logistics Pte. Ltd.,SG,-1649989.11
2025-04-28,2025-04-28,Client Receipt - CloudBridge Co. #69,Sales Receipt,SaaS-GL,0.0,8594.7,SGD,SWIFT MT103,CloudBridge Co. #69,***6871,INV-202504-SaaS-GL-0011,,False,False,REF-355818,First Continental Bank,***1651,Globex APAC Logistics Pte. Ltd.,SG,-1641394.41
2025-04-28,2025-04-28,Client Receipt - Pacific Trade Co. #36,Sales Receipt,Logistics-APAC,0.0,52409.54,SGD,SWIFT MT103,Pacific Trade Co. #36,***1640,INV-202504-Logistics-APAC-0002,,False,False,REF-234956,First Continental Bank,***8479,Globex APAC Logistics Pte. Ltd.,SG,-1588984.87
2025-04-29,2025-04-29,Supplier Payment - HyperCloud Infra #17,Supplier Payment,SaaS-GL,2039.11,0.0,SGD,SWIFT MT103,HyperCloud Infra #17,***7782,,PO-202504-SaaS-GL-0003,False,False,REF-512479,First Continental Bank,***3806,Globex APAC Logistics Pte. Ltd.,SG,-1591023.98
2025-04-29,2025-04-29,Client Receipt - Pacific Trade Co. #2,Sales Receipt,Logistics-APAC,0.0,26774.88,SGD,FAST Credit,Pacific Trade Co. #2,***5331,INV-202504-Logistics-APAC-0001,,False,False,REF-348920,First Continental Bank,***4074,Globex APAC Logistics Pte. Ltd.,SG,-1564249.1
2025-04-30,2025-04-30,Supplier Payment - Port Services #2,Supplier Payment,Logistics-APAC,37022.35,0.0,SGD,MEPS+,Port Services #2,***6835,,PO-202504-Logistics-APAC-0008,False,False,REF-843461,First Continental Bank,***7091,Globex APAC Logistics Pte. Ltd.,SG,-1601271.45
2025-04-30,2025-04-30,Client Receipt - CloudBridge Co. #38,Sales Receipt,SaaS-GL,0.0,5614.88,SGD,FAST Credit,CloudBridge Co. #38,***1342,INV-202504-SaaS-GL-0023,,False,False,REF-322243,First Continental Bank,***6093,Globex APAC Logistics Pte. Ltd.,SG,-1595656.57
2025-04-30,2025-04-30,Interest Earned,Interest Income,ALL,0.0,11735.99,SGD,SWIFT MT103,First Continental Bank,***4942,,,False,False,REF-696083,First Continental Bank,***2226,Globex APAC Logistics Pte. Ltd.,SG,-1583920.58
2025-04-30,2025-04-30,Client Receipt - CloudBridge Co. #67,Sales Receipt,SaaS-GL,0.0,13934.91,SGD,FAST Credit,CloudBridge Co. #67,***8265,INV-202504-SaaS-GL-0014,,False,False,REF-615365,First Continental Bank,***9456,Globex APAC Logistics Pte. Ltd.,SG,-1569985.67
2025-05-01,2025-05-01,Supplier Payment - CodeCraft Contractors #2,Supplier Payment,SaaS-GL,845.77,0.0,SGD,SWIFT MT103,CodeCraft Contractors #2,***7918,,PO-202505-SaaS-GL-0003,False,False,REF-107364,First Continental Bank,***3723,Globex APAC Logistics Pte. Ltd.,SG,-1570831.44
2025-05-01,2025-05-01,Account Maintenance Fee,Bank/Merchant Fees,ALL,2500.0,0.0,SGD,MEPS+,First Continental Bank,***3444,,,False,False,REF-571635,First Continental Bank,***2159,Globex APAC Logistics Pte. Ltd.,SG,-1573331.44
2025-05-01,2025-05-01,Client Receipt - Vertex Advisory Client #49,Sales Receipt,PS-GL,0.0,27686.16,SGD,SWIFT MT103,Vertex Advisory Client #49,***4673,INV-202505-PS-GL-0005,,False,False,REF-362898,First Continental Bank,***1321,Globex APAC Logistics Pte. Ltd.,SG,-1545645.28
2025-05-01,2025-05-01,Client Receipt - CloudBridge Co. #7,Sales Receipt,SaaS-GL,0.0,33444.05,SGD,FAST Credit,CloudBridge Co. #7,***9530,INV-202505-SaaS-GL-0016,,False,False,REF-478755,First Continental Bank,***6726,Globex APAC Logistics Pte. Ltd.,SG,-1512201.23
2025-05-02,2025-05-02,Supplier Payment - Port Services #11,Supplier Payment,Logistics-APAC,51586.28,0.0,SGD,MEPS+,Port Services #11,***2041,,PO-202505-Logistics-APAC-0011,False,False,REF-163158,First Continental Bank,***5044,Globex APAC Logistics Pte. Ltd.,SG,-1563787.51
2025-05-03,2025-05-03,Client Receipt - Pacific Trade Co. #5,Sales Receipt,Logistics-APAC,0.0,55450.71,SGD,SWIFT MT103,Pacific Trade Co. #5,***1698,INV-202505-Logistics-APAC-0005,,False,False,REF-666976,First Continental Bank,***5284,Globex APAC Logistics Pte. Ltd.,SG,-1508336.8
2025-05-05,2025-05-05,Supplier Payment - TransAsia Freight #16,Supplier Payment,Logistics-APAC,17693.37,0.0,SGD,FAST Debit,TransAsia Freight #16,***7828,,PO-202505-Logistics-APAC-0006,False,False,REF-710956,First Continental Bank,***9333,Globex APAC Logistics Pte. Ltd.,SG,-1526030.17
2025-05-05,2025-05-05,Client Receipt - Pacific Trade Co. #14,Sales Receipt,Logistics-APAC,0.0,36149.84,SGD,FAST Credit,Pacific Trade Co. #14,***7818,INV-202505-Logistics-APAC-0001,,False,False,REF-318048,First Continental Bank,***3160,Globex APAC Logistics Pte. Ltd.,SG,-1489880.33
2025-05-06,2025-05-06,Client Receipt - CloudBridge Co. #53,Sales Receipt,SaaS-GL,0.0,16174.04,SGD,FAST Credit,CloudBridge Co. #53,***8888,INV-202505-SaaS-GL-0020,,False,False,REF-914793,First Continental Bank,***1657,Globex APAC Logistics Pte. Ltd.,SG,-1473706.29
2025-05-06,2025-05-06,Client Receipt - Pacific Trade Co. #39,Sales Receipt,Logistics-APAC,0.0,110634.69,SGD,SWIFT MT103,Pacific Trade Co. #39,***1949,INV-202505-Logistics-APAC-0004,,False,False,REF-758643,First Continental Bank,***4788,Globex APAC Logistics Pte. Ltd.,SG,-1363071.6
2025-05-07,2025-05-07,Supplier Payment - ExpertNet Subcontractors #7,Supplier Payment,PS-GL,8297.78,0.0,SGD,SWIFT MT103,ExpertNet Subcontractors #7,***3839,,PO-202505-PS-GL-0004,False,False,REF-758537,First Continental Bank,***8026,Globex APAC Logistics Pte. Ltd.,SG,-1371369.38
2025-05-07,2025-05-07,Supplier Payment - TransAsia Freight #25,Supplier Payment,Logistics-APAC,29832.31,0.0,SGD,SWIFT MT103,TransAsia Freight #25,***9025,,PO-202505-Logistics-APAC-0005,False,False,REF-879308,First Continental Bank,***7584,Globex APAC Logistics Pte. Ltd.,SG,-1401201.69
2025-05-07,2025-05-07,Supplier Payment - Port Services #8,Supplier Payment,Logistics-APAC,32627.6,0.0,SGD,SWIFT MT103,Port Services #8,***8386,,PO-202505-Logistics-APAC-0010,False,False,REF-333634,First Continental Bank,***7544,Globex APAC Logistics Pte. Ltd.,SG,-1433829.29
2025-05-07,2025-05-07,Client Receipt - CloudBridge Co. #6,Sales Receipt,SaaS-GL,0.0,33808.28,SGD,FAST Credit,CloudBridge Co. #6,***7257,INV-202505-SaaS-GL-0029,,False,False,REF-578209,First Continental Bank,***7235,Globex APAC Logistics Pte. Ltd.,SG,-1400021.01
2025-05-07,2025-05-07,Client Receipt - Vertex Advisory Client #23,Sales Receipt,PS-GL,0.0,53924.35,SGD,FAST Credit,Vertex Advisory Client #23,***9641,INV-202505-PS-GL-0007,,False,False,REF-402248,First Continental Bank,***6733,Globex APAC Logistics Pte. Ltd.,SG,-1346096.66
2025-05-08,2025-05-08,Supplier Payment - TransAsia Freight #33,Supplier Payment,Logistics-APAC,685.61,0.0,SGD,FAST Debit,TransAsia Freight #33,***7318,,PO-202505-Logistics-APAC-0002,False,False,REF-881172,First Continental Bank,***3593,Globex APAC Logistics Pte. Ltd.,SG,-1346782.27
2025-05-08,2025-05-08,Merchant Processing Fees,Bank/Merchant Fees,ALL,3372.89,0.0,SGD,FAST Debit,First Continental Bank,***7342,,,False,False,REF-642664,First Continental Bank,***8475,Globex APAC Logistics Pte. Ltd.,SG,-1350155.16
2025-05-08,2025-05-08,Client Receipt - CloudBridge Co. #13,Sales Receipt,SaaS-GL,0.0,5393.66,SGD,SWIFT MT103,CloudBridge Co. #13,***7695,INV-202505-SaaS-GL-0023,,False,False,REF-475851,First Continental Bank,***3513,Globex APAC Logistics Pte. Ltd.,SG,-1344761.5
2025-05-08,2025-05-08,Client Receipt - CloudBridge Co. #31,Sales Receipt,SaaS-GL,0.0,11838.73,SGD,SWIFT MT103,CloudBridge Co. #31,***1853,INV-202505-SaaS-GL-0024,,False,False,REF-729991,First Continental Bank,***2877,Globex APAC Logistics Pte. Ltd.,SG,-1332922.77
2025-05-08,2025-05-08,Client Receipt - CloudBridge Co. #54,Sales Receipt,SaaS-GL,0.0,20717.99,SGD,FAST Credit,CloudBridge Co. #54,***3770,INV-202505-SaaS-GL-0005,,False,False,REF-363491,First Continental Bank,***9563,Globex APAC Logistics Pte. Ltd.,SG,-1312204.78
2025-05-08,2025-05-08,Client Receipt - Vertex Advisory Client #27,Sales Receipt,PS-GL,0.0,36245.43,SGD,FAST Credit,Vertex Advisory Client #27,***9045,INV-202505-PS-GL-0002,,False,False,REF-361689,First Continental Bank,***8433,Globex APAC Logistics Pte. Ltd.,SG,-1275959.35
2025-05-09,2025-05-09,Supplier Payment - ExpertNet Subcontractors #11,Supplier Payment,PS-GL,10931.06,0.0,SGD,MEPS+,ExpertNet Subcontractors #11,***4177,,PO-202505-PS-GL-0009,False,False,REF-990528,First Continental Bank,***3841,Globex APAC Logistics Pte. Ltd.,SG,-1286890.41
2025-05-10,2025-05-10,Supplier Payment - TransAsia Freight #13,Supplier Payment,Logistics-APAC,60918.86,0.0,SGD,MEPS+,TransAsia Freight #13,***2620,,PO-202505-Logistics-APAC-0001,False,False,REF-802111,First Continental Bank,***3294,Globex APAC Logistics Pte. Ltd.,SG,-1347809.27
2025-05-10,2025-05-10,Client Receipt - CloudBridge Co. #53,Sales Receipt,SaaS-GL,0.0,4302.17,SGD,FAST Credit,CloudBridge Co. #53,***6735,INV-202505-SaaS-GL-0021,,False,False,REF-351924,First Continental Bank,***9646,Globex APAC Logistics Pte. Ltd.,SG,-1343507.1
2025-05-10,2025-05-10,Client Receipt - CloudBridge Co. #70,Sales Receipt,SaaS-GL,0.0,26551.7,SGD,FAST Credit,CloudBridge Co. #70,***9881,INV-202505-SaaS-GL-0009,,False,False,REF-678944,First Continental Bank,***9037,Globex APAC Logistics Pte. Ltd.,SG,-1316955.4
2025-05-11,2025-05-11,Supplier Payment - ExpertNet Subcontractors #8,Supplier Payment,PS-GL,6335.8,0.0,SGD,SWIFT MT103,ExpertNet Subcontractors #8,***5840,,PO-202505-PS-GL-0007,False,False,REF-575890,First Continental Bank,***7625,Globex APAC Logistics Pte. Ltd.,SG,-1323291.2
2025-05-12,2025-05-12,Supplier Payment - CodeCraft Contractors #12,Supplier Payment,SaaS-GL,1528.86,0.0,SGD,FAST Debit,CodeCraft Contractors #12,***3373,,PO-202505-SaaS-GL-0010,False,False,REF-208388,First Continental Bank,***3045,Globex APAC Logistics Pte. Ltd.,SG,-1324820.06
2025-05-12,2025-05-12,BluePeak Property Mgmt,Rent & Utilities,ALL,10249.17,0.0,SGD,FAST Debit,BluePeak Property Mgmt,***6938,,,False,False,REF-502807,First Continental Bank,***9355,Globex APAC Logistics Pte. Ltd.,SG,-1335069.23
2025-05-12,2025-05-12,Intercompany Settlement - Globex Consulting UK Ltd.,Intercompany Transfer,ALL,630511.0,0.0,SGD,Internal Transfer,Globex Consulting UK Ltd.,***9106,,,True,True,REF-886338,First Continental Bank,***6755,Globex APAC Logistics Pte. Ltd.,SG,-1965580.23
2025-05-12,2025-05-12,Client Receipt - CloudBridge Co. #34,Sales Receipt,SaaS-GL,0.0,19963.79,SGD,FAST Credit,CloudBridge Co. #34,***1258,INV-202505-SaaS-GL-0028,,False,False,REF-814363,First Continental Bank,***3390,Globex APAC Logistics Pte. Ltd.,SG,-1945616.44
2025-05-12,2025-05-12,Intercompany Reimbursement - Globex Consulting UK Ltd.,Intercompany Transfer,ALL,0.0,252204.4,SGD,Internal Transfer,Globex Consulting UK Ltd.,***5057,,,True,True,REF-104177,First Continental Bank,***3723,Globex APAC Logistics Pte. Ltd.,SG,-1693412.04
2025-05-13,2025-05-13,Supplier Payment - CodeCraft Contractors #3,Supplier Payment,SaaS-GL,21718.84,0.0,SGD,SWIFT MT103,CodeCraft Contractors #3,***7592,,PO-202505-SaaS-GL-0009,False,False,REF-983080,First Continental Bank,***8240,Globex APAC Logistics Pte. Ltd.,SG,-1715130.88
2025-05-13,2025-05-13,Client Receipt - CloudBridge Co. #35,Sales Receipt,SaaS-GL,0.0,1495.79,SGD,SWIFT MT103,CloudBridge Co. #35,***9841,INV-202505-SaaS-GL-0013,,False,False,REF-312245,First Continental Bank,***1145,Globex APAC Logistics Pte. Ltd.,SG,-1713635.09
2025-05-13,2025-05-13,Client Receipt - CloudBridge Co. #9,Sales Receipt,SaaS-GL,0.0,13670.0,SGD,FAST Credit,CloudBridge Co. #9,***3658,INV-202505-SaaS-GL-0008,,False,False,REF-328989,First Continental Bank,***6842,Globex APAC Logistics Pte. Ltd.,SG,-1699965.09
2025-05-13,2025-05-13,Client Receipt - Pacific Trade Co. #27,Sales Receipt,Logistics-APAC,0.0,18258.19,SGD,FAST Credit,Pacific Trade Co. #27,***6794,INV-202505-Logistics-APAC-0003,,False,False,REF-951024,First Continental Bank,***8098,Globex APAC Logistics Pte. Ltd.,SG,-1681706.9
2025-05-14,2025-05-14,Client Receipt - CloudBridge Co. #67,Sales Receipt,SaaS-GL,0.0,8336.32,SGD,FAST Credit,CloudBridge Co. #67,***8505,INV-202505-SaaS-GL-0001,,False,False,REF-503230,First Continental Bank,***4968,Globex APAC Logistics Pte. Ltd.,SG,-1673370.58
2025-05-14,2025-05-14,Client Receipt - CloudBridge Co. #9,Sales Receipt,SaaS-GL,0.0,8895.6,SGD,SWIFT MT103,CloudBridge Co. #9,***9941,INV-202505-SaaS-GL-0025,,False,False,REF-854451,First Continental Bank,***3269,Globex APAC Logistics Pte. Ltd.,SG,-1664474.98
2025-05-14,2025-05-14,Client Receipt - CloudBridge Co. #38,Sales Receipt,SaaS-GL,0.0,11069.89,SGD,FAST Credit,CloudBridge Co. #38,***2053,INV-202505-SaaS-GL-0006,,False,False,REF-531867,First Continental Bank,***1386,Globex APAC Logistics Pte. Ltd.,SG,-1653405.09
2025-05-14,2025-05-14,Client Receipt - CloudBridge Co. #51,Sales Receipt,SaaS-GL,0.0,29073.03,SGD,FAST Credit,CloudBridge Co. #51,***9175,INV-202505-SaaS-GL-0019,,False,False,REF-431943,First Continental Bank,***3929,Globex APAC Logistics Pte. Ltd.,SG,-1624332.06
2025-05-14,2025-05-14,Client Receipt - Pacific Trade Co. #10,Sales Receipt,Logistics-APAC,0.0,41936.37,SGD,FAST Credit,Pacific Trade Co. #10,***6013,INV-202505-Logistics-APAC-0008,,False,False,REF-234794,First Continental Bank,***3664,Globex APAC Logistics Pte. Ltd.,SG,-1582395.69
2025-05-15,2025-05-15,Client Receipt - CloudBridge Co. #63,Sales Receipt,SaaS-GL,0.0,409.02,SGD,FAST Credit,CloudBridge Co. #63,***4227,INV-202505-SaaS-GL-0007,,False,False,REF-872802,First Continental Bank,***8600,Globex APAC Logistics Pte. Ltd.,SG,-1581986.67
2025-05-15,2025-05-15,Client Receipt - CloudBridge Co. #23,Sales Receipt,SaaS-GL,0.0,7778.93,SGD,FAST Credit,CloudBridge Co. #23,***7073,INV-202505-SaaS-GL-0017,,False,False,REF-193893,First Continental Bank,***4943,Globex APAC Logistics Pte. Ltd.,SG,-1574207.74
2025-05-15,2025-05-15,Client Receipt - CloudBridge Co. #5,Sales Receipt,SaaS-GL,0.0,9639.72,SGD,SWIFT MT103,CloudBridge Co. #5,***9184,INV-202505-SaaS-GL-0002,,False,False,REF-676863,First Continental Bank,***6661,Globex APAC Logistics Pte. Ltd.,SG,-1564568.02
2025-05-15,2025-05-15,Client Receipt - Vertex Advisory Client #43,Sales Receipt,PS-GL,0.0,16259.05,SGD,FAST Credit,Vertex Advisory Client #43,***8840,INV-202505-PS-GL-0003,,False,False,REF-894037,First Continental Bank,***1678,Globex APAC Logistics Pte. Ltd.,SG,-1548308.97
2025-05-15,2025-05-15,Client Receipt - CloudBridge Co. #63,Sales Receipt,SaaS-GL,0.0,17355.32,SGD,SWIFT MT103,CloudBridge Co. #63,***3013,INV-202505-SaaS-GL-0010,,False,False,REF-155437,First Continental Bank,***1315,Globex APAC Logistics Pte. Ltd.,SG,-1530953.65
2025-05-16,2025-05-16,Client Receipt - Vertex Advisory Client #51,Sales Receipt,PS-GL,0.0,9542.55,SGD,SWIFT MT103,Vertex Advisory Client #51,***5778,INV-202505-PS-GL-0008,,False,False,REF-702676,First Continental Bank,***5066,Globex APAC Logistics Pte. Ltd.,SG,-1521411.1
2025-05-16,2025-05-16,Client Receipt - Pacific Trade Co. #69,Sales Receipt,Logistics-APAC,0.0,114492.33,SGD,SWIFT MT103,Pacific Trade Co. #69,***3184,INV-202505-Logistics-APAC-0009,,False,False,REF-284661,First Continental Bank,***2402,Globex APAC Logistics Pte. Ltd.,SG,-1406918.77
2025-05-17,2025-05-17,Supplier Payment - HyperCloud Infra #4,Supplier Payment,SaaS-GL,16761.99,0.0,SGD,MEPS+,HyperCloud Infra #4,***6815,,PO-202505-SaaS-GL-0002,False,False,REF-655399,First Continental Bank,***6271,Globex APAC Logistics Pte. Ltd.,SG,-1423680.76
2025-05-18,2025-05-18,Supplier Payment - TransAsia Freight #33,Supplier Payment,Logistics-APAC,29509.07,0.0,SGD,MEPS+,TransAsia Freight #33,***7945,,PO-202505-Logistics-APAC-0004,False,False,REF-277350,First Continental Bank,***7876,Globex APAC Logistics Pte. Ltd.,SG,-1453189.83
2025-05-18,2025-05-18,Client Receipt - Vertex Advisory Client #13,Sales Receipt,PS-GL,0.0,70722.54,SGD,SWIFT MT103,Vertex Advisory Client #13,***5014,INV-202505-PS-GL-0009,,False,False,REF-865693,First Continental Bank,***2284,Globex APAC Logistics Pte. Ltd.,SG,-1382467.29
2025-05-19,2025-05-19,Supplier Payment - ExpertNet Subcontractors #6,Supplier Payment,PS-GL,9553.13,0.0,SGD,MEPS+,ExpertNet Subcontractors #6,***2943,,PO-202505-PS-GL-0003,False,False,REF-888539,First Continental Bank,***2931,Globex APAC Logistics Pte. Ltd.,SG,-1392020.42
2025-05-19,2025-05-19,Supplier Payment - CodeCraft Contractors #2,Supplier Payment,SaaS-GL,19948.94,0.0,SGD,MEPS+,CodeCraft Contractors #2,***4864,,PO-202505-SaaS-GL-0004,False,False,REF-145738,First Continental Bank,***1515,Globex APAC Logistics Pte. Ltd.,SG,-1411969.36
2025-05-19,2025-05-19,Client Receipt - CloudBridge Co. #22,Sales Receipt,SaaS-GL,0.0,10905.89,SGD,SWIFT MT103,CloudBridge Co. #22,***6100,INV-202505-SaaS-GL-0012,,False,False,REF-257336,First Continental Bank,***1356,Globex APAC Logistics Pte. Ltd.,SG,-1401063.47
2025-05-19,2025-05-19,Client Receipt - CloudBridge Co. #4,Sales Receipt,SaaS-GL,0.0,17958.4,SGD,FAST Credit,CloudBridge Co. #4,***9074,INV-202505-SaaS-GL-0003,,False,False,REF-573637,First Continental Bank,***3995,Globex APAC Logistics Pte. Ltd.,SG,-1383105.07
2025-05-19,2025-05-19,Client Receipt - Pacific Trade Co. #68,Sales Receipt,Logistics-APAC,0.0,32016.25,SGD,FAST Credit,Pacific Trade Co. #68,***3218,INV-202505-Logistics-APAC-0002,,False,False,REF-693474,First Continental Bank,***2475,Globex APAC Logistics Pte. Ltd.,SG,-1351088.82
2025-05-19,2025-05-19,Client Receipt - Pacific Trade Co. #26,Sales Receipt,Logistics-APAC,0.0,52907.76,SGD,SWIFT MT103,Pacific Trade Co. #26,***4261,INV-202505-Logistics-APAC-0007,,False,False,REF-960271,First Continental Bank,***4561,Globex APAC Logistics Pte. Ltd.,SG,-1298181.06
2025-05-20,2025-05-20,Supplier Payment - ExpertNet Subcontractors #3,Supplier Payment,PS-GL,9338.82,0.0,SGD,FAST Debit,ExpertNet Subcontractors #3,***5065,,PO-202505-PS-GL-0001,False,False,REF-456316,First Continental Bank,***1429,Globex APAC Logistics Pte. Ltd.,SG,-1307519.88
2025-05-20,2025-05-20,Marketing - Beacon Digital #2,Marketing,ALL,19920.88,0.0,SGD,MEPS+,Beacon Digital #2,***7897,,,False,False,REF-829942,First Continental Bank,***9339,Globex APAC Logistics Pte. Ltd.,SG,-1327440.76
2025-05-20,2025-05-20,Client Receipt - CloudBridge Co. #41,Sales Receipt,SaaS-GL,0.0,6743.78,SGD,SWIFT MT103,CloudBridge Co. #41,***4095,INV-202505-SaaS-GL-0026,,False,False,REF-963480,First Continental Bank,***1819,Globex APAC Logistics Pte. Ltd.,SG,-1320696.98
2025-05-20,2025-05-20,Client Receipt - CloudBridge Co. #48,Sales Receipt,SaaS-GL,0.0,24726.78,SGD,SWIFT MT103,CloudBridge Co. #48,***6227,INV-202505-SaaS-GL-0014,,False,False,REF-551849,First Continental Bank,***2648,Globex APAC Logistics Pte. Ltd.,SG,-1295970.2
2025-05-21,2025-05-21,Supplier Payment - ExpertNet Subcontractors #2,Supplier Payment,PS-GL,7742.94,0.0,SGD,SWIFT MT103,ExpertNet Subcontractors #2,***7179,,PO-202505-PS-GL-0008,False,False,REF-777630,First Continental Bank,***5906,Globex APAC Logistics Pte. Ltd.,SG,-1303713.14
2025-05-21,2025-05-21,VAT/GST Remittance - IRAS Singapore,Tax Payment,ALL,70866.82,0.0,SGD,MEPS+,IRAS Singapore,***4219,,,False,False,REF-773687,First Continental Bank,***8018,Globex APAC Logistics Pte. Ltd.,SG,-1374579.96
2025-05-22,2025-05-22,Supplier Payment - Port Services #8,Supplier Payment,Logistics-APAC,14941.98,0.0,SGD,MEPS+,Port Services #8,***1756,,PO-202505-Logistics-APAC-0007,False,False,REF-478377,First Continental Bank,***8288,Globex APAC Logistics Pte. Ltd.,SG,-1389521.94
2025-05-22,2025-05-22,Client Receipt - Vertex Advisory Client #16,Sales Receipt,PS-GL,0.0,14664.39,SGD,FAST Credit,Vertex Advisory Client #16,***8542,INV-202505-PS-GL-0001,,False,False,REF-139909,First Continental Bank,***8989,Globex APAC Logistics Pte. Ltd.,SG,-1374857.55
2025-05-23,2025-05-23,Supplier Payment - HyperCloud Infra #6,Supplier Payment,SaaS-GL,9717.88,0.0,SGD,SWIFT MT103,HyperCloud Infra #6,***7770,,PO-202505-SaaS-GL-0011,False,False,REF-104839,First Continental Bank,***9981,Globex APAC Logistics Pte. Ltd.,SG,-1384575.43
2025-05-23,2025-05-23,Supplier Payment - Port Services #19,Supplier Payment,Logistics-APAC,32825.18,0.0,SGD,SWIFT MT103,Port Services #19,***2789,,PO-202505-Logistics-APAC-0003,False,False,REF-795149,First Continental Bank,***7335,Globex APAC Logistics Pte. Ltd.,SG,-1417400.61
2025-05-24,2025-05-24,Supplier Payment - CodeCraft Contractors #8,Supplier Payment,SaaS-GL,7543.35,0.0,SGD,MEPS+,CodeCraft Contractors #8,***6135,,PO-202505-SaaS-GL-0006,False,False,REF-834995,First Continental Bank,***6492,Globex APAC Logistics Pte. Ltd.,SG,-1424943.96
2025-05-25,2025-05-25,Supplier Payment - HyperCloud Infra #9,Supplier Payment,SaaS-GL,2227.59,0.0,SGD,MEPS+,HyperCloud Infra #9,***8929,,PO-202505-SaaS-GL-0008,False,False,REF-666822,First Continental Bank,***3243,Globex APAC Logistics Pte. Ltd.,SG,-1427171.55
2025-05-25,2025-05-25,Supplier Payment - HyperCloud Infra #12,Supplier Payment,SaaS-GL,6394.73,0.0,SGD,FAST Debit,HyperCloud Infra #12,***3393,,PO-202505-SaaS-GL-0005,False,False,REF-932946,First Continental Bank,***9684,Globex APAC Logistics Pte. Ltd.,SG,-1433566.28
2025-05-26,2025-05-26,Supplier Payment - ExpertNet Subcontractors #4,Supplier Payment,PS-GL,1556.2,0.0,SGD,SWIFT MT103,ExpertNet Subcontractors #4,***9557,,PO-202505-PS-GL-0005,False,False,REF-893656,First Continental Bank,***8605,Globex APAC Logistics Pte. Ltd.,SG,-1435122.48
2025-05-26,2025-05-26,Supplier Payment - CodeCraft Contractors #2,Supplier Payment,SaaS-GL,10263.74,0.0,SGD,SWIFT MT103,CodeCraft Contractors #2,***7365,,PO-202505-SaaS-GL-0007,False,False,REF-319394,First Continental Bank,***5316,Globex APAC Logistics Pte. Ltd.,SG,-1445386.22
2025-05-26,2025-05-26,Intercompany Settlement - Globex Retail NA LLC,Intercompany Transfer,ALL,817001.0,0.0,SGD,Internal Transfer,Globex Retail NA LLC,***9965,,,True,True,REF-946462,First Continental Bank,***5242,Globex APAC Logistics Pte. Ltd.,SG,-2262387.22
2025-05-26,2025-05-26,Client Receipt - Pacific Trade Co. #14,Sales Receipt,Logistics-APAC,0.0,31091.44,SGD,FAST Credit,Pacific Trade Co. #14,***1711,INV-202505-Logistics-APAC-0006,,False,False,REF-409504,First Continental Bank,***2818,Globex APAC Logistics Pte. Ltd.,SG,-2231295.78
2025-05-26,2025-05-26,Client Receipt - CloudBridge Co. #73,Sales Receipt,SaaS-GL,0.0,79502.39,SGD,SWIFT MT103,CloudBridge Co. #73,***2288,INV-202505-SaaS-GL-0018,,False,False,REF-179979,First Continental Bank,***7808,Globex APAC Logistics Pte. Ltd.,SG,-2151793.39
2025-05-27,2025-05-27,Client Receipt - CloudBridge Co. #33,Sales Receipt,SaaS-GL,0.0,380.85,SGD,SWIFT MT103,CloudBridge Co. #33,***9504,INV-202505-SaaS-GL-0015,,False,False,REF-742566,First Continental Bank,***1700,Globex APAC Logistics Pte. Ltd.,SG,-2151412.54
2025-05-27,2025-05-27,Client Receipt - Vertex Advisory Client #51,Sales Receipt,PS-GL,0.0,24993.0,SGD,SWIFT MT103,Vertex Advisory Client #51,***9470,INV-202505-PS-GL-0010,,False,False,REF-303489,First Continental Bank,***8718,Globex APAC Logistics Pte. Ltd.,SG,-2126419.54
2025-05-27,2025-05-27,Client Receipt - Vertex Advisory Client #9,Sales Receipt,PS-GL,0.0,28636.58,SGD,FAST Credit,Vertex Advisory Client #9,***6286,INV-202505-PS-GL-0004,,False,False,REF-822963,First Continental Bank,***5569,Globex APAC Logistics Pte. Ltd.,SG,-2097782.96
2025-05-27,2025-05-27,Client Receipt - CloudBridge Co. #37,Sales Receipt,SaaS-GL,0.0,32991.86,SGD,FAST Credit,CloudBridge Co. #37,***7244,INV-202505-SaaS-GL-0004,,False,False,REF-439058,First Continental Bank,***8393,Globex APAC Logistics Pte. Ltd.,SG,-2064791.1
2025-05-28,2025-05-28,Merchant Processing Fees,Bank/Merchant Fees,ALL,543.58,0.0,SGD,MEPS+,First Continental Bank,***8570,,,False,False,REF-557734,First Continental Bank,***5199,Globex APAC Logistics Pte. Ltd.,SG,-2065334.68
2025-05-28,2025-05-28,Supplier Payment - ExpertNet Subcontractors #6,Supplier Payment,PS-GL,6477.05,0.0,SGD,FAST Debit,ExpertNet Subcontractors #6,***6454,,PO-202505-PS-GL-0006,False,False,REF-611380,First Continental Bank,***2226,Globex APAC Logistics Pte. Ltd.,SG,-2071811.73
2025-05-28,2025-05-28,Client Receipt - Vertex Advisory Client #52,Sales Receipt,PS-GL,0.0,24643.02,SGD,SWIFT MT103,Vertex Advisory Client #52,***9369,INV-202505-PS-GL-0006,,False,False,REF-395996,First Continental Bank,***5876,Globex APAC Logistics Pte. Ltd.,SG,-2047168.71
2025-05-29,2025-05-29,Supplier Payment - CodeCraft Contractors #12,Supplier Payment,SaaS-GL,4462.94,0.0,SGD,MEPS+,CodeCraft Contractors #12,***7685,,PO-202505-SaaS-GL-0001,False,False,REF-727202,First Continental Bank,***7538,Globex APAC Logistics Pte. Ltd.,SG,-2051631.65
2025-05-29,2025-05-29,Marketing - Aurelia Media #6,Marketing,ALL,12714.26,0.0,SGD,FAST Debit,Aurelia Media #6,***2041,,,False,False,REF-772008,First Continental Bank,***3602,Globex APAC Logistics Pte. Ltd.,SG,-2064345.91
2025-05-29,2025-05-29,Supplier Payment - ExpertNet Subcontractors #13,Supplier Payment,PS-GL,31962.34,0.0,SGD,FAST Debit,ExpertNet Subcontractors #13,***1057,,PO-202505-PS-GL-0002,False,False,REF-539863,First Continental Bank,***6069,Globex APAC Logistics Pte. Ltd.,SG,-2096308.25
2025-05-29,2025-05-29,Supplier Payment - TransAsia Freight #38,Supplier Payment,Logistics-APAC,43254.27,0.0,SGD,SWIFT MT103,TransAsia Freight #38,***9315,,PO-202505-Logistics-APAC-0009,False,False,REF-467903,First Continental Bank,***9351,Globex APAC Logistics Pte. Ltd.,SG,-2139562.52
2025-05-29,2025-05-29,Client Receipt - CloudBridge Co. #34,Sales Receipt,SaaS-GL,0.0,2566.36,SGD,SWIFT MT103,CloudBridge Co. #34,***1571,INV-202505-SaaS-GL-0027,,False,False,REF-159058,First Continental Bank,***3650,Globex APAC Logistics Pte. Ltd.,SG,-2136996.16
2025-05-29,2025-05-29,Client Receipt - CloudBridge Co. #44,Sales Receipt,SaaS-GL,0.0,2631.38,SGD,FAST Credit,CloudBridge Co. #44,***3971,INV-202505-SaaS-GL-0022,,False,False,REF-888265,First Continental Bank,***3001,Globex APAC Logistics Pte. Ltd.,SG,-2134364.78
2025-05-30,2025-05-30,Supplier Payment - TransAsia Freight #39,Supplier Payment,Logistics-APAC,3963.68,0.0,SGD,MEPS+,TransAsia Freight #39,***8315,,PO-202505-Logistics-APAC-0008,False,False,REF-377133,First Continental Bank,***8504,Globex APAC Logistics Pte. Ltd.,SG,-2138328.46
2025-05-30,2025-05-30,Supplier Payment - TransAsia Freight #5,Supplier Payment,Logistics-APAC,40698.38,0.0,SGD,SWIFT MT103,TransAsia Freight #5,***7490,,PO-202505-Logistics-APAC-0012,False,False,REF-197004,First Continental Bank,***8204,Globex APAC Logistics Pte. Ltd.,SG,-2179026.84
2025-05-30,2025-05-30,Payroll - GlobalPay Services Ltd,Payroll,ALL,203846.96,0.0,SGD,MEPS+,GlobalPay Services Ltd,***1613,,,False,False,REF-235302,First Continental Bank,***1643,Globex APAC Logistics Pte. Ltd.,SG,-2382873.8
2025-05-30,2025-05-30,Interest Earned,Interest Income,ALL,0.0,9234.38,SGD,SWIFT MT103,First Continental Bank,***2887,,,False,False,REF-537710,First Continental Bank,***1602,Globex APAC Logistics Pte. Ltd.,SG,-2373639.42
2025-05-30,2025-05-30,Client Receipt - Pacific Trade Co. #48,Sales Receipt,Logistics-APAC,0.0,19257.54,SGD,SWIFT MT103,Pacific Trade Co. #48,***2836,INV-202505-Logistics-APAC-0010,,False,False,REF-583579,First Continental Bank,***2145,Globex APAC Logistics Pte. Ltd.,SG,-2354381.88
2025-05-31,2025-05-31,Client Receipt - CloudBridge Co. #24,Sales Receipt,SaaS-GL,0.0,2649.89,SGD,FAST Credit,CloudBridge Co. #24,***3924,INV-202505-SaaS-GL-0011,,False,False,REF-495457,First Continental Bank,***4190,Globex APAC Logistics Pte. Ltd.,SG,-2351731.99
2025-06-01,2025-06-01,Account Maintenance Fee,Bank/Merchant Fees,ALL,2500.0,0.0,SGD,MEPS+,First Continental Bank,***7871,,,False,False,REF-684818,First Continental Bank,***2411,Globex APAC Logistics Pte. Ltd.,SG,-2354231.99
2025-06-02,2025-06-02,Client Receipt - CloudBridge Co. #2,Sales Receipt,SaaS-GL,0.0,5554.86,SGD,FAST Credit,CloudBridge Co. #2,***5961,INV-202506-SaaS-GL-0006,,False,False,REF-303647,First Continental Bank,***2982,Globex APAC Logistics Pte. Ltd.,SG,-2348677.13
2025-06-02,2025-06-02,Client Receipt - CloudBridge Co. #49,Sales Receipt,SaaS-GL,0.0,27311.88,SGD,SWIFT MT103,CloudBridge Co. #49,***2646,INV-202506-SaaS-GL-0009,,False,False,REF-937870,First Continental Bank,***1974,Globex APAC Logistics Pte. Ltd.,SG,-2321365.25
2025-06-02,2025-06-02,Client Receipt - CloudBridge Co. #55,Sales Receipt,SaaS-GL,0.0,42937.46,SGD,SWIFT MT103,CloudBridge Co. #55,***6981,INV-202506-SaaS-GL-0023,,False,False,REF-515690,First Continental Bank,***3138,Globex APAC Logistics Pte. Ltd.,SG,-2278427.79
2025-06-03,2025-06-03,Client Receipt - CloudBridge Co. #63,Sales Receipt,SaaS-GL,0.0,22270.53,SGD,SWIFT MT103,CloudBridge Co. #63,***5989,INV-202506-SaaS-GL-0028,,False,False,REF-828830,First Continental Bank,***3418,Globex APAC Logistics Pte. Ltd.,SG,-2256157.26
2025-06-04,2025-06-04,Supplier Payment - CodeCraft Contractors #12,Supplier Payment,SaaS-GL,1679.71,0.0,SGD,FAST Debit,CodeCraft Contractors #12,***9446,,PO-202506-SaaS-GL-0009,False,False,REF-955749,First Continental Bank,***5510,Globex APAC Logistics Pte. Ltd.,SG,-2257836.97
2025-06-04,2025-06-04,Supplier Payment - HyperCloud Infra #11,Supplier Payment,SaaS-GL,4846.85,0.0,SGD,SWIFT MT103,HyperCloud Infra #11,***5615,,PO-202506-SaaS-GL-0002,False,False,REF-530547,First Continental Bank,***3057,Globex APAC Logistics Pte. Ltd.,SG,-2262683.82
2025-06-04,2025-06-04,Supplier Payment - ExpertNet Subcontractors #17,Supplier Payment,PS-GL,7757.53,0.0,SGD,MEPS+,ExpertNet Subcontractors #17,***6951,,PO-202506-PS-GL-0001,False,False,REF-745252,First Continental Bank,***5154,Globex APAC Logistics Pte. Ltd.,SG,-2270441.35
2025-06-04,2025-06-04,Client Receipt - CloudBridge Co. #17,Sales Receipt,SaaS-GL,0.0,6165.74,SGD,FAST Credit,CloudBridge Co. #17,***6558,INV-202506-SaaS-GL-0012,,False,False,REF-421044,First Continental Bank,***2482,Globex APAC Logistics Pte. Ltd.,SG,-2264275.61
2025-06-04,2025-06-04,Client Receipt - Vertex Advisory Client #16,Sales Receipt,PS-GL,0.0,32317.15,SGD,SWIFT MT103,Vertex Advisory Client #16,***5017,INV-202506-PS-GL-0007,,False,False,REF-254040,First Continental Bank,***9645,Globex APAC Logistics Pte. Ltd.,SG,-2231958.46
2025-06-05,2025-06-05,Supplier Payment - TransAsia Freight #24,Supplier Payment,Logistics-APAC,20164.1,0.0,SGD,FAST Debit,TransAsia Freight #24,***9133,,PO-202506-Logistics-APAC-0008,False,False,REF-582656,First Continental Bank,***9522,Globex APAC Logistics Pte. Ltd.,SG,-2252122.56
2025-06-05,2025-06-05,Client Receipt - Pacific Trade Co. #10,Sales Receipt,Logistics-APAC,0.0,1750.28,SGD,FAST Credit,Pacific Trade Co. #10,***4198,INV-202506-Logistics-APAC-0017,,False,False,REF-449000,First Continental Bank,***5568,Globex APAC Logistics Pte. Ltd.,SG,-2250372.28
2025-06-05,2025-06-05,Client Receipt - CloudBridge Co. #64,Sales Receipt,SaaS-GL,0.0,9627.94,SGD,FAST Credit,CloudBridge Co. #64,***2604,INV-202506-SaaS-GL-0019,,False,False,REF-494578,First Continental Bank,***1631,Globex APAC Logistics Pte. Ltd.,SG,-2240744.34
2025-06-05,2025-06-05,Client Receipt - CloudBridge Co. #74,Sales Receipt,SaaS-GL,0.0,43072.75,SGD,SWIFT MT103,CloudBridge Co. #74,***1157,INV-202506-SaaS-GL-0022,,False,False,REF-962710,First Continental Bank,***8174,Globex APAC Logistics Pte. Ltd.,SG,-2197671.59
2025-06-05,2025-06-05,Client Receipt - Pacific Trade Co. #42,Sales Receipt,Logistics-APAC,0.0,54700.7,SGD,FAST Credit,Pacific Trade Co. #42,***9902,INV-202506-Logistics-APAC-0005,,False,False,REF-607150,First Continental Bank,***4182,Globex APAC Logistics Pte. Ltd.,SG,-2142970.89
2025-06-06,2025-06-06,Marketing - Aurelia Media #10,Marketing,ALL,1077.87,0.0,SGD,SWIFT MT103,Aurelia Media #10,***3486,,,False,False,REF-988876,First Continental Bank,***2289,Globex APAC Logistics Pte. Ltd.,SG,-2144048.76
2025-06-06,2025-06-06,BluePeak Property Mgmt,Rent & Utilities,ALL,9693.58,0.0,SGD,MEPS+,BluePeak Property Mgmt,***9454,,,False,False,REF-109531,First Continental Bank,***6996,Globex APAC Logistics Pte. Ltd.,SG,-2153742.34
2025-06-06,2025-06-06,Client Receipt - Vertex Advisory Client #11,Sales Receipt,PS-GL,0.0,19921.95,SGD,FAST Credit,Vertex Advisory Client #11,***5083,INV-202506-PS-GL-0004,,False,False,REF-215782,First Continental Bank,***2205,Globex APAC Logistics Pte. Ltd.,SG,-2133820.39
2025-06-06,2025-06-06,Client Receipt - Pacific Trade Co. #68,Sales Receipt,Logistics-APAC,0.0,52641.79,SGD,SWIFT MT103,Pacific Trade Co. #68,***9309,INV-202506-Logistics-APAC-0006,,False,False,REF-368622,First Continental Bank,***6091,Globex APAC Logistics Pte. Ltd.,SG,-2081178.6
2025-06-06,2025-06-06,Client Receipt - Pacific Trade Co. #29,Sales Receipt,Logistics-APAC,0.0,74814.68,SGD,FAST Credit,Pacific Trade Co. #29,***9721,INV-202506-Logistics-APAC-0013,,False,False,REF-520418,First Continental Bank,***6912,Globex APAC Logistics Pte. Ltd.,SG,-2006363.92
2025-06-08,2025-06-08,Client Receipt - Pacific Trade Co. #27,Sales Receipt,Logistics-APAC,0.0,28900.6,SGD,SWIFT MT103,Pacific Trade Co. #27,***1834,INV-202506-Logistics-APAC-0003,,False,False,REF-624767,First Continental Bank,***6603,Globex APAC Logistics Pte. Ltd.,SG,-1977463.32
2025-06-09,2025-06-09,Supplier Payment - HyperCloud Infra #4,Supplier Payment,SaaS-GL,214.72,0.0,SGD,FAST Debit,HyperCloud Infra #4,***1244,,PO-202506-SaaS-GL-0003,False,False,REF-273392,First Continental Bank,***8024,Globex APAC Logistics Pte. Ltd.,SG,-1977678.04
2025-06-09,2025-06-09,Supplier Payment - TransAsia Freight #13,Supplier Payment,Logistics-APAC,11649.95,0.0,SGD,FAST Debit,TransAsia Freight #13,***7191,,PO-202506-Logistics-APAC-0005,False,False,REF-827958,First Continental Bank,***9802,Globex APAC Logistics Pte. Ltd.,SG,-1989327.99
2025-06-09,2025-06-09,Supplier Payment - TransAsia Freight #15,Supplier Payment,Logistics-APAC,58791.32,0.0,SGD,MEPS+,TransAsia Freight #15,***2714,,PO-202506-Logistics-APAC-0010,False,False,REF-844847,First Continental Bank,***1620,Globex APAC Logistics Pte. Ltd.,SG,-2048119.31
2025-06-09,2025-06-09,Client Receipt - CloudBridge Co. #73,Sales Receipt,SaaS-GL,0.0,4844.62,SGD,FAST Credit,CloudBridge Co. #73,***7017,INV-202506-SaaS-GL-0018,,False,False,REF-104880,First Continental Bank,***7352,Globex APAC Logistics Pte. Ltd.,SG,-2043274.69
2025-06-09,2025-06-09,Client Receipt - CloudBridge Co. #37,Sales Receipt,SaaS-GL,0.0,14601.1,SGD,FAST Credit,CloudBridge Co. #37,***8698,INV-202506-SaaS-GL-0005,,False,False,REF-950485,First Continental Bank,***7459,Globex APAC Logistics Pte. Ltd.,SG,-2028673.59
2025-06-09,2025-06-09,Client Receipt - Pacific Trade Co. #3,Sales Receipt,Logistics-APAC,0.0,27975.78,SGD,SWIFT MT103,Pacific Trade Co. #3,***7862,INV-202506-Logistics-APAC-0011,,False,False,REF-170839,First Continental Bank,***6935,Globex APAC Logistics Pte. Ltd.,SG,-2000697.81
2025-06-10,2025-06-10,Metro Water & Waste,Rent & Utilities,ALL,573.32,0.0,SGD,FAST Debit,Metro Water & Waste,***8952,,,False,False,REF-659070,First Continental Bank,***1205,Globex APAC Logistics Pte. Ltd.,SG,-2001271.13
2025-06-10,2025-06-10,Supplier Payment - CodeCraft Contractors #8,Supplier Payment,SaaS-GL,3565.04,0.0,SGD,SWIFT MT103,CodeCraft Contractors #8,***4911,,PO-202506-SaaS-GL-0005,False,False,REF-629072,First Continental Bank,***8921,Globex APAC Logistics Pte. Ltd.,SG,-2004836.17
2025-06-10,2025-06-10,Client Receipt - CloudBridge Co. #20,Sales Receipt,SaaS-GL,0.0,4343.88,SGD,FAST Credit,CloudBridge Co. #20,***2350,INV-202506-SaaS-GL-0015,,False,False,REF-663237,First Continental Bank,***2960,Globex APAC Logistics Pte. Ltd.,SG,-2000492.29
2025-06-11,2025-06-11,Supplier Payment - HyperCloud Infra #18,Supplier Payment,SaaS-GL,1420.89,0.0,SGD,FAST Debit,HyperCloud Infra #18,***1939,,PO-202506-SaaS-GL-0006,False,False,REF-814926,First Continental Bank,***2792,Globex APAC Logistics Pte. Ltd.,SG,-2001913.18
2025-06-11,2025-06-11,Supplier Payment - ExpertNet Subcontractors #5,Supplier Payment,PS-GL,1776.18,0.0,SGD,MEPS+,ExpertNet Subcontractors #5,***5760,,PO-202506-PS-GL-0005,False,False,REF-542143,First Continental Bank,***4896,Globex APAC Logistics Pte. Ltd.,SG,-2003689.36
2025-06-11,2025-06-11,Supplier Payment - ExpertNet Subcontractors #17,Supplier Payment,PS-GL,13201.61,0.0,SGD,MEPS+,ExpertNet Subcontractors #17,***5410,,PO-202506-PS-GL-0006,False,False,REF-917553,First Continental Bank,***1683,Globex APAC Logistics Pte. Ltd.,SG,-2016890.97
2025-06-11,2025-06-11,Supplier Payment - ExpertNet Subcontractors #1,Supplier Payment,PS-GL,34209.1,0.0,SGD,SWIFT MT103,ExpertNet Subcontractors #1,***5630,,PO-202506-PS-GL-0008,False,False,REF-897558,First Continental Bank,***3405,Globex APAC Logistics Pte. Ltd.,SG,-2051100.07
2025-06-11,2025-06-11,Client Receipt - Pacific Trade Co. #36,Sales Receipt,Logistics-APAC,0.0,6151.32,SGD,SWIFT MT103,Pacific Trade Co. #36,***3681,INV-202506-Logistics-APAC-0004,,False,False,REF-138700,First Continental Bank,***2576,Globex APAC Logistics Pte. Ltd.,SG,-2044948.75
2025-06-11,2025-06-11,Client Receipt - CloudBridge Co. #61,Sales Receipt,SaaS-GL,0.0,14616.49,SGD,SWIFT MT103,CloudBridge Co. #61,***3715,INV-202506-SaaS-GL-0016,,False,False,REF-249277,First Continental Bank,***3098,Globex APAC Logistics Pte. Ltd.,SG,-2030332.26
2025-06-11,2025-06-11,Client Receipt - Vertex Advisory Client #21,Sales Receipt,PS-GL,0.0,20475.05,SGD,FAST Credit,Vertex Advisory Client #21,***3562,INV-202506-PS-GL-0005,,False,False,REF-274055,First Continental Bank,***1766,Globex APAC Logistics Pte. Ltd.,SG,-2009857.21
2025-06-11,2025-06-11,Client Receipt - Vertex Advisory Client #49,Sales Receipt,PS-GL,0.0,22476.65,SGD,FAST Credit,Vertex Advisory Client #49,***2310,INV-202506-PS-GL-0002,,False,False,REF-855119,First Continental Bank,***2567,Globex APAC Logistics Pte. Ltd.,SG,-1987380.56
2025-06-12,2025-06-12,Supplier Payment - CodeCraft Contractors #1,Supplier Payment,SaaS-GL,3692.18,0.0,SGD,SWIFT MT103,CodeCraft Contractors #1,***6246,,PO-202506-SaaS-GL-0004,False,False,REF-857514,First Continental Bank,***7186,Globex APAC Logistics Pte. Ltd.,SG,-1991072.74
2025-06-12,2025-06-12,Intercompany Settlement - Globex EMEA Manufacturing Ltd.,Intercompany Transfer,ALL,646344.0,0.0,SGD,Internal Transfer,Globex EMEA Manufacturing Ltd.,***5632,,,True,True,REF-894261,First Continental Bank,***2933,Globex APAC Logistics Pte. Ltd.,SG,-2637416.74
2025-06-12,2025-06-12,Client Receipt - Pacific Trade Co. #61,Sales Receipt,Logistics-APAC,0.0,14955.4,SGD,SWIFT MT103,Pacific Trade Co. #61,***5288,INV-202506-Logistics-APAC-0001,,False,False,REF-245860,First Continental Bank,***6563,Globex APAC Logistics Pte. Ltd.,SG,-2622461.34
2025-06-12,2025-06-12,Client Receipt - Vertex Advisory Client #36,Sales Receipt,PS-GL,0.0,34298.07,SGD,SWIFT MT103,Vertex Advisory Client #36,***2965,INV-202506-PS-GL-0006,,False,False,REF-581423,First Continental Bank,***6386,Globex APAC Logistics Pte. Ltd.,SG,-2588163.27
2025-06-12,2025-06-12,Intercompany Reimbursement - Globex EMEA Manufacturing Ltd.,Intercompany Transfer,ALL,0.0,258537.6,SGD,Internal Transfer,Globex EMEA Manufacturing Ltd.,***7374,,,True,True,REF-319525,First Continental Bank,***1822,Globex APAC Logistics Pte. Ltd.,SG,-2329625.67
2025-06-13,2025-06-13,Supplier Payment - HyperCloud Infra #10,Supplier Payment,SaaS-GL,1041.91,0.0,SGD,MEPS+,HyperCloud Infra #10,***9096,,PO-202506-SaaS-GL-0012,False,False,REF-260849,First Continental Bank,***2879,Globex APAC Logistics Pte. Ltd.,SG,-2330667.58
2025-06-13,2025-06-13,Marketing - Aurelia Media #2,Marketing,ALL,7344.41,0.0,SGD,SWIFT MT103,Aurelia Media #2,***7206,,,False,False,REF-951995,First Continental Bank,***1022,Globex APAC Logistics Pte. Ltd.,SG,-2338011.99
2025-06-13,2025-06-13,Client Receipt - Pacific Trade Co. #43,Sales Receipt,Logistics-APAC,0.0,14480.42,SGD,FAST Credit,Pacific Trade Co. #43,***2207,INV-202506-Logistics-APAC-0014,,False,False,REF-521961,First Continental Bank,***3681,Globex APAC Logistics Pte. Ltd.,SG,-2323531.57
2025-06-14,2025-06-14,Client Receipt - CloudBridge Co. #13,Sales Receipt,SaaS-GL,0.0,15184.7,SGD,FAST Credit,CloudBridge Co. #13,***4323,INV-202506-SaaS-GL-0030,,False,False,REF-175137,First Continental Bank,***4966,Globex APAC Logistics Pte. Ltd.,SG,-2308346.87
2025-06-15,2025-06-15,Client Receipt - Pacific Trade Co. #20,Sales Receipt,Logistics-APAC,0.0,17481.05,SGD,SWIFT MT103,Pacific Trade Co. #20,***3311,INV-202506-Logistics-APAC-0009,,False,False,REF-835932,First Continental Bank,***1129,Globex APAC Logistics Pte. Ltd.,SG,-2290865.82
2025-06-16,2025-06-16,Supplier Payment - ExpertNet Subcontractors #5,Supplier Payment,PS-GL,10506.69,0.0,SGD,FAST Debit,ExpertNet Subcontractors #5,***9215,,PO-202506-PS-GL-0003,False,False,REF-797742,First Continental Bank,***2579,Globex APAC Logistics Pte. Ltd.,SG,-2301372.51
2025-06-16,2025-06-16,Supplier Payment - ExpertNet Subcontractors #10,Supplier Payment,PS-GL,12142.46,0.0,SGD,FAST Debit,ExpertNet Subcontractors #10,***5898,,PO-202506-PS-GL-0004,False,False,REF-614783,First Continental Bank,***2225,Globex APAC Logistics Pte. Ltd.,SG,-2313514.97
2025-06-16,2025-06-16,Supplier Payment - HyperCloud Infra #15,Supplier Payment,SaaS-GL,18141.12,0.0,SGD,FAST Debit,HyperCloud Infra #15,***7168,,PO-202506-SaaS-GL-0001,False,False,REF-580149,First Continental Bank,***9750,Globex APAC Logistics Pte. Ltd.,SG,-2331656.09
2025-06-16,2025-06-16,Supplier Payment - HyperCloud Infra #16,Supplier Payment,SaaS-GL,19335.13,0.0,SGD,SWIFT MT103,HyperCloud Infra #16,***9647,,PO-202506-SaaS-GL-0008,False,False,REF-972761,First Continental Bank,***4997,Globex APAC Logistics Pte. Ltd.,SG,-2350991.22
2025-06-16,2025-06-16,Client Receipt - CloudBridge Co. #62,Sales Receipt,SaaS-GL,0.0,5716.18,SGD,SWIFT MT103,CloudBridge Co. #62,***4507,INV-202506-SaaS-GL-0025,,False,False,REF-780723,First Continental Bank,***2430,Globex APAC Logistics Pte. Ltd.,SG,-2345275.04
2025-06-16,2025-06-16,Client Receipt - CloudBridge Co. #13,Sales Receipt,SaaS-GL,0.0,8451.11,SGD,FAST Credit,CloudBridge Co. #13,***8624,INV-202506-SaaS-GL-0021,,False,False,REF-348463,First Continental Bank,***7542,Globex APAC Logistics Pte. Ltd.,SG,-2336823.93
2025-06-16,2025-06-16,Client Receipt - CloudBridge Co. #26,Sales Receipt,SaaS-GL,0.0,8518.33,SGD,SWIFT MT103,CloudBridge Co. #26,***9037,INV-202506-SaaS-GL-0013,,False,False,REF-148050,First Continental Bank,***2116,Globex APAC Logistics Pte. Ltd.,SG,-2328305.6
2025-06-16,2025-06-16,Client Receipt - Pacific Trade Co. #68,Sales Receipt,Logistics-APAC,0.0,20347.82,SGD,SWIFT MT103,Pacific Trade Co. #68,***1572,INV-202506-Logistics-APAC-0007,,False,False,REF-714672,First Continental Bank,***6431,Globex APAC Logistics Pte. Ltd.,SG,-2307957.78
2025-06-17,2025-06-17,Merchant Processing Fees,Bank/Merchant Fees,ALL,1168.86,0.0,SGD,FAST Debit,First Continental Bank,***3098,,,False,False,REF-765678,First Continental Bank,***4887,Globex APAC Logistics Pte. Ltd.,SG,-2309126.64
2025-06-17,2025-06-17,Merchant Processing Fees,Bank/Merchant Fees,ALL,2635.86,0.0,SGD,MEPS+,First Continental Bank,***1094,,,False,False,REF-890270,First Continental Bank,***1512,Globex APAC Logistics Pte. Ltd.,SG,-2311762.5
2025-06-17,2025-06-17,Client Receipt - CloudBridge Co. #67,Sales Receipt,SaaS-GL,0.0,3766.15,SGD,SWIFT MT103,CloudBridge Co. #67,***7435,INV-202506-SaaS-GL-0003,,False,False,REF-989661,First Continental Bank,***8480,Globex APAC Logistics Pte. Ltd.,SG,-2307996.35
2025-06-17,2025-06-17,Client Receipt - Pacific Trade Co. #40,Sales Receipt,Logistics-APAC,0.0,11691.91,SGD,FAST Credit,Pacific Trade Co. #40,***6299,INV-202506-Logistics-APAC-0015,,False,False,REF-617348,First Continental Bank,***2781,Globex APAC Logistics Pte. Ltd.,SG,-2296304.44
2025-06-17,2025-06-17,Client Receipt - Pacific Trade Co. #4,Sales Receipt,Logistics-APAC,0.0,12843.85,SGD,SWIFT MT103,Pacific Trade Co. #4,***7665,INV-202506-Logistics-APAC-0002,,False,False,REF-233032,First Continental Bank,***5855,Globex APAC Logistics Pte. Ltd.,SG,-2283460.59
2025-06-17,2025-06-17,Client Receipt - CloudBridge Co. #32,Sales Receipt,SaaS-GL,0.0,14757.63,SGD,SWIFT MT103,CloudBridge Co. #32,***6763,INV-202506-SaaS-GL-0020,,False,False,REF-598091,First Continental Bank,***6745,Globex APAC Logistics Pte. Ltd.,SG,-2268702.96
2025-06-17,2025-06-17,Client Receipt - CloudBridge Co. #52,Sales Receipt,SaaS-GL,0.0,21308.83,SGD,SWIFT MT103,CloudBridge Co. #52,***8891,INV-202506-SaaS-GL-0024,,False,False,REF-469376,First Continental Bank,***6326,Globex APAC Logistics Pte. Ltd.,SG,-2247394.13
2025-06-18,2025-06-18,Supplier Payment - HyperCloud Infra #4,Supplier Payment,SaaS-GL,1084.62,0.0,SGD,MEPS+,HyperCloud Infra #4,***3006,,PO-202506-SaaS-GL-0011,False,False,REF-311214,First Continental Bank,***4639,Globex APAC Logistics Pte. Ltd.,SG,-2248478.75
2025-06-18,2025-06-18,Supplier Payment - TransAsia Freight #35,Supplier Payment,Logistics-APAC,8039.35,0.0,SGD,FAST Debit,TransAsia Freight #35,***3713,,PO-202506-Logistics-APAC-0001,False,False,REF-349344,First Continental Bank,***5442,Globex APAC Logistics Pte. Ltd.,SG,-2256518.1
2025-06-18,2025-06-18,Supplier Payment - TransAsia Freight #7,Supplier Payment,Logistics-APAC,26710.64,0.0,SGD,MEPS+,TransAsia Freight #7,***9098,,PO-202506-Logistics-APAC-0002,False,False,REF-874172,First Continental Bank,***9546,Globex APAC Logistics Pte. Ltd.,SG,-2283228.74
2025-06-18,2025-06-18,Supplier Payment - TransAsia Freight #41,Supplier Payment,Logistics-APAC,71956.59,0.0,SGD,FAST Debit,TransAsia Freight #41,***2742,,PO-202506-Logistics-APAC-0006,False,False,REF-622341,First Continental Bank,***8688,Globex APAC Logistics Pte. Ltd.,SG,-2355185.33
2025-06-18,2025-06-18,Client Receipt - CloudBridge Co. #22,Sales Receipt,SaaS-GL,0.0,260.91,SGD,FAST Credit,CloudBridge Co. #22,***1772,INV-202506-SaaS-GL-0011,,False,False,REF-895271,First Continental Bank,***9393,Globex APAC Logistics Pte. Ltd.,SG,-2354924.42
2025-06-18,2025-06-18,Client Receipt - CloudBridge Co. #79,Sales Receipt,SaaS-GL,0.0,13312.96,SGD,FAST Credit,CloudBridge Co. #79,***9359,INV-202506-SaaS-GL-0008,,False,False,REF-370687,First Continental Bank,***9622,Globex APAC Logistics Pte. Ltd.,SG,-2341611.46
2025-06-18,2025-06-18,Client Receipt - CloudBridge Co. #33,Sales Receipt,SaaS-GL,0.0,21208.52,SGD,SWIFT MT103,CloudBridge Co. #33,***8349,INV-202506-SaaS-GL-0007,,False,False,REF-722585,First Continental Bank,***9298,Globex APAC Logistics Pte. Ltd.,SG,-2320402.94
2025-06-18,2025-06-18,Client Receipt - Pacific Trade Co. #6,Sales Receipt,Logistics-APAC,0.0,54759.37,SGD,SWIFT MT103,Pacific Trade Co. #6,***8881,INV-202506-Logistics-APAC-0016,,False,False,REF-167235,First Continental Bank,***6485,Globex APAC Logistics Pte. Ltd.,SG,-2265643.57
2025-06-19,2025-06-19,Supplier Payment - TransAsia Freight #35,Supplier Payment,Logistics-APAC,61794.0,0.0,SGD,SWIFT MT103,TransAsia Freight #35,***5870,,PO-202506-Logistics-APAC-0009,False,False,REF-691416,First Continental Bank,***1647,Globex APAC Logistics Pte. Ltd.,SG,-2327437.57
2025-06-19,2025-06-19,Client Receipt - Vertex Advisory Client #31,Sales Receipt,PS-GL,0.0,19072.12,SGD,FAST Credit,Vertex Advisory Client #31,***5061,INV-202506-PS-GL-0008,,False,False,REF-348708,First Continental Bank,***2243,Globex APAC Logistics Pte. Ltd.,SG,-2308365.45
2025-06-20,2025-06-20,Supplier Payment - TransAsia Freight #4,Supplier Payment,Logistics-APAC,21104.66,0.0,SGD,MEPS+,TransAsia Freight #4,***6767,,PO-202506-Logistics-APAC-0007,False,False,REF-681448,First Continental Bank,***5367,Globex APAC Logistics Pte. Ltd.,SG,-2329470.11
2025-06-20,2025-06-20,Client Receipt - Pacific Trade Co. #21,Sales Receipt,Logistics-APAC,0.0,12523.34,SGD,SWIFT MT103,Pacific Trade Co. #21,***8398,INV-202506-Logistics-APAC-0008,,False,False,REF-858609,First Continental Bank,***5086,Globex APAC Logistics Pte. Ltd.,SG,-2316946.77
2025-06-21,2025-06-21,Supplier Payment - CodeCraft Contractors #12,Supplier Payment,SaaS-GL,46260.88,0.0,SGD,FAST Debit,CodeCraft Contractors #12,***9914,,PO-202506-SaaS-GL-0007,False,False,REF-391471,First Continental Bank,***4418,Globex APAC Logistics Pte. Ltd.,SG,-2363207.65
2025-06-21,2025-06-21,VAT/GST Remittance - IRAS Singapore,Tax Payment,ALL,75458.43,0.0,SGD,FAST Debit,IRAS Singapore,***9900,,,False,False,REF-799570,First Continental Bank,***5121,Globex APAC Logistics Pte. Ltd.,SG,-2438666.08
2025-06-22,2025-06-22,Supplier Payment - ExpertNet Subcontractors #16,Supplier Payment,PS-GL,3851.59,0.0,SGD,SWIFT MT103,ExpertNet Subcontractors #16,***5926,,PO-202506-PS-GL-0007,False,False,REF-365509,First Continental Bank,***1039,Globex APAC Logistics Pte. Ltd.,SG,-2442517.67
2025-06-23,2025-06-23,Supplier Payment - ExpertNet Subcontractors #18,Supplier Payment,PS-GL,8749.96,0.0,SGD,SWIFT MT103,ExpertNet Subcontractors #18,***4846,,PO-202506-PS-GL-0002,False,False,REF-883276,First Continental Bank,***3168,Globex APAC Logistics Pte. Ltd.,SG,-2451267.63
2025-06-23,2025-06-23,Client Receipt - CloudBridge Co. #38,Sales Receipt,SaaS-GL,0.0,2141.2,SGD,FAST Credit,CloudBridge Co. #38,***5424,INV-202506-SaaS-GL-0002,,False,False,REF-583309,First Continental Bank,***1573,Globex APAC Logistics Pte. Ltd.,SG,-2449126.43
2025-06-23,2025-06-23,Client Receipt - CloudBridge Co. #63,Sales Receipt,SaaS-GL,0.0,5854.7,SGD,SWIFT MT103,CloudBridge Co. #63,***7014,INV-202506-SaaS-GL-0027,,False,False,REF-968473,First Continental Bank,***4902,Globex APAC Logistics Pte. Ltd.,SG,-2443271.73
2025-06-23,2025-06-23,Client Receipt - CloudBridge Co. #24,Sales Receipt,SaaS-GL,0.0,27300.17,SGD,SWIFT MT103,CloudBridge Co. #24,***5802,INV-202506-SaaS-GL-0004,,False,False,REF-971634,First Continental Bank,***8992,Globex APAC Logistics Pte. Ltd.,SG,-2415971.56
2025-06-23,2025-06-23,Client Receipt - Pacific Trade Co. #63,Sales Receipt,Logistics-APAC,0.0,43410.57,SGD,FAST Credit,Pacific Trade Co. #63,***6763,INV-202506-Logistics-APAC-0010,,False,False,REF-518189,First Continental Bank,***3397,Globex APAC Logistics Pte. Ltd.,SG,-2372560.99
2025-06-24,2025-06-24,Supplier Payment - HyperCloud Infra #1,Supplier Payment,SaaS-GL,131.58,0.0,SGD,SWIFT MT103,HyperCloud Infra #1,***1731,,PO-202506-SaaS-GL-0010,False,False,REF-109048,First Continental Bank,***3223,Globex APAC Logistics Pte. Ltd.,SG,-2372692.57
2025-06-24,2025-06-24,Supplier Payment - Port Services #12,Supplier Payment,Logistics-APAC,21920.82,0.0,SGD,MEPS+,Port Services #12,***1557,,PO-202506-Logistics-APAC-0004,False,False,REF-438967,First Continental Bank,***1419,Globex APAC Logistics Pte. Ltd.,SG,-2394613.39
2025-06-25,2025-06-25,Client Receipt - CloudBridge Co. #13,Sales Receipt,SaaS-GL,0.0,13706.06,SGD,FAST Credit,CloudBridge Co. #13,***8561,INV-202506-SaaS-GL-0029,,False,False,REF-833082,First Continental Bank,***6001,Globex APAC Logistics Pte. Ltd.,SG,-2380907.33
2025-06-25,2025-06-25,Client Receipt - Pacific Trade Co. #51,Sales Receipt,Logistics-APAC,0.0,62766.24,SGD,SWIFT MT103,Pacific Trade Co. #51,***8084,INV-202506-Logistics-APAC-0012,,False,False,REF-719940,First Continental Bank,***5596,Globex APAC Logistics Pte. Ltd.,SG,-2318141.09
2025-06-25,2025-06-25,Client Receipt - Vertex Advisory Client #26,Sales Receipt,PS-GL,0.0,116452.58,SGD,FAST Credit,Vertex Advisory Client #26,***5175,INV-202506-PS-GL-0003,,False,False,REF-136878,First Continental Bank,***8783,Globex APAC Logistics Pte. Ltd.,SG,-2201688.51
2025-06-26,2025-06-26,"Intercompany Settlement - Globex International Holdings, Inc.",Intercompany Transfer,ALL,727984.0,0.0,SGD,Internal Transfer,"Globex International Holdings, Inc.",***2394,,,True,True,REF-104833,First Continental Bank,***7029,Globex APAC Logistics Pte. Ltd.,SG,-2929672.51
2025-06-26,2025-06-26,Client Receipt - CloudBridge Co. #4,Sales Receipt,SaaS-GL,0.0,867.78,SGD,FAST Credit,CloudBridge Co. #4,***6073,INV-202506-SaaS-GL-0001,,False,False,REF-413161,First Continental Bank,***1029,Globex APAC Logistics Pte. Ltd.,SG,-2928804.73
2025-06-26,2025-06-26,Client Receipt - CloudBridge Co. #16,Sales Receipt,SaaS-GL,0.0,11011.81,SGD,FAST Credit,CloudBridge Co. #16,***5882,INV-202506-SaaS-GL-0017,,False,False,REF-796020,First Continental Bank,***8490,Globex APAC Logistics Pte. Ltd.,SG,-2917792.92
2025-06-26,2025-06-26,Client Receipt - Vertex Advisory Client #58,Sales Receipt,PS-GL,0.0,12417.37,SGD,SWIFT MT103,Vertex Advisory Client #58,***8806,INV-202506-PS-GL-0009,,False,False,REF-486153,First Continental Bank,***5048,Globex APAC Logistics Pte. Ltd.,SG,-2905375.55
2025-06-26,2025-06-26,Client Receipt - CloudBridge Co. #18,Sales Receipt,SaaS-GL,0.0,50697.16,SGD,SWIFT MT103,CloudBridge Co. #18,***6026,INV-202506-SaaS-GL-0010,,False,False,REF-973028,First Continental Bank,***3388,Globex APAC Logistics Pte. Ltd.,SG,-2854678.39
2025-06-27,2025-06-27,Marketing - Aurelia Media #8,Marketing,ALL,23505.64,0.0,SGD,SWIFT MT103,Aurelia Media #8,***6943,,,False,False,REF-445016,First Continental Bank,***9551,Globex APAC Logistics Pte. Ltd.,SG,-2878184.03
2025-06-27,2025-06-27,Client Receipt - Vertex Advisory Client #41,Sales Receipt,PS-GL,0.0,29886.13,SGD,FAST Credit,Vertex Advisory Client #41,***5456,INV-202506-PS-GL-0001,,False,False,REF-790272,First Continental Bank,***6143,Globex APAC Logistics Pte. Ltd.,SG,-2848297.9
2025-06-28,2025-06-28,Client Receipt - CloudBridge Co. #19,Sales Receipt,SaaS-GL,0.0,16359.78,SGD,SWIFT MT103,CloudBridge Co. #19,***4668,INV-202506-SaaS-GL-0014,,False,False,REF-402952,First Continental Bank,***1491,Globex APAC Logistics Pte. Ltd.,SG,-2831938.12
2025-06-30,2025-06-30,Supplier Payment - Port Services #12,Supplier Payment,Logistics-APAC,56405.16,0.0,SGD,FAST Debit,Port Services #12,***5944,,PO-202506-Logistics-APAC-0003,False,False,REF-727967,First Continental Bank,***7536,Globex APAC Logistics Pte. Ltd.,SG,-2888343.28
2025-06-30,2025-06-30,Payroll - GlobalPay Services Ltd,Payroll,ALL,205109.12,0.0,SGD,FAST Debit,GlobalPay Services Ltd,***3888,,,False,False,REF-980895,First Continental Bank,***4917,Globex APAC Logistics Pte. Ltd.,SG,-3093452.4
2025-06-30,2025-06-30,Interest Earned,Interest Income,ALL,0.0,11615.42,SGD,SWIFT MT103,First Continental Bank,***4328,,,False,False,REF-207409,First Continental Bank,***9404,Globex APAC Logistics Pte. Ltd.,SG,-3081836.98
2025-06-30,2025-06-30,Client Receipt - CloudBridge Co. #34,Sales Receipt,SaaS-GL,0.0,25204.38,SGD,SWIFT MT103,CloudBridge Co. #34,***6666,INV-202506-SaaS-GL-0026,,False,False,REF-947962,First Continental Bank,***5548,Globex APAC Logistics Pte. Ltd.,SG,-3056632.6
2025-07-01,2025-07-01,Account Maintenance Fee,Bank/Merchant Fees,ALL,2500.0,0.0,SGD,SWIFT MT103,First Continental Bank,***6702,,,False,False,REF-779821,First Continental Bank,***1613,Globex APAC Logistics Pte. Ltd.,SG,-3059132.6
2025-07-02,2025-07-02,Supplier Payment - ExpertNet Subcontractors #14,Supplier Payment,PS-GL,2575.04,0.0,SGD,FAST Debit,ExpertNet Subcontractors #14,***7166,,PO-202507-PS-GL-0008,False,False,REF-171466,First Continental Bank,***2588,Globex APAC Logistics Pte. Ltd.,SG,-3061707.64
2025-07-03,2025-07-03,Supplier Payment - ExpertNet Subcontractors #8,Supplier Payment,PS-GL,7601.72,0.0,SGD,MEPS+,ExpertNet Subcontractors #8,***2222,,PO-202507-PS-GL-0001,False,False,REF-636254,First Continental Bank,***7465,Globex APAC Logistics Pte. Ltd.,SG,-3069309.36
2025-07-03,2025-07-03,Client Receipt - CloudBridge Co. #4,Sales Receipt,SaaS-GL,0.0,14675.29,SGD,FAST Credit,CloudBridge Co. #4,***1991,INV-202507-SaaS-GL-0001,,False,False,REF-696395,First Continental Bank,***8887,Globex APAC Logistics Pte. Ltd.,SG,-3054634.07
2025-07-04,2025-07-04,Supplier Payment - ExpertNet Subcontractors #4,Supplier Payment,PS-GL,4879.12,0.0,SGD,SWIFT MT103,ExpertNet Subcontractors #4,***9790,,PO-202507-PS-GL-0002,False,False,REF-316383,First Continental Bank,***7260,Globex APAC Logistics Pte. Ltd.,SG,-3059513.19
2025-07-04,2025-07-04,Supplier Payment - TransAsia Freight #14,Supplier Payment,Logistics-APAC,9537.26,0.0,SGD,SWIFT MT103,TransAsia Freight #14,***8759,,PO-202507-Logistics-APAC-0008,False,False,REF-606655,First Continental Bank,***3899,Globex APAC Logistics Pte. Ltd.,SG,-3069050.45
2025-07-04,2025-07-04,Client Receipt - CloudBridge Co. #16,Sales Receipt,SaaS-GL,0.0,40077.94,SGD,FAST Credit,CloudBridge Co. #16,***3636,INV-202507-SaaS-GL-0017,,False,False,REF-290915,First Continental Bank,***3410,Globex APAC Logistics Pte. Ltd.,SG,-3028972.51
2025-07-05,2025-07-05,Supplier Payment - CodeCraft Contractors #3,Supplier Payment,SaaS-GL,604.61,0.0,SGD,FAST Debit,CodeCraft Contractors #3,***6550,,PO-202507-SaaS-GL-0001,False,False,REF-932354,First Continental Bank,***7063,Globex APAC Logistics Pte. Ltd.,SG,-3029577.12
2025-07-05,2025-07-05,Supplier Payment - HyperCloud Infra #17,Supplier Payment,SaaS-GL,6014.62,0.0,SGD,FAST Debit,HyperCloud Infra #17,***1155,,PO-202507-SaaS-GL-0002,False,False,REF-612377,First Continental Bank,***3502,Globex APAC Logistics Pte. Ltd.,SG,-3035591.74
2025-07-06,2025-07-06,Client Receipt - CloudBridge Co. #45,Sales Receipt,SaaS-GL,0.0,8461.75,SGD,SWIFT MT103,CloudBridge Co. #45,***3131,INV-202507-SaaS-GL-0020,,False,False,REF-406778,First Continental Bank,***6434,Globex APAC Logistics Pte. Ltd.,SG,-3027129.99
2025-07-07,2025-07-07,Client Receipt - Vertex Advisory Client #2,Sales Receipt,PS-GL,0.0,4639.16,SGD,FAST Credit,Vertex Advisory Client #2,***3321,INV-202507-PS-GL-0004,,False,False,REF-482354,First Continental Bank,***6919,Globex APAC Logistics Pte. Ltd.,SG,-3022490.83
2025-07-07,2025-07-07,Client Receipt - CloudBridge Co. #33,Sales Receipt,SaaS-GL,0.0,10922.69,SGD,SWIFT MT103,CloudBridge Co. #33,***8275,INV-202507-SaaS-GL-0024,,False,False,REF-590746,First Continental Bank,***1552,Globex APAC Logistics Pte. Ltd.,SG,-3011568.14
2025-07-08,2025-07-08,Supplier Payment - ExpertNet Subcontractors #9,Supplier Payment,PS-GL,11992.83,0.0,SGD,SWIFT MT103,ExpertNet Subcontractors #9,***5224,,PO-202507-PS-GL-0004,False,False,REF-528334,First Continental Bank,***8553,Globex APAC Logistics Pte. Ltd.,SG,-3023560.97
2025-07-08,2025-07-08,Client Receipt - CloudBridge Co. #8,Sales Receipt,SaaS-GL,0.0,3422.93,SGD,SWIFT MT103,CloudBridge Co. #8,***2626,INV-202507-SaaS-GL-0006,,False,False,REF-244301,First Continental Bank,***3279,Globex APAC Logistics Pte. Ltd.,SG,-3020138.04
2025-07-08,2025-07-08,Client Receipt - CloudBridge Co. #15,Sales Receipt,SaaS-GL,0.0,3783.26,SGD,SWIFT MT103,CloudBridge Co. #15,***1578,INV-202507-SaaS-GL-0007,,False,False,REF-582847,First Continental Bank,***2705,Globex APAC Logistics Pte. Ltd.,SG,-3016354.78
2025-07-08,2025-07-08,Client Receipt - CloudBridge Co. #72,Sales Receipt,SaaS-GL,0.0,25837.26,SGD,SWIFT MT103,CloudBridge Co. #72,***8339,INV-202507-SaaS-GL-0009,,False,False,REF-124992,First Continental Bank,***9206,Globex APAC Logistics Pte. Ltd.,SG,-2990517.52
2025-07-09,2025-07-09,Merchant Processing Fees,Bank/Merchant Fees,ALL,3296.43,0.0,SGD,FAST Debit,First Continental Bank,***9797,,,False,False,REF-767128,First Continental Bank,***2264,Globex APAC Logistics Pte. Ltd.,SG,-2993813.95
2025-07-09,2025-07-09,Client Receipt - CloudBridge Co. #41,Sales Receipt,SaaS-GL,0.0,6036.4,SGD,FAST Credit,CloudBridge Co. #41,***1640,INV-202507-SaaS-GL-0027,,False,False,REF-825647,First Continental Bank,***1281,Globex APAC Logistics Pte. Ltd.,SG,-2987777.55
2025-07-09,2025-07-09,Client Receipt - CloudBridge Co. #40,Sales Receipt,SaaS-GL,0.0,11513.1,SGD,FAST Credit,CloudBridge Co. #40,***2072,INV-202507-SaaS-GL-0010,,False,False,REF-528088,First Continental Bank,***7069,Globex APAC Logistics Pte. Ltd.,SG,-2976264.45
2025-07-09,2025-07-09,Client Receipt - Vertex Advisory Client #54,Sales Receipt,PS-GL,0.0,45646.14,SGD,SWIFT MT103,Vertex Advisory Client #54,***2403,INV-202507-PS-GL-0011,,False,False,REF-379138,First Continental Bank,***5634,Globex APAC Logistics Pte. Ltd.,SG,-2930618.31
2025-07-09,2025-07-09,Client Receipt - Pacific Trade Co. #54,Sales Receipt,Logistics-APAC,0.0,50034.24,SGD,FAST Credit,Pacific Trade Co. #54,***3290,INV-202507-Logistics-APAC-0009,,False,False,REF-131493,First Continental Bank,***6857,Globex APAC Logistics Pte. Ltd.,SG,-2880584.07
2025-07-10,2025-07-10,Supplier Payment - ExpertNet Subcontractors #16,Supplier Payment,PS-GL,1440.35,0.0,SGD,SWIFT MT103,ExpertNet Subcontractors #16,***8328,,PO-202507-PS-GL-0007,False,False,REF-155753,First Continental Bank,***1858,Globex APAC Logistics Pte. Ltd.,SG,-2882024.42
2025-07-10,2025-07-10,Supplier Payment - ExpertNet Subcontractors #4,Supplier Payment,PS-GL,5788.87,0.0,SGD,MEPS+,ExpertNet Subcontractors #4,***9497,,PO-202507-PS-GL-0006,False,False,REF-110058,First Continental Bank,***6967,Globex APAC Logistics Pte. Ltd.,SG,-2887813.29
2025-07-10,2025-07-10,Supplier Payment - Port Services #19,Supplier Payment,Logistics-APAC,62438.21,0.0,SGD,SWIFT MT103,Port Services #19,***8230,,PO-202507-Logistics-APAC-0009,False,False,REF-325806,First Continental Bank,***6463,Globex APAC Logistics Pte. Ltd.,SG,-2950251.5
2025-07-10,2025-07-10,Client Receipt - CloudBridge Co. #41,Sales Receipt,SaaS-GL,0.0,10540.2,SGD,SWIFT MT103,CloudBridge Co. #41,***6947,INV-202507-SaaS-GL-0004,,False,False,REF-811572,First Continental Bank,***8882,Globex APAC Logistics Pte. Ltd.,SG,-2939711.3
2025-07-10,2025-07-10,Client Receipt - CloudBridge Co. #44,Sales Receipt,SaaS-GL,0.0,18924.67,SGD,FAST Credit,CloudBridge Co. #44,***4429,INV-202507-SaaS-GL-0026,,False,False,REF-449274,First Continental Bank,***1856,Globex APAC Logistics Pte. Ltd.,SG,-2920786.63
2025-07-10,2025-07-10,Client Receipt - CloudBridge Co. #61,Sales Receipt,SaaS-GL,0.0,19510.56,SGD,SWIFT MT103,CloudBridge Co. #61,***5218,INV-202507-SaaS-GL-0023,,False,False,REF-531878,First Continental Bank,***9584,Globex APAC Logistics Pte. Ltd.,SG,-2901276.07
2025-07-10,2025-07-10,Client Receipt - Vertex Advisory Client #13,Sales Receipt,PS-GL,0.0,51216.65,SGD,SWIFT MT103,Vertex Advisory Client #13,***7724,INV-202507-PS-GL-0002,,False,False,REF-619883,First Continental Bank,***6241,Globex APAC Logistics Pte. Ltd.,SG,-2850059.42
2025-07-12,2025-07-12,"Intercompany Settlement - Globex International Holdings, Inc.",Intercompany Transfer,ALL,608025.0,0.0,SGD,Internal Transfer,"Globex International Holdings, Inc.",***2610,,,True,True,REF-260054,First Continental Bank,***3552,Globex APAC Logistics Pte. Ltd.,SG,-3458084.42
2025-07-12,2025-07-12,Client Receipt - Pacific Trade Co. #58,Sales Receipt,Logistics-APAC,0.0,15277.29,SGD,SWIFT MT103,Pacific Trade Co. #58,***7626,INV-202507-Logistics-APAC-0004,,False,False,REF-272758,First Continental Bank,***4235,Globex APAC Logistics Pte. Ltd.,SG,-3442807.13
2025-07-12,2025-07-12,"Intercompany Reimbursement - Globex International Holdings, Inc.",Intercompany Transfer,ALL,0.0,243210.0,SGD,Internal Transfer,"Globex International Holdings, Inc.",***8411,,,True,True,REF-656929,First Continental Bank,***8279,Globex APAC Logistics Pte. Ltd.,SG,-3199597.13
2025-07-13,2025-07-13,Supplier Payment - HyperCloud Infra #18,Supplier Payment,SaaS-GL,2959.16,0.0,SGD,FAST Debit,HyperCloud Infra #18,***3887,,PO-202507-SaaS-GL-0004,False,False,REF-922357,First Continental Bank,***9465,Globex APAC Logistics Pte. Ltd.,SG,-3202556.29
2025-07-14,2025-07-14,Client Receipt - CloudBridge Co. #69,Sales Receipt,SaaS-GL,0.0,4674.54,SGD,SWIFT MT103,CloudBridge Co. #69,***1617,INV-202507-SaaS-GL-0016,,False,False,REF-695818,First Continental Bank,***5921,Globex APAC Logistics Pte. Ltd.,SG,-3197881.75
2025-07-14,2025-07-14,Client Receipt - CloudBridge Co. #73,Sales Receipt,SaaS-GL,0.0,17338.19,SGD,FAST Credit,CloudBridge Co. #73,***8997,INV-202507-SaaS-GL-0028,,False,False,REF-254715,First Continental Bank,***7098,Globex APAC Logistics Pte. Ltd.,SG,-3180543.56
2025-07-14,2025-07-14,Client Receipt - Pacific Trade Co. #25,Sales Receipt,Logistics-APAC,0.0,21091.78,SGD,FAST Credit,Pacific Trade Co. #25,***5261,INV-202507-Logistics-APAC-0007,,False,False,REF-739724,First Continental Bank,***6953,Globex APAC Logistics Pte. Ltd.,SG,-3159451.78
2025-07-15,2025-07-15,Alphagrid Utilities,Rent & Utilities,ALL,9694.85,0.0,SGD,SWIFT MT103,Alphagrid Utilities,***5627,,,False,False,REF-506571,First Continental Bank,***9067,Globex APAC Logistics Pte. Ltd.,SG,-3169146.63
2025-07-15,2025-07-15,Client Receipt - Vertex Advisory Client #26,Sales Receipt,PS-GL,0.0,15355.27,SGD,SWIFT MT103,Vertex Advisory Client #26,***4877,INV-202507-PS-GL-0007,,False,False,REF-925057,First Continental Bank,***6726,Globex APAC Logistics Pte. Ltd.,SG,-3153791.36
2025-07-15,2025-07-15,Client Receipt - CloudBridge Co. #79,Sales Receipt,SaaS-GL,0.0,16797.43,SGD,FAST Credit,CloudBridge Co. #79,***4986,INV-202507-SaaS-GL-0018,,False,False,REF-266429,First Continental Bank,***1072,Globex APAC Logistics Pte. Ltd.,SG,-3136993.93
2025-07-16,2025-07-16,Supplier Payment - Port Services #13,Supplier Payment,Logistics-APAC,1017.96,0.0,SGD,SWIFT MT103,Port Services #13,***5808,,PO-202507-Logistics-APAC-0002,False,False,REF-931553,First Continental Bank,***6689,Globex APAC Logistics Pte. Ltd.,SG,-3138011.89
2025-07-16,2025-07-16,Client Receipt - Vertex Advisory Client #44,Sales Receipt,PS-GL,0.0,21151.35,SGD,SWIFT MT103,Vertex Advisory Client #44,***3150,INV-202507-PS-GL-0001,,False,False,REF-573559,First Continental Bank,***6401,Globex APAC Logistics Pte. Ltd.,SG,-3116860.54
2025-07-16,2025-07-16,Client Receipt - CloudBridge Co. #48,Sales Receipt,SaaS-GL,0.0,26685.31,SGD,SWIFT MT103,CloudBridge Co. #48,***6138,INV-202507-SaaS-GL-0029,,False,False,REF-499873,First Continental Bank,***9159,Globex APAC Logistics Pte. Ltd.,SG,-3090175.23
2025-07-16,2025-07-16,Client Receipt - Vertex Advisory Client #20,Sales Receipt,PS-GL,0.0,31690.31,SGD,SWIFT MT103,Vertex Advisory Client #20,***4643,INV-202507-PS-GL-0010,,False,False,REF-476771,First Continental Bank,***9575,Globex APAC Logistics Pte. Ltd.,SG,-3058484.92
2025-07-17,2025-07-17,Supplier Payment - TransAsia Freight #36,Supplier Payment,Logistics-APAC,44838.44,0.0,SGD,FAST Debit,TransAsia Freight #36,***9101,,PO-202507-Logistics-APAC-0006,False,False,REF-217424,First Continental Bank,***2713,Globex APAC Logistics Pte. Ltd.,SG,-3103323.36
2025-07-17,2025-07-17,Client Receipt - CloudBridge Co. #31,Sales Receipt,SaaS-GL,0.0,1498.45,SGD,FAST Credit,CloudBridge Co. #31,***8230,INV-202507-SaaS-GL-0025,,False,False,REF-695645,First Continental Bank,***6959,Globex APAC Logistics Pte. Ltd.,SG,-3101824.91
2025-07-18,2025-07-18,Supplier Payment - ExpertNet Subcontractors #17,Supplier Payment,PS-GL,3922.92,0.0,SGD,FAST Debit,ExpertNet Subcontractors #17,***8580,,PO-202507-PS-GL-0005,False,False,REF-486517,First Continental Bank,***5688,Globex APAC Logistics Pte. Ltd.,SG,-3105747.83
2025-07-18,2025-07-18,Client Receipt - Vertex Advisory Client #10,Sales Receipt,PS-GL,0.0,6343.65,SGD,SWIFT MT103,Vertex Advisory Client #10,***8110,INV-202507-PS-GL-0012,,False,False,REF-848975,First Continental Bank,***9247,Globex APAC Logistics Pte. Ltd.,SG,-3099404.18
2025-07-19,2025-07-19,Supplier Payment - HyperCloud Infra #9,Supplier Payment,SaaS-GL,3274.59,0.0,SGD,SWIFT MT103,HyperCloud Infra #9,***7997,,PO-202507-SaaS-GL-0007,False,False,REF-515561,First Continental Bank,***7808,Globex APAC Logistics Pte. Ltd.,SG,-3102678.77
2025-07-20,2025-07-20,Marketing - Beacon Digital #3,Marketing,ALL,21809.82,0.0,SGD,SWIFT MT103,Beacon Digital #3,***8025,,,False,False,REF-887464,First Continental Bank,***9261,Globex APAC Logistics Pte. Ltd.,SG,-3124488.59
2025-07-20,2025-07-20,VAT/GST Remittance - IRAS Singapore,Tax Payment,ALL,73566.98,0.0,SGD,SWIFT MT103,IRAS Singapore,***7200,,,False,False,REF-803468,First Continental Bank,***8270,Globex APAC Logistics Pte. Ltd.,SG,-3198055.57
2025-07-20,2025-07-20,Client Receipt - Vertex Advisory Client #53,Sales Receipt,PS-GL,0.0,1137.68,SGD,FAST Credit,Vertex Advisory Client #53,***9239,INV-202507-PS-GL-0009,,False,False,REF-325104,First Continental Bank,***7802,Globex APAC Logistics Pte. Ltd.,SG,-3196917.89
2025-07-21,2025-07-21,Supplier Payment - TransAsia Freight #34,Supplier Payment,Logistics-APAC,32456.54,0.0,SGD,MEPS+,TransAsia Freight #34,***6117,,PO-202507-Logistics-APAC-0011,False,False,REF-721251,First Continental Bank,***2575,Globex APAC Logistics Pte. Ltd.,SG,-3229374.43
2025-07-22,2025-07-22,Supplier Payment - TransAsia Freight #19,Supplier Payment,Logistics-APAC,34973.57,0.0,SGD,SWIFT MT103,TransAsia Freight #19,***4219,,PO-202507-Logistics-APAC-0005,False,False,REF-367544,First Continental Bank,***9883,Globex APAC Logistics Pte. Ltd.,SG,-3264348.0
2025-07-22,2025-07-22,Client Receipt - Pacific Trade Co. #2,Sales Receipt,Logistics-APAC,0.0,51323.01,SGD,SWIFT MT103,Pacific Trade Co. #2,***7020,INV-202507-Logistics-APAC-0008,,False,False,REF-375397,First Continental Bank,***7799,Globex APAC Logistics Pte. Ltd.,SG,-3213024.99
2025-07-22,2025-07-22,Client Receipt - CloudBridge Co. #71,Sales Receipt,SaaS-GL,0.0,56137.39,SGD,SWIFT MT103,CloudBridge Co. #71,***8342,INV-202507-SaaS-GL-0015,,False,False,REF-604507,First Continental Bank,***5324,Globex APAC Logistics Pte. Ltd.,SG,-3156887.6
2025-07-23,2025-07-23,Supplier Payment - Port Services #17,Supplier Payment,Logistics-APAC,7245.82,0.0,SGD,MEPS+,Port Services #17,***7256,,PO-202507-Logistics-APAC-0003,False,False,REF-900585,First Continental Bank,***6467,Globex APAC Logistics Pte. Ltd.,SG,-3164133.42
2025-07-23,2025-07-23,Client Receipt - CloudBridge Co. #74,Sales Receipt,SaaS-GL,0.0,4498.43,SGD,FAST Credit,CloudBridge Co. #74,***4595,INV-202507-SaaS-GL-0019,,False,False,REF-357589,First Continental Bank,***4345,Globex APAC Logistics Pte. Ltd.,SG,-3159634.99
2025-07-23,2025-07-23,Client Receipt - CloudBridge Co. #69,Sales Receipt,SaaS-GL,0.0,7519.61,SGD,SWIFT MT103,CloudBridge Co. #69,***9240,INV-202507-SaaS-GL-0003,,False,False,REF-425353,First Continental Bank,***2094,Globex APAC Logistics Pte. Ltd.,SG,-3152115.38
2025-07-24,2025-07-24,Supplier Payment - TransAsia Freight #31,Supplier Payment,Logistics-APAC,31464.45,0.0,SGD,MEPS+,TransAsia Freight #31,***2322,,PO-202507-Logistics-APAC-0001,False,False,REF-609865,First Continental Bank,***8012,Globex APAC Logistics Pte. Ltd.,SG,-3183579.83
2025-07-24,2025-07-24,Supplier Payment - ExpertNet Subcontractors #18,Supplier Payment,PS-GL,43146.46,0.0,SGD,SWIFT MT103,ExpertNet Subcontractors #18,***2835,,PO-202507-PS-GL-0009,False,False,REF-489360,First Continental Bank,***6178,Globex APAC Logistics Pte. Ltd.,SG,-3226726.29
2025-07-24,2025-07-24,Client Receipt - Pacific Trade Co. #15,Sales Receipt,Logistics-APAC,0.0,16804.44,SGD,FAST Credit,Pacific Trade Co. #15,***1352,INV-202507-Logistics-APAC-0005,,False,False,REF-637985,First Continental Bank,***4617,Globex APAC Logistics Pte. Ltd.,SG,-3209921.85
2025-07-24,2025-07-24,Client Receipt - CloudBridge Co. #11,Sales Receipt,SaaS-GL,0.0,19542.09,SGD,SWIFT MT103,CloudBridge Co. #11,***7796,INV-202507-SaaS-GL-0012,,False,False,REF-917993,First Continental Bank,***5521,Globex APAC Logistics Pte. Ltd.,SG,-3190379.76
2025-07-24,2025-07-24,Client Receipt - Pacific Trade Co. #56,Sales Receipt,Logistics-APAC,0.0,48188.29,SGD,FAST Credit,Pacific Trade Co. #56,***5378,INV-202507-Logistics-APAC-0006,,False,False,REF-321360,First Continental Bank,***1087,Globex APAC Logistics Pte. Ltd.,SG,-3142191.47
2025-07-25,2025-07-25,Supplier Payment - CodeCraft Contractors #2,Supplier Payment,SaaS-GL,8454.09,0.0,SGD,SWIFT MT103,CodeCraft Contractors #2,***2366,,PO-202507-SaaS-GL-0003,False,False,REF-286888,First Continental Bank,***4482,Globex APAC Logistics Pte. Ltd.,SG,-3150645.56
2025-07-25,2025-07-25,Marketing - Beacon Digital #6,Marketing,ALL,8644.05,0.0,SGD,FAST Debit,Beacon Digital #6,***1507,,,False,False,REF-851797,First Continental Bank,***6414,Globex APAC Logistics Pte. Ltd.,SG,-3159289.61
2025-07-25,2025-07-25,Client Receipt - Vertex Advisory Client #4,Sales Receipt,PS-GL,0.0,11018.04,SGD,SWIFT MT103,Vertex Advisory Client #4,***9691,INV-202507-PS-GL-0006,,False,False,REF-139777,First Continental Bank,***9815,Globex APAC Logistics Pte. Ltd.,SG,-3148271.57
2025-07-26,2025-07-26,Payroll - GlobalPay Services Ltd,Payroll,ALL,97204.83,0.0,SGD,SWIFT MT103,GlobalPay Services Ltd,***9009,,,False,False,REF-193711,First Continental Bank,***9970,Globex APAC Logistics Pte. Ltd.,SG,-3245476.4
2025-07-26,2025-07-26,Payroll - GlobalPay Services Ltd,Payroll,ALL,97204.83,0.0,SGD,SWIFT MT103,GlobalPay Services Ltd,***6090,,,False,False,REF-335467,First Continental Bank,***6885,Globex APAC Logistics Pte. Ltd.,SG,-3342681.23
2025-07-26,2025-07-26,Intercompany Settlement - Globex EMEA Manufacturing Ltd.,Intercompany Transfer,ALL,322010.0,0.0,SGD,Internal Transfer,Globex EMEA Manufacturing Ltd.,***4858,,,True,True,REF-711326,First Continental Bank,***4552,Globex APAC Logistics Pte. Ltd.,SG,-3664691.23
2025-07-26,2025-07-26,Client Receipt - CloudBridge Co. #44,Sales Receipt,SaaS-GL,0.0,3690.83,SGD,FAST Credit,CloudBridge Co. #44,***4677,INV-202507-SaaS-GL-0011,,False,False,REF-717574,First Continental Bank,***3583,Globex APAC Logistics Pte. Ltd.,SG,-3661000.4
2025-07-26,2025-07-26,Client Receipt - Pacific Trade Co. #54,Sales Receipt,Logistics-APAC,0.0,57724.57,SGD,FAST Credit,Pacific Trade Co. #54,***3032,INV-202507-Logistics-APAC-0001,,False,False,REF-444179,First Continental Bank,***1647,Globex APAC Logistics Pte. Ltd.,SG,-3603275.83
2025-07-27,2025-07-27,Supplier Payment - ExpertNet Subcontractors #18,Supplier Payment,PS-GL,6457.57,0.0,SGD,SWIFT MT103,ExpertNet Subcontractors #18,***8782,,PO-202507-PS-GL-0003,False,False,REF-778392,First Continental Bank,***9399,Globex APAC Logistics Pte. Ltd.,SG,-3609733.4
2025-07-28,2025-07-28,Supplier Payment - HyperCloud Infra #1,Supplier Payment,SaaS-GL,12234.33,0.0,SGD,FAST Debit,HyperCloud Infra #1,***8606,,PO-202507-SaaS-GL-0008,False,False,REF-418951,First Continental Bank,***1520,Globex APAC Logistics Pte. Ltd.,SG,-3621967.73
2025-07-28,2025-07-28,Supplier Payment - TransAsia Freight #2,Supplier Payment,Logistics-APAC,51946.42,0.0,SGD,SWIFT MT103,TransAsia Freight #2,***1738,,PO-202507-Logistics-APAC-0007,False,False,REF-503229,First Continental Bank,***7129,Globex APAC Logistics Pte. Ltd.,SG,-3673914.15
2025-07-28,2025-07-28,Corporate Tax Estimate,Tax Payment,ALL,55278.98,0.0,SGD,FAST Debit,IRAS Singapore,***7379,,,False,False,REF-305938,First Continental Bank,***4728,Globex APAC Logistics Pte. Ltd.,SG,-3729193.13
2025-07-28,2025-07-28,Client Receipt - CloudBridge Co. #22,Sales Receipt,SaaS-GL,0.0,2059.37,SGD,SWIFT MT103,CloudBridge Co. #22,***5727,INV-202507-SaaS-GL-0014,,False,False,REF-231577,First Continental Bank,***1993,Globex APAC Logistics Pte. Ltd.,SG,-3727133.76
2025-07-28,2025-07-28,Client Receipt - Pacific Trade Co. #43,Sales Receipt,Logistics-APAC,0.0,8909.87,SGD,FAST Credit,Pacific Trade Co. #43,***8995,INV-202507-Logistics-APAC-0003,,False,False,REF-259401,First Continental Bank,***4290,Globex APAC Logistics Pte. Ltd.,SG,-3718223.89
2025-07-29,2025-07-29,Supplier Payment - CodeCraft Contractors #7,Supplier Payment,SaaS-GL,14945.55,0.0,SGD,MEPS+,CodeCraft Contractors #7,***4653,,PO-202507-SaaS-GL-0006,False,False,REF-225149,First Continental Bank,***3297,Globex APAC Logistics Pte. Ltd.,SG,-3733169.44
2025-07-29,2025-07-29,Supplier Payment - HyperCloud Infra #18,Supplier Payment,SaaS-GL,18222.14,0.0,SGD,FAST Debit,HyperCloud Infra #18,***5723,,PO-202507-SaaS-GL-0009,False,False,REF-266046,First Continental Bank,***3519,Globex APAC Logistics Pte. Ltd.,SG,-3751391.58
2025-07-29,2025-07-29,Supplier Payment - CodeCraft Contractors #3,Supplier Payment,SaaS-GL,29876.28,0.0,SGD,SWIFT MT103,CodeCraft Contractors #3,***3274,,PO-202507-SaaS-GL-0005,False,False,REF-821560,First Continental Bank,***8965,Globex APAC Logistics Pte. Ltd.,SG,-3781267.86
2025-07-29,2025-07-29,Client Receipt - CloudBridge Co. #53,Sales Receipt,SaaS-GL,0.0,28457.75,SGD,SWIFT MT103,CloudBridge Co. #53,***4083,INV-202507-SaaS-GL-0013,,False,False,REF-374177,First Continental Bank,***6950,Globex APAC Logistics Pte. Ltd.,SG,-3752810.11
2025-07-29,2025-07-29,Client Receipt - Pacific Trade Co. #1,Sales Receipt,Logistics-APAC,0.0,139471.62,SGD,FAST Credit,Pacific Trade Co. #1,***3388,INV-202507-Logistics-APAC-0002,,False,False,REF-961525,First Continental Bank,***2301,Globex APAC Logistics Pte. Ltd.,SG,-3613338.49
2025-07-30,2025-07-30,Merchant Processing Fees,Bank/Merchant Fees,ALL,311.43,0.0,SGD,MEPS+,First Continental Bank,***2830,,,False,False,REF-551814,First Continental Bank,***6800,Globex APAC Logistics Pte. Ltd.,SG,-3613649.92
2025-07-30,2025-07-30,Supplier Payment - TransAsia Freight #5,Supplier Payment,Logistics-APAC,3597.56,0.0,SGD,FAST Debit,TransAsia Freight #5,***6261,,PO-202507-Logistics-APAC-0004,False,False,REF-960347,First Continental Bank,***9171,Globex APAC Logistics Pte. Ltd.,SG,-3617247.48
2025-07-30,2025-07-30,Supplier Payment - TransAsia Freight #41,Supplier Payment,Logistics-APAC,61947.18,0.0,SGD,SWIFT MT103,TransAsia Freight #41,***1312,,PO-202507-Logistics-APAC-0010,False,False,REF-778406,First Continental Bank,***9746,Globex APAC Logistics Pte. Ltd.,SG,-3679194.66
2025-07-30,2025-07-30,Client Receipt - Vertex Advisory Client #39,Sales Receipt,PS-GL,0.0,5835.45,SGD,FAST Credit,Vertex Advisory Client #39,***8358,INV-202507-PS-GL-0005,,False,False,REF-156327,First Continental Bank,***1992,Globex APAC Logistics Pte. Ltd.,SG,-3673359.21
2025-07-30,2025-07-30,Interest Earned,Interest Income,ALL,0.0,10621.98,SGD,FAST Credit,First Continental Bank,***9774,,,False,False,REF-702077,First Continental Bank,***2006,Globex APAC Logistics Pte. Ltd.,SG,-3662737.23
2025-07-30,2025-07-30,Client Receipt - CloudBridge Co. #71,Sales Receipt,SaaS-GL,0.0,15159.38,SGD,FAST Credit,CloudBridge Co. #71,***5320,INV-202507-SaaS-GL-0021,,False,False,REF-466781,First Continental Bank,***5534,Globex APAC Logistics Pte. Ltd.,SG,-3647577.85
2025-07-30,2025-07-30,Client Receipt - Pacific Trade Co. #37,Sales Receipt,Logistics-APAC,0.0,78979.77,SGD,FAST Credit,Pacific Trade Co. #37,***9737,INV-202507-Logistics-APAC-0010,,False,False,REF-989433,First Continental Bank,***6618,Globex APAC Logistics Pte. Ltd.,SG,-3568598.08
2025-07-31,2025-07-31,Client Receipt - CloudBridge Co. #12,Sales Receipt,SaaS-GL,0.0,1989.59,SGD,FAST Credit,CloudBridge Co. #12,***6287,INV-202507-SaaS-GL-0022,,False,False,REF-711452,First Continental Bank,***5240,Globex APAC Logistics Pte. Ltd.,SG,-3566608.49
2025-07-31,2025-07-31,Client Receipt - CloudBridge Co. #19,Sales Receipt,SaaS-GL,0.0,3794.86,SGD,FAST Credit,CloudBridge Co. #19,***7805,INV-202507-SaaS-GL-0002,,False,False,REF-441785,First Continental Bank,***4585,Globex APAC Logistics Pte. Ltd.,SG,-3562813.63
2025-07-31,2025-07-31,Client Receipt - Vertex Advisory Client #16,Sales Receipt,PS-GL,0.0,26821.92,SGD,SWIFT MT103,Vertex Advisory Client #16,***2374,INV-202507-PS-GL-0008,,False,False,REF-838548,First Continental Bank,***8280,Globex APAC Logistics Pte. Ltd.,SG,-3535991.71
2025-07-31,2025-07-31,Client Receipt - CloudBridge Co. #10,Sales Receipt,SaaS-GL,0.0,26832.44,SGD,SWIFT MT103,CloudBridge Co. #10,***4944,INV-202507-SaaS-GL-0008,,False,False,REF-113329,First Continental Bank,***6437,Globex APAC Logistics Pte. Ltd.,SG,-3509159.27
2025-07-31,2025-07-31,Client Receipt - CloudBridge Co. #13,Sales Receipt,SaaS-GL,0.0,28642.68,SGD,SWIFT MT103,CloudBridge Co. #13,***1830,INV-202507-SaaS-GL-0005,,False,False,REF-560120,First Continental Bank,***9295,Globex APAC Logistics Pte. Ltd.,SG,-3480516.59
2025-07-31,2025-07-31,Client Receipt - Vertex Advisory Client #37,Sales Receipt,PS-GL,0.0,71827.31,SGD,FAST Credit,Vertex Advisory Client #37,***1535,INV-202507-PS-GL-0003,,False,False,REF-145160,First Continental Bank,***9886,Globex APAC Logistics Pte. Ltd.,SG,-3408689.28
2025-08-01,2025-08-01,Account Maintenance Fee,Bank/Merchant Fees,ALL,2500.0,0.0,SGD,MEPS+,First Continental Bank,***9158,,,False,False,REF-913553,First Continental Bank,***1909,Globex APAC Logistics Pte. Ltd.,SG,-3411189.28
2025-08-01,2025-08-01,Supplier Payment - HyperCloud Infra #4,Supplier Payment,SaaS-GL,8994.84,0.0,SGD,FAST Debit,HyperCloud Infra #4,***4361,,PO-202508-SaaS-GL-0003,False,False,REF-567747,First Continental Bank,***4254,Globex APAC Logistics Pte. Ltd.,SG,-3420184.12
2025-08-01,2025-08-01,Supplier Payment - CodeCraft Contractors #11,Supplier Payment,SaaS-GL,9982.96,0.0,SGD,SWIFT MT103,CodeCraft Contractors #11,***8765,,PO-202508-SaaS-GL-0010,False,False,REF-865586,First Continental Bank,***4327,Globex APAC Logistics Pte. Ltd.,SG,-3430167.08
2025-08-01,2025-08-01,Supplier Payment - ExpertNet Subcontractors #18,Supplier Payment,PS-GL,15222.19,0.0,SGD,FAST Debit,ExpertNet Subcontractors #18,***8380,,PO-202508-PS-GL-0012,False,False,REF-242256,First Continental Bank,***2761,Globex APAC Logistics Pte. Ltd.,SG,-3445389.27
2025-08-01,2025-08-01,Client Receipt - CloudBridge Co. #19,Sales Receipt,SaaS-GL,0.0,32719.36,SGD,FAST Credit,CloudBridge Co. #19,***6456,INV-202508-SaaS-GL-0019,,False,False,REF-551380,First Continental Bank,***7506,Globex APAC Logistics Pte. Ltd.,SG,-3412669.91
2025-08-01,2025-08-01,Client Receipt - Vertex Advisory Client #49,Sales Receipt,PS-GL,0.0,36500.97,SGD,FAST Credit,Vertex Advisory Client #49,***5184,INV-202508-PS-GL-0007,,False,False,REF-586754,First Continental Bank,***7114,Globex APAC Logistics Pte. Ltd.,SG,-3376168.94
2025-08-03,2025-08-03,Supplier Payment - TransAsia Freight #12,Supplier Payment,Logistics-APAC,35596.67,0.0,SGD,MEPS+,TransAsia Freight #12,***4077,,PO-202508-Logistics-APAC-0001,False,False,REF-692593,First Continental Bank,***4237,Globex APAC Logistics Pte. Ltd.,SG,-3411765.61
2025-08-03,2025-08-03,Client Receipt - CloudBridge Co. #70,Sales Receipt,SaaS-GL,0.0,56970.58,SGD,SWIFT MT103,CloudBridge Co. #70,***2164,INV-202508-SaaS-GL-0009,,False,False,REF-746507,First Continental Bank,***3026,Globex APAC Logistics Pte. Ltd.,SG,-3354795.03
2025-08-04,2025-08-04,Marketing - Beacon Digital #2,Marketing,ALL,29977.8,0.0,SGD,SWIFT MT103,Beacon Digital #2,***7079,,,False,False,REF-606371,First Continental Bank,***5616,Globex APAC Logistics Pte. Ltd.,SG,-3384772.83
2025-08-04,2025-08-04,Client Receipt - CloudBridge Co. #19,Sales Receipt,SaaS-GL,0.0,4590.95,SGD,FAST Credit,CloudBridge Co. #19,***7234,INV-202508-SaaS-GL-0029,,False,False,REF-550953,First Continental Bank,***1706,Globex APAC Logistics Pte. Ltd.,SG,-3380181.88
2025-08-04,2025-08-04,Client Receipt - CloudBridge Co. #13,Sales Receipt,SaaS-GL,0.0,5138.65,SGD,FAST Credit,CloudBridge Co. #13,***3866,INV-202508-SaaS-GL-0025,,False,False,REF-355838,First Continental Bank,***3070,Globex APAC Logistics Pte. Ltd.,SG,-3375043.23
2025-08-04,2025-08-04,Client Receipt - Vertex Advisory Client #54,Sales Receipt,PS-GL,0.0,8113.33,SGD,FAST Credit,Vertex Advisory Client #54,***4100,INV-202508-PS-GL-0004,,False,False,REF-361609,First Continental Bank,***1876,Globex APAC Logistics Pte. Ltd.,SG,-3366929.9
2025-08-05,2025-08-05,Supplier Payment - ExpertNet Subcontractors #8,Supplier Payment,PS-GL,8675.63,0.0,SGD,MEPS+,ExpertNet Subcontractors #8,***3851,,PO-202508-PS-GL-0005,False,False,REF-642888,First Continental Bank,***2551,Globex APAC Logistics Pte. Ltd.,SG,-3375605.53
2025-08-05,2025-08-05,Client Receipt - CloudBridge Co. #77,Sales Receipt,SaaS-GL,0.0,933.76,SGD,FAST Credit,CloudBridge Co. #77,***3367,INV-202508-SaaS-GL-0008,,False,False,REF-912826,First Continental Bank,***3004,Globex APAC Logistics Pte. Ltd.,SG,-3374671.77
2025-08-05,2025-08-05,Client Receipt - CloudBridge Co. #47,Sales Receipt,SaaS-GL,0.0,3238.91,SGD,SWIFT MT103,CloudBridge Co. #47,***3789,INV-202508-SaaS-GL-0021,,False,False,REF-155825,First Continental Bank,***3074,Globex APAC Logistics Pte. Ltd.,SG,-3371432.86
2025-08-05,2025-08-05,Client Receipt - CloudBridge Co. #49,Sales Receipt,SaaS-GL,0.0,11046.99,SGD,SWIFT MT103,CloudBridge Co. #49,***5978,INV-202508-SaaS-GL-0003,,False,False,REF-399134,First Continental Bank,***2360,Globex APAC Logistics Pte. Ltd.,SG,-3360385.87
2025-08-05,2025-08-05,Client Receipt - Pacific Trade Co. #10,Sales Receipt,Logistics-APAC,0.0,14297.11,SGD,SWIFT MT103,Pacific Trade Co. #10,***6179,INV-202508-Logistics-APAC-0006,,False,False,REF-354781,First Continental Bank,***6923,Globex APAC Logistics Pte. Ltd.,SG,-3346088.76
2025-08-05,2025-08-05,Client Receipt - CloudBridge Co. #10,Sales Receipt,SaaS-GL,0.0,27202.38,SGD,FAST Credit,CloudBridge Co. #10,***5514,INV-202508-SaaS-GL-0002,,False,False,REF-139260,First Continental Bank,***6541,Globex APAC Logistics Pte. Ltd.,SG,-3318886.38
2025-08-06,2025-08-06,Supplier Payment - HyperCloud Infra #10,Supplier Payment,SaaS-GL,4776.61,0.0,SGD,SWIFT MT103,HyperCloud Infra #10,***4101,,PO-202508-SaaS-GL-0002,False,False,REF-658118,First Continental Bank,***4964,Globex APAC Logistics Pte. Ltd.,SG,-3323662.99
2025-08-06,2025-08-06,Supplier Payment - Port Services #14,Supplier Payment,Logistics-APAC,59706.36,0.0,SGD,SWIFT MT103,Port Services #14,***2054,,PO-202508-Logistics-APAC-0010,False,False,REF-647726,First Continental Bank,***1282,Globex APAC Logistics Pte. Ltd.,SG,-3383369.35
2025-08-06,2025-08-06,Client Receipt - CloudBridge Co. #34,Sales Receipt,SaaS-GL,0.0,1585.63,SGD,SWIFT MT103,CloudBridge Co. #34,***4704,INV-202508-SaaS-GL-0005,,False,False,REF-286427,First Continental Bank,***3472,Globex APAC Logistics Pte. Ltd.,SG,-3381783.72
2025-08-07,2025-08-07,Supplier Payment - ExpertNet Subcontractors #15,Supplier Payment,PS-GL,86.78,0.0,SGD,SWIFT MT103,ExpertNet Subcontractors #15,***4848,,PO-202508-PS-GL-0010,False,False,REF-562742,First Continental Bank,***5858,Globex APAC Logistics Pte. Ltd.,SG,-3381870.5
2025-08-07,2025-08-07,Supplier Payment - ExpertNet Subcontractors #5,Supplier Payment,PS-GL,3796.61,0.0,SGD,SWIFT MT103,ExpertNet Subcontractors #5,***1378,,PO-202508-PS-GL-0008,False,False,REF-193824,First Continental Bank,***5700,Globex APAC Logistics Pte. Ltd.,SG,-3385667.11
2025-08-07,2025-08-07,Client Receipt - CloudBridge Co. #46,Sales Receipt,SaaS-GL,0.0,1962.43,SGD,SWIFT MT103,CloudBridge Co. #46,***9493,INV-202508-SaaS-GL-0028,,False,False,REF-245067,First Continental Bank,***8877,Globex APAC Logistics Pte. Ltd.,SG,-3383704.68
2025-08-08,2025-08-08,Supplier Payment - HyperCloud Infra #1,Supplier Payment,SaaS-GL,1170.26,0.0,SGD,MEPS+,HyperCloud Infra #1,***7353,,PO-202508-SaaS-GL-0007,False,False,REF-263465,First Continental Bank,***3568,Globex APAC Logistics Pte. Ltd.,SG,-3384874.94
2025-08-08,2025-08-08,Metro Water & Waste,Rent & Utilities,ALL,8718.28,0.0,SGD,FAST Debit,Metro Water & Waste,***1164,,,False,False,REF-892308,First Continental Bank,***4643,Globex APAC Logistics Pte. Ltd.,SG,-3393593.22
2025-08-08,2025-08-08,Supplier Payment - Port Services #3,Supplier Payment,Logistics-APAC,19465.37,0.0,SGD,SWIFT MT103,Port Services #3,***3053,,PO-202508-Logistics-APAC-0005,False,False,REF-435320,First Continental Bank,***4347,Globex APAC Logistics Pte. Ltd.,SG,-3413058.59
2025-08-08,2025-08-08,Client Receipt - CloudBridge Co. #12,Sales Receipt,SaaS-GL,0.0,3210.38,SGD,SWIFT MT103,CloudBridge Co. #12,***9087,INV-202508-SaaS-GL-0010,,False,False,REF-832293,First Continental Bank,***7075,Globex APAC Logistics Pte. Ltd.,SG,-3409848.21
2025-08-10,2025-08-10,Client Receipt - CloudBridge Co. #21,Sales Receipt,SaaS-GL,0.0,1781.42,SGD,SWIFT MT103,CloudBridge Co. #21,***6026,INV-202508-SaaS-GL-0015,,False,False,REF-713086,First Continental Bank,***2402,Globex APAC Logistics Pte. Ltd.,SG,-3408066.79
2025-08-10,2025-08-10,Client Receipt - CloudBridge Co. #25,Sales Receipt,SaaS-GL,0.0,20567.29,SGD,SWIFT MT103,CloudBridge Co. #25,***7407,INV-202508-SaaS-GL-0024,,False,False,REF-749422,First Continental Bank,***3155,Globex APAC Logistics Pte. Ltd.,SG,-3387499.5
2025-08-12,2025-08-12,Supplier Payment - Port Services #18,Supplier Payment,Logistics-APAC,3201.27,0.0,SGD,MEPS+,Port Services #18,***3561,,PO-202508-Logistics-APAC-0007,False,False,REF-677388,First Continental Bank,***3056,Globex APAC Logistics Pte. Ltd.,SG,-3390700.77
2025-08-12,2025-08-12,Supplier Payment - CodeCraft Contractors #12,Supplier Payment,SaaS-GL,6126.57,0.0,SGD,MEPS+,CodeCraft Contractors #12,***1926,,PO-202508-SaaS-GL-0004,False,False,REF-267690,First Continental Bank,***4564,Globex APAC Logistics Pte. Ltd.,SG,-3396827.34
2025-08-12,2025-08-12,Supplier Payment - TransAsia Freight #20,Supplier Payment,Logistics-APAC,28129.04,0.0,SGD,MEPS+,TransAsia Freight #20,***1464,,PO-202508-Logistics-APAC-0003,False,False,REF-212332,First Continental Bank,***3032,Globex APAC Logistics Pte. Ltd.,SG,-3424956.38
2025-08-12,2025-08-12,Intercompany Settlement - Globex Retail NA LLC,Intercompany Transfer,ALL,821234.0,0.0,SGD,Internal Transfer,Globex Retail NA LLC,***9406,,,True,True,REF-225301,First Continental Bank,***1216,Globex APAC Logistics Pte. Ltd.,SG,-4246190.38
2025-08-12,2025-08-12,Client Receipt - CloudBridge Co. #68,Sales Receipt,SaaS-GL,0.0,3631.7,SGD,FAST Credit,CloudBridge Co. #68,***3905,INV-202508-SaaS-GL-0027,,False,False,REF-899963,First Continental Bank,***1993,Globex APAC Logistics Pte. Ltd.,SG,-4242558.68
2025-08-12,2025-08-12,Client Receipt - Pacific Trade Co. #26,Sales Receipt,Logistics-APAC,0.0,60821.6,SGD,FAST Credit,Pacific Trade Co. #26,***8927,INV-202508-Logistics-APAC-0014,,False,False,REF-770198,First Continental Bank,***7340,Globex APAC Logistics Pte. Ltd.,SG,-4181737.08
2025-08-12,2025-08-12,Intercompany Reimbursement - Globex Retail NA LLC,Intercompany Transfer,ALL,0.0,328493.6,SGD,Internal Transfer,Globex Retail NA LLC,***1892,,,True,True,REF-868429,First Continental Bank,***7703,Globex APAC Logistics Pte. Ltd.,SG,-3853243.48
2025-08-13,2025-08-13,Alphagrid Utilities,Rent & Utilities,ALL,629.89,0.0,SGD,MEPS+,Alphagrid Utilities,***4328,,,False,False,REF-508143,First Continental Bank,***2572,Globex APAC Logistics Pte. Ltd.,SG,-3853873.37
2025-08-14,2025-08-14,Supplier Payment - TransAsia Freight #10,Supplier Payment,Logistics-APAC,25517.94,0.0,SGD,FAST Debit,TransAsia Freight #10,***6576,,PO-202508-Logistics-APAC-0008,False,False,REF-791989,First Continental Bank,***1327,Globex APAC Logistics Pte. Ltd.,SG,-3879391.31
2025-08-14,2025-08-14,Client Receipt - Vertex Advisory Client #51,Sales Receipt,PS-GL,0.0,5630.65,SGD,SWIFT MT103,Vertex Advisory Client #51,***6345,INV-202508-PS-GL-0006,,False,False,REF-478900,First Continental Bank,***9176,Globex APAC Logistics Pte. Ltd.,SG,-3873760.66
2025-08-14,2025-08-14,Client Receipt - CloudBridge Co. #77,Sales Receipt,SaaS-GL,0.0,7972.75,SGD,SWIFT MT103,CloudBridge Co. #77,***9168,INV-202508-SaaS-GL-0014,,False,False,REF-542078,First Continental Bank,***5168,Globex APAC Logistics Pte. Ltd.,SG,-3865787.91
2025-08-14,2025-08-14,Client Receipt - Pacific Trade Co. #58,Sales Receipt,Logistics-APAC,0.0,26438.48,SGD,FAST Credit,Pacific Trade Co. #58,***9940,INV-202508-Logistics-APAC-0013,,False,False,REF-883644,First Continental Bank,***1577,Globex APAC Logistics Pte. Ltd.,SG,-3839349.43
2025-08-15,2025-08-15,Supplier Payment - TransAsia Freight #29,Supplier Payment,Logistics-APAC,947.52,0.0,SGD,SWIFT MT103,TransAsia Freight #29,***7315,,PO-202508-Logistics-APAC-0009,False,False,REF-248908,First Continental Bank,***3271,Globex APAC Logistics Pte. Ltd.,SG,-3840296.95
2025-08-15,2025-08-15,Client Receipt - CloudBridge Co. #77,Sales Receipt,SaaS-GL,0.0,1483.43,SGD,FAST Credit,CloudBridge Co. #77,***1739,INV-202508-SaaS-GL-0020,,False,False,REF-294517,First Continental Bank,***5140,Globex APAC Logistics Pte. Ltd.,SG,-3838813.52
2025-08-15,2025-08-15,Client Receipt - Pacific Trade Co. #65,Sales Receipt,Logistics-APAC,0.0,26563.86,SGD,SWIFT MT103,Pacific Trade Co. #65,***2156,INV-202508-Logistics-APAC-0004,,False,False,REF-694197,First Continental Bank,***8609,Globex APAC Logistics Pte. Ltd.,SG,-3812249.66
2025-08-16,2025-08-16,Client Receipt - Vertex Advisory Client #1,Sales Receipt,PS-GL,0.0,34337.56,SGD,FAST Credit,Vertex Advisory Client #1,***7982,INV-202508-PS-GL-0002,,False,False,REF-256126,First Continental Bank,***7872,Globex APAC Logistics Pte. Ltd.,SG,-3777912.1
2025-08-16,2025-08-16,Client Receipt - Pacific Trade Co. #24,Sales Receipt,Logistics-APAC,0.0,70988.72,SGD,FAST Credit,Pacific Trade Co. #24,***4299,INV-202508-Logistics-APAC-0008,,False,False,REF-973090,First Continental Bank,***5289,Globex APAC Logistics Pte. Ltd.,SG,-3706923.38
2025-08-17,2025-08-17,Supplier Payment - HyperCloud Infra #5,Supplier Payment,SaaS-GL,4806.82,0.0,SGD,FAST Debit,HyperCloud Infra #5,***1984,,PO-202508-SaaS-GL-0005,False,False,REF-648913,First Continental Bank,***1895,Globex APAC Logistics Pte. Ltd.,SG,-3711730.2
2025-08-18,2025-08-18,Marketing - Beacon Digital #4,Marketing,ALL,81.95,0.0,SGD,FAST Debit,Beacon Digital #4,***6348,,,False,False,REF-621220,First Continental Bank,***7603,Globex APAC Logistics Pte. Ltd.,SG,-3711812.15
2025-08-18,2025-08-18,Supplier Payment - ExpertNet Subcontractors #3,Supplier Payment,PS-GL,11658.99,0.0,SGD,MEPS+,ExpertNet Subcontractors #3,***5595,,PO-202508-PS-GL-0009,False,False,REF-803037,First Continental Bank,***3162,Globex APAC Logistics Pte. Ltd.,SG,-3723471.14
2025-08-18,2025-08-18,Supplier Payment - CodeCraft Contractors #8,Supplier Payment,SaaS-GL,36378.91,0.0,SGD,FAST Debit,CodeCraft Contractors #8,***3251,,PO-202508-SaaS-GL-0006,False,False,REF-575191,First Continental Bank,***2288,Globex APAC Logistics Pte. Ltd.,SG,-3759850.05
2025-08-18,2025-08-18,Client Receipt - CloudBridge Co. #24,Sales Receipt,SaaS-GL,0.0,1680.0,SGD,FAST Credit,CloudBridge Co. #24,***2400,INV-202508-SaaS-GL-0017,,False,False,REF-273093,First Continental Bank,***3581,Globex APAC Logistics Pte. Ltd.,SG,-3758170.05
2025-08-18,2025-08-18,Client Receipt - Pacific Trade Co. #11,Sales Receipt,Logistics-APAC,0.0,32223.16,SGD,SWIFT MT103,Pacific Trade Co. #11,***6640,INV-202508-Logistics-APAC-0010,,False,False,REF-408942,First Continental Bank,***9355,Globex APAC Logistics Pte. Ltd.,SG,-3725946.89
2025-08-19,2025-08-19,Supplier Payment - ExpertNet Subcontractors #15,Supplier Payment,PS-GL,15714.1,0.0,SGD,FAST Debit,ExpertNet Subcontractors #15,***7340,,PO-202508-PS-GL-0007,False,False,REF-386310,First Continental Bank,***7312,Globex APAC Logistics Pte. Ltd.,SG,-3741660.99
2025-08-19,2025-08-19,Supplier Payment - TransAsia Freight #2,Supplier Payment,Logistics-APAC,84066.81,0.0,SGD,MEPS+,TransAsia Freight #2,***3735,,PO-202508-Logistics-APAC-0006,False,False,REF-428371,First Continental Bank,***5451,Globex APAC Logistics Pte. Ltd.,SG,-3825727.8
2025-08-19,2025-08-19,Client Receipt - CloudBridge Co. #71,Sales Receipt,SaaS-GL,0.0,3661.61,SGD,FAST Credit,CloudBridge Co. #71,***2090,INV-202508-SaaS-GL-0018,,False,False,REF-455028,First Continental Bank,***6740,Globex APAC Logistics Pte. Ltd.,SG,-3822066.19
2025-08-19,2025-08-19,Client Receipt - Vertex Advisory Client #55,Sales Receipt,PS-GL,0.0,5161.19,SGD,SWIFT MT103,Vertex Advisory Client #55,***9415,INV-202508-PS-GL-0001,,False,False,REF-958175,First Continental Bank,***4963,Globex APAC Logistics Pte. Ltd.,SG,-3816905.0
2025-08-20,2025-08-20,Supplier Payment - HyperCloud Infra #2,Supplier Payment,SaaS-GL,2022.49,0.0,SGD,MEPS+,HyperCloud Infra #2,***1526,,PO-202508-SaaS-GL-0009,False,False,REF-919530,First Continental Bank,***6772,Globex APAC Logistics Pte. Ltd.,SG,-3818927.49
2025-08-20,2025-08-20,Supplier Payment - TransAsia Freight #6,Supplier Payment,Logistics-APAC,42439.69,0.0,SGD,SWIFT MT103,TransAsia Freight #6,***2144,,PO-202508-Logistics-APAC-0002,False,False,REF-557918,First Continental Bank,***6517,Globex APAC Logistics Pte. Ltd.,SG,-3861367.18
2025-08-20,2025-08-20,VAT/GST Remittance - IRAS Singapore,Tax Payment,ALL,74798.32,0.0,SGD,MEPS+,IRAS Singapore,***8128,,,False,False,REF-169408,First Continental Bank,***7344,Globex APAC Logistics Pte. Ltd.,SG,-3936165.5
2025-08-20,2025-08-20,Client Receipt - Vertex Advisory Client #38,Sales Receipt,PS-GL,0.0,1240.8,SGD,SWIFT MT103,Vertex Advisory Client #38,***5633,INV-202508-PS-GL-0008,,False,False,REF-235863,First Continental Bank,***2193,Globex APAC Logistics Pte. Ltd.,SG,-3934924.7
2025-08-20,2025-08-20,Client Receipt - Pacific Trade Co. #10,Sales Receipt,Logistics-APAC,0.0,30659.58,SGD,FAST Credit,Pacific Trade Co. #10,***3671,INV-202508-Logistics-APAC-0003,,False,False,REF-581604,First Continental Bank,***2559,Globex APAC Logistics Pte. Ltd.,SG,-3904265.12
2025-08-21,2025-08-21,Client Receipt - Pacific Trade Co. #19,Sales Receipt,Logistics-APAC,0.0,3177.31,SGD,FAST Credit,Pacific Trade Co. #19,***7546,INV-202508-Logistics-APAC-0015,,False,False,REF-237474,First Continental Bank,***5848,Globex APAC Logistics Pte. Ltd.,SG,-3901087.81
2025-08-21,2025-08-21,Client Receipt - CloudBridge Co. #29,Sales Receipt,SaaS-GL,0.0,4814.28,SGD,SWIFT MT103,CloudBridge Co. #29,***2322,INV-202508-SaaS-GL-0001,,False,False,REF-135769,First Continental Bank,***7042,Globex APAC Logistics Pte. Ltd.,SG,-3896273.53
2025-08-21,2025-08-21,Client Receipt - Vertex Advisory Client #23,Sales Receipt,PS-GL,0.0,8954.62,SGD,FAST Credit,Vertex Advisory Client #23,***6371,INV-202508-PS-GL-0003,,False,False,REF-821093,First Continental Bank,***2142,Globex APAC Logistics Pte. Ltd.,SG,-3887318.91
2025-08-21,2025-08-21,Client Receipt - CloudBridge Co. #60,Sales Receipt,SaaS-GL,0.0,10084.86,SGD,SWIFT MT103,CloudBridge Co. #60,***5208,INV-202508-SaaS-GL-0011,,False,False,REF-806122,First Continental Bank,***4775,Globex APAC Logistics Pte. Ltd.,SG,-3877234.05
2025-08-21,2025-08-21,Client Receipt - Pacific Trade Co. #48,Sales Receipt,Logistics-APAC,0.0,11173.54,SGD,FAST Credit,Pacific Trade Co. #48,***7576,INV-202508-Logistics-APAC-0005,,False,False,REF-380416,First Continental Bank,***2491,Globex APAC Logistics Pte. Ltd.,SG,-3866060.51
2025-08-22,2025-08-22,Merchant Processing Fees,Bank/Merchant Fees,ALL,1891.33,0.0,SGD,SWIFT MT103,First Continental Bank,***4247,,,False,False,REF-370770,First Continental Bank,***8137,Globex APAC Logistics Pte. Ltd.,SG,-3867951.84
2025-08-22,2025-08-22,Supplier Payment - ExpertNet Subcontractors #7,Supplier Payment,PS-GL,3397.33,0.0,SGD,SWIFT MT103,ExpertNet Subcontractors #7,***9703,,PO-202508-PS-GL-0003,False,False,REF-758594,First Continental Bank,***4599,Globex APAC Logistics Pte. Ltd.,SG,-3871349.17
2025-08-22,2025-08-22,Supplier Payment - TransAsia Freight #14,Supplier Payment,Logistics-APAC,25319.57,0.0,SGD,SWIFT MT103,TransAsia Freight #14,***2355,,PO-202508-Logistics-APAC-0004,False,False,REF-295867,First Continental Bank,***2815,Globex APAC Logistics Pte. Ltd.,SG,-3896668.74
2025-08-22,2025-08-22,Client Receipt - CloudBridge Co. #46,Sales Receipt,SaaS-GL,0.0,7219.24,SGD,FAST Credit,CloudBridge Co. #46,***4002,INV-202508-SaaS-GL-0007,,False,False,REF-857336,First Continental Bank,***2258,Globex APAC Logistics Pte. Ltd.,SG,-3889449.5
2025-08-22,2025-08-22,Client Receipt - Pacific Trade Co. #38,Sales Receipt,Logistics-APAC,0.0,18081.85,SGD,FAST Credit,Pacific Trade Co. #38,***4875,INV-202508-Logistics-APAC-0009,,False,False,REF-146865,First Continental Bank,***3576,Globex APAC Logistics Pte. Ltd.,SG,-3871367.65
2025-08-22,2025-08-22,Client Receipt - Vertex Advisory Client #36,Sales Receipt,PS-GL,0.0,43433.29,SGD,SWIFT MT103,Vertex Advisory Client #36,***9914,INV-202508-PS-GL-0010,,False,False,REF-921972,First Continental Bank,***9026,Globex APAC Logistics Pte. Ltd.,SG,-3827934.36
2025-08-23,2025-08-23,Client Receipt - CloudBridge Co. #39,Sales Receipt,SaaS-GL,0.0,3464.28,SGD,FAST Credit,CloudBridge Co. #39,***7864,INV-202508-SaaS-GL-0026,,False,False,REF-339674,First Continental Bank,***5737,Globex APAC Logistics Pte. Ltd.,SG,-3824470.08
2025-08-23,2025-08-23,Client Receipt - Pacific Trade Co. #3,Sales Receipt,Logistics-APAC,0.0,12278.22,SGD,SWIFT MT103,Pacific Trade Co. #3,***6536,INV-202508-Logistics-APAC-0001,,False,False,REF-646112,First Continental Bank,***8959,Globex APAC Logistics Pte. Ltd.,SG,-3812191.86
2025-08-24,2025-08-24,Supplier Payment - ExpertNet Subcontractors #12,Supplier Payment,PS-GL,4184.0,0.0,SGD,FAST Debit,ExpertNet Subcontractors #12,***1415,,PO-202508-PS-GL-0001,False,False,REF-860487,First Continental Bank,***9397,Globex APAC Logistics Pte. Ltd.,SG,-3816375.86
2025-08-24,2025-08-24,Supplier Payment - ExpertNet Subcontractors #10,Supplier Payment,PS-GL,7926.64,0.0,SGD,MEPS+,ExpertNet Subcontractors #10,***3436,,PO-202508-PS-GL-0011,False,False,REF-667847,First Continental Bank,***7294,Globex APAC Logistics Pte. Ltd.,SG,-3824302.5
2025-08-25,2025-08-25,Payroll - GlobalPay Services Ltd,Payroll,ALL,89900.52,0.0,SGD,SWIFT MT103,GlobalPay Services Ltd,***2949,,,False,False,REF-459475,First Continental Bank,***5680,Globex APAC Logistics Pte. Ltd.,SG,-3914203.02
2025-08-25,2025-08-25,Client Receipt - CloudBridge Co. #57,Sales Receipt,SaaS-GL,0.0,15476.35,SGD,FAST Credit,CloudBridge Co. #57,***1983,INV-202508-SaaS-GL-0022,,False,False,REF-719395,First Continental Bank,***1344,Globex APAC Logistics Pte. Ltd.,SG,-3898726.67
2025-08-25,2025-08-25,Client Receipt - Pacific Trade Co. #29,Sales Receipt,Logistics-APAC,0.0,26084.5,SGD,SWIFT MT103,Pacific Trade Co. #29,***7819,INV-202508-Logistics-APAC-0012,,False,False,REF-211458,First Continental Bank,***5684,Globex APAC Logistics Pte. Ltd.,SG,-3872642.17
2025-08-25,2025-08-25,Client Receipt - CloudBridge Co. #6,Sales Receipt,SaaS-GL,0.0,63802.56,SGD,FAST Credit,CloudBridge Co. #6,***9949,INV-202508-SaaS-GL-0016,,False,False,REF-642547,First Continental Bank,***7637,Globex APAC Logistics Pte. Ltd.,SG,-3808839.61
2025-08-26,2025-08-26,Supplier Payment - HyperCloud Infra #3,Supplier Payment,SaaS-GL,3396.73,0.0,SGD,FAST Debit,HyperCloud Infra #3,***8698,,PO-202508-SaaS-GL-0001,False,False,REF-861484,First Continental Bank,***9886,Globex APAC Logistics Pte. Ltd.,SG,-3812236.34
2025-08-26,2025-08-26,Intercompany Settlement - Globex Consulting UK Ltd.,Intercompany Transfer,ALL,775685.0,0.0,SGD,Internal Transfer,Globex Consulting UK Ltd.,***4640,,,True,True,REF-235462,First Continental Bank,***1559,Globex APAC Logistics Pte. Ltd.,SG,-4587921.34
2025-08-26,2025-08-26,Client Receipt - CloudBridge Co. #7,Sales Receipt,SaaS-GL,0.0,22497.89,SGD,FAST Credit,CloudBridge Co. #7,***9603,INV-202508-SaaS-GL-0013,,False,False,REF-231533,First Continental Bank,***8703,Globex APAC Logistics Pte. Ltd.,SG,-4565423.45
2025-08-26,2025-08-26,Client Receipt - CloudBridge Co. #63,Sales Receipt,SaaS-GL,0.0,40004.06,SGD,SWIFT MT103,CloudBridge Co. #63,***6105,INV-202508-SaaS-GL-0004,,False,False,REF-768715,First Continental Bank,***4834,Globex APAC Logistics Pte. Ltd.,SG,-4525419.39
2025-08-26,2025-08-26,Client Receipt - Vertex Advisory Client #38,Sales Receipt,PS-GL,0.0,103864.96,SGD,FAST Credit,Vertex Advisory Client #38,***1137,INV-202508-PS-GL-0005,,False,False,REF-655135,First Continental Bank,***4127,Globex APAC Logistics Pte. Ltd.,SG,-4421554.43
2025-08-27,2025-08-27,Merchant Processing Fees,Bank/Merchant Fees,ALL,1655.93,0.0,SGD,MEPS+,First Continental Bank,***9633,,,False,False,REF-848536,First Continental Bank,***2765,Globex APAC Logistics Pte. Ltd.,SG,-4423210.36
2025-08-27,2025-08-27,Supplier Payment - ExpertNet Subcontractors #10,Supplier Payment,PS-GL,6974.21,0.0,SGD,FAST Debit,ExpertNet Subcontractors #10,***7874,,PO-202508-PS-GL-0002,False,False,REF-672987,First Continental Bank,***9358,Globex APAC Logistics Pte. Ltd.,SG,-4430184.57
2025-08-27,2025-08-27,Client Receipt - Pacific Trade Co. #42,Sales Receipt,Logistics-APAC,0.0,2524.99,SGD,SWIFT MT103,Pacific Trade Co. #42,***8428,INV-202508-Logistics-APAC-0007,,False,False,REF-946436,First Continental Bank,***4551,Globex APAC Logistics Pte. Ltd.,SG,-4427659.58
2025-08-27,2025-08-27,Client Receipt - CloudBridge Co. #30,Sales Receipt,SaaS-GL,0.0,13418.37,SGD,FAST Credit,CloudBridge Co. #30,***1555,INV-202508-SaaS-GL-0012,,False,False,REF-254567,First Continental Bank,***7217,Globex APAC Logistics Pte. Ltd.,SG,-4414241.21
2025-08-28,2025-08-28,Supplier Payment - ExpertNet Subcontractors #5,Supplier Payment,PS-GL,523.81,0.0,SGD,MEPS+,ExpertNet Subcontractors #5,***4148,,PO-202508-PS-GL-0004,False,False,REF-784702,First Continental Bank,***7707,Globex APAC Logistics Pte. Ltd.,SG,-4414765.02
2025-08-28,2025-08-28,Supplier Payment - CodeCraft Contractors #3,Supplier Payment,SaaS-GL,3871.95,0.0,SGD,FAST Debit,CodeCraft Contractors #3,***5059,,PO-202508-SaaS-GL-0011,False,False,REF-628572,First Continental Bank,***2996,Globex APAC Logistics Pte. Ltd.,SG,-4418636.97
2025-08-28,2025-08-28,Client Receipt - CloudBridge Co. #2,Sales Receipt,SaaS-GL,0.0,32766.41,SGD,FAST Credit,CloudBridge Co. #2,***5674,INV-202508-SaaS-GL-0023,,False,False,REF-375098,First Continental Bank,***1600,Globex APAC Logistics Pte. Ltd.,SG,-4385870.56
2025-08-28,2025-08-28,Client Receipt - Pacific Trade Co. #65,Sales Receipt,Logistics-APAC,0.0,40330.66,SGD,FAST Credit,Pacific Trade Co. #65,***2677,INV-202508-Logistics-APAC-0011,,False,False,REF-472951,First Continental Bank,***7775,Globex APAC Logistics Pte. Ltd.,SG,-4345539.9
2025-08-28,2025-08-28,Client Receipt - Pacific Trade Co. #42,Sales Receipt,Logistics-APAC,0.0,87771.05,SGD,FAST Credit,Pacific Trade Co. #42,***2333,INV-202508-Logistics-APAC-0002,,False,False,REF-800361,First Continental Bank,***2757,Globex APAC Logistics Pte. Ltd.,SG,-4257768.85
2025-08-29,2025-08-29,Supplier Payment - HyperCloud Infra #9,Supplier Payment,SaaS-GL,10227.96,0.0,SGD,MEPS+,HyperCloud Infra #9,***1327,,PO-202508-SaaS-GL-0008,False,False,REF-172124,First Continental Bank,***3918,Globex APAC Logistics Pte. Ltd.,SG,-4267996.81
2025-08-29,2025-08-29,Client Receipt - CloudBridge Co. #19,Sales Receipt,SaaS-GL,0.0,14146.65,SGD,FAST Credit,CloudBridge Co. #19,***2870,INV-202508-SaaS-GL-0006,,False,False,REF-466456,First Continental Bank,***4302,Globex APAC Logistics Pte. Ltd.,SG,-4253850.16
2025-08-30,2025-08-30,Supplier Payment - ExpertNet Subcontractors #2,Supplier Payment,PS-GL,5254.34,0.0,SGD,SWIFT MT103,ExpertNet Subcontractors #2,***9736,,PO-202508-PS-GL-0006,False,False,REF-649276,First Continental Bank,***8060,Globex APAC Logistics Pte. Ltd.,SG,-4259104.5
2025-08-30,2025-08-30,Payroll - GlobalPay Services Ltd,Payroll,ALL,89900.52,0.0,SGD,MEPS+,GlobalPay Services Ltd,***2971,,,False,False,REF-175061,First Continental Bank,***1507,Globex APAC Logistics Pte. Ltd.,SG,-4349005.02
2025-08-30,2025-08-30,Interest Earned,Interest Income,ALL,0.0,10635.49,SGD,SWIFT MT103,First Continental Bank,***4948,,,False,False,REF-522753,First Continental Bank,***4040,Globex APAC Logistics Pte. Ltd.,SG,-4338369.53
2025-08-31,2025-08-31,Client Receipt - Vertex Advisory Client #29,Sales Receipt,PS-GL,0.0,30811.41,SGD,SWIFT MT103,Vertex Advisory Client #29,***9258,INV-202508-PS-GL-0009,,False,False,REF-495216,First Continental Bank,***6068,Globex APAC Logistics Pte. Ltd.,SG,-4307558.12
