Date,ValueDate,Description,Category,BusinessUnit,Debit,Credit,Currency,PaymentRail,Counterparty,CounterpartyAccount,InvoiceID,PONumber,Intercompany,EliminateInConsolidation,Reference,Bank,AccountNumberMasked,Company,Jurisdiction,Balance
01/09/2023,01/09/2023,Account Maintenance Fee,Bank/Merchant Fees,ALL,2500,0,EUR,SWIFT MT103,First Continental Bank,***8830,,,FALSE,FALSE,REF-818453,First Continental Bank,***7686,Globex EMEA Manufacturing Ltd.,IE,9997500
04/09/2023,04/09/2023,Supplier Payment - CodeCraft Contractors #7,Supplier Payment,SaaS-GL,13395.25,0,EUR,SEPA Credit Transfer,CodeCraft Contractors #7,***4106,,PO-202309-SaaS-GL-0004,FALSE,FALSE,REF-214419,First Continental Bank,***1406,Globex EMEA Manufacturing Ltd.,IE,9984104.75
04/09/2023,04/09/2023,Marketing - Aurelia Media #8,Marketing,ALL,22950.09,0,EUR,SEPA Debit,Aurelia Media #8,***1786,,,FALSE,FALSE,REF-779385,First Continental Bank,***4030,Globex EMEA Manufacturing Ltd.,IE,9961154.66
04/09/2023,04/09/2023,Supplier Payment - EuroFab Assembly #5,Supplier Payment,CEM-EMEA,58381.84,0,EUR,SEPA Credit Transfer,EuroFab Assembly #5,***9396,,PO-202309-CEM-EMEA-0008,FALSE,FALSE,REF-865384,First Continental Bank,***6724,Globex EMEA Manufacturing Ltd.,IE,9902772.82
04/09/2023,04/09/2023,Client Receipt - CloudBridge Co. #6,Sales Receipt,SaaS-GL,0,27157.27,EUR,SEPA SCT Inst,CloudBridge Co. #6,***9264,INV-202309-SaaS-GL-0012,,FALSE,FALSE,REF-552706,First Continental Bank,***1457,Globex EMEA Manufacturing Ltd.,IE,9929930.09
05/09/2023,05/09/2023,Supplier Payment - ExpertNet Subcontractors #9,Supplier Payment,PS-GL,5862.5,0,EUR,SEPA Credit Transfer,ExpertNet Subcontractors #9,***9305,,PO-202309-PS-GL-0005,FALSE,FALSE,REF-399431,First Continental Bank,***9436,Globex EMEA Manufacturing Ltd.,IE,9924067.59
05/09/2023,05/09/2023,Client Receipt - Novatek Components Ltd #4,Sales Receipt,CEM-EMEA,0,180590.41,EUR,Card Settlement,Novatek Components Ltd #4,***2703,INV-202309-CEM-EMEA-0001,,FALSE,FALSE,REF-665592,First Continental Bank,***7568,Globex EMEA Manufacturing Ltd.,IE,10104658
06/09/2023,06/09/2023,Supplier Payment - Stelliform Parts BV #11,Supplier Payment,CEM-EMEA,7902.08,0,EUR,SEPA Credit Transfer,Stelliform Parts BV #11,***4927,,PO-202309-CEM-EMEA-0004,FALSE,FALSE,REF-577661,First Continental Bank,***8665,Globex EMEA Manufacturing Ltd.,IE,10096755.92
06/09/2023,06/09/2023,Supplier Payment - Stelliform Parts BV #18,Supplier Payment,CEM-EMEA,110805,0,EUR,SEPA Debit,Stelliform Parts BV #18,***4717,,PO-202309-CEM-EMEA-0006,FALSE,FALSE,REF-461264,First Continental Bank,***9581,Globex EMEA Manufacturing Ltd.,IE,9985950.92
06/09/2023,06/09/2023,Client Receipt - Aurora Electronics GmbH #13,Sales Receipt,CEM-EMEA,0,5912.61,EUR,SEPA SCT,Aurora Electronics GmbH #13,***4376,INV-202309-CEM-EMEA-0005,,FALSE,FALSE,REF-369948,First Continental Bank,***3809,Globex EMEA Manufacturing Ltd.,IE,9991863.53
06/09/2023,06/09/2023,Client Receipt - CloudBridge Co. #34,Sales Receipt,SaaS-GL,0,8600.89,EUR,SEPA SCT Inst,CloudBridge Co. #34,***4189,INV-202309-SaaS-GL-0002,,FALSE,FALSE,REF-278647,First Continental Bank,***6804,Globex EMEA Manufacturing Ltd.,IE,10000464.42
08/09/2023,08/09/2023,Supplier Payment - CodeCraft Contractors #6,Supplier Payment,SaaS-GL,9590.29,0,EUR,SEPA Credit Transfer,CodeCraft Contractors #6,***1089,,PO-202309-SaaS-GL-0003,FALSE,FALSE,REF-689715,First Continental Bank,***4193,Globex EMEA Manufacturing Ltd.,IE,9990874.13
09/09/2023,09/09/2023,Client Receipt - CloudBridge Co. #28,Sales Receipt,SaaS-GL,0,12064.09,EUR,SEPA SCT Inst,CloudBridge Co. #28,***9480,INV-202309-SaaS-GL-0013,,FALSE,FALSE,REF-986307,First Continental Bank,***8571,Globex EMEA Manufacturing Ltd.,IE,10002938.22
09/09/2023,09/09/2023,Client Receipt - Novatek Components Ltd #12,Sales Receipt,CEM-EMEA,0,94087.91,EUR,SEPA SCT,Novatek Components Ltd #12,***6106,INV-202309-CEM-EMEA-0009,,FALSE,FALSE,REF-774336,First Continental Bank,***3422,Globex EMEA Manufacturing Ltd.,IE,10097026.13
11/09/2023,11/09/2023,Client Receipt - CloudBridge Co. #48,Sales Receipt,SaaS-GL,0,12478.96,EUR,SEPA SCT,CloudBridge Co. #48,***9762,INV-202309-SaaS-GL-0003,,FALSE,FALSE,REF-143662,First Continental Bank,***6451,Globex EMEA Manufacturing Ltd.,IE,10109505.09
11/09/2023,11/09/2023,Client Receipt - Vertex Advisory Client #51,Sales Receipt,PS-GL,0,25733.82,EUR,Card Settlement,Vertex Advisory Client #51,***5542,INV-202309-PS-GL-0007,,FALSE,FALSE,REF-542220,First Continental Bank,***5250,Globex EMEA Manufacturing Ltd.,IE,10135238.91
11/09/2023,11/09/2023,Client Receipt - Vertex Advisory Client #18,Sales Receipt,PS-GL,0,49114.55,EUR,Card Settlement,Vertex Advisory Client #18,***6766,INV-202309-PS-GL-0006,,FALSE,FALSE,REF-372249,First Continental Bank,***2860,Globex EMEA Manufacturing Ltd.,IE,10184353.46
12/09/2023,12/09/2023,Merchant Processing Fees,Bank/Merchant Fees,ALL,4267.09,0,EUR,SWIFT MT103,First Continental Bank,***6431,,,FALSE,FALSE,REF-588511,First Continental Bank,***7323,Globex EMEA Manufacturing Ltd.,IE,10180086.37
12/09/2023,12/09/2023,Supplier Payment - ExpertNet Subcontractors #6,Supplier Payment,PS-GL,13463.58,0,EUR,SWIFT MT103,ExpertNet Subcontractors #6,***3807,,PO-202309-PS-GL-0004,FALSE,FALSE,REF-675941,First Continental Bank,***7304,Globex EMEA Manufacturing Ltd.,IE,10166622.79
12/09/2023,12/09/2023,Supplier Payment - ExpertNet Subcontractors #1,Supplier Payment,PS-GL,28933.52,0,EUR,SEPA Credit Transfer,ExpertNet Subcontractors #1,***2169,,PO-202309-PS-GL-0001,FALSE,FALSE,REF-945316,First Continental Bank,***9146,Globex EMEA Manufacturing Ltd.,IE,10137689.27
12/09/2023,12/09/2023,Intercompany Settlement - Globex Retail NA LLC,Intercompany Transfer,ALL,887498,0,EUR,Internal Transfer,Globex Retail NA LLC,***7432,,,TRUE,TRUE,REF-583799,First Continental Bank,***1659,Globex EMEA Manufacturing Ltd.,IE,9250191.27
12/09/2023,12/09/2023,Client Receipt - Vertex Advisory Client #13,Sales Receipt,PS-GL,0,27463.28,EUR,Card Settlement,Vertex Advisory Client #13,***4845,INV-202309-PS-GL-0010,,FALSE,FALSE,REF-992093,First Continental Bank,***6244,Globex EMEA Manufacturing Ltd.,IE,9277654.55
12/09/2023,12/09/2023,Client Receipt - CloudBridge Co. #16,Sales Receipt,SaaS-GL,0,55125.74,EUR,SEPA SCT,CloudBridge Co. #16,***7725,INV-202309-SaaS-GL-0015,,FALSE,FALSE,REF-467400,First Continental Bank,***9973,Globex EMEA Manufacturing Ltd.,IE,9332780.29
13/09/2023,13/09/2023,Supplier Payment - EuroFab Assembly #9,Supplier Payment,CEM-EMEA,98533.17,0,EUR,SEPA Credit Transfer,EuroFab Assembly #9,***9314,,PO-202309-CEM-EMEA-0010,FALSE,FALSE,REF-708923,First Continental Bank,***7032,Globex EMEA Manufacturing Ltd.,IE,9234247.12
13/09/2023,13/09/2023,Client Receipt - Aurora Electronics GmbH #3,Sales Receipt,CEM-EMEA,0,44270.81,EUR,SEPA SCT,Aurora Electronics GmbH #3,***8286,INV-202309-CEM-EMEA-0008,,FALSE,FALSE,REF-459021,First Continental Bank,***7923,Globex EMEA Manufacturing Ltd.,IE,9278517.93
13/09/2023,13/09/2023,Client Receipt - Novatek Components Ltd #3,Sales Receipt,CEM-EMEA,0,102008.16,EUR,SEPA SCT Inst,Novatek Components Ltd #3,***4120,INV-202309-CEM-EMEA-0004,,FALSE,FALSE,REF-511144,First Continental Bank,***4823,Globex EMEA Manufacturing Ltd.,IE,9380526.09
14/09/2023,14/09/2023,Supplier Payment - Stelliform Parts BV #2,Supplier Payment,CEM-EMEA,55498.22,0,EUR,SEPA Credit Transfer,Stelliform Parts BV #2,***5460,,PO-202309-CEM-EMEA-0003,FALSE,FALSE,REF-626612,First Continental Bank,***5346,Globex EMEA Manufacturing Ltd.,IE,9325027.87
14/09/2023,14/09/2023,Client Receipt - CloudBridge Co. #59,Sales Receipt,SaaS-GL,0,39566.28,EUR,SEPA SCT Inst,CloudBridge Co. #59,***3562,INV-202309-SaaS-GL-0001,,FALSE,FALSE,REF-971042,First Continental Bank,***4926,Globex EMEA Manufacturing Ltd.,IE,9364594.15
14/09/2023,14/09/2023,Client Receipt - Aurora Electronics GmbH #15,Sales Receipt,CEM-EMEA,0,42837.56,EUR,SEPA SCT,Aurora Electronics GmbH #15,***9647,INV-202309-CEM-EMEA-0007,,FALSE,FALSE,REF-182015,First Continental Bank,***8538,Globex EMEA Manufacturing Ltd.,IE,9407431.71
14/09/2023,14/09/2023,Client Receipt - Vertex Advisory Client #20,Sales Receipt,PS-GL,0,94974.48,EUR,SEPA SCT,Vertex Advisory Client #20,***5801,INV-202309-PS-GL-0001,,FALSE,FALSE,REF-485516,First Continental Bank,***1756,Globex EMEA Manufacturing Ltd.,IE,9502406.19
15/09/2023,15/09/2023,Supplier Payment - ExpertNet Subcontractors #5,Supplier Payment,PS-GL,4108.43,0,EUR,SEPA Credit Transfer,ExpertNet Subcontractors #5,***2874,,PO-202309-PS-GL-0008,FALSE,FALSE,REF-490159,First Continental Bank,***5675,Globex EMEA Manufacturing Ltd.,IE,9498297.76
15/09/2023,15/09/2023,Loan Interest Payment,Loan Interest,ALL,85000,0,EUR,SWIFT MT103,First Continental Bank - Corporate Lending,***8691,,,FALSE,FALSE,REF-951504,First Continental Bank,***2671,Globex EMEA Manufacturing Ltd.,IE,9413297.76
15/09/2023,15/09/2023,Supplier Payment - Stelliform Parts BV #17,Supplier Payment,CEM-EMEA,109072.58,0,EUR,SWIFT MT103,Stelliform Parts BV #17,***3669,,PO-202309-CEM-EMEA-0011,FALSE,FALSE,REF-908726,First Continental Bank,***7908,Globex EMEA Manufacturing Ltd.,IE,9304225.18
15/09/2023,15/09/2023,Loan Principal Repayment,Loan Principal,ALL,500000,0,EUR,SEPA Debit,First Continental Bank - Corporate Lending,***3124,,,FALSE,FALSE,REF-813107,First Continental Bank,***5317,Globex EMEA Manufacturing Ltd.,IE,8804225.18
15/09/2023,15/09/2023,Client Receipt - Vertex Advisory Client #10,Sales Receipt,PS-GL,0,801.22,EUR,SEPA SCT Inst,Vertex Advisory Client #10,***4473,INV-202309-PS-GL-0002,,FALSE,FALSE,REF-403086,First Continental Bank,***5616,Globex EMEA Manufacturing Ltd.,IE,8805026.4
18/09/2023,18/09/2023,Supplier Payment - ExpertNet Subcontractors #19,Supplier Payment,PS-GL,21209.5,0,EUR,SEPA Credit Transfer,ExpertNet Subcontractors #19,***5363,,PO-202309-PS-GL-0003,FALSE,FALSE,REF-331789,First Continental Bank,***4897,Globex EMEA Manufacturing Ltd.,IE,8783816.9
18/09/2023,18/09/2023,Client Receipt - CloudBridge Co. #70,Sales Receipt,SaaS-GL,0,8998.08,EUR,SEPA SCT Inst,CloudBridge Co. #70,***5011,INV-202309-SaaS-GL-0022,,FALSE,FALSE,REF-472870,First Continental Bank,***7612,Globex EMEA Manufacturing Ltd.,IE,8792814.98
18/09/2023,18/09/2023,Client Receipt - Novatek Components Ltd #5,Sales Receipt,CEM-EMEA,0,37084.38,EUR,SEPA SCT,Novatek Components Ltd #5,***5038,INV-202309-CEM-EMEA-0010,,FALSE,FALSE,REF-957966,First Continental Bank,***7953,Globex EMEA Manufacturing Ltd.,IE,8829899.36
18/09/2023,18/09/2023,Client Receipt - CloudBridge Co. #51,Sales Receipt,SaaS-GL,0,127604.32,EUR,Card Settlement,CloudBridge Co. #51,***6388,INV-202309-SaaS-GL-0011,,FALSE,FALSE,REF-801895,First Continental Bank,***4595,Globex EMEA Manufacturing Ltd.,IE,8957503.68
19/09/2023,19/09/2023,Alphagrid Utilities,Rent & Utilities,ALL,16064.21,0,EUR,SWIFT MT103,Alphagrid Utilities,***3840,,,FALSE,FALSE,REF-472549,First Continental Bank,***1893,Globex EMEA Manufacturing Ltd.,IE,8941439.47
19/09/2023,19/09/2023,Marketing - Beacon Digital #9,Marketing,ALL,26981.51,0,EUR,SEPA Credit Transfer,Beacon Digital #9,***3081,,,FALSE,FALSE,REF-455902,First Continental Bank,***1651,Globex EMEA Manufacturing Ltd.,IE,8914457.96
19/09/2023,19/09/2023,Supplier Payment - HyperCloud Infra #18,Supplier Payment,SaaS-GL,27951.12,0,EUR,SWIFT MT103,HyperCloud Infra #18,***1074,,PO-202309-SaaS-GL-0005,FALSE,FALSE,REF-298617,First Continental Bank,***6810,Globex EMEA Manufacturing Ltd.,IE,8886506.84
19/09/2023,19/09/2023,Client Receipt - CloudBridge Co. #40,Sales Receipt,SaaS-GL,0,3241.67,EUR,Card Settlement,CloudBridge Co. #40,***3928,INV-202309-SaaS-GL-0017,,FALSE,FALSE,REF-951827,First Continental Bank,***9274,Globex EMEA Manufacturing Ltd.,IE,8889748.51
19/09/2023,19/09/2023,Client Receipt - CloudBridge Co. #49,Sales Receipt,SaaS-GL,0,7352.37,EUR,SEPA SCT Inst,CloudBridge Co. #49,***4490,INV-202309-SaaS-GL-0004,,FALSE,FALSE,REF-580429,First Continental Bank,***5648,Globex EMEA Manufacturing Ltd.,IE,8897100.88
19/09/2023,19/09/2023,Client Receipt - CloudBridge Co. #51,Sales Receipt,SaaS-GL,0,17336.37,EUR,SEPA SCT,CloudBridge Co. #51,***4597,INV-202309-SaaS-GL-0008,,FALSE,FALSE,REF-115086,First Continental Bank,***9934,Globex EMEA Manufacturing Ltd.,IE,8914437.25
20/09/2023,20/09/2023,Supplier Payment - HyperCloud Infra #3,Supplier Payment,SaaS-GL,11448.24,0,EUR,SWIFT MT103,HyperCloud Infra #3,***6748,,PO-202309-SaaS-GL-0006,FALSE,FALSE,REF-281757,First Continental Bank,***3990,Globex EMEA Manufacturing Ltd.,IE,8902989.01
20/09/2023,20/09/2023,Supplier Payment - EuroFab Assembly #22,Supplier Payment,CEM-EMEA,35326.8,0,EUR,SEPA Debit,EuroFab Assembly #22,***6425,,PO-202309-CEM-EMEA-0001,FALSE,FALSE,REF-719744,First Continental Bank,***7008,Globex EMEA Manufacturing Ltd.,IE,8867662.21
20/09/2023,20/09/2023,Client Receipt - CloudBridge Co. #5,Sales Receipt,SaaS-GL,0,5880.46,EUR,Card Settlement,CloudBridge Co. #5,***3638,INV-202309-SaaS-GL-0010,,FALSE,FALSE,REF-672611,First Continental Bank,***3449,Globex EMEA Manufacturing Ltd.,IE,8873542.67
20/09/2023,20/09/2023,Client Receipt - CloudBridge Co. #25,Sales Receipt,SaaS-GL,0,41287.17,EUR,Card Settlement,CloudBridge Co. #25,***2782,INV-202309-SaaS-GL-0006,,FALSE,FALSE,REF-197736,First Continental Bank,***8371,Globex EMEA Manufacturing Ltd.,IE,8914829.84
21/09/2023,21/09/2023,Supplier Payment - Stelliform Parts BV #9,Supplier Payment,CEM-EMEA,46087.66,0,EUR,SEPA Debit,Stelliform Parts BV #9,***9320,,PO-202309-CEM-EMEA-0009,FALSE,FALSE,REF-755846,First Continental Bank,***2801,Globex EMEA Manufacturing Ltd.,IE,8868742.18
21/09/2023,21/09/2023,Client Receipt - CloudBridge Co. #78,Sales Receipt,SaaS-GL,0,17252.11,EUR,SEPA SCT Inst,CloudBridge Co. #78,***7703,INV-202309-SaaS-GL-0005,,FALSE,FALSE,REF-261743,First Continental Bank,***9321,Globex EMEA Manufacturing Ltd.,IE,8885994.29
21/09/2023,21/09/2023,Client Receipt - CloudBridge Co. #63,Sales Receipt,SaaS-GL,0,27537.07,EUR,SEPA SCT,CloudBridge Co. #63,***9859,INV-202309-SaaS-GL-0019,,FALSE,FALSE,REF-760760,First Continental Bank,***1330,Globex EMEA Manufacturing Ltd.,IE,8913531.36
21/09/2023,21/09/2023,Client Receipt - Novatek Components Ltd #10,Sales Receipt,CEM-EMEA,0,139047.52,EUR,SEPA SCT Inst,Novatek Components Ltd #10,***1145,INV-202309-CEM-EMEA-0011,,FALSE,FALSE,REF-285644,First Continental Bank,***6208,Globex EMEA Manufacturing Ltd.,IE,9052578.88
22/09/2023,22/09/2023,VAT/GST Remittance - Revenue Ireland,Tax Payment,ALL,120433.87,0,EUR,SEPA Debit,Revenue Ireland,***9760,,,FALSE,FALSE,REF-916936,First Continental Bank,***3101,Globex EMEA Manufacturing Ltd.,IE,8932145.01
22/09/2023,22/09/2023,Client Receipt - CloudBridge Co. #36,Sales Receipt,SaaS-GL,0,13593.94,EUR,SEPA SCT,CloudBridge Co. #36,***4428,INV-202309-SaaS-GL-0016,,FALSE,FALSE,REF-893135,First Continental Bank,***7306,Globex EMEA Manufacturing Ltd.,IE,8945738.95
22/09/2023,22/09/2023,Client Receipt - CloudBridge Co. #51,Sales Receipt,SaaS-GL,0,31521.96,EUR,SEPA SCT Inst,CloudBridge Co. #51,***7203,INV-202309-SaaS-GL-0014,,FALSE,FALSE,REF-884487,First Continental Bank,***8534,Globex EMEA Manufacturing Ltd.,IE,8977260.91
22/09/2023,22/09/2023,Client Receipt - Vertex Advisory Client #57,Sales Receipt,PS-GL,0,40624.22,EUR,SEPA SCT,Vertex Advisory Client #57,***2769,INV-202309-PS-GL-0003,,FALSE,FALSE,REF-670156,First Continental Bank,***3660,Globex EMEA Manufacturing Ltd.,IE,9017885.13
23/09/2023,23/09/2023,Supplier Payment - EuroFab Assembly #21,Supplier Payment,CEM-EMEA,30950.21,0,EUR,SEPA Credit Transfer,EuroFab Assembly #21,***5070,,PO-202309-CEM-EMEA-0007,FALSE,FALSE,REF-947800,First Continental Bank,***5719,Globex EMEA Manufacturing Ltd.,IE,8986934.92
23/09/2023,23/09/2023,Client Receipt - Aurora Electronics GmbH #1,Sales Receipt,CEM-EMEA,0,71498.13,EUR,SEPA SCT Inst,Aurora Electronics GmbH #1,***7610,INV-202309-CEM-EMEA-0006,,FALSE,FALSE,REF-424410,First Continental Bank,***2442,Globex EMEA Manufacturing Ltd.,IE,9058433.05
25/09/2023,25/09/2023,Supplier Payment - ExpertNet Subcontractors #12,Supplier Payment,PS-GL,3241.97,0,EUR,SEPA Debit,ExpertNet Subcontractors #12,***3579,,PO-202309-PS-GL-0002,FALSE,FALSE,REF-523052,First Continental Bank,***4804,Globex EMEA Manufacturing Ltd.,IE,9055191.08
25/09/2023,25/09/2023,Supplier Payment - CodeCraft Contractors #5,Supplier Payment,SaaS-GL,20220.02,0,EUR,SWIFT MT103,CodeCraft Contractors #5,***3658,,PO-202309-SaaS-GL-0001,FALSE,FALSE,REF-679479,First Continental Bank,***1737,Globex EMEA Manufacturing Ltd.,IE,9034971.06
25/09/2023,25/09/2023,Supplier Payment - CodeCraft Contractors #14,Supplier Payment,SaaS-GL,23761.15,0,EUR,SEPA Debit,CodeCraft Contractors #14,***7775,,PO-202309-SaaS-GL-0007,FALSE,FALSE,REF-956929,First Continental Bank,***5470,Globex EMEA Manufacturing Ltd.,IE,9011209.91
25/09/2023,25/09/2023,Supplier Payment - ExpertNet Subcontractors #8,Supplier Payment,PS-GL,31045.13,0,EUR,SEPA Debit,ExpertNet Subcontractors #8,***1180,,PO-202309-PS-GL-0007,FALSE,FALSE,REF-349898,First Continental Bank,***9343,Globex EMEA Manufacturing Ltd.,IE,8980164.78
25/09/2023,25/09/2023,Client Receipt - CloudBridge Co. #15,Sales Receipt,SaaS-GL,0,2639.13,EUR,SEPA SCT,CloudBridge Co. #15,***4492,INV-202309-SaaS-GL-0007,,FALSE,FALSE,REF-442115,First Continental Bank,***5880,Globex EMEA Manufacturing Ltd.,IE,8982803.91
26/09/2023,26/09/2023,Merchant Processing Fees,Bank/Merchant Fees,ALL,1811.8,0,EUR,SWIFT MT103,First Continental Bank,***7431,,,FALSE,FALSE,REF-376501,First Continental Bank,***8894,Globex EMEA Manufacturing Ltd.,IE,8980992.11
26/09/2023,26/09/2023,Supplier Payment - HyperCloud Infra #10,Supplier Payment,SaaS-GL,2267.41,0,EUR,SEPA Credit Transfer,HyperCloud Infra #10,***1754,,PO-202309-SaaS-GL-0008,FALSE,FALSE,REF-951695,First Continental Bank,***8252,Globex EMEA Manufacturing Ltd.,IE,8978724.7
26/09/2023,26/09/2023,Supplier Payment - HyperCloud Infra #17,Supplier Payment,SaaS-GL,18658.95,0,EUR,SWIFT MT103,HyperCloud Infra #17,***4730,,PO-202309-SaaS-GL-0009,FALSE,FALSE,REF-503336,First Continental Bank,***8424,Globex EMEA Manufacturing Ltd.,IE,8960065.75
26/09/2023,26/09/2023,Intercompany Settlement - Globex Consulting UK Ltd.,Intercompany Transfer,ALL,202926,0,EUR,Internal Transfer,Globex Consulting UK Ltd.,***6830,,,TRUE,TRUE,REF-141951,First Continental Bank,***5729,Globex EMEA Manufacturing Ltd.,IE,8757139.75
26/09/2023,26/09/2023,Client Receipt - Vertex Advisory Client #19,Sales Receipt,PS-GL,0,26787.24,EUR,SEPA SCT,Vertex Advisory Client #19,***6190,INV-202309-PS-GL-0009,,FALSE,FALSE,REF-506387,First Continental Bank,***1928,Globex EMEA Manufacturing Ltd.,IE,8783926.99
27/09/2023,27/09/2023,Payroll - GlobalPay Services Ltd,Payroll,ALL,162048.64,0,EUR,SWIFT MT103,GlobalPay Services Ltd,***6948,,,FALSE,FALSE,REF-357486,First Continental Bank,***9567,Globex EMEA Manufacturing Ltd.,IE,8621878.35
27/09/2023,27/09/2023,Client Receipt - Vertex Advisory Client #46,Sales Receipt,PS-GL,0,7347.56,EUR,SEPA SCT,Vertex Advisory Client #46,***7813,INV-202309-PS-GL-0005,,FALSE,FALSE,REF-283301,First Continental Bank,***4485,Globex EMEA Manufacturing Ltd.,IE,8629225.91
27/09/2023,27/09/2023,Client Receipt - Vertex Advisory Client #54,Sales Receipt,PS-GL,0,38319.08,EUR,SEPA SCT Inst,Vertex Advisory Client #54,***1671,INV-202309-PS-GL-0008,,FALSE,FALSE,REF-950123,First Continental Bank,***3266,Globex EMEA Manufacturing Ltd.,IE,8667544.99
28/09/2023,28/09/2023,Supplier Payment - Stelliform Parts BV #16,Supplier Payment,CEM-EMEA,16272.95,0,EUR,SEPA Debit,Stelliform Parts BV #16,***5405,,PO-202309-CEM-EMEA-0002,FALSE,FALSE,REF-976770,First Continental Bank,***5522,Globex EMEA Manufacturing Ltd.,IE,8651272.04
28/09/2023,28/09/2023,Supplier Payment - EuroFab Assembly #24,Supplier Payment,CEM-EMEA,16287.55,0,EUR,SEPA Debit,EuroFab Assembly #24,***4222,,PO-202309-CEM-EMEA-0005,FALSE,FALSE,REF-564522,First Continental Bank,***2316,Globex EMEA Manufacturing Ltd.,IE,8634984.49
28/09/2023,28/09/2023,Client Receipt - CloudBridge Co. #36,Sales Receipt,SaaS-GL,0,8790.26,EUR,Card Settlement,CloudBridge Co. #36,***1704,INV-202309-SaaS-GL-0009,,FALSE,FALSE,REF-820111,First Continental Bank,***9710,Globex EMEA Manufacturing Ltd.,IE,8643774.75
28/09/2023,28/09/2023,Client Receipt - CloudBridge Co. #47,Sales Receipt,SaaS-GL,0,28247.35,EUR,SEPA SCT Inst,CloudBridge Co. #47,***9727,INV-202309-SaaS-GL-0021,,FALSE,FALSE,REF-543072,First Continental Bank,***1618,Globex EMEA Manufacturing Ltd.,IE,8672022.1
28/09/2023,28/09/2023,Client Receipt - CloudBridge Co. #61,Sales Receipt,SaaS-GL,0,62040.13,EUR,Card Settlement,CloudBridge Co. #61,***8390,INV-202309-SaaS-GL-0020,,FALSE,FALSE,REF-408185,First Continental Bank,***7832,Globex EMEA Manufacturing Ltd.,IE,8734062.23
28/09/2023,28/09/2023,Client Receipt - CloudBridge Co. #78,Sales Receipt,SaaS-GL,0,72466.55,EUR,Card Settlement,CloudBridge Co. #78,***5233,INV-202309-SaaS-GL-0018,,FALSE,FALSE,REF-479008,First Continental Bank,***6599,Globex EMEA Manufacturing Ltd.,IE,8806528.78
29/09/2023,29/09/2023,Supplier Payment - Stelliform Parts BV #18,Supplier Payment,CEM-EMEA,3611.97,0,EUR,SEPA Credit Transfer,Stelliform Parts BV #18,***1868,,PO-202309-CEM-EMEA-0012,FALSE,FALSE,REF-742593,First Continental Bank,***7685,Globex EMEA Manufacturing Ltd.,IE,8802916.81
29/09/2023,29/09/2023,Supplier Payment - CodeCraft Contractors #14,Supplier Payment,SaaS-GL,11479.65,0,EUR,SEPA Credit Transfer,CodeCraft Contractors #14,***2053,,PO-202309-SaaS-GL-0002,FALSE,FALSE,REF-365742,First Continental Bank,***6800,Globex EMEA Manufacturing Ltd.,IE,8791437.16
29/09/2023,29/09/2023,Supplier Payment - ExpertNet Subcontractors #4,Supplier Payment,PS-GL,18291.8,0,EUR,SEPA Debit,ExpertNet Subcontractors #4,***3932,,PO-202309-PS-GL-0006,FALSE,FALSE,REF-623295,First Continental Bank,***7450,Globex EMEA Manufacturing Ltd.,IE,8773145.36
29/09/2023,29/09/2023,Payroll - GlobalPay Services Ltd,Payroll,ALL,162048.64,0,EUR,SEPA Debit,GlobalPay Services Ltd,***3595,,,FALSE,FALSE,REF-131948,First Continental Bank,***8056,Globex EMEA Manufacturing Ltd.,IE,8611096.72
29/09/2023,29/09/2023,Client Receipt - Aurora Electronics GmbH #10,Sales Receipt,CEM-EMEA,0,31202.56,EUR,SEPA SCT Inst,Aurora Electronics GmbH #10,***6601,INV-202309-CEM-EMEA-0002,,FALSE,FALSE,REF-887980,First Continental Bank,***4952,Globex EMEA Manufacturing Ltd.,IE,8642299.28
29/09/2023,29/09/2023,Client Receipt - Vertex Advisory Client #59,Sales Receipt,PS-GL,0,109356,EUR,Card Settlement,Vertex Advisory Client #59,***8549,INV-202309-PS-GL-0004,,FALSE,FALSE,REF-626481,First Continental Bank,***6958,Globex EMEA Manufacturing Ltd.,IE,8751655.28
29/09/2023,29/09/2023,Client Receipt - Aurora Electronics GmbH #9,Sales Receipt,CEM-EMEA,0,232676.66,EUR,SEPA SCT,Aurora Electronics GmbH #9,***1714,INV-202309-CEM-EMEA-0003,,FALSE,FALSE,REF-356953,First Continental Bank,***6497,Globex EMEA Manufacturing Ltd.,IE,8984331.94
30/09/2023,30/09/2023,Interest Earned,Interest Income,ALL,0,11763.93,EUR,SEPA SCT,First Continental Bank,***7101,,,FALSE,FALSE,REF-119257,First Continental Bank,***8644,Globex EMEA Manufacturing Ltd.,IE,8996095.87
01/10/2023,01/10/2023,Account Maintenance Fee,Bank/Merchant Fees,ALL,2500,0,EUR,SEPA Credit Transfer,First Continental Bank,***7882,,,FALSE,FALSE,REF-550459,First Continental Bank,***9274,Globex EMEA Manufacturing Ltd.,IE,8993595.87
01/10/2023,01/10/2023,Supplier Payment - HyperCloud Infra #12,Supplier Payment,SaaS-GL,41157.14,0,EUR,SEPA Credit Transfer,HyperCloud Infra #12,***8984,,PO-202310-SaaS-GL-0002,FALSE,FALSE,REF-205959,First Continental Bank,***1885,Globex EMEA Manufacturing Ltd.,IE,8952438.73
01/10/2023,01/10/2023,Client Receipt - CloudBridge Co. #72,Sales Receipt,SaaS-GL,0,5570.44,EUR,SEPA SCT,CloudBridge Co. #72,***4085,INV-202310-SaaS-GL-0025,,FALSE,FALSE,REF-164963,First Continental Bank,***1341,Globex EMEA Manufacturing Ltd.,IE,8958009.17
02/10/2023,02/10/2023,Client Receipt - CloudBridge Co. #54,Sales Receipt,SaaS-GL,0,3320.39,EUR,Card Settlement,CloudBridge Co. #54,***2630,INV-202310-SaaS-GL-0014,,FALSE,FALSE,REF-357827,First Continental Bank,***9398,Globex EMEA Manufacturing Ltd.,IE,8961329.56
02/10/2023,02/10/2023,Client Receipt - CloudBridge Co. #59,Sales Receipt,SaaS-GL,0,21883.73,EUR,SEPA SCT,CloudBridge Co. #59,***2541,INV-202310-SaaS-GL-0010,,FALSE,FALSE,REF-212114,First Continental Bank,***1700,Globex EMEA Manufacturing Ltd.,IE,8983213.29
03/10/2023,03/10/2023,Supplier Payment - ExpertNet Subcontractors #16,Supplier Payment,PS-GL,5435.66,0,EUR,SWIFT MT103,ExpertNet Subcontractors #16,***9526,,PO-202310-PS-GL-0002,FALSE,FALSE,REF-982367,First Continental Bank,***4573,Globex EMEA Manufacturing Ltd.,IE,8977777.63
03/10/2023,03/10/2023,Supplier Payment - ExpertNet Subcontractors #15,Supplier Payment,PS-GL,6851.56,0,EUR,SWIFT MT103,ExpertNet Subcontractors #15,***7509,,PO-202310-PS-GL-0008,FALSE,FALSE,REF-409721,First Continental Bank,***4194,Globex EMEA Manufacturing Ltd.,IE,8970926.07
03/10/2023,03/10/2023,Supplier Payment - ExpertNet Subcontractors #3,Supplier Payment,PS-GL,10526.61,0,EUR,SEPA Debit,ExpertNet Subcontractors #3,***5628,,PO-202310-PS-GL-0001,FALSE,FALSE,REF-576247,First Continental Bank,***2034,Globex EMEA Manufacturing Ltd.,IE,8960399.46
03/10/2023,03/10/2023,Client Receipt - Vertex Advisory Client #36,Sales Receipt,PS-GL,0,975.08,EUR,Card Settlement,Vertex Advisory Client #36,***3377,INV-202310-PS-GL-0001,,FALSE,FALSE,REF-730389,First Continental Bank,***1580,Globex EMEA Manufacturing Ltd.,IE,8961374.54
05/10/2023,05/10/2023,Supplier Payment - HyperCloud Infra #1,Supplier Payment,SaaS-GL,14892.45,0,EUR,SEPA Debit,HyperCloud Infra #1,***7928,,PO-202310-SaaS-GL-0001,FALSE,FALSE,REF-523855,First Continental Bank,***2093,Globex EMEA Manufacturing Ltd.,IE,8946482.09
05/10/2023,05/10/2023,Supplier Payment - ExpertNet Subcontractors #17,Supplier Payment,PS-GL,25241.17,0,EUR,SEPA Credit Transfer,ExpertNet Subcontractors #17,***2375,,PO-202310-PS-GL-0003,FALSE,FALSE,REF-729511,First Continental Bank,***3342,Globex EMEA Manufacturing Ltd.,IE,8921240.92
05/10/2023,05/10/2023,Supplier Payment - Stelliform Parts BV #1,Supplier Payment,CEM-EMEA,55190.14,0,EUR,SEPA Credit Transfer,Stelliform Parts BV #1,***5813,,PO-202310-CEM-EMEA-0009,FALSE,FALSE,REF-601359,First Continental Bank,***5230,Globex EMEA Manufacturing Ltd.,IE,8866050.78
06/10/2023,06/10/2023,Supplier Payment - HyperCloud Infra #11,Supplier Payment,SaaS-GL,180.41,0,EUR,SEPA Credit Transfer,HyperCloud Infra #11,***1637,,PO-202310-SaaS-GL-0011,FALSE,FALSE,REF-681739,First Continental Bank,***3419,Globex EMEA Manufacturing Ltd.,IE,8865870.37
06/10/2023,06/10/2023,Client Receipt - Vertex Advisory Client #17,Sales Receipt,PS-GL,0,49609.96,EUR,SEPA SCT,Vertex Advisory Client #17,***2069,INV-202310-PS-GL-0005,,FALSE,FALSE,REF-702251,First Continental Bank,***6181,Globex EMEA Manufacturing Ltd.,IE,8915480.33
07/10/2023,07/10/2023,Supplier Payment - EuroFab Assembly #19,Supplier Payment,CEM-EMEA,33389.63,0,EUR,SEPA Credit Transfer,EuroFab Assembly #19,***3357,,PO-202310-CEM-EMEA-0010,FALSE,FALSE,REF-891059,First Continental Bank,***2705,Globex EMEA Manufacturing Ltd.,IE,8882090.7
07/10/2023,07/10/2023,Client Receipt - CloudBridge Co. #25,Sales Receipt,SaaS-GL,0,3650.93,EUR,SEPA SCT,CloudBridge Co. #25,***2463,INV-202310-SaaS-GL-0003,,FALSE,FALSE,REF-636670,First Continental Bank,***5093,Globex EMEA Manufacturing Ltd.,IE,8885741.63
07/10/2023,07/10/2023,Client Receipt - Aurora Electronics GmbH #11,Sales Receipt,CEM-EMEA,0,65465.17,EUR,SEPA SCT,Aurora Electronics GmbH #11,***6646,INV-202310-CEM-EMEA-0001,,FALSE,FALSE,REF-464820,First Continental Bank,***8940,Globex EMEA Manufacturing Ltd.,IE,8951206.8
09/10/2023,09/10/2023,Supplier Payment - HyperCloud Infra #17,Supplier Payment,SaaS-GL,7214.63,0,EUR,SWIFT MT103,HyperCloud Infra #17,***7113,,PO-202310-SaaS-GL-0007,FALSE,FALSE,REF-399495,First Continental Bank,***2069,Globex EMEA Manufacturing Ltd.,IE,8943992.17
09/10/2023,09/10/2023,Supplier Payment - Stelliform Parts BV #2,Supplier Payment,CEM-EMEA,28797.51,0,EUR,SEPA Debit,Stelliform Parts BV #2,***1609,,PO-202310-CEM-EMEA-0007,FALSE,FALSE,REF-147085,First Continental Bank,***8142,Globex EMEA Manufacturing Ltd.,IE,8915194.66
10/10/2023,10/10/2023,Supplier Payment - HyperCloud Infra #19,Supplier Payment,SaaS-GL,10394.4,0,EUR,SWIFT MT103,HyperCloud Infra #19,***6981,,PO-202310-SaaS-GL-0010,FALSE,FALSE,REF-737883,First Continental Bank,***6745,Globex EMEA Manufacturing Ltd.,IE,8904800.26
10/10/2023,10/10/2023,Supplier Payment - EuroFab Assembly #20,Supplier Payment,CEM-EMEA,21497.93,0,EUR,SWIFT MT103,EuroFab Assembly #20,***5570,,PO-202310-CEM-EMEA-0002,FALSE,FALSE,REF-754397,First Continental Bank,***5332,Globex EMEA Manufacturing Ltd.,IE,8883302.33
10/10/2023,10/10/2023,Supplier Payment - EuroFab Assembly #10,Supplier Payment,CEM-EMEA,72807.91,0,EUR,SWIFT MT103,EuroFab Assembly #10,***1771,,PO-202310-CEM-EMEA-0001,FALSE,FALSE,REF-637158,First Continental Bank,***6472,Globex EMEA Manufacturing Ltd.,IE,8810494.42
10/10/2023,10/10/2023,Client Receipt - CloudBridge Co. #53,Sales Receipt,SaaS-GL,0,755.9,EUR,SEPA SCT,CloudBridge Co. #53,***3385,INV-202310-SaaS-GL-0019,,FALSE,FALSE,REF-673238,First Continental Bank,***6590,Globex EMEA Manufacturing Ltd.,IE,8811250.32
10/10/2023,10/10/2023,Client Receipt - CloudBridge Co. #53,Sales Receipt,SaaS-GL,0,19357.64,EUR,SEPA SCT,CloudBridge Co. #53,***1630,INV-202310-SaaS-GL-0008,,FALSE,FALSE,REF-800662,First Continental Bank,***1618,Globex EMEA Manufacturing Ltd.,IE,8830607.96
10/10/2023,10/10/2023,Client Receipt - Aurora Electronics GmbH #7,Sales Receipt,CEM-EMEA,0,82723.53,EUR,SEPA SCT,Aurora Electronics GmbH #7,***3248,INV-202310-CEM-EMEA-0010,,FALSE,FALSE,REF-643006,First Continental Bank,***4722,Globex EMEA Manufacturing Ltd.,IE,8913331.49
11/10/2023,11/10/2023,Supplier Payment - ExpertNet Subcontractors #10,Supplier Payment,PS-GL,9733.66,0,EUR,SEPA Credit Transfer,ExpertNet Subcontractors #10,***7686,,PO-202310-PS-GL-0004,FALSE,FALSE,REF-697844,First Continental Bank,***1397,Globex EMEA Manufacturing Ltd.,IE,8903597.83
11/10/2023,11/10/2023,Client Receipt - CloudBridge Co. #45,Sales Receipt,SaaS-GL,0,13813.77,EUR,SEPA SCT Inst,CloudBridge Co. #45,***4812,INV-202310-SaaS-GL-0021,,FALSE,FALSE,REF-604649,First Continental Bank,***5431,Globex EMEA Manufacturing Ltd.,IE,8917411.6
11/10/2023,11/10/2023,Client Receipt - CloudBridge Co. #68,Sales Receipt,SaaS-GL,0,14089.21,EUR,SEPA SCT,CloudBridge Co. #68,***4948,INV-202310-SaaS-GL-0016,,FALSE,FALSE,REF-510980,First Continental Bank,***8450,Globex EMEA Manufacturing Ltd.,IE,8931500.81
11/10/2023,11/10/2023,Client Receipt - CloudBridge Co. #44,Sales Receipt,SaaS-GL,0,16544.4,EUR,Card Settlement,CloudBridge Co. #44,***6880,INV-202310-SaaS-GL-0017,,FALSE,FALSE,REF-543158,First Continental Bank,***8280,Globex EMEA Manufacturing Ltd.,IE,8948045.21
11/10/2023,11/10/2023,Client Receipt - CloudBridge Co. #29,Sales Receipt,SaaS-GL,0,33822.21,EUR,Card Settlement,CloudBridge Co. #29,***7023,INV-202310-SaaS-GL-0018,,FALSE,FALSE,REF-642921,First Continental Bank,***3231,Globex EMEA Manufacturing Ltd.,IE,8981867.42
12/10/2023,12/10/2023,Supplier Payment - Stelliform Parts BV #25,Supplier Payment,CEM-EMEA,48071.85,0,EUR,SEPA Credit Transfer,Stelliform Parts BV #25,***6495,,PO-202310-CEM-EMEA-0003,FALSE,FALSE,REF-851944,First Continental Bank,***1712,Globex EMEA Manufacturing Ltd.,IE,8933795.57
12/10/2023,12/10/2023,Intercompany Settlement - Globex Consulting UK Ltd.,Intercompany Transfer,ALL,194682,0,EUR,Internal Transfer,Globex Consulting UK Ltd.,***1728,,,TRUE,TRUE,REF-299122,First Continental Bank,***1482,Globex EMEA Manufacturing Ltd.,IE,8739113.57
12/10/2023,12/10/2023,Client Receipt - Aurora Electronics GmbH #9,Sales Receipt,CEM-EMEA,0,52374.02,EUR,SEPA SCT Inst,Aurora Electronics GmbH #9,***8933,INV-202310-CEM-EMEA-0008,,FALSE,FALSE,REF-420995,First Continental Bank,***9405,Globex EMEA Manufacturing Ltd.,IE,8791487.59
12/10/2023,12/10/2023,Client Receipt - CloudBridge Co. #35,Sales Receipt,SaaS-GL,0,88365.35,EUR,SEPA SCT Inst,CloudBridge Co. #35,***3270,INV-202310-SaaS-GL-0027,,FALSE,FALSE,REF-395025,First Continental Bank,***5406,Globex EMEA Manufacturing Ltd.,IE,8879852.94
12/10/2023,12/10/2023,Client Receipt - Aurora Electronics GmbH #2,Sales Receipt,CEM-EMEA,0,128012.24,EUR,Card Settlement,Aurora Electronics GmbH #2,***9924,INV-202310-CEM-EMEA-0003,,FALSE,FALSE,REF-579815,First Continental Bank,***5205,Globex EMEA Manufacturing Ltd.,IE,9007865.18
13/10/2023,13/10/2023,Supplier Payment - ExpertNet Subcontractors #4,Supplier Payment,PS-GL,10042.67,0,EUR,SEPA Debit,ExpertNet Subcontractors #4,***3779,,PO-202310-PS-GL-0007,FALSE,FALSE,REF-999516,First Continental Bank,***3955,Globex EMEA Manufacturing Ltd.,IE,8997822.51
13/10/2023,13/10/2023,Metro Water & Waste,Rent & Utilities,ALL,17863.32,0,EUR,SEPA Debit,Metro Water & Waste,***5439,,,FALSE,FALSE,REF-813050,First Continental Bank,***6363,Globex EMEA Manufacturing Ltd.,IE,8979959.19
13/10/2023,13/10/2023,Client Receipt - Novatek Components Ltd #4,Sales Receipt,CEM-EMEA,0,76556.72,EUR,SEPA SCT,Novatek Components Ltd #4,***3701,INV-202310-CEM-EMEA-0009,,FALSE,FALSE,REF-153687,First Continental Bank,***8714,Globex EMEA Manufacturing Ltd.,IE,9056515.91
14/10/2023,14/10/2023,Supplier Payment - ExpertNet Subcontractors #17,Supplier Payment,PS-GL,11189.78,0,EUR,SWIFT MT103,ExpertNet Subcontractors #17,***3722,,PO-202310-PS-GL-0009,FALSE,FALSE,REF-673404,First Continental Bank,***7419,Globex EMEA Manufacturing Ltd.,IE,9045326.13
14/10/2023,14/10/2023,Marketing - Aurelia Media #1,Marketing,ALL,13975.6,0,EUR,SWIFT MT103,Aurelia Media #1,***2156,,,FALSE,FALSE,REF-166745,First Continental Bank,***7073,Globex EMEA Manufacturing Ltd.,IE,9031350.53
15/10/2023,15/10/2023,Loan Interest Payment,Loan Interest,ALL,85000,0,EUR,SEPA Credit Transfer,First Continental Bank - Corporate Lending,***7045,,,FALSE,FALSE,REF-775496,First Continental Bank,***7745,Globex EMEA Manufacturing Ltd.,IE,8946350.53
15/10/2023,15/10/2023,Loan Principal Repayment,Loan Principal,ALL,500000,0,EUR,SWIFT MT103,First Continental Bank - Corporate Lending,***4984,,,FALSE,FALSE,REF-781828,First Continental Bank,***8101,Globex EMEA Manufacturing Ltd.,IE,8446350.53
15/10/2023,15/10/2023,Client Receipt - CloudBridge Co. #15,Sales Receipt,SaaS-GL,0,33073.27,EUR,SEPA SCT Inst,CloudBridge Co. #15,***4796,INV-202310-SaaS-GL-0024,,FALSE,FALSE,REF-811028,First Continental Bank,***7323,Globex EMEA Manufacturing Ltd.,IE,8479423.8
16/10/2023,16/10/2023,Supplier Payment - HyperCloud Infra #15,Supplier Payment,SaaS-GL,30345.42,0,EUR,SWIFT MT103,HyperCloud Infra #15,***8176,,PO-202310-SaaS-GL-0008,FALSE,FALSE,REF-744457,First Continental Bank,***5772,Globex EMEA Manufacturing Ltd.,IE,8449078.38
16/10/2023,16/10/2023,Marketing - Beacon Digital #1,Marketing,ALL,43416.2,0,EUR,SEPA Credit Transfer,Beacon Digital #1,***7011,,,FALSE,FALSE,REF-408654,First Continental Bank,***6854,Globex EMEA Manufacturing Ltd.,IE,8405662.18
16/10/2023,16/10/2023,Client Receipt - CloudBridge Co. #20,Sales Receipt,SaaS-GL,0,8854.38,EUR,SEPA SCT,CloudBridge Co. #20,***9731,INV-202310-SaaS-GL-0013,,FALSE,FALSE,REF-822461,First Continental Bank,***2022,Globex EMEA Manufacturing Ltd.,IE,8414516.56
16/10/2023,16/10/2023,Client Receipt - CloudBridge Co. #40,Sales Receipt,SaaS-GL,0,34795.86,EUR,SEPA SCT Inst,CloudBridge Co. #40,***8184,INV-202310-SaaS-GL-0009,,FALSE,FALSE,REF-177666,First Continental Bank,***4356,Globex EMEA Manufacturing Ltd.,IE,8449312.42
17/10/2023,17/10/2023,Supplier Payment - EuroFab Assembly #2,Supplier Payment,CEM-EMEA,23349.14,0,EUR,SEPA Credit Transfer,EuroFab Assembly #2,***1752,,PO-202310-CEM-EMEA-0004,FALSE,FALSE,REF-806397,First Continental Bank,***5426,Globex EMEA Manufacturing Ltd.,IE,8425963.28
17/10/2023,17/10/2023,Client Receipt - CloudBridge Co. #5,Sales Receipt,SaaS-GL,0,10162.89,EUR,SEPA SCT,CloudBridge Co. #5,***4745,INV-202310-SaaS-GL-0004,,FALSE,FALSE,REF-428450,First Continental Bank,***8408,Globex EMEA Manufacturing Ltd.,IE,8436126.17
17/10/2023,17/10/2023,Client Receipt - CloudBridge Co. #73,Sales Receipt,SaaS-GL,0,14330.28,EUR,Card Settlement,CloudBridge Co. #73,***7043,INV-202310-SaaS-GL-0022,,FALSE,FALSE,REF-873713,First Continental Bank,***6840,Globex EMEA Manufacturing Ltd.,IE,8450456.45
17/10/2023,17/10/2023,Client Receipt - Vertex Advisory Client #42,Sales Receipt,PS-GL,0,32161.85,EUR,SEPA SCT Inst,Vertex Advisory Client #42,***2224,INV-202310-PS-GL-0006,,FALSE,FALSE,REF-349144,First Continental Bank,***9109,Globex EMEA Manufacturing Ltd.,IE,8482618.3
18/10/2023,18/10/2023,Supplier Payment - EuroFab Assembly #20,Supplier Payment,CEM-EMEA,46537.05,0,EUR,SEPA Credit Transfer,EuroFab Assembly #20,***6472,,PO-202310-CEM-EMEA-0011,FALSE,FALSE,REF-686334,First Continental Bank,***7726,Globex EMEA Manufacturing Ltd.,IE,8436081.25
18/10/2023,18/10/2023,Client Receipt - Vertex Advisory Client #42,Sales Receipt,PS-GL,0,2756.13,EUR,Card Settlement,Vertex Advisory Client #42,***4204,INV-202310-PS-GL-0011,,FALSE,FALSE,REF-305628,First Continental Bank,***2416,Globex EMEA Manufacturing Ltd.,IE,8438837.38
18/10/2023,18/10/2023,Client Receipt - Vertex Advisory Client #11,Sales Receipt,PS-GL,0,51236.37,EUR,SEPA SCT Inst,Vertex Advisory Client #11,***5014,INV-202310-PS-GL-0010,,FALSE,FALSE,REF-532445,First Continental Bank,***2080,Globex EMEA Manufacturing Ltd.,IE,8490073.75
18/10/2023,18/10/2023,Client Receipt - CloudBridge Co. #74,Sales Receipt,SaaS-GL,0,102954.16,EUR,Card Settlement,CloudBridge Co. #74,***5446,INV-202310-SaaS-GL-0007,,FALSE,FALSE,REF-676454,First Continental Bank,***5104,Globex EMEA Manufacturing Ltd.,IE,8593027.91
19/10/2023,19/10/2023,Supplier Payment - Stelliform Parts BV #1,Supplier Payment,CEM-EMEA,114263.7,0,EUR,SWIFT MT103,Stelliform Parts BV #1,***7115,,PO-202310-CEM-EMEA-0006,FALSE,FALSE,REF-943743,First Continental Bank,***3651,Globex EMEA Manufacturing Ltd.,IE,8478764.21
19/10/2023,19/10/2023,Client Receipt - CloudBridge Co. #74,Sales Receipt,SaaS-GL,0,17921.73,EUR,SEPA SCT Inst,CloudBridge Co. #74,***4151,INV-202310-SaaS-GL-0020,,FALSE,FALSE,REF-621538,First Continental Bank,***2640,Globex EMEA Manufacturing Ltd.,IE,8496685.94
19/10/2023,19/10/2023,Client Receipt - CloudBridge Co. #76,Sales Receipt,SaaS-GL,0,29156.38,EUR,SEPA SCT,CloudBridge Co. #76,***8146,INV-202310-SaaS-GL-0023,,FALSE,FALSE,REF-630841,First Continental Bank,***1926,Globex EMEA Manufacturing Ltd.,IE,8525842.32
19/10/2023,19/10/2023,Client Receipt - CloudBridge Co. #5,Sales Receipt,SaaS-GL,0,29573,EUR,Card Settlement,CloudBridge Co. #5,***8253,INV-202310-SaaS-GL-0028,,FALSE,FALSE,REF-668073,First Continental Bank,***5893,Globex EMEA Manufacturing Ltd.,IE,8555415.32
20/10/2023,20/10/2023,Client Receipt - Vertex Advisory Client #31,Sales Receipt,PS-GL,0,12345,EUR,Card Settlement,Vertex Advisory Client #31,***3916,INV-202310-PS-GL-0007,,FALSE,FALSE,REF-151189,First Continental Bank,***6959,Globex EMEA Manufacturing Ltd.,IE,8567760.32
20/10/2023,20/10/2023,Client Receipt - Aurora Electronics GmbH #19,Sales Receipt,CEM-EMEA,0,21994.53,EUR,Card Settlement,Aurora Electronics GmbH #19,***7898,INV-202310-CEM-EMEA-0004,,FALSE,FALSE,REF-462431,First Continental Bank,***6010,Globex EMEA Manufacturing Ltd.,IE,8589754.85
20/10/2023,20/10/2023,Client Receipt - Vertex Advisory Client #20,Sales Receipt,PS-GL,0,112849.47,EUR,SEPA SCT,Vertex Advisory Client #20,***4930,INV-202310-PS-GL-0012,,FALSE,FALSE,REF-181035,First Continental Bank,***4119,Globex EMEA Manufacturing Ltd.,IE,8702604.32
22/10/2023,22/10/2023,Supplier Payment - Stelliform Parts BV #17,Supplier Payment,CEM-EMEA,63182.54,0,EUR,SWIFT MT103,Stelliform Parts BV #17,***6829,,PO-202310-CEM-EMEA-0008,FALSE,FALSE,REF-345080,First Continental Bank,***9968,Globex EMEA Manufacturing Ltd.,IE,8639421.78
22/10/2023,22/10/2023,VAT/GST Remittance - Revenue Ireland,Tax Payment,ALL,139832.37,0,EUR,SWIFT MT103,Revenue Ireland,***9006,,,FALSE,FALSE,REF-341776,First Continental Bank,***4059,Globex EMEA Manufacturing Ltd.,IE,8499589.41
22/10/2023,22/10/2023,Client Receipt - Novatek Components Ltd #1,Sales Receipt,CEM-EMEA,0,27821.87,EUR,SEPA SCT,Novatek Components Ltd #1,***2746,INV-202310-CEM-EMEA-0006,,FALSE,FALSE,REF-960966,First Continental Bank,***3110,Globex EMEA Manufacturing Ltd.,IE,8527411.28
23/10/2023,23/10/2023,Supplier Payment - HyperCloud Infra #19,Supplier Payment,SaaS-GL,4682.98,0,EUR,SEPA Debit,HyperCloud Infra #19,***4912,,PO-202310-SaaS-GL-0005,FALSE,FALSE,REF-591494,First Continental Bank,***9742,Globex EMEA Manufacturing Ltd.,IE,8522728.3
23/10/2023,23/10/2023,Client Receipt - CloudBridge Co. #21,Sales Receipt,SaaS-GL,0,50012.6,EUR,SEPA SCT,CloudBridge Co. #21,***2369,INV-202310-SaaS-GL-0015,,FALSE,FALSE,REF-993443,First Continental Bank,***3694,Globex EMEA Manufacturing Ltd.,IE,8572740.9
24/10/2023,24/10/2023,Supplier Payment - CodeCraft Contractors #4,Supplier Payment,SaaS-GL,4185.91,0,EUR,SEPA Credit Transfer,CodeCraft Contractors #4,***7170,,PO-202310-SaaS-GL-0006,FALSE,FALSE,REF-515998,First Continental Bank,***4483,Globex EMEA Manufacturing Ltd.,IE,8568554.99
24/10/2023,24/10/2023,Client Receipt - Vertex Advisory Client #6,Sales Receipt,PS-GL,0,1101.75,EUR,SEPA SCT Inst,Vertex Advisory Client #6,***5528,INV-202310-PS-GL-0003,,FALSE,FALSE,REF-247819,First Continental Bank,***8529,Globex EMEA Manufacturing Ltd.,IE,8569656.74
24/10/2023,24/10/2023,Client Receipt - CloudBridge Co. #31,Sales Receipt,SaaS-GL,0,4450.31,EUR,SEPA SCT,CloudBridge Co. #31,***8561,INV-202310-SaaS-GL-0026,,FALSE,FALSE,REF-949416,First Continental Bank,***9770,Globex EMEA Manufacturing Ltd.,IE,8574107.05
24/10/2023,24/10/2023,Client Receipt - CloudBridge Co. #47,Sales Receipt,SaaS-GL,0,5056.4,EUR,Card Settlement,CloudBridge Co. #47,***3189,INV-202310-SaaS-GL-0006,,FALSE,FALSE,REF-797334,First Continental Bank,***2905,Globex EMEA Manufacturing Ltd.,IE,8579163.45
24/10/2023,24/10/2023,Client Receipt - CloudBridge Co. #39,Sales Receipt,SaaS-GL,0,13272.01,EUR,SEPA SCT,CloudBridge Co. #39,***8129,INV-202310-SaaS-GL-0012,,FALSE,FALSE,REF-841127,First Continental Bank,***6390,Globex EMEA Manufacturing Ltd.,IE,8592435.46
24/10/2023,24/10/2023,Client Receipt - Vertex Advisory Client #52,Sales Receipt,PS-GL,0,41580.47,EUR,SEPA SCT,Vertex Advisory Client #52,***3287,INV-202310-PS-GL-0008,,FALSE,FALSE,REF-621589,First Continental Bank,***7003,Globex EMEA Manufacturing Ltd.,IE,8634015.93
24/10/2023,24/10/2023,Client Receipt - Novatek Components Ltd #14,Sales Receipt,CEM-EMEA,0,165159.55,EUR,SEPA SCT,Novatek Components Ltd #14,***6132,INV-202310-CEM-EMEA-0002,,FALSE,FALSE,REF-863122,First Continental Bank,***8287,Globex EMEA Manufacturing Ltd.,IE,8799175.48
24/10/2023,24/10/2023,Client Receipt - Aurora Electronics GmbH #3,Sales Receipt,CEM-EMEA,0,214230.27,EUR,Card Settlement,Aurora Electronics GmbH #3,***6311,INV-202310-CEM-EMEA-0007,,FALSE,FALSE,REF-892006,First Continental Bank,***2341,Globex EMEA Manufacturing Ltd.,IE,9013405.75
25/10/2023,25/10/2023,Merchant Processing Fees,Bank/Merchant Fees,ALL,1025.62,0,EUR,SEPA Debit,First Continental Bank,***2564,,,FALSE,FALSE,REF-647279,First Continental Bank,***8218,Globex EMEA Manufacturing Ltd.,IE,9012380.13
25/10/2023,25/10/2023,Supplier Payment - EuroFab Assembly #2,Supplier Payment,CEM-EMEA,63364.3,0,EUR,SWIFT MT103,EuroFab Assembly #2,***4986,,PO-202310-CEM-EMEA-0012,FALSE,FALSE,REF-651146,First Continental Bank,***2975,Globex EMEA Manufacturing Ltd.,IE,8949015.83
25/10/2023,25/10/2023,Payroll - GlobalPay Services Ltd,Payroll,ALL,176788.21,0,EUR,SEPA Credit Transfer,GlobalPay Services Ltd,***5486,,,FALSE,FALSE,REF-351018,First Continental Bank,***9826,Globex EMEA Manufacturing Ltd.,IE,8772227.62
25/10/2023,25/10/2023,Client Receipt - CloudBridge Co. #40,Sales Receipt,SaaS-GL,0,4152.98,EUR,SEPA SCT Inst,CloudBridge Co. #40,***3173,INV-202310-SaaS-GL-0002,,FALSE,FALSE,REF-672815,First Continental Bank,***3662,Globex EMEA Manufacturing Ltd.,IE,8776380.6
25/10/2023,25/10/2023,Client Receipt - CloudBridge Co. #72,Sales Receipt,SaaS-GL,0,10364.57,EUR,SEPA SCT Inst,CloudBridge Co. #72,***4847,INV-202310-SaaS-GL-0005,,FALSE,FALSE,REF-714584,First Continental Bank,***6848,Globex EMEA Manufacturing Ltd.,IE,8786745.17
25/10/2023,25/10/2023,Client Receipt - Vertex Advisory Client #14,Sales Receipt,PS-GL,0,83946.32,EUR,SEPA SCT,Vertex Advisory Client #14,***1042,INV-202310-PS-GL-0004,,FALSE,FALSE,REF-923847,First Continental Bank,***4949,Globex EMEA Manufacturing Ltd.,IE,8870691.49
26/10/2023,26/10/2023,Supplier Payment - ExpertNet Subcontractors #6,Supplier Payment,PS-GL,20312.17,0,EUR,SWIFT MT103,ExpertNet Subcontractors #6,***7298,,PO-202310-PS-GL-0005,FALSE,FALSE,REF-341285,First Continental Bank,***5940,Globex EMEA Manufacturing Ltd.,IE,8850379.32
26/10/2023,26/10/2023,Intercompany Settlement - Globex Consulting UK Ltd.,Intercompany Transfer,ALL,290777,0,EUR,Internal Transfer,Globex Consulting UK Ltd.,***4642,,,TRUE,TRUE,REF-191611,First Continental Bank,***9757,Globex EMEA Manufacturing Ltd.,IE,8559602.32
26/10/2023,26/10/2023,Client Receipt - Novatek Components Ltd #9,Sales Receipt,CEM-EMEA,0,245000.48,EUR,SEPA SCT,Novatek Components Ltd #9,***9523,INV-202310-CEM-EMEA-0005,,FALSE,FALSE,REF-554947,First Continental Bank,***9915,Globex EMEA Manufacturing Ltd.,IE,8804602.8
27/10/2023,27/10/2023,Client Receipt - Vertex Advisory Client #7,Sales Receipt,PS-GL,0,34577.87,EUR,SEPA SCT Inst,Vertex Advisory Client #7,***4365,INV-202310-PS-GL-0002,,FALSE,FALSE,REF-357316,First Continental Bank,***9615,Globex EMEA Manufacturing Ltd.,IE,8839180.67
28/10/2023,28/10/2023,Corporate Tax Estimate,Tax Payment,ALL,98962.19,0,EUR,SWIFT MT103,HMRC UK,***6277,,,FALSE,FALSE,REF-466815,First Continental Bank,***1101,Globex EMEA Manufacturing Ltd.,IE,8740218.48
29/10/2023,29/10/2023,Supplier Payment - HyperCloud Infra #5,Supplier Payment,SaaS-GL,15146.52,0,EUR,SEPA Credit Transfer,HyperCloud Infra #5,***2096,,PO-202310-SaaS-GL-0009,FALSE,FALSE,REF-462358,First Continental Bank,***3940,Globex EMEA Manufacturing Ltd.,IE,8725071.96
30/10/2023,30/10/2023,Supplier Payment - HyperCloud Infra #16,Supplier Payment,SaaS-GL,6746.04,0,EUR,SWIFT MT103,HyperCloud Infra #16,***9164,,PO-202310-SaaS-GL-0004,FALSE,FALSE,REF-814032,First Continental Bank,***7860,Globex EMEA Manufacturing Ltd.,IE,8718325.92
30/10/2023,30/10/2023,Supplier Payment - ExpertNet Subcontractors #17,Supplier Payment,PS-GL,39438.8,0,EUR,SWIFT MT103,ExpertNet Subcontractors #17,***4339,,PO-202310-PS-GL-0006,FALSE,FALSE,REF-551468,First Continental Bank,***6363,Globex EMEA Manufacturing Ltd.,IE,8678887.12
30/10/2023,30/10/2023,Payroll - GlobalPay Services Ltd,Payroll,ALL,176788.21,0,EUR,SWIFT MT103,GlobalPay Services Ltd,***6466,,,FALSE,FALSE,REF-545331,First Continental Bank,***5950,Globex EMEA Manufacturing Ltd.,IE,8502098.91
30/10/2023,30/10/2023,Interest Earned,Interest Income,ALL,0,9942.2,EUR,Card Settlement,First Continental Bank,***7122,,,FALSE,FALSE,REF-186526,First Continental Bank,***5315,Globex EMEA Manufacturing Ltd.,IE,8512041.11
30/10/2023,30/10/2023,Client Receipt - Vertex Advisory Client #1,Sales Receipt,PS-GL,0,39433.32,EUR,Card Settlement,Vertex Advisory Client #1,***6758,INV-202310-PS-GL-0009,,FALSE,FALSE,REF-359047,First Continental Bank,***4432,Globex EMEA Manufacturing Ltd.,IE,8551474.43
30/10/2023,30/10/2023,Client Receipt - CloudBridge Co. #64,Sales Receipt,SaaS-GL,0,80878.86,EUR,Card Settlement,CloudBridge Co. #64,***6996,INV-202310-SaaS-GL-0011,,FALSE,FALSE,REF-220717,First Continental Bank,***2174,Globex EMEA Manufacturing Ltd.,IE,8632353.29
31/10/2023,31/10/2023,Merchant Processing Fees,Bank/Merchant Fees,ALL,5707.11,0,EUR,SEPA Credit Transfer,First Continental Bank,***1345,,,FALSE,FALSE,REF-644338,First Continental Bank,***5618,Globex EMEA Manufacturing Ltd.,IE,8626646.18
31/10/2023,31/10/2023,Supplier Payment - CodeCraft Contractors #14,Supplier Payment,SaaS-GL,17703.39,0,EUR,SWIFT MT103,CodeCraft Contractors #14,***1154,,PO-202310-SaaS-GL-0003,FALSE,FALSE,REF-537791,First Continental Bank,***5260,Globex EMEA Manufacturing Ltd.,IE,8608942.79
31/10/2023,31/10/2023,Supplier Payment - Stelliform Parts BV #6,Supplier Payment,CEM-EMEA,77151.33,0,EUR,SEPA Debit,Stelliform Parts BV #6,***6564,,PO-202310-CEM-EMEA-0005,FALSE,FALSE,REF-392116,First Continental Bank,***4994,Globex EMEA Manufacturing Ltd.,IE,8531791.46
31/10/2023,31/10/2023,Client Receipt - CloudBridge Co. #21,Sales Receipt,SaaS-GL,0,6844.15,EUR,Card Settlement,CloudBridge Co. #21,***4597,INV-202310-SaaS-GL-0001,,FALSE,FALSE,REF-459445,First Continental Bank,***5622,Globex EMEA Manufacturing Ltd.,IE,8538635.61
31/10/2023,31/10/2023,Client Receipt - CloudBridge Co. #18,Sales Receipt,SaaS-GL,0,16832.59,EUR,SEPA SCT,CloudBridge Co. #18,***5546,INV-202310-SaaS-GL-0029,,FALSE,FALSE,REF-401581,First Continental Bank,***7029,Globex EMEA Manufacturing Ltd.,IE,8555468.2
01/11/2023,01/11/2023,Account Maintenance Fee,Bank/Merchant Fees,ALL,2500,0,EUR,SEPA Debit,First Continental Bank,***7840,,,FALSE,FALSE,REF-692068,First Continental Bank,***2815,Globex EMEA Manufacturing Ltd.,IE,8552968.2
01/11/2023,01/11/2023,Supplier Payment - EuroFab Assembly #4,Supplier Payment,CEM-EMEA,71530.68,0,EUR,SEPA Credit Transfer,EuroFab Assembly #4,***4078,,PO-202311-CEM-EMEA-0005,FALSE,FALSE,REF-314028,First Continental Bank,***2438,Globex EMEA Manufacturing Ltd.,IE,8481437.52
01/11/2023,01/11/2023,Client Receipt - CloudBridge Co. #39,Sales Receipt,SaaS-GL,0,8035.58,EUR,SEPA SCT,CloudBridge Co. #39,***7883,INV-202311-SaaS-GL-0001,,FALSE,FALSE,REF-967724,First Continental Bank,***6293,Globex EMEA Manufacturing Ltd.,IE,8489473.1
01/11/2023,01/11/2023,Client Receipt - Vertex Advisory Client #59,Sales Receipt,PS-GL,0,21156.75,EUR,SEPA SCT,Vertex Advisory Client #59,***8295,INV-202311-PS-GL-0010,,FALSE,FALSE,REF-608975,First Continental Bank,***8266,Globex EMEA Manufacturing Ltd.,IE,8510629.85
01/11/2023,01/11/2023,Client Receipt - CloudBridge Co. #15,Sales Receipt,SaaS-GL,0,47692.23,EUR,Card Settlement,CloudBridge Co. #15,***1872,INV-202311-SaaS-GL-0010,,FALSE,FALSE,REF-124826,First Continental Bank,***1628,Globex EMEA Manufacturing Ltd.,IE,8558322.08
01/11/2023,01/11/2023,Client Receipt - Novatek Components Ltd #4,Sales Receipt,CEM-EMEA,0,168214.39,EUR,Card Settlement,Novatek Components Ltd #4,***3502,INV-202311-CEM-EMEA-0006,,FALSE,FALSE,REF-229763,First Continental Bank,***6983,Globex EMEA Manufacturing Ltd.,IE,8726536.47
02/11/2023,02/11/2023,Supplier Payment - CodeCraft Contractors #14,Supplier Payment,SaaS-GL,5371.81,0,EUR,SEPA Debit,CodeCraft Contractors #14,***9617,,PO-202311-SaaS-GL-0011,FALSE,FALSE,REF-392085,First Continental Bank,***7561,Globex EMEA Manufacturing Ltd.,IE,8721164.66
02/11/2023,02/11/2023,Northshore Power,Rent & Utilities,ALL,20544.03,0,EUR,SEPA Credit Transfer,Northshore Power,***4283,,,FALSE,FALSE,REF-436599,First Continental Bank,***2882,Globex EMEA Manufacturing Ltd.,IE,8700620.63
03/11/2023,03/11/2023,Client Receipt - Vertex Advisory Client #24,Sales Receipt,PS-GL,0,3330.26,EUR,Card Settlement,Vertex Advisory Client #24,***3857,INV-202311-PS-GL-0007,,FALSE,FALSE,REF-380046,First Continental Bank,***5818,Globex EMEA Manufacturing Ltd.,IE,8703950.89
03/11/2023,03/11/2023,Client Receipt - Aurora Electronics GmbH #8,Sales Receipt,CEM-EMEA,0,204902.43,EUR,SEPA SCT,Aurora Electronics GmbH #8,***2044,INV-202311-CEM-EMEA-0010,,FALSE,FALSE,REF-928589,First Continental Bank,***9458,Globex EMEA Manufacturing Ltd.,IE,8908853.32
06/11/2023,06/11/2023,Supplier Payment - ExpertNet Subcontractors #2,Supplier Payment,PS-GL,4245.33,0,EUR,SEPA Credit Transfer,ExpertNet Subcontractors #2,***1427,,PO-202311-PS-GL-0010,FALSE,FALSE,REF-754483,First Continental Bank,***7221,Globex EMEA Manufacturing Ltd.,IE,8904607.99
06/11/2023,06/11/2023,Supplier Payment - HyperCloud Infra #7,Supplier Payment,SaaS-GL,34926.22,0,EUR,SEPA Debit,HyperCloud Infra #7,***6566,,PO-202311-SaaS-GL-0008,FALSE,FALSE,REF-138637,First Continental Bank,***5691,Globex EMEA Manufacturing Ltd.,IE,8869681.77
06/11/2023,06/11/2023,Client Receipt - CloudBridge Co. #43,Sales Receipt,SaaS-GL,0,54453.31,EUR,Card Settlement,CloudBridge Co. #43,***1810,INV-202311-SaaS-GL-0015,,FALSE,FALSE,REF-659276,First Continental Bank,***3987,Globex EMEA Manufacturing Ltd.,IE,8924135.08
07/11/2023,07/11/2023,Supplier Payment - HyperCloud Infra #1,Supplier Payment,SaaS-GL,5297.83,0,EUR,SEPA Debit,HyperCloud Infra #1,***1530,,PO-202311-SaaS-GL-0005,FALSE,FALSE,REF-324405,First Continental Bank,***9043,Globex EMEA Manufacturing Ltd.,IE,8918837.25
07/11/2023,07/11/2023,Client Receipt - CloudBridge Co. #17,Sales Receipt,SaaS-GL,0,4711.29,EUR,SEPA SCT Inst,CloudBridge Co. #17,***2688,INV-202311-SaaS-GL-0020,,FALSE,FALSE,REF-378934,First Continental Bank,***7119,Globex EMEA Manufacturing Ltd.,IE,8923548.54
07/11/2023,07/11/2023,Client Receipt - CloudBridge Co. #8,Sales Receipt,SaaS-GL,0,26406.71,EUR,SEPA SCT,CloudBridge Co. #8,***2848,INV-202311-SaaS-GL-0011,,FALSE,FALSE,REF-268047,First Continental Bank,***4695,Globex EMEA Manufacturing Ltd.,IE,8949955.25
07/11/2023,07/11/2023,Client Receipt - Aurora Electronics GmbH #18,Sales Receipt,CEM-EMEA,0,44522.58,EUR,Card Settlement,Aurora Electronics GmbH #18,***7699,INV-202311-CEM-EMEA-0005,,FALSE,FALSE,REF-451348,First Continental Bank,***7162,Globex EMEA Manufacturing Ltd.,IE,8994477.83
08/11/2023,08/11/2023,Supplier Payment - HyperCloud Infra #3,Supplier Payment,SaaS-GL,7385.11,0,EUR,SEPA Debit,HyperCloud Infra #3,***2589,,PO-202311-SaaS-GL-0001,FALSE,FALSE,REF-160947,First Continental Bank,***2526,Globex EMEA Manufacturing Ltd.,IE,8987092.72
08/11/2023,08/11/2023,Supplier Payment - EuroFab Assembly #3,Supplier Payment,CEM-EMEA,29359.91,0,EUR,SWIFT MT103,EuroFab Assembly #3,***2244,,PO-202311-CEM-EMEA-0007,FALSE,FALSE,REF-482063,First Continental Bank,***7410,Globex EMEA Manufacturing Ltd.,IE,8957732.81
08/11/2023,08/11/2023,Client Receipt - CloudBridge Co. #18,Sales Receipt,SaaS-GL,0,9811.07,EUR,Card Settlement,CloudBridge Co. #18,***7905,INV-202311-SaaS-GL-0027,,FALSE,FALSE,REF-150840,First Continental Bank,***8288,Globex EMEA Manufacturing Ltd.,IE,8967543.88
08/11/2023,08/11/2023,Client Receipt - CloudBridge Co. #43,Sales Receipt,SaaS-GL,0,10024.25,EUR,Card Settlement,CloudBridge Co. #43,***6024,INV-202311-SaaS-GL-0005,,FALSE,FALSE,REF-612450,First Continental Bank,***2898,Globex EMEA Manufacturing Ltd.,IE,8977568.13
08/11/2023,08/11/2023,Client Receipt - CloudBridge Co. #66,Sales Receipt,SaaS-GL,0,33607.25,EUR,Card Settlement,CloudBridge Co. #66,***3877,INV-202311-SaaS-GL-0014,,FALSE,FALSE,REF-816528,First Continental Bank,***6017,Globex EMEA Manufacturing Ltd.,IE,9011175.38
08/11/2023,08/11/2023,Client Receipt - Vertex Advisory Client #48,Sales Receipt,PS-GL,0,36512.85,EUR,SEPA SCT,Vertex Advisory Client #48,***1463,INV-202311-PS-GL-0011,,FALSE,FALSE,REF-229410,First Continental Bank,***7807,Globex EMEA Manufacturing Ltd.,IE,9047688.23
09/11/2023,09/11/2023,Supplier Payment - ExpertNet Subcontractors #10,Supplier Payment,PS-GL,6964.49,0,EUR,SEPA Credit Transfer,ExpertNet Subcontractors #10,***4600,,PO-202311-PS-GL-0004,FALSE,FALSE,REF-760764,First Continental Bank,***1439,Globex EMEA Manufacturing Ltd.,IE,9040723.74
09/11/2023,09/11/2023,Client Receipt - CloudBridge Co. #30,Sales Receipt,SaaS-GL,0,7945.11,EUR,SEPA SCT,CloudBridge Co. #30,***8760,INV-202311-SaaS-GL-0021,,FALSE,FALSE,REF-523835,First Continental Bank,***6450,Globex EMEA Manufacturing Ltd.,IE,9048668.85
09/11/2023,09/11/2023,Client Receipt - Vertex Advisory Client #29,Sales Receipt,PS-GL,0,60390.44,EUR,SEPA SCT,Vertex Advisory Client #29,***2441,INV-202311-PS-GL-0008,,FALSE,FALSE,REF-200468,First Continental Bank,***6375,Globex EMEA Manufacturing Ltd.,IE,9109059.29
10/11/2023,10/11/2023,Supplier Payment - HyperCloud Infra #15,Supplier Payment,SaaS-GL,28454.8,0,EUR,SEPA Debit,HyperCloud Infra #15,***7068,,PO-202311-SaaS-GL-0007,FALSE,FALSE,REF-356935,First Continental Bank,***7634,Globex EMEA Manufacturing Ltd.,IE,9080604.49
10/11/2023,10/11/2023,Supplier Payment - EuroFab Assembly #20,Supplier Payment,CEM-EMEA,122735.48,0,EUR,SEPA Debit,EuroFab Assembly #20,***2709,,PO-202311-CEM-EMEA-0002,FALSE,FALSE,REF-207577,First Continental Bank,***3679,Globex EMEA Manufacturing Ltd.,IE,8957869.01
10/11/2023,10/11/2023,Client Receipt - Aurora Electronics GmbH #15,Sales Receipt,CEM-EMEA,0,16863.4,EUR,Card Settlement,Aurora Electronics GmbH #15,***9432,INV-202311-CEM-EMEA-0009,,FALSE,FALSE,REF-221036,First Continental Bank,***3956,Globex EMEA Manufacturing Ltd.,IE,8974732.41
10/11/2023,10/11/2023,Client Receipt - CloudBridge Co. #18,Sales Receipt,SaaS-GL,0,21985.37,EUR,SEPA SCT,CloudBridge Co. #18,***7904,INV-202311-SaaS-GL-0024,,FALSE,FALSE,REF-204815,First Continental Bank,***1500,Globex EMEA Manufacturing Ltd.,IE,8996717.78
11/11/2023,11/11/2023,Client Receipt - Vertex Advisory Client #16,Sales Receipt,PS-GL,0,55501.14,EUR,Card Settlement,Vertex Advisory Client #16,***2674,INV-202311-PS-GL-0005,,FALSE,FALSE,REF-356448,First Continental Bank,***3913,Globex EMEA Manufacturing Ltd.,IE,9052218.92
12/11/2023,12/11/2023,"Intercompany Settlement - Globex International Holdings, Inc.",Intercompany Transfer,ALL,440374,0,EUR,Internal Transfer,"Globex International Holdings, Inc.",***3904,,,TRUE,TRUE,REF-844858,First Continental Bank,***6291,Globex EMEA Manufacturing Ltd.,IE,8611844.92
12/11/2023,12/11/2023,Client Receipt - Vertex Advisory Client #2,Sales Receipt,PS-GL,0,68836.21,EUR,SEPA SCT,Vertex Advisory Client #2,***3436,INV-202311-PS-GL-0001,,FALSE,FALSE,REF-341418,First Continental Bank,***3172,Globex EMEA Manufacturing Ltd.,IE,8680681.13
13/11/2023,13/11/2023,Client Receipt - Vertex Advisory Client #36,Sales Receipt,PS-GL,0,28278.89,EUR,SEPA SCT Inst,Vertex Advisory Client #36,***2014,INV-202311-PS-GL-0009,,FALSE,FALSE,REF-143723,First Continental Bank,***9561,Globex EMEA Manufacturing Ltd.,IE,8708960.02
13/11/2023,13/11/2023,Client Receipt - Novatek Components Ltd #4,Sales Receipt,CEM-EMEA,0,84698.17,EUR,Card Settlement,Novatek Components Ltd #4,***8787,INV-202311-CEM-EMEA-0007,,FALSE,FALSE,REF-568446,First Continental Bank,***9288,Globex EMEA Manufacturing Ltd.,IE,8793658.19
14/11/2023,14/11/2023,Supplier Payment - ExpertNet Subcontractors #18,Supplier Payment,PS-GL,35573.9,0,EUR,SEPA Credit Transfer,ExpertNet Subcontractors #18,***2217,,PO-202311-PS-GL-0003,FALSE,FALSE,REF-861541,First Continental Bank,***5769,Globex EMEA Manufacturing Ltd.,IE,8758084.29
14/11/2023,14/11/2023,Client Receipt - CloudBridge Co. #62,Sales Receipt,SaaS-GL,0,5443.66,EUR,SEPA SCT,CloudBridge Co. #62,***3182,INV-202311-SaaS-GL-0026,,FALSE,FALSE,REF-230623,First Continental Bank,***8326,Globex EMEA Manufacturing Ltd.,IE,8763527.95
14/11/2023,14/11/2023,Client Receipt - CloudBridge Co. #74,Sales Receipt,SaaS-GL,0,8975.98,EUR,SEPA SCT,CloudBridge Co. #74,***9221,INV-202311-SaaS-GL-0025,,FALSE,FALSE,REF-634966,First Continental Bank,***3948,Globex EMEA Manufacturing Ltd.,IE,8772503.93
14/11/2023,14/11/2023,Client Receipt - CloudBridge Co. #14,Sales Receipt,SaaS-GL,0,27990.91,EUR,SEPA SCT Inst,CloudBridge Co. #14,***8541,INV-202311-SaaS-GL-0009,,FALSE,FALSE,REF-223585,First Continental Bank,***7608,Globex EMEA Manufacturing Ltd.,IE,8800494.84
14/11/2023,14/11/2023,Client Receipt - Novatek Components Ltd #2,Sales Receipt,CEM-EMEA,0,89256.79,EUR,SEPA SCT Inst,Novatek Components Ltd #2,***4779,INV-202311-CEM-EMEA-0002,,FALSE,FALSE,REF-588252,First Continental Bank,***1197,Globex EMEA Manufacturing Ltd.,IE,8889751.63
14/11/2023,14/11/2023,Client Receipt - Aurora Electronics GmbH #11,Sales Receipt,CEM-EMEA,0,174971.57,EUR,SEPA SCT Inst,Aurora Electronics GmbH #11,***3131,INV-202311-CEM-EMEA-0008,,FALSE,FALSE,REF-767197,First Continental Bank,***1582,Globex EMEA Manufacturing Ltd.,IE,9064723.2
15/11/2023,15/11/2023,Supplier Payment - ExpertNet Subcontractors #17,Supplier Payment,PS-GL,5032.55,0,EUR,SEPA Credit Transfer,ExpertNet Subcontractors #17,***2885,,PO-202311-PS-GL-0005,FALSE,FALSE,REF-951092,First Continental Bank,***4414,Globex EMEA Manufacturing Ltd.,IE,9059690.65
15/11/2023,15/11/2023,Supplier Payment - HyperCloud Infra #1,Supplier Payment,SaaS-GL,10761.76,0,EUR,SEPA Debit,HyperCloud Infra #1,***3927,,PO-202311-SaaS-GL-0002,FALSE,FALSE,REF-596058,First Continental Bank,***9728,Globex EMEA Manufacturing Ltd.,IE,9048928.89
15/11/2023,15/11/2023,Supplier Payment - ExpertNet Subcontractors #2,Supplier Payment,PS-GL,15902.27,0,EUR,SEPA Credit Transfer,ExpertNet Subcontractors #2,***6699,,PO-202311-PS-GL-0008,FALSE,FALSE,REF-622894,First Continental Bank,***6806,Globex EMEA Manufacturing Ltd.,IE,9033026.62
15/11/2023,15/11/2023,Loan Interest Payment,Loan Interest,ALL,85000,0,EUR,SEPA Credit Transfer,First Continental Bank - Corporate Lending,***1053,,,FALSE,FALSE,REF-326398,First Continental Bank,***6059,Globex EMEA Manufacturing Ltd.,IE,8948026.62
15/11/2023,15/11/2023,Loan Principal Repayment,Loan Principal,ALL,500000,0,EUR,SEPA Credit Transfer,First Continental Bank - Corporate Lending,***2434,,,FALSE,FALSE,REF-770964,First Continental Bank,***5038,Globex EMEA Manufacturing Ltd.,IE,8448026.62
15/11/2023,15/11/2023,Client Receipt - CloudBridge Co. #2,Sales Receipt,SaaS-GL,0,16243.78,EUR,Card Settlement,CloudBridge Co. #2,***3766,INV-202311-SaaS-GL-0008,,FALSE,FALSE,REF-949594,First Continental Bank,***4233,Globex EMEA Manufacturing Ltd.,IE,8464270.4
15/11/2023,15/11/2023,Client Receipt - CloudBridge Co. #14,Sales Receipt,SaaS-GL,0,30607.49,EUR,SEPA SCT Inst,CloudBridge Co. #14,***7866,INV-202311-SaaS-GL-0002,,FALSE,FALSE,REF-634682,First Continental Bank,***1014,Globex EMEA Manufacturing Ltd.,IE,8494877.89
15/11/2023,15/11/2023,Client Receipt - CloudBridge Co. #55,Sales Receipt,SaaS-GL,0,93252.24,EUR,SEPA SCT Inst,CloudBridge Co. #55,***7049,INV-202311-SaaS-GL-0006,,FALSE,FALSE,REF-101832,First Continental Bank,***8493,Globex EMEA Manufacturing Ltd.,IE,8588130.13
15/11/2023,15/11/2023,Client Receipt - Vertex Advisory Client #18,Sales Receipt,PS-GL,0,94557.54,EUR,SEPA SCT Inst,Vertex Advisory Client #18,***6211,INV-202311-PS-GL-0004,,FALSE,FALSE,REF-606785,First Continental Bank,***9784,Globex EMEA Manufacturing Ltd.,IE,8682687.67
15/11/2023,15/11/2023,Client Receipt - Aurora Electronics GmbH #14,Sales Receipt,CEM-EMEA,0,131592.2,EUR,SEPA SCT Inst,Aurora Electronics GmbH #14,***1569,INV-202311-CEM-EMEA-0011,,FALSE,FALSE,REF-927758,First Continental Bank,***9098,Globex EMEA Manufacturing Ltd.,IE,8814279.87
16/11/2023,16/11/2023,Client Receipt - CloudBridge Co. #30,Sales Receipt,SaaS-GL,0,12803.21,EUR,SEPA SCT,CloudBridge Co. #30,***1250,INV-202311-SaaS-GL-0017,,FALSE,FALSE,REF-718250,First Continental Bank,***2013,Globex EMEA Manufacturing Ltd.,IE,8827083.08
16/11/2023,16/11/2023,Client Receipt - Aurora Electronics GmbH #3,Sales Receipt,CEM-EMEA,0,14894.42,EUR,SEPA SCT Inst,Aurora Electronics GmbH #3,***8025,INV-202311-CEM-EMEA-0001,,FALSE,FALSE,REF-348570,First Continental Bank,***2130,Globex EMEA Manufacturing Ltd.,IE,8841977.5
16/11/2023,16/11/2023,Client Receipt - CloudBridge Co. #67,Sales Receipt,SaaS-GL,0,60542.48,EUR,SEPA SCT Inst,CloudBridge Co. #67,***6446,INV-202311-SaaS-GL-0023,,FALSE,FALSE,REF-579503,First Continental Bank,***7803,Globex EMEA Manufacturing Ltd.,IE,8902519.98
17/11/2023,17/11/2023,Supplier Payment - CodeCraft Contractors #6,Supplier Payment,SaaS-GL,5892.63,0,EUR,SEPA Debit,CodeCraft Contractors #6,***6376,,PO-202311-SaaS-GL-0010,FALSE,FALSE,REF-716484,First Continental Bank,***1879,Globex EMEA Manufacturing Ltd.,IE,8896627.35
17/11/2023,17/11/2023,Client Receipt - Vertex Advisory Client #11,Sales Receipt,PS-GL,0,89210.03,EUR,Card Settlement,Vertex Advisory Client #11,***9019,INV-202311-PS-GL-0003,,FALSE,FALSE,REF-458800,First Continental Bank,***8526,Globex EMEA Manufacturing Ltd.,IE,8985837.38
18/11/2023,18/11/2023,Supplier Payment - ExpertNet Subcontractors #10,Supplier Payment,PS-GL,23339.67,0,EUR,SWIFT MT103,ExpertNet Subcontractors #10,***5424,,PO-202311-PS-GL-0006,FALSE,FALSE,REF-824922,First Continental Bank,***4785,Globex EMEA Manufacturing Ltd.,IE,8962497.71
18/11/2023,18/11/2023,Supplier Payment - CodeCraft Contractors #9,Supplier Payment,SaaS-GL,26242.24,0,EUR,SWIFT MT103,CodeCraft Contractors #9,***2495,,PO-202311-SaaS-GL-0004,FALSE,FALSE,REF-993956,First Continental Bank,***2736,Globex EMEA Manufacturing Ltd.,IE,8936255.47
18/11/2023,18/11/2023,Client Receipt - Vertex Advisory Client #58,Sales Receipt,PS-GL,0,44151.56,EUR,Card Settlement,Vertex Advisory Client #58,***7363,INV-202311-PS-GL-0002,,FALSE,FALSE,REF-272247,First Continental Bank,***9899,Globex EMEA Manufacturing Ltd.,IE,8980407.03
19/11/2023,19/11/2023,Supplier Payment - Stelliform Parts BV #10,Supplier Payment,CEM-EMEA,51303.22,0,EUR,SEPA Credit Transfer,Stelliform Parts BV #10,***2390,,PO-202311-CEM-EMEA-0012,FALSE,FALSE,REF-463655,First Continental Bank,***9165,Globex EMEA Manufacturing Ltd.,IE,8929103.81
20/11/2023,20/11/2023,Supplier Payment - Stelliform Parts BV #24,Supplier Payment,CEM-EMEA,42000.29,0,EUR,SWIFT MT103,Stelliform Parts BV #24,***6704,,PO-202311-CEM-EMEA-0011,FALSE,FALSE,REF-982213,First Continental Bank,***4392,Globex EMEA Manufacturing Ltd.,IE,8887103.52
21/11/2023,21/11/2023,Client Receipt - CloudBridge Co. #43,Sales Receipt,SaaS-GL,0,21058.65,EUR,Card Settlement,CloudBridge Co. #43,***6374,INV-202311-SaaS-GL-0022,,FALSE,FALSE,REF-258357,First Continental Bank,***9963,Globex EMEA Manufacturing Ltd.,IE,8908162.17
21/11/2023,21/11/2023,Client Receipt - Vertex Advisory Client #16,Sales Receipt,PS-GL,0,23726.14,EUR,SEPA SCT Inst,Vertex Advisory Client #16,***5881,INV-202311-PS-GL-0006,,FALSE,FALSE,REF-989199,First Continental Bank,***3131,Globex EMEA Manufacturing Ltd.,IE,8931888.31
21/11/2023,21/11/2023,Client Receipt - CloudBridge Co. #14,Sales Receipt,SaaS-GL,0,59684.66,EUR,Card Settlement,CloudBridge Co. #14,***7865,INV-202311-SaaS-GL-0016,,FALSE,FALSE,REF-411029,First Continental Bank,***3023,Globex EMEA Manufacturing Ltd.,IE,8991572.97
22/11/2023,22/11/2023,Merchant Processing Fees,Bank/Merchant Fees,ALL,1566.19,0,EUR,SWIFT MT103,First Continental Bank,***4236,,,FALSE,FALSE,REF-567789,First Continental Bank,***3880,Globex EMEA Manufacturing Ltd.,IE,8990006.78
22/11/2023,22/11/2023,Supplier Payment - ExpertNet Subcontractors #7,Supplier Payment,PS-GL,11258.38,0,EUR,SWIFT MT103,ExpertNet Subcontractors #7,***8987,,PO-202311-PS-GL-0002,FALSE,FALSE,REF-652990,First Continental Bank,***2950,Globex EMEA Manufacturing Ltd.,IE,8978748.4
22/11/2023,22/11/2023,Supplier Payment - HyperCloud Infra #12,Supplier Payment,SaaS-GL,16688.63,0,EUR,SEPA Debit,HyperCloud Infra #12,***5687,,PO-202311-SaaS-GL-0009,FALSE,FALSE,REF-857081,First Continental Bank,***4743,Globex EMEA Manufacturing Ltd.,IE,8962059.77
22/11/2023,22/11/2023,VAT/GST Remittance - Revenue Ireland,Tax Payment,ALL,149966.29,0,EUR,SWIFT MT103,Revenue Ireland,***7814,,,FALSE,FALSE,REF-377858,First Continental Bank,***8077,Globex EMEA Manufacturing Ltd.,IE,8812093.48
23/11/2023,23/11/2023,Supplier Payment - HyperCloud Infra #18,Supplier Payment,SaaS-GL,2527.44,0,EUR,SWIFT MT103,HyperCloud Infra #18,***2594,,PO-202311-SaaS-GL-0006,FALSE,FALSE,REF-220415,First Continental Bank,***9542,Globex EMEA Manufacturing Ltd.,IE,8809566.04
23/11/2023,23/11/2023,Supplier Payment - ExpertNet Subcontractors #1,Supplier Payment,PS-GL,15148.97,0,EUR,SWIFT MT103,ExpertNet Subcontractors #1,***5486,,PO-202311-PS-GL-0009,FALSE,FALSE,REF-318569,First Continental Bank,***7647,Globex EMEA Manufacturing Ltd.,IE,8794417.07
23/11/2023,23/11/2023,Client Receipt - CloudBridge Co. #45,Sales Receipt,SaaS-GL,0,6472.78,EUR,SEPA SCT,CloudBridge Co. #45,***4575,INV-202311-SaaS-GL-0012,,FALSE,FALSE,REF-460978,First Continental Bank,***9965,Globex EMEA Manufacturing Ltd.,IE,8800889.85
23/11/2023,23/11/2023,Client Receipt - Novatek Components Ltd #7,Sales Receipt,CEM-EMEA,0,102837.44,EUR,Card Settlement,Novatek Components Ltd #7,***1603,INV-202311-CEM-EMEA-0004,,FALSE,FALSE,REF-478061,First Continental Bank,***5554,Globex EMEA Manufacturing Ltd.,IE,8903727.29
24/11/2023,24/11/2023,Supplier Payment - Stelliform Parts BV #5,Supplier Payment,CEM-EMEA,23782.84,0,EUR,SEPA Credit Transfer,Stelliform Parts BV #5,***7131,,PO-202311-CEM-EMEA-0001,FALSE,FALSE,REF-360615,First Continental Bank,***8673,Globex EMEA Manufacturing Ltd.,IE,8879944.45
24/11/2023,24/11/2023,Supplier Payment - ExpertNet Subcontractors #15,Supplier Payment,PS-GL,29226.66,0,EUR,SEPA Debit,ExpertNet Subcontractors #15,***3708,,PO-202311-PS-GL-0001,FALSE,FALSE,REF-410055,First Continental Bank,***8124,Globex EMEA Manufacturing Ltd.,IE,8850717.79
24/11/2023,24/11/2023,Marketing - Aurelia Media #8,Marketing,ALL,35016.91,0,EUR,SEPA Credit Transfer,Aurelia Media #8,***1471,,,FALSE,FALSE,REF-894810,First Continental Bank,***8270,Globex EMEA Manufacturing Ltd.,IE,8815700.88
25/11/2023,25/11/2023,Supplier Payment - Stelliform Parts BV #27,Supplier Payment,CEM-EMEA,8003.82,0,EUR,SEPA Debit,Stelliform Parts BV #27,***4216,,PO-202311-CEM-EMEA-0006,FALSE,FALSE,REF-614847,First Continental Bank,***3221,Globex EMEA Manufacturing Ltd.,IE,8807697.06
25/11/2023,25/11/2023,Payroll - GlobalPay Services Ltd,Payroll,ALL,410327.93,0,EUR,SEPA Debit,GlobalPay Services Ltd,***7683,,,FALSE,FALSE,REF-960732,First Continental Bank,***8535,Globex EMEA Manufacturing Ltd.,IE,8397369.13
26/11/2023,26/11/2023,Supplier Payment - Stelliform Parts BV #31,Supplier Payment,CEM-EMEA,68787.87,0,EUR,SEPA Credit Transfer,Stelliform Parts BV #31,***2043,,PO-202311-CEM-EMEA-0004,FALSE,FALSE,REF-727996,First Continental Bank,***4556,Globex EMEA Manufacturing Ltd.,IE,8328581.26
26/11/2023,26/11/2023,Intercompany Settlement - Globex Consulting UK Ltd.,Intercompany Transfer,ALL,490387,0,EUR,Internal Transfer,Globex Consulting UK Ltd.,***5055,,,TRUE,TRUE,REF-226274,First Continental Bank,***7031,Globex EMEA Manufacturing Ltd.,IE,7838194.26
26/11/2023,26/11/2023,Client Receipt - CloudBridge Co. #79,Sales Receipt,SaaS-GL,0,41087.34,EUR,Card Settlement,CloudBridge Co. #79,***2650,INV-202311-SaaS-GL-0019,,FALSE,FALSE,REF-929129,First Continental Bank,***4212,Globex EMEA Manufacturing Ltd.,IE,7879281.6
26/11/2023,26/11/2023,Intercompany Reimbursement - Globex Consulting UK Ltd.,Intercompany Transfer,ALL,0,196154.8,EUR,Internal Transfer,Globex Consulting UK Ltd.,***4520,,,TRUE,TRUE,REF-446343,First Continental Bank,***7412,Globex EMEA Manufacturing Ltd.,IE,8075436.4
27/11/2023,27/11/2023,Supplier Payment - EuroFab Assembly #21,Supplier Payment,CEM-EMEA,100556.75,0,EUR,SWIFT MT103,EuroFab Assembly #21,***1394,,PO-202311-CEM-EMEA-0010,FALSE,FALSE,REF-825976,First Continental Bank,***3988,Globex EMEA Manufacturing Ltd.,IE,7974879.65
27/11/2023,27/11/2023,Client Receipt - CloudBridge Co. #65,Sales Receipt,SaaS-GL,0,31778.7,EUR,Card Settlement,CloudBridge Co. #65,***7121,INV-202311-SaaS-GL-0018,,FALSE,FALSE,REF-855055,First Continental Bank,***8436,Globex EMEA Manufacturing Ltd.,IE,8006658.35
27/11/2023,27/11/2023,Client Receipt - CloudBridge Co. #34,Sales Receipt,SaaS-GL,0,47138.37,EUR,Card Settlement,CloudBridge Co. #34,***1102,INV-202311-SaaS-GL-0003,,FALSE,FALSE,REF-238905,First Continental Bank,***9230,Globex EMEA Manufacturing Ltd.,IE,8053796.72
28/11/2023,28/11/2023,Supplier Payment - ExpertNet Subcontractors #10,Supplier Payment,PS-GL,11003.32,0,EUR,SWIFT MT103,ExpertNet Subcontractors #10,***8199,,PO-202311-PS-GL-0007,FALSE,FALSE,REF-724789,First Continental Bank,***2491,Globex EMEA Manufacturing Ltd.,IE,8042793.4
28/11/2023,28/11/2023,Marketing - Aurelia Media #3,Marketing,ALL,27146.41,0,EUR,SEPA Debit,Aurelia Media #3,***5889,,,FALSE,FALSE,REF-322753,First Continental Bank,***3919,Globex EMEA Manufacturing Ltd.,IE,8015646.99
28/11/2023,28/11/2023,Client Receipt - CloudBridge Co. #48,Sales Receipt,SaaS-GL,0,40279.27,EUR,Card Settlement,CloudBridge Co. #48,***2555,INV-202311-SaaS-GL-0007,,FALSE,FALSE,REF-896668,First Continental Bank,***3919,Globex EMEA Manufacturing Ltd.,IE,8055926.26
28/11/2023,28/11/2023,Client Receipt - CloudBridge Co. #11,Sales Receipt,SaaS-GL,0,58520.15,EUR,SEPA SCT Inst,CloudBridge Co. #11,***9712,INV-202311-SaaS-GL-0004,,FALSE,FALSE,REF-918758,First Continental Bank,***3411,Globex EMEA Manufacturing Ltd.,IE,8114446.41
29/11/2023,29/11/2023,Merchant Processing Fees,Bank/Merchant Fees,ALL,6038.16,0,EUR,SWIFT MT103,First Continental Bank,***2569,,,FALSE,FALSE,REF-792631,First Continental Bank,***8316,Globex EMEA Manufacturing Ltd.,IE,8108408.25
29/11/2023,29/11/2023,Supplier Payment - CodeCraft Contractors #9,Supplier Payment,SaaS-GL,18985.5,0,EUR,SEPA Credit Transfer,CodeCraft Contractors #9,***1830,,PO-202311-SaaS-GL-0003,FALSE,FALSE,REF-143860,First Continental Bank,***1800,Globex EMEA Manufacturing Ltd.,IE,8089422.75
30/11/2023,30/11/2023,Supplier Payment - HyperCloud Infra #19,Supplier Payment,SaaS-GL,10931.13,0,EUR,SWIFT MT103,HyperCloud Infra #19,***9000,,PO-202311-SaaS-GL-0012,FALSE,FALSE,REF-752137,First Continental Bank,***8855,Globex EMEA Manufacturing Ltd.,IE,8078491.62
30/11/2023,30/11/2023,Supplier Payment - EuroFab Assembly #9,Supplier Payment,CEM-EMEA,29860.52,0,EUR,SEPA Credit Transfer,EuroFab Assembly #9,***9101,,PO-202311-CEM-EMEA-0008,FALSE,FALSE,REF-501770,First Continental Bank,***8970,Globex EMEA Manufacturing Ltd.,IE,8048631.1
30/11/2023,30/11/2023,Supplier Payment - EuroFab Assembly #8,Supplier Payment,CEM-EMEA,35688.12,0,EUR,SEPA Debit,EuroFab Assembly #8,***1343,,PO-202311-CEM-EMEA-0003,FALSE,FALSE,REF-989253,First Continental Bank,***4454,Globex EMEA Manufacturing Ltd.,IE,8012942.98
30/11/2023,30/11/2023,Supplier Payment - Stelliform Parts BV #26,Supplier Payment,CEM-EMEA,152303.03,0,EUR,SWIFT MT103,Stelliform Parts BV #26,***1268,,PO-202311-CEM-EMEA-0009,FALSE,FALSE,REF-901847,First Continental Bank,***2722,Globex EMEA Manufacturing Ltd.,IE,7860639.95
30/11/2023,30/11/2023,Client Receipt - CloudBridge Co. #2,Sales Receipt,SaaS-GL,0,1925.87,EUR,Card Settlement,CloudBridge Co. #2,***2986,INV-202311-SaaS-GL-0013,,FALSE,FALSE,REF-326675,First Continental Bank,***8434,Globex EMEA Manufacturing Ltd.,IE,7862565.82
30/11/2023,30/11/2023,Interest Earned,Interest Income,ALL,0,10831.01,EUR,SEPA SCT,First Continental Bank,***7340,,,FALSE,FALSE,REF-820340,First Continental Bank,***4564,Globex EMEA Manufacturing Ltd.,IE,7873396.83
30/11/2023,30/11/2023,Client Receipt - Aurora Electronics GmbH #9,Sales Receipt,CEM-EMEA,0,193767.5,EUR,SEPA SCT Inst,Aurora Electronics GmbH #9,***3161,INV-202311-CEM-EMEA-0003,,FALSE,FALSE,REF-327380,First Continental Bank,***7859,Globex EMEA Manufacturing Ltd.,IE,8067164.33
01/12/2023,01/12/2023,Account Maintenance Fee,Bank/Merchant Fees,ALL,2500,0,EUR,SEPA Credit Transfer,First Continental Bank,***7227,,,FALSE,FALSE,REF-588700,First Continental Bank,***2713,Globex EMEA Manufacturing Ltd.,IE,8064664.33
01/12/2023,01/12/2023,Supplier Payment - Stelliform Parts BV #23,Supplier Payment,CEM-EMEA,67280.31,0,EUR,SEPA Credit Transfer,Stelliform Parts BV #23,***9440,,PO-202312-CEM-EMEA-0011,FALSE,FALSE,REF-734021,First Continental Bank,***8932,Globex EMEA Manufacturing Ltd.,IE,7997384.02
01/12/2023,01/12/2023,Supplier Payment - EuroFab Assembly #24,Supplier Payment,CEM-EMEA,70931.39,0,EUR,SWIFT MT103,EuroFab Assembly #24,***9128,,PO-202312-CEM-EMEA-0007,FALSE,FALSE,REF-492148,First Continental Bank,***6531,Globex EMEA Manufacturing Ltd.,IE,7926452.63
01/12/2023,01/12/2023,Client Receipt - Aurora Electronics GmbH #5,Sales Receipt,CEM-EMEA,0,47184.23,EUR,Card Settlement,Aurora Electronics GmbH #5,***9856,INV-202312-CEM-EMEA-0005,,FALSE,FALSE,REF-555977,First Continental Bank,***9619,Globex EMEA Manufacturing Ltd.,IE,7973636.86
02/12/2023,02/12/2023,Supplier Payment - CodeCraft Contractors #14,Supplier Payment,SaaS-GL,7822.25,0,EUR,SEPA Credit Transfer,CodeCraft Contractors #14,***9051,,PO-202312-SaaS-GL-0008,FALSE,FALSE,REF-307121,First Continental Bank,***9652,Globex EMEA Manufacturing Ltd.,IE,7965814.61
02/12/2023,02/12/2023,Supplier Payment - HyperCloud Infra #3,Supplier Payment,SaaS-GL,23056.3,0,EUR,SEPA Debit,HyperCloud Infra #3,***6974,,PO-202312-SaaS-GL-0009,FALSE,FALSE,REF-192437,First Continental Bank,***9671,Globex EMEA Manufacturing Ltd.,IE,7942758.31
04/12/2023,04/12/2023,Supplier Payment - ExpertNet Subcontractors #2,Supplier Payment,PS-GL,2722.54,0,EUR,SEPA Debit,ExpertNet Subcontractors #2,***9913,,PO-202312-PS-GL-0007,FALSE,FALSE,REF-257237,First Continental Bank,***9438,Globex EMEA Manufacturing Ltd.,IE,7940035.77
04/12/2023,04/12/2023,Supplier Payment - Stelliform Parts BV #1,Supplier Payment,CEM-EMEA,55183.34,0,EUR,SWIFT MT103,Stelliform Parts BV #1,***2143,,PO-202312-CEM-EMEA-0008,FALSE,FALSE,REF-627084,First Continental Bank,***6610,Globex EMEA Manufacturing Ltd.,IE,7884852.43
04/12/2023,04/12/2023,Client Receipt - CloudBridge Co. #67,Sales Receipt,SaaS-GL,0,12998.89,EUR,Card Settlement,CloudBridge Co. #67,***3640,INV-202312-SaaS-GL-0015,,FALSE,FALSE,REF-547503,First Continental Bank,***5188,Globex EMEA Manufacturing Ltd.,IE,7897851.32
04/12/2023,04/12/2023,Client Receipt - CloudBridge Co. #35,Sales Receipt,SaaS-GL,0,25787.66,EUR,SEPA SCT,CloudBridge Co. #35,***1833,INV-202312-SaaS-GL-0019,,FALSE,FALSE,REF-865683,First Continental Bank,***6442,Globex EMEA Manufacturing Ltd.,IE,7923638.98
04/12/2023,04/12/2023,Client Receipt - CloudBridge Co. #15,Sales Receipt,SaaS-GL,0,28500.14,EUR,SEPA SCT,CloudBridge Co. #15,***5735,INV-202312-SaaS-GL-0006,,FALSE,FALSE,REF-740647,First Continental Bank,***7217,Globex EMEA Manufacturing Ltd.,IE,7952139.12
05/12/2023,05/12/2023,Supplier Payment - CodeCraft Contractors #9,Supplier Payment,SaaS-GL,18992.01,0,EUR,SEPA Debit,CodeCraft Contractors #9,***1251,,PO-202312-SaaS-GL-0007,FALSE,FALSE,REF-954094,First Continental Bank,***6422,Globex EMEA Manufacturing Ltd.,IE,7933147.11
05/12/2023,05/12/2023,Client Receipt - CloudBridge Co. #6,Sales Receipt,SaaS-GL,0,1226.96,EUR,Card Settlement,CloudBridge Co. #6,***8651,INV-202312-SaaS-GL-0016,,FALSE,FALSE,REF-716496,First Continental Bank,***3366,Globex EMEA Manufacturing Ltd.,IE,7934374.07
05/12/2023,05/12/2023,Client Receipt - Aurora Electronics GmbH #8,Sales Receipt,CEM-EMEA,0,4738.33,EUR,SEPA SCT Inst,Aurora Electronics GmbH #8,***8538,INV-202312-CEM-EMEA-0009,,FALSE,FALSE,REF-747707,First Continental Bank,***7578,Globex EMEA Manufacturing Ltd.,IE,7939112.4
05/12/2023,05/12/2023,Client Receipt - CloudBridge Co. #18,Sales Receipt,SaaS-GL,0,11248.23,EUR,SEPA SCT,CloudBridge Co. #18,***3073,INV-202312-SaaS-GL-0004,,FALSE,FALSE,REF-238372,First Continental Bank,***7438,Globex EMEA Manufacturing Ltd.,IE,7950360.63
06/12/2023,06/12/2023,Supplier Payment - ExpertNet Subcontractors #1,Supplier Payment,PS-GL,18918.08,0,EUR,SEPA Credit Transfer,ExpertNet Subcontractors #1,***5004,,PO-202312-PS-GL-0002,FALSE,FALSE,REF-443144,First Continental Bank,***6126,Globex EMEA Manufacturing Ltd.,IE,7931442.55
06/12/2023,06/12/2023,Supplier Payment - Stelliform Parts BV #19,Supplier Payment,CEM-EMEA,102561.98,0,EUR,SEPA Credit Transfer,Stelliform Parts BV #19,***5399,,PO-202312-CEM-EMEA-0009,FALSE,FALSE,REF-788137,First Continental Bank,***8124,Globex EMEA Manufacturing Ltd.,IE,7828880.57
06/12/2023,06/12/2023,Client Receipt - Aurora Electronics GmbH #5,Sales Receipt,CEM-EMEA,0,197033.36,EUR,SEPA SCT,Aurora Electronics GmbH #5,***7119,INV-202312-CEM-EMEA-0007,,FALSE,FALSE,REF-463394,First Continental Bank,***3859,Globex EMEA Manufacturing Ltd.,IE,8025913.93
07/12/2023,07/12/2023,Supplier Payment - HyperCloud Infra #7,Supplier Payment,SaaS-GL,17363.2,0,EUR,SWIFT MT103,HyperCloud Infra #7,***5351,,PO-202312-SaaS-GL-0006,FALSE,FALSE,REF-434859,First Continental Bank,***6456,Globex EMEA Manufacturing Ltd.,IE,8008550.73
07/12/2023,07/12/2023,Client Receipt - CloudBridge Co. #10,Sales Receipt,SaaS-GL,0,7857.63,EUR,SEPA SCT Inst,CloudBridge Co. #10,***4494,INV-202312-SaaS-GL-0008,,FALSE,FALSE,REF-411303,First Continental Bank,***3477,Globex EMEA Manufacturing Ltd.,IE,8016408.36
07/12/2023,07/12/2023,Client Receipt - CloudBridge Co. #19,Sales Receipt,SaaS-GL,0,78184.48,EUR,SEPA SCT,CloudBridge Co. #19,***7210,INV-202312-SaaS-GL-0022,,FALSE,FALSE,REF-904270,First Continental Bank,***2163,Globex EMEA Manufacturing Ltd.,IE,8094592.84
07/12/2023,07/12/2023,Client Receipt - Aurora Electronics GmbH #3,Sales Receipt,CEM-EMEA,0,87858.77,EUR,SEPA SCT Inst,Aurora Electronics GmbH #3,***2026,INV-202312-CEM-EMEA-0012,,FALSE,FALSE,REF-438762,First Continental Bank,***2882,Globex EMEA Manufacturing Ltd.,IE,8182451.61
08/12/2023,08/12/2023,Supplier Payment - ExpertNet Subcontractors #3,Supplier Payment,PS-GL,7065.93,0,EUR,SWIFT MT103,ExpertNet Subcontractors #3,***9676,,PO-202312-PS-GL-0009,FALSE,FALSE,REF-562274,First Continental Bank,***2698,Globex EMEA Manufacturing Ltd.,IE,8175385.68
08/12/2023,08/12/2023,Supplier Payment - Stelliform Parts BV #3,Supplier Payment,CEM-EMEA,53697.19,0,EUR,SWIFT MT103,Stelliform Parts BV #3,***6350,,PO-202312-CEM-EMEA-0001,FALSE,FALSE,REF-250684,First Continental Bank,***4035,Globex EMEA Manufacturing Ltd.,IE,8121688.49
08/12/2023,08/12/2023,Supplier Payment - EuroFab Assembly #12,Supplier Payment,CEM-EMEA,72063.44,0,EUR,SEPA Credit Transfer,EuroFab Assembly #12,***4921,,PO-202312-CEM-EMEA-0003,FALSE,FALSE,REF-903038,First Continental Bank,***8033,Globex EMEA Manufacturing Ltd.,IE,8049625.05
08/12/2023,08/12/2023,Client Receipt - CloudBridge Co. #5,Sales Receipt,SaaS-GL,0,36780.83,EUR,SEPA SCT,CloudBridge Co. #5,***5109,INV-202312-SaaS-GL-0010,,FALSE,FALSE,REF-814765,First Continental Bank,***6609,Globex EMEA Manufacturing Ltd.,IE,8086405.88
08/12/2023,08/12/2023,Client Receipt - Aurora Electronics GmbH #14,Sales Receipt,CEM-EMEA,0,160154.91,EUR,Card Settlement,Aurora Electronics GmbH #14,***7642,INV-202312-CEM-EMEA-0011,,FALSE,FALSE,REF-876615,First Continental Bank,***6293,Globex EMEA Manufacturing Ltd.,IE,8246560.79
10/12/2023,10/12/2023,Client Receipt - CloudBridge Co. #44,Sales Receipt,SaaS-GL,0,93639.44,EUR,SEPA SCT,CloudBridge Co. #44,***9143,INV-202312-SaaS-GL-0013,,FALSE,FALSE,REF-741262,First Continental Bank,***6629,Globex EMEA Manufacturing Ltd.,IE,8340200.23
11/12/2023,11/12/2023,Supplier Payment - CodeCraft Contractors #8,Supplier Payment,SaaS-GL,27953.42,0,EUR,SEPA Debit,CodeCraft Contractors #8,***5285,,PO-202312-SaaS-GL-0002,FALSE,FALSE,REF-648213,First Continental Bank,***2036,Globex EMEA Manufacturing Ltd.,IE,8312246.81
12/12/2023,12/12/2023,Intercompany Settlement - Globex Consulting UK Ltd.,Intercompany Transfer,ALL,629629,0,EUR,Internal Transfer,Globex Consulting UK Ltd.,***1631,,,TRUE,TRUE,REF-590572,First Continental Bank,***2346,Globex EMEA Manufacturing Ltd.,IE,7682617.81
12/12/2023,12/12/2023,Client Receipt - Novatek Components Ltd #1,Sales Receipt,CEM-EMEA,0,128921.34,EUR,SEPA SCT,Novatek Components Ltd #1,***1091,INV-202312-CEM-EMEA-0003,,FALSE,FALSE,REF-276875,First Continental Bank,***4630,Globex EMEA Manufacturing Ltd.,IE,7811539.15
13/12/2023,13/12/2023,Supplier Payment - HyperCloud Infra #5,Supplier Payment,SaaS-GL,23841.21,0,EUR,SEPA Debit,HyperCloud Infra #5,***9220,,PO-202312-SaaS-GL-0005,FALSE,FALSE,REF-848912,First Continental Bank,***9202,Globex EMEA Manufacturing Ltd.,IE,7787697.94
13/12/2023,13/12/2023,Client Receipt - CloudBridge Co. #31,Sales Receipt,SaaS-GL,0,12861.33,EUR,SEPA SCT,CloudBridge Co. #31,***2727,INV-202312-SaaS-GL-0020,,FALSE,FALSE,REF-932037,First Continental Bank,***8957,Globex EMEA Manufacturing Ltd.,IE,7800559.27
13/12/2023,13/12/2023,Client Receipt - Vertex Advisory Client #6,Sales Receipt,PS-GL,0,25947.08,EUR,Card Settlement,Vertex Advisory Client #6,***2575,INV-202312-PS-GL-0005,,FALSE,FALSE,REF-283753,First Continental Bank,***1382,Globex EMEA Manufacturing Ltd.,IE,7826506.35
13/12/2023,13/12/2023,Client Receipt - Novatek Components Ltd #3,Sales Receipt,CEM-EMEA,0,60716.4,EUR,SEPA SCT Inst,Novatek Components Ltd #3,***7951,INV-202312-CEM-EMEA-0010,,FALSE,FALSE,REF-933616,First Continental Bank,***6284,Globex EMEA Manufacturing Ltd.,IE,7887222.75
14/12/2023,14/12/2023,Supplier Payment - CodeCraft Contractors #6,Supplier Payment,SaaS-GL,4557.32,0,EUR,SWIFT MT103,CodeCraft Contractors #6,***7648,,PO-202312-SaaS-GL-0004,FALSE,FALSE,REF-144877,First Continental Bank,***5118,Globex EMEA Manufacturing Ltd.,IE,7882665.43
14/12/2023,14/12/2023,Client Receipt - Vertex Advisory Client #44,Sales Receipt,PS-GL,0,3281.94,EUR,SEPA SCT Inst,Vertex Advisory Client #44,***8118,INV-202312-PS-GL-0003,,FALSE,FALSE,REF-770411,First Continental Bank,***5177,Globex EMEA Manufacturing Ltd.,IE,7885947.37
15/12/2023,15/12/2023,Supplier Payment - Stelliform Parts BV #21,Supplier Payment,CEM-EMEA,39914.78,0,EUR,SEPA Debit,Stelliform Parts BV #21,***4600,,PO-202312-CEM-EMEA-0004,FALSE,FALSE,REF-905662,First Continental Bank,***5062,Globex EMEA Manufacturing Ltd.,IE,7846032.59
15/12/2023,15/12/2023,Marketing - Aurelia Media #3,Marketing,ALL,44439.3,0,EUR,SWIFT MT103,Aurelia Media #3,***2384,,,FALSE,FALSE,REF-204237,First Continental Bank,***2244,Globex EMEA Manufacturing Ltd.,IE,7801593.29
15/12/2023,15/12/2023,Loan Interest Payment,Loan Interest,ALL,85000,0,EUR,SWIFT MT103,First Continental Bank - Corporate Lending,***5139,,,FALSE,FALSE,REF-237765,First Continental Bank,***8562,Globex EMEA Manufacturing Ltd.,IE,7716593.29
15/12/2023,15/12/2023,Loan Principal Repayment,Loan Principal,ALL,500000,0,EUR,SWIFT MT103,First Continental Bank - Corporate Lending,***4510,,,FALSE,FALSE,REF-400170,First Continental Bank,***8294,Globex EMEA Manufacturing Ltd.,IE,7216593.29
15/12/2023,15/12/2023,Client Receipt - Vertex Advisory Client #28,Sales Receipt,PS-GL,0,25321.19,EUR,SEPA SCT,Vertex Advisory Client #28,***4027,INV-202312-PS-GL-0008,,FALSE,FALSE,REF-803112,First Continental Bank,***6102,Globex EMEA Manufacturing Ltd.,IE,7241914.48
16/12/2023,16/12/2023,Client Receipt - Vertex Advisory Client #54,Sales Receipt,PS-GL,0,250628.96,EUR,SEPA SCT,Vertex Advisory Client #54,***7765,INV-202312-PS-GL-0004,,FALSE,FALSE,REF-998008,First Continental Bank,***6863,Globex EMEA Manufacturing Ltd.,IE,7492543.44
17/12/2023,17/12/2023,Client Receipt - CloudBridge Co. #31,Sales Receipt,SaaS-GL,0,10714.16,EUR,Card Settlement,CloudBridge Co. #31,***4160,INV-202312-SaaS-GL-0009,,FALSE,FALSE,REF-390294,First Continental Bank,***8306,Globex EMEA Manufacturing Ltd.,IE,7503257.6
17/12/2023,17/12/2023,Client Receipt - CloudBridge Co. #55,Sales Receipt,SaaS-GL,0,58280.89,EUR,SEPA SCT,CloudBridge Co. #55,***2017,INV-202312-SaaS-GL-0007,,FALSE,FALSE,REF-724062,First Continental Bank,***3623,Globex EMEA Manufacturing Ltd.,IE,7561538.49
18/12/2023,18/12/2023,Marketing - Aurelia Media #2,Marketing,ALL,26427.81,0,EUR,SWIFT MT103,Aurelia Media #2,***3016,,,FALSE,FALSE,REF-225008,First Continental Bank,***9450,Globex EMEA Manufacturing Ltd.,IE,7535110.68
18/12/2023,18/12/2023,Supplier Payment - ExpertNet Subcontractors #9,Supplier Payment,PS-GL,31676.23,0,EUR,SEPA Debit,ExpertNet Subcontractors #9,***7795,,PO-202312-PS-GL-0011,FALSE,FALSE,REF-578780,First Continental Bank,***8797,Globex EMEA Manufacturing Ltd.,IE,7503434.45
18/12/2023,18/12/2023,Client Receipt - Aurora Electronics GmbH #15,Sales Receipt,CEM-EMEA,0,16439.49,EUR,SEPA SCT Inst,Aurora Electronics GmbH #15,***6893,INV-202312-CEM-EMEA-0001,,FALSE,FALSE,REF-274840,First Continental Bank,***5310,Globex EMEA Manufacturing Ltd.,IE,7519873.94
18/12/2023,18/12/2023,Client Receipt - CloudBridge Co. #34,Sales Receipt,SaaS-GL,0,17606.76,EUR,SEPA SCT,CloudBridge Co. #34,***9513,INV-202312-SaaS-GL-0014,,FALSE,FALSE,REF-244394,First Continental Bank,***4646,Globex EMEA Manufacturing Ltd.,IE,7537480.7
18/12/2023,18/12/2023,Client Receipt - Vertex Advisory Client #39,Sales Receipt,PS-GL,0,155361.18,EUR,SEPA SCT,Vertex Advisory Client #39,***2987,INV-202312-PS-GL-0006,,FALSE,FALSE,REF-535461,First Continental Bank,***9278,Globex EMEA Manufacturing Ltd.,IE,7692841.88
19/12/2023,19/12/2023,Supplier Payment - ExpertNet Subcontractors #5,Supplier Payment,PS-GL,34797.36,0,EUR,SEPA Credit Transfer,ExpertNet Subcontractors #5,***3132,,PO-202312-PS-GL-0008,FALSE,FALSE,REF-272097,First Continental Bank,***6408,Globex EMEA Manufacturing Ltd.,IE,7658044.52
19/12/2023,19/12/2023,VAT/GST Remittance - Revenue Ireland,Tax Payment,ALL,174422.87,0,EUR,SEPA Credit Transfer,Revenue Ireland,***7074,,,FALSE,FALSE,REF-674014,First Continental Bank,***6903,Globex EMEA Manufacturing Ltd.,IE,7483621.65
19/12/2023,19/12/2023,Client Receipt - Vertex Advisory Client #19,Sales Receipt,PS-GL,0,14358.2,EUR,SEPA SCT Inst,Vertex Advisory Client #19,***2776,INV-202312-PS-GL-0002,,FALSE,FALSE,REF-164601,First Continental Bank,***7349,Globex EMEA Manufacturing Ltd.,IE,7497979.85
19/12/2023,19/12/2023,Client Receipt - CloudBridge Co. #73,Sales Receipt,SaaS-GL,0,25924.25,EUR,SEPA SCT,CloudBridge Co. #73,***3623,INV-202312-SaaS-GL-0005,,FALSE,FALSE,REF-249707,First Continental Bank,***7873,Globex EMEA Manufacturing Ltd.,IE,7523904.1
19/12/2023,19/12/2023,Client Receipt - CloudBridge Co. #63,Sales Receipt,SaaS-GL,0,36224.24,EUR,Card Settlement,CloudBridge Co. #63,***3149,INV-202312-SaaS-GL-0002,,FALSE,FALSE,REF-702392,First Continental Bank,***4726,Globex EMEA Manufacturing Ltd.,IE,7560128.34
19/12/2023,19/12/2023,Client Receipt - CloudBridge Co. #71,Sales Receipt,SaaS-GL,0,65646.21,EUR,SEPA SCT Inst,CloudBridge Co. #71,***3959,INV-202312-SaaS-GL-0001,,FALSE,FALSE,REF-846804,First Continental Bank,***8193,Globex EMEA Manufacturing Ltd.,IE,7625774.55
20/12/2023,20/12/2023,BluePeak Property Mgmt,Rent & Utilities,ALL,22526.87,0,EUR,SEPA Debit,BluePeak Property Mgmt,***9806,,,FALSE,FALSE,REF-206729,First Continental Bank,***7227,Globex EMEA Manufacturing Ltd.,IE,7603247.68
20/12/2023,20/12/2023,Supplier Payment - HyperCloud Infra #10,Supplier Payment,SaaS-GL,25103.65,0,EUR,SEPA Credit Transfer,HyperCloud Infra #10,***7025,,PO-202312-SaaS-GL-0011,FALSE,FALSE,REF-746035,First Continental Bank,***3000,Globex EMEA Manufacturing Ltd.,IE,7578144.03
20/12/2023,20/12/2023,Client Receipt - CloudBridge Co. #29,Sales Receipt,SaaS-GL,0,52818.56,EUR,SEPA SCT,CloudBridge Co. #29,***4935,INV-202312-SaaS-GL-0021,,FALSE,FALSE,REF-735041,First Continental Bank,***3422,Globex EMEA Manufacturing Ltd.,IE,7630962.59
20/12/2023,20/12/2023,Client Receipt - Novatek Components Ltd #7,Sales Receipt,CEM-EMEA,0,53065.11,EUR,Card Settlement,Novatek Components Ltd #7,***6125,INV-202312-CEM-EMEA-0004,,FALSE,FALSE,REF-758806,First Continental Bank,***1967,Globex EMEA Manufacturing Ltd.,IE,7684027.7
21/12/2023,21/12/2023,Supplier Payment - CodeCraft Contractors #4,Supplier Payment,SaaS-GL,10305.82,0,EUR,SWIFT MT103,CodeCraft Contractors #4,***9486,,PO-202312-SaaS-GL-0010,FALSE,FALSE,REF-123918,First Continental Bank,***3614,Globex EMEA Manufacturing Ltd.,IE,7673721.88
21/12/2023,21/12/2023,Supplier Payment - HyperCloud Infra #7,Supplier Payment,SaaS-GL,11950.79,0,EUR,SEPA Credit Transfer,HyperCloud Infra #7,***8939,,PO-202312-SaaS-GL-0003,FALSE,FALSE,REF-425317,First Continental Bank,***6872,Globex EMEA Manufacturing Ltd.,IE,7661771.09
21/12/2023,21/12/2023,Supplier Payment - ExpertNet Subcontractors #13,Supplier Payment,PS-GL,15241.45,0,EUR,SWIFT MT103,ExpertNet Subcontractors #13,***3718,,PO-202312-PS-GL-0005,FALSE,FALSE,REF-642174,First Continental Bank,***8448,Globex EMEA Manufacturing Ltd.,IE,7646529.64
21/12/2023,21/12/2023,Supplier Payment - EuroFab Assembly #13,Supplier Payment,CEM-EMEA,79000.14,0,EUR,SWIFT MT103,EuroFab Assembly #13,***4624,,PO-202312-CEM-EMEA-0012,FALSE,FALSE,REF-253941,First Continental Bank,***5580,Globex EMEA Manufacturing Ltd.,IE,7567529.5
21/12/2023,21/12/2023,Client Receipt - CloudBridge Co. #66,Sales Receipt,SaaS-GL,0,36588.51,EUR,SEPA SCT,CloudBridge Co. #66,***4295,INV-202312-SaaS-GL-0011,,FALSE,FALSE,REF-621620,First Continental Bank,***3132,Globex EMEA Manufacturing Ltd.,IE,7604118.01
21/12/2023,21/12/2023,Client Receipt - CloudBridge Co. #3,Sales Receipt,SaaS-GL,0,78223.6,EUR,SEPA SCT,CloudBridge Co. #3,***6185,INV-202312-SaaS-GL-0017,,FALSE,FALSE,REF-503626,First Continental Bank,***8606,Globex EMEA Manufacturing Ltd.,IE,7682341.61
21/12/2023,21/12/2023,Client Receipt - Aurora Electronics GmbH #9,Sales Receipt,CEM-EMEA,0,86253.32,EUR,Card Settlement,Aurora Electronics GmbH #9,***6236,INV-202312-CEM-EMEA-0002,,FALSE,FALSE,REF-814385,First Continental Bank,***3832,Globex EMEA Manufacturing Ltd.,IE,7768594.93
22/12/2023,22/12/2023,Supplier Payment - ExpertNet Subcontractors #3,Supplier Payment,PS-GL,35442.73,0,EUR,SEPA Debit,ExpertNet Subcontractors #3,***4801,,PO-202312-PS-GL-0003,FALSE,FALSE,REF-956696,First Continental Bank,***6265,Globex EMEA Manufacturing Ltd.,IE,7733152.2
22/12/2023,22/12/2023,Supplier Payment - EuroFab Assembly #12,Supplier Payment,CEM-EMEA,40484.83,0,EUR,SWIFT MT103,EuroFab Assembly #12,***7132,,PO-202312-CEM-EMEA-0002,FALSE,FALSE,REF-489604,First Continental Bank,***8541,Globex EMEA Manufacturing Ltd.,IE,7692667.37
22/12/2023,22/12/2023,Client Receipt - Vertex Advisory Client #47,Sales Receipt,PS-GL,0,36999.24,EUR,Card Settlement,Vertex Advisory Client #47,***1111,INV-202312-PS-GL-0001,,FALSE,FALSE,REF-498208,First Continental Bank,***9917,Globex EMEA Manufacturing Ltd.,IE,7729666.61
22/12/2023,22/12/2023,Client Receipt - CloudBridge Co. #14,Sales Receipt,SaaS-GL,0,61706.97,EUR,Card Settlement,CloudBridge Co. #14,***8655,INV-202312-SaaS-GL-0012,,FALSE,FALSE,REF-777907,First Continental Bank,***1813,Globex EMEA Manufacturing Ltd.,IE,7791373.58
22/12/2023,22/12/2023,Client Receipt - CloudBridge Co. #79,Sales Receipt,SaaS-GL,0,120934.19,EUR,Card Settlement,CloudBridge Co. #79,***3920,INV-202312-SaaS-GL-0018,,FALSE,FALSE,REF-870705,First Continental Bank,***4360,Globex EMEA Manufacturing Ltd.,IE,7912307.77
23/12/2023,23/12/2023,Client Receipt - CloudBridge Co. #43,Sales Receipt,SaaS-GL,0,9341.11,EUR,SEPA SCT,CloudBridge Co. #43,***7335,INV-202312-SaaS-GL-0003,,FALSE,FALSE,REF-251273,First Continental Bank,***9675,Globex EMEA Manufacturing Ltd.,IE,7921648.88
25/12/2023,25/12/2023,Merchant Processing Fees,Bank/Merchant Fees,ALL,1314.06,0,EUR,SEPA Credit Transfer,First Continental Bank,***3721,,,FALSE,FALSE,REF-343931,First Continental Bank,***3668,Globex EMEA Manufacturing Ltd.,IE,7920334.82
25/12/2023,25/12/2023,Payroll - GlobalPay Services Ltd,Payroll,ALL,456145.39,0,EUR,SWIFT MT103,GlobalPay Services Ltd,***4993,,,FALSE,FALSE,REF-799287,First Continental Bank,***4672,Globex EMEA Manufacturing Ltd.,IE,7464189.43
26/12/2023,26/12/2023,Supplier Payment - ExpertNet Subcontractors #13,Supplier Payment,PS-GL,1721.03,0,EUR,SEPA Credit Transfer,ExpertNet Subcontractors #13,***4152,,PO-202312-PS-GL-0010,FALSE,FALSE,REF-440246,First Continental Bank,***5940,Globex EMEA Manufacturing Ltd.,IE,7462468.4
26/12/2023,26/12/2023,Supplier Payment - EuroFab Assembly #23,Supplier Payment,CEM-EMEA,15429.56,0,EUR,SEPA Debit,EuroFab Assembly #23,***1405,,PO-202312-CEM-EMEA-0005,FALSE,FALSE,REF-993077,First Continental Bank,***3366,Globex EMEA Manufacturing Ltd.,IE,7447038.84
26/12/2023,26/12/2023,Supplier Payment - Stelliform Parts BV #20,Supplier Payment,CEM-EMEA,119672.13,0,EUR,SWIFT MT103,Stelliform Parts BV #20,***6049,,PO-202312-CEM-EMEA-0006,FALSE,FALSE,REF-845897,First Continental Bank,***7617,Globex EMEA Manufacturing Ltd.,IE,7327366.71
26/12/2023,26/12/2023,"Intercompany Settlement - Globex International Holdings, Inc.",Intercompany Transfer,ALL,709654,0,EUR,Internal Transfer,"Globex International Holdings, Inc.",***5740,,,TRUE,TRUE,REF-836825,First Continental Bank,***8101,Globex EMEA Manufacturing Ltd.,IE,6617712.71
26/12/2023,26/12/2023,Client Receipt - Novatek Components Ltd #7,Sales Receipt,CEM-EMEA,0,119957.4,EUR,Card Settlement,Novatek Components Ltd #7,***5975,INV-202312-CEM-EMEA-0008,,FALSE,FALSE,REF-550066,First Continental Bank,***5847,Globex EMEA Manufacturing Ltd.,IE,6737670.11
27/12/2023,27/12/2023,Supplier Payment - ExpertNet Subcontractors #1,Supplier Payment,PS-GL,3692.2,0,EUR,SEPA Debit,ExpertNet Subcontractors #1,***3557,,PO-202312-PS-GL-0001,FALSE,FALSE,REF-189141,First Continental Bank,***9041,Globex EMEA Manufacturing Ltd.,IE,6733977.91
27/12/2023,27/12/2023,Merchant Processing Fees,Bank/Merchant Fees,ALL,7251.83,0,EUR,SWIFT MT103,First Continental Bank,***8116,,,FALSE,FALSE,REF-418002,First Continental Bank,***7164,Globex EMEA Manufacturing Ltd.,IE,6726726.08
27/12/2023,27/12/2023,Supplier Payment - HyperCloud Infra #6,Supplier Payment,SaaS-GL,23334.94,0,EUR,SEPA Credit Transfer,HyperCloud Infra #6,***9522,,PO-202312-SaaS-GL-0001,FALSE,FALSE,REF-325298,First Continental Bank,***8519,Globex EMEA Manufacturing Ltd.,IE,6703391.14
27/12/2023,27/12/2023,Supplier Payment - Stelliform Parts BV #5,Supplier Payment,CEM-EMEA,108002.95,0,EUR,SEPA Debit,Stelliform Parts BV #5,***9352,,PO-202312-CEM-EMEA-0010,FALSE,FALSE,REF-185058,First Continental Bank,***7198,Globex EMEA Manufacturing Ltd.,IE,6595388.19
27/12/2023,27/12/2023,Client Receipt - Vertex Advisory Client #52,Sales Receipt,PS-GL,0,76832.24,EUR,Card Settlement,Vertex Advisory Client #52,***7096,INV-202312-PS-GL-0007,,FALSE,FALSE,REF-367805,First Continental Bank,***2583,Globex EMEA Manufacturing Ltd.,IE,6672220.43
27/12/2023,27/12/2023,Client Receipt - Aurora Electronics GmbH #9,Sales Receipt,CEM-EMEA,0,411380.73,EUR,Card Settlement,Aurora Electronics GmbH #9,***1863,INV-202312-CEM-EMEA-0006,,FALSE,FALSE,REF-728069,First Continental Bank,***6078,Globex EMEA Manufacturing Ltd.,IE,7083601.16
28/12/2023,28/12/2023,Supplier Payment - ExpertNet Subcontractors #9,Supplier Payment,PS-GL,10434.46,0,EUR,SWIFT MT103,ExpertNet Subcontractors #9,***8983,,PO-202312-PS-GL-0004,FALSE,FALSE,REF-133406,First Continental Bank,***3700,Globex EMEA Manufacturing Ltd.,IE,7073166.7
30/12/2023,30/12/2023,Supplier Payment - ExpertNet Subcontractors #7,Supplier Payment,PS-GL,14907,0,EUR,SWIFT MT103,ExpertNet Subcontractors #7,***3747,,PO-202312-PS-GL-0006,FALSE,FALSE,REF-404265,First Continental Bank,***6646,Globex EMEA Manufacturing Ltd.,IE,7058259.7
30/12/2023,30/12/2023,Interest Earned,Interest Income,ALL,0,10644.78,EUR,SEPA SCT Inst,First Continental Bank,***1349,,,FALSE,FALSE,REF-307062,First Continental Bank,***3009,Globex EMEA Manufacturing Ltd.,IE,7068904.48
01/01/2024,01/01/2024,Supplier Payment - Stelliform Parts BV #34,Supplier Payment,CEM-EMEA,944.81,0,EUR,SWIFT MT103,Stelliform Parts BV #34,***2578,,PO-202401-CEM-EMEA-0004,FALSE,FALSE,REF-893889,First Continental Bank,***2412,Globex EMEA Manufacturing Ltd.,IE,7067959.67
01/01/2024,01/01/2024,Account Maintenance Fee,Bank/Merchant Fees,ALL,2500,0,EUR,SWIFT MT103,First Continental Bank,***1200,,,FALSE,FALSE,REF-449295,First Continental Bank,***5413,Globex EMEA Manufacturing Ltd.,IE,7065459.67
01/01/2024,01/01/2024,Supplier Payment - Stelliform Parts BV #1,Supplier Payment,CEM-EMEA,6905.1,0,EUR,SEPA Credit Transfer,Stelliform Parts BV #1,***8194,,PO-202401-CEM-EMEA-0005,FALSE,FALSE,REF-657638,First Continental Bank,***6142,Globex EMEA Manufacturing Ltd.,IE,7058554.57
02/01/2024,02/01/2024,Supplier Payment - CodeCraft Contractors #12,Supplier Payment,SaaS-GL,338.84,0,EUR,SEPA Debit,CodeCraft Contractors #12,***6956,,PO-202401-SaaS-GL-0008,FALSE,FALSE,REF-346828,First Continental Bank,***3765,Globex EMEA Manufacturing Ltd.,IE,7058215.73
02/01/2024,02/01/2024,Supplier Payment - HyperCloud Infra #15,Supplier Payment,SaaS-GL,5338.85,0,EUR,SWIFT MT103,HyperCloud Infra #15,***6040,,PO-202401-SaaS-GL-0006,FALSE,FALSE,REF-229375,First Continental Bank,***7420,Globex EMEA Manufacturing Ltd.,IE,7052876.88
02/01/2024,02/01/2024,Supplier Payment - Stelliform Parts BV #30,Supplier Payment,CEM-EMEA,19863.28,0,EUR,SEPA Credit Transfer,Stelliform Parts BV #30,***4766,,PO-202401-CEM-EMEA-0003,FALSE,FALSE,REF-370790,First Continental Bank,***8118,Globex EMEA Manufacturing Ltd.,IE,7033013.6
02/01/2024,02/01/2024,Supplier Payment - HyperCloud Infra #16,Supplier Payment,SaaS-GL,21054.78,0,EUR,SEPA Credit Transfer,HyperCloud Infra #16,***4636,,PO-202401-SaaS-GL-0002,FALSE,FALSE,REF-875075,First Continental Bank,***2206,Globex EMEA Manufacturing Ltd.,IE,7011958.82
03/01/2024,03/01/2024,Supplier Payment - EuroFab Assembly #24,Supplier Payment,CEM-EMEA,26500.04,0,EUR,SEPA Credit Transfer,EuroFab Assembly #24,***4009,,PO-202401-CEM-EMEA-0009,FALSE,FALSE,REF-628369,First Continental Bank,***9812,Globex EMEA Manufacturing Ltd.,IE,6985458.78
03/01/2024,03/01/2024,Client Receipt - CloudBridge Co. #26,Sales Receipt,SaaS-GL,0,38772.9,EUR,SEPA SCT,CloudBridge Co. #26,***8833,INV-202401-SaaS-GL-0020,,FALSE,FALSE,REF-321695,First Continental Bank,***7885,Globex EMEA Manufacturing Ltd.,IE,7024231.68
04/01/2024,04/01/2024,Marketing - Beacon Digital #8,Marketing,ALL,202.59,0,EUR,SEPA Debit,Beacon Digital #8,***4981,,,FALSE,FALSE,REF-904989,First Continental Bank,***7658,Globex EMEA Manufacturing Ltd.,IE,7024029.09
04/01/2024,04/01/2024,Client Receipt - CloudBridge Co. #45,Sales Receipt,SaaS-GL,0,822.33,EUR,Card Settlement,CloudBridge Co. #45,***6077,INV-202401-SaaS-GL-0016,,FALSE,FALSE,REF-178956,First Continental Bank,***6205,Globex EMEA Manufacturing Ltd.,IE,7024851.42
04/01/2024,04/01/2024,Client Receipt - Vertex Advisory Client #13,Sales Receipt,PS-GL,0,15031.51,EUR,SEPA SCT Inst,Vertex Advisory Client #13,***3463,INV-202401-PS-GL-0001,,FALSE,FALSE,REF-122511,First Continental Bank,***4069,Globex EMEA Manufacturing Ltd.,IE,7039882.93
04/01/2024,04/01/2024,Client Receipt - Aurora Electronics GmbH #16,Sales Receipt,CEM-EMEA,0,15079.84,EUR,SEPA SCT,Aurora Electronics GmbH #16,***7821,INV-202401-CEM-EMEA-0011,,FALSE,FALSE,REF-953513,First Continental Bank,***9478,Globex EMEA Manufacturing Ltd.,IE,7054962.77
04/01/2024,04/01/2024,Client Receipt - Novatek Components Ltd #1,Sales Receipt,CEM-EMEA,0,17567.02,EUR,Card Settlement,Novatek Components Ltd #1,***8088,INV-202401-CEM-EMEA-0004,,FALSE,FALSE,REF-147150,First Continental Bank,***8006,Globex EMEA Manufacturing Ltd.,IE,7072529.79
04/01/2024,04/01/2024,Client Receipt - CloudBridge Co. #25,Sales Receipt,SaaS-GL,0,18540.69,EUR,Card Settlement,CloudBridge Co. #25,***1969,INV-202401-SaaS-GL-0022,,FALSE,FALSE,REF-824064,First Continental Bank,***4046,Globex EMEA Manufacturing Ltd.,IE,7091070.48
04/01/2024,04/01/2024,Client Receipt - Novatek Components Ltd #11,Sales Receipt,CEM-EMEA,0,43236.63,EUR,Card Settlement,Novatek Components Ltd #11,***2640,INV-202401-CEM-EMEA-0012,,FALSE,FALSE,REF-338280,First Continental Bank,***7236,Globex EMEA Manufacturing Ltd.,IE,7134307.11
04/01/2024,04/01/2024,Client Receipt - Aurora Electronics GmbH #15,Sales Receipt,CEM-EMEA,0,162255.44,EUR,SEPA SCT Inst,Aurora Electronics GmbH #15,***4069,INV-202401-CEM-EMEA-0007,,FALSE,FALSE,REF-114269,First Continental Bank,***8773,Globex EMEA Manufacturing Ltd.,IE,7296562.55
05/01/2024,05/01/2024,Client Receipt - CloudBridge Co. #2,Sales Receipt,SaaS-GL,0,46212.56,EUR,SEPA SCT,CloudBridge Co. #2,***6471,INV-202401-SaaS-GL-0010,,FALSE,FALSE,REF-598925,First Continental Bank,***5473,Globex EMEA Manufacturing Ltd.,IE,7342775.11
06/01/2024,06/01/2024,Client Receipt - CloudBridge Co. #60,Sales Receipt,SaaS-GL,0,5204.84,EUR,Card Settlement,CloudBridge Co. #60,***9546,INV-202401-SaaS-GL-0007,,FALSE,FALSE,REF-276545,First Continental Bank,***2162,Globex EMEA Manufacturing Ltd.,IE,7347979.95
07/01/2024,07/01/2024,Merchant Processing Fees,Bank/Merchant Fees,ALL,1371.78,0,EUR,SEPA Debit,First Continental Bank,***4260,,,FALSE,FALSE,REF-535269,First Continental Bank,***4447,Globex EMEA Manufacturing Ltd.,IE,7346608.17
07/01/2024,07/01/2024,Client Receipt - CloudBridge Co. #13,Sales Receipt,SaaS-GL,0,21104.33,EUR,SEPA SCT,CloudBridge Co. #13,***5585,INV-202401-SaaS-GL-0024,,FALSE,FALSE,REF-807204,First Continental Bank,***1392,Globex EMEA Manufacturing Ltd.,IE,7367712.5
08/01/2024,08/01/2024,Client Receipt - CloudBridge Co. #78,Sales Receipt,SaaS-GL,0,7032,EUR,SEPA SCT Inst,CloudBridge Co. #78,***6193,INV-202401-SaaS-GL-0026,,FALSE,FALSE,REF-365631,First Continental Bank,***5004,Globex EMEA Manufacturing Ltd.,IE,7374744.5
09/01/2024,09/01/2024,Supplier Payment - HyperCloud Infra #15,Supplier Payment,SaaS-GL,6929.48,0,EUR,SEPA Debit,HyperCloud Infra #15,***8688,,PO-202401-SaaS-GL-0003,FALSE,FALSE,REF-385221,First Continental Bank,***9518,Globex EMEA Manufacturing Ltd.,IE,7367815.02
10/01/2024,10/01/2024,Supplier Payment - EuroFab Assembly #4,Supplier Payment,CEM-EMEA,29972.16,0,EUR,SEPA Credit Transfer,EuroFab Assembly #4,***1547,,PO-202401-CEM-EMEA-0007,FALSE,FALSE,REF-587202,First Continental Bank,***5274,Globex EMEA Manufacturing Ltd.,IE,7337842.86
10/01/2024,10/01/2024,Client Receipt - CloudBridge Co. #74,Sales Receipt,SaaS-GL,0,11463.98,EUR,Card Settlement,CloudBridge Co. #74,***2204,INV-202401-SaaS-GL-0006,,FALSE,FALSE,REF-610400,First Continental Bank,***4703,Globex EMEA Manufacturing Ltd.,IE,7349306.84
10/01/2024,10/01/2024,Client Receipt - Vertex Advisory Client #19,Sales Receipt,PS-GL,0,19206.58,EUR,SEPA SCT,Vertex Advisory Client #19,***9041,INV-202401-PS-GL-0004,,FALSE,FALSE,REF-868649,First Continental Bank,***8952,Globex EMEA Manufacturing Ltd.,IE,7368513.42
10/01/2024,10/01/2024,Client Receipt - Vertex Advisory Client #56,Sales Receipt,PS-GL,0,58463.66,EUR,SEPA SCT Inst,Vertex Advisory Client #56,***3644,INV-202401-PS-GL-0002,,FALSE,FALSE,REF-775654,First Continental Bank,***5809,Globex EMEA Manufacturing Ltd.,IE,7426977.08
11/01/2024,11/01/2024,Supplier Payment - HyperCloud Infra #19,Supplier Payment,SaaS-GL,16178.91,0,EUR,SEPA Debit,HyperCloud Infra #19,***7508,,PO-202401-SaaS-GL-0009,FALSE,FALSE,REF-931446,First Continental Bank,***2976,Globex EMEA Manufacturing Ltd.,IE,7410798.17
11/01/2024,11/01/2024,Client Receipt - Aurora Electronics GmbH #1,Sales Receipt,CEM-EMEA,0,81252.51,EUR,SEPA SCT,Aurora Electronics GmbH #1,***8318,INV-202401-CEM-EMEA-0016,,FALSE,FALSE,REF-519854,First Continental Bank,***7746,Globex EMEA Manufacturing Ltd.,IE,7492050.68
11/01/2024,11/01/2024,Client Receipt - Aurora Electronics GmbH #15,Sales Receipt,CEM-EMEA,0,129506.94,EUR,SEPA SCT,Aurora Electronics GmbH #15,***5181,INV-202401-CEM-EMEA-0009,,FALSE,FALSE,REF-953129,First Continental Bank,***8256,Globex EMEA Manufacturing Ltd.,IE,7621557.62
12/01/2024,12/01/2024,Supplier Payment - ExpertNet Subcontractors #19,Supplier Payment,PS-GL,9716.39,0,EUR,SWIFT MT103,ExpertNet Subcontractors #19,***1847,,PO-202401-PS-GL-0011,FALSE,FALSE,REF-758972,First Continental Bank,***5154,Globex EMEA Manufacturing Ltd.,IE,7611841.23
12/01/2024,12/01/2024,Supplier Payment - ExpertNet Subcontractors #16,Supplier Payment,PS-GL,13284.8,0,EUR,SWIFT MT103,ExpertNet Subcontractors #16,***5712,,PO-202401-PS-GL-0009,FALSE,FALSE,REF-132917,First Continental Bank,***7463,Globex EMEA Manufacturing Ltd.,IE,7598556.43
12/01/2024,12/01/2024,Intercompany Settlement - Globex Retail NA LLC,Intercompany Transfer,ALL,399104,0,EUR,Internal Transfer,Globex Retail NA LLC,***8006,,,TRUE,TRUE,REF-564630,First Continental Bank,***4143,Globex EMEA Manufacturing Ltd.,IE,7199452.43
12/01/2024,12/01/2024,Intercompany Reimbursement - Globex Retail NA LLC,Intercompany Transfer,ALL,0,159641.6,EUR,Internal Transfer,Globex Retail NA LLC,***3107,,,TRUE,TRUE,REF-710106,First Continental Bank,***8995,Globex EMEA Manufacturing Ltd.,IE,7359094.03
15/01/2024,15/01/2024,Supplier Payment - ExpertNet Subcontractors #15,Supplier Payment,PS-GL,4796.51,0,EUR,SWIFT MT103,ExpertNet Subcontractors #15,***4980,,PO-202401-PS-GL-0010,FALSE,FALSE,REF-371860,First Continental Bank,***7880,Globex EMEA Manufacturing Ltd.,IE,7354297.52
15/01/2024,15/01/2024,Supplier Payment - ExpertNet Subcontractors #1,Supplier Payment,PS-GL,10952.2,0,EUR,SEPA Credit Transfer,ExpertNet Subcontractors #1,***8909,,PO-202401-PS-GL-0003,FALSE,FALSE,REF-668848,First Continental Bank,***1293,Globex EMEA Manufacturing Ltd.,IE,7343345.32
15/01/2024,15/01/2024,Supplier Payment - Stelliform Parts BV #2,Supplier Payment,CEM-EMEA,26337.45,0,EUR,SEPA Debit,Stelliform Parts BV #2,***1975,,PO-202401-CEM-EMEA-0008,FALSE,FALSE,REF-159467,First Continental Bank,***5107,Globex EMEA Manufacturing Ltd.,IE,7317007.87
15/01/2024,15/01/2024,Loan Interest Payment,Loan Interest,ALL,85000,0,EUR,SEPA Credit Transfer,First Continental Bank - Corporate Lending,***3110,,,FALSE,FALSE,REF-668143,First Continental Bank,***1066,Globex EMEA Manufacturing Ltd.,IE,7232007.87
15/01/2024,15/01/2024,Loan Principal Repayment,Loan Principal,ALL,500000,0,EUR,SEPA Credit Transfer,First Continental Bank - Corporate Lending,***7946,,,FALSE,FALSE,REF-800854,First Continental Bank,***8270,Globex EMEA Manufacturing Ltd.,IE,6732007.87
15/01/2024,15/01/2024,Client Receipt - Aurora Electronics GmbH #9,Sales Receipt,CEM-EMEA,0,34530.44,EUR,SEPA SCT,Aurora Electronics GmbH #9,***3424,INV-202401-CEM-EMEA-0015,,FALSE,FALSE,REF-561775,First Continental Bank,***1730,Globex EMEA Manufacturing Ltd.,IE,6766538.31
16/01/2024,16/01/2024,Supplier Payment - ExpertNet Subcontractors #16,Supplier Payment,PS-GL,7019.73,0,EUR,SEPA Debit,ExpertNet Subcontractors #16,***9737,,PO-202401-PS-GL-0001,FALSE,FALSE,REF-831124,First Continental Bank,***4486,Globex EMEA Manufacturing Ltd.,IE,6759518.58
16/01/2024,16/01/2024,Supplier Payment - ExpertNet Subcontractors #15,Supplier Payment,PS-GL,7489.6,0,EUR,SEPA Credit Transfer,ExpertNet Subcontractors #15,***7852,,PO-202401-PS-GL-0002,FALSE,FALSE,REF-660887,First Continental Bank,***6143,Globex EMEA Manufacturing Ltd.,IE,6752028.98
16/01/2024,16/01/2024,Supplier Payment - HyperCloud Infra #9,Supplier Payment,SaaS-GL,7862.06,0,EUR,SWIFT MT103,HyperCloud Infra #9,***9494,,PO-202401-SaaS-GL-0007,FALSE,FALSE,REF-679068,First Continental Bank,***5832,Globex EMEA Manufacturing Ltd.,IE,6744166.92
16/01/2024,16/01/2024,Client Receipt - CloudBridge Co. #71,Sales Receipt,SaaS-GL,0,1901.71,EUR,SEPA SCT Inst,CloudBridge Co. #71,***6881,INV-202401-SaaS-GL-0001,,FALSE,FALSE,REF-863792,First Continental Bank,***6893,Globex EMEA Manufacturing Ltd.,IE,6746068.63
16/01/2024,16/01/2024,Client Receipt - CloudBridge Co. #47,Sales Receipt,SaaS-GL,0,23803.38,EUR,SEPA SCT Inst,CloudBridge Co. #47,***3491,INV-202401-SaaS-GL-0013,,FALSE,FALSE,REF-977731,First Continental Bank,***8610,Globex EMEA Manufacturing Ltd.,IE,6769872.01
16/01/2024,16/01/2024,Client Receipt - CloudBridge Co. #19,Sales Receipt,SaaS-GL,0,30477.61,EUR,SEPA SCT Inst,CloudBridge Co. #19,***8326,INV-202401-SaaS-GL-0021,,FALSE,FALSE,REF-453605,First Continental Bank,***3124,Globex EMEA Manufacturing Ltd.,IE,6800349.62
17/01/2024,17/01/2024,Supplier Payment - ExpertNet Subcontractors #8,Supplier Payment,PS-GL,18763.71,0,EUR,SEPA Credit Transfer,ExpertNet Subcontractors #8,***3889,,PO-202401-PS-GL-0007,FALSE,FALSE,REF-134234,First Continental Bank,***6757,Globex EMEA Manufacturing Ltd.,IE,6781585.91
17/01/2024,17/01/2024,Client Receipt - Aurora Electronics GmbH #10,Sales Receipt,CEM-EMEA,0,4315.02,EUR,SEPA SCT,Aurora Electronics GmbH #10,***8846,INV-202401-CEM-EMEA-0006,,FALSE,FALSE,REF-586887,First Continental Bank,***3110,Globex EMEA Manufacturing Ltd.,IE,6785900.93
17/01/2024,17/01/2024,Client Receipt - CloudBridge Co. #51,Sales Receipt,SaaS-GL,0,15620.74,EUR,SEPA SCT Inst,CloudBridge Co. #51,***4734,INV-202401-SaaS-GL-0014,,FALSE,FALSE,REF-839054,First Continental Bank,***7559,Globex EMEA Manufacturing Ltd.,IE,6801521.67
17/01/2024,17/01/2024,Client Receipt - CloudBridge Co. #7,Sales Receipt,SaaS-GL,0,24311.51,EUR,SEPA SCT,CloudBridge Co. #7,***2626,INV-202401-SaaS-GL-0009,,FALSE,FALSE,REF-830092,First Continental Bank,***4454,Globex EMEA Manufacturing Ltd.,IE,6825833.18
17/01/2024,17/01/2024,Client Receipt - Novatek Components Ltd #7,Sales Receipt,CEM-EMEA,0,37394.65,EUR,SEPA SCT,Novatek Components Ltd #7,***9941,INV-202401-CEM-EMEA-0002,,FALSE,FALSE,REF-636347,First Continental Bank,***9130,Globex EMEA Manufacturing Ltd.,IE,6863227.83
18/01/2024,18/01/2024,Supplier Payment - EuroFab Assembly #6,Supplier Payment,CEM-EMEA,2354.15,0,EUR,SEPA Debit,EuroFab Assembly #6,***9294,,PO-202401-CEM-EMEA-0006,FALSE,FALSE,REF-761955,First Continental Bank,***3821,Globex EMEA Manufacturing Ltd.,IE,6860873.68
18/01/2024,18/01/2024,Supplier Payment - ExpertNet Subcontractors #8,Supplier Payment,PS-GL,2804.73,0,EUR,SEPA Debit,ExpertNet Subcontractors #8,***8581,,PO-202401-PS-GL-0004,FALSE,FALSE,REF-690167,First Continental Bank,***2684,Globex EMEA Manufacturing Ltd.,IE,6858068.95
18/01/2024,18/01/2024,Supplier Payment - HyperCloud Infra #10,Supplier Payment,SaaS-GL,7571.51,0,EUR,SEPA Credit Transfer,HyperCloud Infra #10,***6535,,PO-202401-SaaS-GL-0001,FALSE,FALSE,REF-511016,First Continental Bank,***5468,Globex EMEA Manufacturing Ltd.,IE,6850497.44
18/01/2024,18/01/2024,Supplier Payment - Stelliform Parts BV #19,Supplier Payment,CEM-EMEA,184952.27,0,EUR,SEPA Debit,Stelliform Parts BV #19,***1632,,PO-202401-CEM-EMEA-0010,FALSE,FALSE,REF-311677,First Continental Bank,***7897,Globex EMEA Manufacturing Ltd.,IE,6665545.17
18/01/2024,18/01/2024,Client Receipt - Vertex Advisory Client #2,Sales Receipt,PS-GL,0,1464.15,EUR,SEPA SCT Inst,Vertex Advisory Client #2,***5478,INV-202401-PS-GL-0006,,FALSE,FALSE,REF-417598,First Continental Bank,***4064,Globex EMEA Manufacturing Ltd.,IE,6667009.32
18/01/2024,18/01/2024,Client Receipt - CloudBridge Co. #56,Sales Receipt,SaaS-GL,0,9796.48,EUR,Card Settlement,CloudBridge Co. #56,***9314,INV-202401-SaaS-GL-0011,,FALSE,FALSE,REF-180715,First Continental Bank,***4186,Globex EMEA Manufacturing Ltd.,IE,6676805.8
18/01/2024,18/01/2024,Client Receipt - CloudBridge Co. #22,Sales Receipt,SaaS-GL,0,65870.82,EUR,SEPA SCT,CloudBridge Co. #22,***8132,INV-202401-SaaS-GL-0003,,FALSE,FALSE,REF-409605,First Continental Bank,***5803,Globex EMEA Manufacturing Ltd.,IE,6742676.62
19/01/2024,19/01/2024,Client Receipt - CloudBridge Co. #47,Sales Receipt,SaaS-GL,0,25569.25,EUR,SEPA SCT,CloudBridge Co. #47,***9496,INV-202401-SaaS-GL-0015,,FALSE,FALSE,REF-178751,First Continental Bank,***8292,Globex EMEA Manufacturing Ltd.,IE,6768245.87
19/01/2024,19/01/2024,Client Receipt - Vertex Advisory Client #35,Sales Receipt,PS-GL,0,65353.1,EUR,Card Settlement,Vertex Advisory Client #35,***7092,INV-202401-PS-GL-0005,,FALSE,FALSE,REF-756332,First Continental Bank,***2927,Globex EMEA Manufacturing Ltd.,IE,6833598.97
20/01/2024,20/01/2024,BluePeak Property Mgmt,Rent & Utilities,ALL,9164.24,0,EUR,SEPA Credit Transfer,BluePeak Property Mgmt,***8019,,,FALSE,FALSE,REF-724159,First Continental Bank,***3207,Globex EMEA Manufacturing Ltd.,IE,6824434.73
21/01/2024,21/01/2024,Supplier Payment - Stelliform Parts BV #1,Supplier Payment,CEM-EMEA,41902.58,0,EUR,SEPA Credit Transfer,Stelliform Parts BV #1,***4605,,PO-202401-CEM-EMEA-0002,FALSE,FALSE,REF-558242,First Continental Bank,***2933,Globex EMEA Manufacturing Ltd.,IE,6782532.15
21/01/2024,21/01/2024,Client Receipt - CloudBridge Co. #20,Sales Receipt,SaaS-GL,0,13802.16,EUR,SEPA SCT Inst,CloudBridge Co. #20,***3682,INV-202401-SaaS-GL-0005,,FALSE,FALSE,REF-860866,First Continental Bank,***9250,Globex EMEA Manufacturing Ltd.,IE,6796334.31
22/01/2024,22/01/2024,Supplier Payment - ExpertNet Subcontractors #12,Supplier Payment,PS-GL,5552.82,0,EUR,SEPA Credit Transfer,ExpertNet Subcontractors #12,***6069,,PO-202401-PS-GL-0008,FALSE,FALSE,REF-300114,First Continental Bank,***1077,Globex EMEA Manufacturing Ltd.,IE,6790781.49
22/01/2024,22/01/2024,VAT/GST Remittance - Revenue Ireland,Tax Payment,ALL,86813.22,0,EUR,SWIFT MT103,Revenue Ireland,***9392,,,FALSE,FALSE,REF-696030,First Continental Bank,***9419,Globex EMEA Manufacturing Ltd.,IE,6703968.27
22/01/2024,22/01/2024,Client Receipt - CloudBridge Co. #71,Sales Receipt,SaaS-GL,0,2174.63,EUR,Card Settlement,CloudBridge Co. #71,***7755,INV-202401-SaaS-GL-0008,,FALSE,FALSE,REF-461720,First Continental Bank,***8035,Globex EMEA Manufacturing Ltd.,IE,6706142.9
23/01/2024,23/01/2024,Supplier Payment - ExpertNet Subcontractors #6,Supplier Payment,PS-GL,2637.4,0,EUR,SWIFT MT103,ExpertNet Subcontractors #6,***1381,,PO-202401-PS-GL-0006,FALSE,FALSE,REF-992798,First Continental Bank,***3612,Globex EMEA Manufacturing Ltd.,IE,6703505.5
23/01/2024,23/01/2024,Client Receipt - CloudBridge Co. #66,Sales Receipt,SaaS-GL,0,4973.61,EUR,Card Settlement,CloudBridge Co. #66,***5590,INV-202401-SaaS-GL-0012,,FALSE,FALSE,REF-652818,First Continental Bank,***7408,Globex EMEA Manufacturing Ltd.,IE,6708479.11
23/01/2024,23/01/2024,Client Receipt - Aurora Electronics GmbH #16,Sales Receipt,CEM-EMEA,0,6849.81,EUR,SEPA SCT,Aurora Electronics GmbH #16,***1734,INV-202401-CEM-EMEA-0003,,FALSE,FALSE,REF-999882,First Continental Bank,***6723,Globex EMEA Manufacturing Ltd.,IE,6715328.92
24/01/2024,24/01/2024,Supplier Payment - ExpertNet Subcontractors #2,Supplier Payment,PS-GL,5291.61,0,EUR,SWIFT MT103,ExpertNet Subcontractors #2,***1169,,PO-202401-PS-GL-0005,FALSE,FALSE,REF-311976,First Continental Bank,***7003,Globex EMEA Manufacturing Ltd.,IE,6710037.31
24/01/2024,24/01/2024,Supplier Payment - Stelliform Parts BV #2,Supplier Payment,CEM-EMEA,72379.18,0,EUR,SWIFT MT103,Stelliform Parts BV #2,***1181,,PO-202401-CEM-EMEA-0001,FALSE,FALSE,REF-870319,First Continental Bank,***4847,Globex EMEA Manufacturing Ltd.,IE,6637658.13
24/01/2024,24/01/2024,Client Receipt - CloudBridge Co. #67,Sales Receipt,SaaS-GL,0,9197.34,EUR,SEPA SCT Inst,CloudBridge Co. #67,***5539,INV-202401-SaaS-GL-0018,,FALSE,FALSE,REF-932104,First Continental Bank,***3102,Globex EMEA Manufacturing Ltd.,IE,6646855.47
25/01/2024,25/01/2024,Client Receipt - CloudBridge Co. #31,Sales Receipt,SaaS-GL,0,241.14,EUR,Card Settlement,CloudBridge Co. #31,***4175,INV-202401-SaaS-GL-0017,,FALSE,FALSE,REF-943990,First Continental Bank,***2045,Globex EMEA Manufacturing Ltd.,IE,6647096.61
25/01/2024,25/01/2024,Client Receipt - Novatek Components Ltd #4,Sales Receipt,CEM-EMEA,0,4716.56,EUR,Card Settlement,Novatek Components Ltd #4,***4732,INV-202401-CEM-EMEA-0010,,FALSE,FALSE,REF-878685,First Continental Bank,***7845,Globex EMEA Manufacturing Ltd.,IE,6651813.17
25/01/2024,25/01/2024,Client Receipt - CloudBridge Co. #25,Sales Receipt,SaaS-GL,0,22361.58,EUR,SEPA SCT,CloudBridge Co. #25,***5651,INV-202401-SaaS-GL-0019,,FALSE,FALSE,REF-543591,First Continental Bank,***2054,Globex EMEA Manufacturing Ltd.,IE,6674174.75
26/01/2024,26/01/2024,Skyline Internet Services,Rent & Utilities,ALL,2251.77,0,EUR,SEPA Debit,Skyline Internet Services,***1397,,,FALSE,FALSE,REF-559352,First Continental Bank,***2717,Globex EMEA Manufacturing Ltd.,IE,6671922.98
26/01/2024,26/01/2024,Merchant Processing Fees,Bank/Merchant Fees,ALL,2891.35,0,EUR,SEPA Debit,First Continental Bank,***7018,,,FALSE,FALSE,REF-524272,First Continental Bank,***2880,Globex EMEA Manufacturing Ltd.,IE,6669031.63
26/01/2024,26/01/2024,Intercompany Settlement - Globex APAC Logistics Pte. Ltd.,Intercompany Transfer,ALL,898301,0,EUR,Internal Transfer,Globex APAC Logistics Pte. Ltd.,***4145,,,TRUE,TRUE,REF-263128,First Continental Bank,***1839,Globex EMEA Manufacturing Ltd.,IE,5770730.63
26/01/2024,26/01/2024,Client Receipt - CloudBridge Co. #14,Sales Receipt,SaaS-GL,0,1620.69,EUR,Card Settlement,CloudBridge Co. #14,***1924,INV-202401-SaaS-GL-0002,,FALSE,FALSE,REF-938777,First Continental Bank,***5827,Globex EMEA Manufacturing Ltd.,IE,5772351.32
26/01/2024,26/01/2024,Client Receipt - Aurora Electronics GmbH #10,Sales Receipt,CEM-EMEA,0,6531.22,EUR,SEPA SCT Inst,Aurora Electronics GmbH #10,***2541,INV-202401-CEM-EMEA-0013,,FALSE,FALSE,REF-549838,First Continental Bank,***9931,Globex EMEA Manufacturing Ltd.,IE,5778882.54
26/01/2024,26/01/2024,Client Receipt - Vertex Advisory Client #17,Sales Receipt,PS-GL,0,7279.13,EUR,SEPA SCT,Vertex Advisory Client #17,***1800,INV-202401-PS-GL-0007,,FALSE,FALSE,REF-380266,First Continental Bank,***4474,Globex EMEA Manufacturing Ltd.,IE,5786161.67
26/01/2024,26/01/2024,Client Receipt - Vertex Advisory Client #12,Sales Receipt,PS-GL,0,88358.12,EUR,Card Settlement,Vertex Advisory Client #12,***9311,INV-202401-PS-GL-0008,,FALSE,FALSE,REF-120730,First Continental Bank,***2083,Globex EMEA Manufacturing Ltd.,IE,5874519.79
27/01/2024,27/01/2024,Payroll - GlobalPay Services Ltd,Payroll,ALL,229607.39,0,EUR,SEPA Credit Transfer,GlobalPay Services Ltd,***4237,,,FALSE,FALSE,REF-292487,First Continental Bank,***2438,Globex EMEA Manufacturing Ltd.,IE,5644912.4
28/01/2024,28/01/2024,Corporate Tax Estimate,Tax Payment,ALL,66223.14,0,EUR,SEPA Debit,HMRC UK,***2940,,,FALSE,FALSE,REF-765569,First Continental Bank,***8114,Globex EMEA Manufacturing Ltd.,IE,5578689.26
28/01/2024,28/01/2024,Client Receipt - Aurora Electronics GmbH #2,Sales Receipt,CEM-EMEA,0,18478.08,EUR,SEPA SCT Inst,Aurora Electronics GmbH #2,***2487,INV-202401-CEM-EMEA-0005,,FALSE,FALSE,REF-418298,First Continental Bank,***8854,Globex EMEA Manufacturing Ltd.,IE,5597167.34
29/01/2024,29/01/2024,Supplier Payment - CodeCraft Contractors #2,Supplier Payment,SaaS-GL,13976.94,0,EUR,SEPA Credit Transfer,CodeCraft Contractors #2,***6470,,PO-202401-SaaS-GL-0004,FALSE,FALSE,REF-561342,First Continental Bank,***7506,Globex EMEA Manufacturing Ltd.,IE,5583190.4
29/01/2024,29/01/2024,Client Receipt - CloudBridge Co. #27,Sales Receipt,SaaS-GL,0,2627.06,EUR,SEPA SCT Inst,CloudBridge Co. #27,***4612,INV-202401-SaaS-GL-0025,,FALSE,FALSE,REF-980340,First Continental Bank,***2029,Globex EMEA Manufacturing Ltd.,IE,5585817.46
29/01/2024,29/01/2024,Client Receipt - CloudBridge Co. #58,Sales Receipt,SaaS-GL,0,12130.41,EUR,SEPA SCT Inst,CloudBridge Co. #58,***6279,INV-202401-SaaS-GL-0023,,FALSE,FALSE,REF-209697,First Continental Bank,***7963,Globex EMEA Manufacturing Ltd.,IE,5597947.87
29/01/2024,29/01/2024,Client Receipt - Aurora Electronics GmbH #10,Sales Receipt,CEM-EMEA,0,18305.79,EUR,Card Settlement,Aurora Electronics GmbH #10,***3010,INV-202401-CEM-EMEA-0001,,FALSE,FALSE,REF-118047,First Continental Bank,***4471,Globex EMEA Manufacturing Ltd.,IE,5616253.66
30/01/2024,30/01/2024,Interest Earned,Interest Income,ALL,0,12422.56,EUR,SEPA SCT Inst,First Continental Bank,***9244,,,FALSE,FALSE,REF-415814,First Continental Bank,***1118,Globex EMEA Manufacturing Ltd.,IE,5628676.22
30/01/2024,30/01/2024,Client Receipt - Aurora Electronics GmbH #18,Sales Receipt,CEM-EMEA,0,38190.05,EUR,SEPA SCT Inst,Aurora Electronics GmbH #18,***1523,INV-202401-CEM-EMEA-0008,,FALSE,FALSE,REF-955241,First Continental Bank,***3476,Globex EMEA Manufacturing Ltd.,IE,5666866.27
30/01/2024,30/01/2024,Client Receipt - Novatek Components Ltd #3,Sales Receipt,CEM-EMEA,0,68641.7,EUR,SEPA SCT,Novatek Components Ltd #3,***8060,INV-202401-CEM-EMEA-0014,,FALSE,FALSE,REF-504954,First Continental Bank,***1944,Globex EMEA Manufacturing Ltd.,IE,5735507.97
31/01/2024,31/01/2024,Supplier Payment - CodeCraft Contractors #7,Supplier Payment,SaaS-GL,17889.08,0,EUR,SEPA Credit Transfer,CodeCraft Contractors #7,***1295,,PO-202401-SaaS-GL-0005,FALSE,FALSE,REF-770871,First Continental Bank,***1457,Globex EMEA Manufacturing Ltd.,IE,5717618.89
31/01/2024,31/01/2024,Marketing - Beacon Digital #4,Marketing,ALL,35083.35,0,EUR,SEPA Debit,Beacon Digital #4,***4015,,,FALSE,FALSE,REF-746771,First Continental Bank,***4977,Globex EMEA Manufacturing Ltd.,IE,5682535.54
31/01/2024,31/01/2024,Client Receipt - CloudBridge Co. #59,Sales Receipt,SaaS-GL,0,25913.77,EUR,Card Settlement,CloudBridge Co. #59,***3237,INV-202401-SaaS-GL-0004,,FALSE,FALSE,REF-898549,First Continental Bank,***5271,Globex EMEA Manufacturing Ltd.,IE,5708449.31
31/01/2024,31/01/2024,Client Receipt - Vertex Advisory Client #43,Sales Receipt,PS-GL,0,39208.76,EUR,Card Settlement,Vertex Advisory Client #43,***9403,INV-202401-PS-GL-0003,,FALSE,FALSE,REF-915218,First Continental Bank,***2810,Globex EMEA Manufacturing Ltd.,IE,5747658.07
01/02/2024,01/02/2024,Account Maintenance Fee,Bank/Merchant Fees,ALL,2500,0,EUR,SEPA Debit,First Continental Bank,***3947,,,FALSE,FALSE,REF-194469,First Continental Bank,***3380,Globex EMEA Manufacturing Ltd.,IE,5745158.07
01/02/2024,01/02/2024,Supplier Payment - EuroFab Assembly #18,Supplier Payment,CEM-EMEA,9140.49,0,EUR,SWIFT MT103,EuroFab Assembly #18,***2085,,PO-202402-CEM-EMEA-0001,FALSE,FALSE,REF-655033,First Continental Bank,***5963,Globex EMEA Manufacturing Ltd.,IE,5736017.58
01/02/2024,01/02/2024,Supplier Payment - EuroFab Assembly #13,Supplier Payment,CEM-EMEA,35726.86,0,EUR,SWIFT MT103,EuroFab Assembly #13,***3996,,PO-202402-CEM-EMEA-0005,FALSE,FALSE,REF-589460,First Continental Bank,***3389,Globex EMEA Manufacturing Ltd.,IE,5700290.72
01/02/2024,01/02/2024,Client Receipt - Aurora Electronics GmbH #1,Sales Receipt,CEM-EMEA,0,3656.24,EUR,Card Settlement,Aurora Electronics GmbH #1,***4809,INV-202402-CEM-EMEA-0014,,FALSE,FALSE,REF-632008,First Continental Bank,***9771,Globex EMEA Manufacturing Ltd.,IE,5703946.96
02/02/2024,02/02/2024,Merchant Processing Fees,Bank/Merchant Fees,ALL,1030.96,0,EUR,SEPA Credit Transfer,First Continental Bank,***6032,,,FALSE,FALSE,REF-951949,First Continental Bank,***6128,Globex EMEA Manufacturing Ltd.,IE,5702916
02/02/2024,02/02/2024,Supplier Payment - ExpertNet Subcontractors #18,Supplier Payment,PS-GL,21622.73,0,EUR,SEPA Credit Transfer,ExpertNet Subcontractors #18,***4390,,PO-202402-PS-GL-0007,FALSE,FALSE,REF-270118,First Continental Bank,***5411,Globex EMEA Manufacturing Ltd.,IE,5681293.27
02/02/2024,02/02/2024,Supplier Payment - ExpertNet Subcontractors #12,Supplier Payment,PS-GL,32793.16,0,EUR,SWIFT MT103,ExpertNet Subcontractors #12,***8763,,PO-202402-PS-GL-0008,FALSE,FALSE,REF-142577,First Continental Bank,***8065,Globex EMEA Manufacturing Ltd.,IE,5648500.11
02/02/2024,02/02/2024,Client Receipt - Aurora Electronics GmbH #2,Sales Receipt,CEM-EMEA,0,12480.13,EUR,SEPA SCT Inst,Aurora Electronics GmbH #2,***6689,INV-202402-CEM-EMEA-0008,,FALSE,FALSE,REF-919110,First Continental Bank,***2215,Globex EMEA Manufacturing Ltd.,IE,5660980.24
02/02/2024,02/02/2024,Client Receipt - Aurora Electronics GmbH #4,Sales Receipt,CEM-EMEA,0,136926.63,EUR,SEPA SCT,Aurora Electronics GmbH #4,***8794,INV-202402-CEM-EMEA-0009,,FALSE,FALSE,REF-634222,First Continental Bank,***8272,Globex EMEA Manufacturing Ltd.,IE,5797906.87
04/02/2024,04/02/2024,Supplier Payment - ExpertNet Subcontractors #18,Supplier Payment,PS-GL,10552.96,0,EUR,SEPA Debit,ExpertNet Subcontractors #18,***3587,,PO-202402-PS-GL-0001,FALSE,FALSE,REF-723860,First Continental Bank,***4670,Globex EMEA Manufacturing Ltd.,IE,5787353.91
04/02/2024,04/02/2024,Client Receipt - CloudBridge Co. #16,Sales Receipt,SaaS-GL,0,28762.35,EUR,Card Settlement,CloudBridge Co. #16,***1042,INV-202402-SaaS-GL-0002,,FALSE,FALSE,REF-393750,First Continental Bank,***5983,Globex EMEA Manufacturing Ltd.,IE,5816116.26
04/02/2024,04/02/2024,Client Receipt - CloudBridge Co. #4,Sales Receipt,SaaS-GL,0,134138.76,EUR,SEPA SCT,CloudBridge Co. #4,***8927,INV-202402-SaaS-GL-0009,,FALSE,FALSE,REF-329290,First Continental Bank,***5211,Globex EMEA Manufacturing Ltd.,IE,5950255.02
05/02/2024,05/02/2024,Supplier Payment - HyperCloud Infra #19,Supplier Payment,SaaS-GL,752.82,0,EUR,SEPA Debit,HyperCloud Infra #19,***4837,,PO-202402-SaaS-GL-0007,FALSE,FALSE,REF-773131,First Continental Bank,***3229,Globex EMEA Manufacturing Ltd.,IE,5949502.2
05/02/2024,05/02/2024,Client Receipt - Novatek Components Ltd #14,Sales Receipt,CEM-EMEA,0,34772.69,EUR,SEPA SCT Inst,Novatek Components Ltd #14,***3056,INV-202402-CEM-EMEA-0015,,FALSE,FALSE,REF-531518,First Continental Bank,***6435,Globex EMEA Manufacturing Ltd.,IE,5984274.89
06/02/2024,06/02/2024,Supplier Payment - HyperCloud Infra #6,Supplier Payment,SaaS-GL,2486.07,0,EUR,SEPA Credit Transfer,HyperCloud Infra #6,***5692,,PO-202402-SaaS-GL-0002,FALSE,FALSE,REF-645602,First Continental Bank,***1293,Globex EMEA Manufacturing Ltd.,IE,5981788.82
06/02/2024,06/02/2024,Supplier Payment - Stelliform Parts BV #19,Supplier Payment,CEM-EMEA,69316.52,0,EUR,SWIFT MT103,Stelliform Parts BV #19,***7365,,PO-202402-CEM-EMEA-0004,FALSE,FALSE,REF-139050,First Continental Bank,***5070,Globex EMEA Manufacturing Ltd.,IE,5912472.3
06/02/2024,06/02/2024,Client Receipt - CloudBridge Co. #34,Sales Receipt,SaaS-GL,0,5118.12,EUR,SEPA SCT,CloudBridge Co. #34,***6090,INV-202402-SaaS-GL-0013,,FALSE,FALSE,REF-447734,First Continental Bank,***2764,Globex EMEA Manufacturing Ltd.,IE,5917590.42
07/02/2024,07/02/2024,Supplier Payment - Stelliform Parts BV #1,Supplier Payment,CEM-EMEA,1493.02,0,EUR,SEPA Debit,Stelliform Parts BV #1,***3069,,PO-202402-CEM-EMEA-0008,FALSE,FALSE,REF-909913,First Continental Bank,***5784,Globex EMEA Manufacturing Ltd.,IE,5916097.4
07/02/2024,07/02/2024,Supplier Payment - ExpertNet Subcontractors #16,Supplier Payment,PS-GL,1493.94,0,EUR,SEPA Credit Transfer,ExpertNet Subcontractors #16,***8903,,PO-202402-PS-GL-0009,FALSE,FALSE,REF-976719,First Continental Bank,***8103,Globex EMEA Manufacturing Ltd.,IE,5914603.46
07/02/2024,07/02/2024,Merchant Processing Fees,Bank/Merchant Fees,ALL,4008.23,0,EUR,SEPA Credit Transfer,First Continental Bank,***1821,,,FALSE,FALSE,REF-104042,First Continental Bank,***3511,Globex EMEA Manufacturing Ltd.,IE,5910595.23
07/02/2024,07/02/2024,Supplier Payment - HyperCloud Infra #19,Supplier Payment,SaaS-GL,6603.37,0,EUR,SWIFT MT103,HyperCloud Infra #19,***2574,,PO-202402-SaaS-GL-0009,FALSE,FALSE,REF-509416,First Continental Bank,***4960,Globex EMEA Manufacturing Ltd.,IE,5903991.86
07/02/2024,07/02/2024,Supplier Payment - CodeCraft Contractors #6,Supplier Payment,SaaS-GL,8653.65,0,EUR,SEPA Credit Transfer,CodeCraft Contractors #6,***9558,,PO-202402-SaaS-GL-0010,FALSE,FALSE,REF-556619,First Continental Bank,***6321,Globex EMEA Manufacturing Ltd.,IE,5895338.21
07/02/2024,07/02/2024,Client Receipt - CloudBridge Co. #7,Sales Receipt,SaaS-GL,0,21935.03,EUR,Card Settlement,CloudBridge Co. #7,***4719,INV-202402-SaaS-GL-0001,,FALSE,FALSE,REF-210302,First Continental Bank,***3659,Globex EMEA Manufacturing Ltd.,IE,5917273.24
07/02/2024,07/02/2024,Client Receipt - Vertex Advisory Client #14,Sales Receipt,PS-GL,0,32011.41,EUR,SEPA SCT,Vertex Advisory Client #14,***9484,INV-202402-PS-GL-0001,,FALSE,FALSE,REF-417989,First Continental Bank,***5318,Globex EMEA Manufacturing Ltd.,IE,5949284.65
08/02/2024,08/02/2024,Supplier Payment - HyperCloud Infra #1,Supplier Payment,SaaS-GL,4002.58,0,EUR,SEPA Debit,HyperCloud Infra #1,***9998,,PO-202402-SaaS-GL-0003,FALSE,FALSE,REF-283844,First Continental Bank,***1823,Globex EMEA Manufacturing Ltd.,IE,5945282.07
08/02/2024,08/02/2024,Supplier Payment - ExpertNet Subcontractors #2,Supplier Payment,PS-GL,13871.87,0,EUR,SEPA Credit Transfer,ExpertNet Subcontractors #2,***5108,,PO-202402-PS-GL-0003,FALSE,FALSE,REF-368199,First Continental Bank,***9794,Globex EMEA Manufacturing Ltd.,IE,5931410.2
08/02/2024,08/02/2024,Client Receipt - CloudBridge Co. #5,Sales Receipt,SaaS-GL,0,1676.14,EUR,SEPA SCT,CloudBridge Co. #5,***7187,INV-202402-SaaS-GL-0016,,FALSE,FALSE,REF-881209,First Continental Bank,***3926,Globex EMEA Manufacturing Ltd.,IE,5933086.34
09/02/2024,09/02/2024,Supplier Payment - EuroFab Assembly #22,Supplier Payment,CEM-EMEA,16684.7,0,EUR,SEPA Credit Transfer,EuroFab Assembly #22,***8419,,PO-202402-CEM-EMEA-0009,FALSE,FALSE,REF-314640,First Continental Bank,***8809,Globex EMEA Manufacturing Ltd.,IE,5916401.64
09/02/2024,09/02/2024,Client Receipt - Novatek Components Ltd #1,Sales Receipt,CEM-EMEA,0,27749.39,EUR,SEPA SCT Inst,Novatek Components Ltd #1,***2788,INV-202402-CEM-EMEA-0005,,FALSE,FALSE,REF-434464,First Continental Bank,***7732,Globex EMEA Manufacturing Ltd.,IE,5944151.03
12/02/2024,12/02/2024,Supplier Payment - ExpertNet Subcontractors #8,Supplier Payment,PS-GL,18004.86,0,EUR,SEPA Credit Transfer,ExpertNet Subcontractors #8,***1694,,PO-202402-PS-GL-0005,FALSE,FALSE,REF-909938,First Continental Bank,***3266,Globex EMEA Manufacturing Ltd.,IE,5926146.17
12/02/2024,12/02/2024,Intercompany Settlement - Globex Retail NA LLC,Intercompany Transfer,ALL,319451,0,EUR,Internal Transfer,Globex Retail NA LLC,***5229,,,TRUE,TRUE,REF-639556,First Continental Bank,***4294,Globex EMEA Manufacturing Ltd.,IE,5606695.17
12/02/2024,12/02/2024,Client Receipt - Vertex Advisory Client #7,Sales Receipt,PS-GL,0,10541.42,EUR,SEPA SCT Inst,Vertex Advisory Client #7,***8605,INV-202402-PS-GL-0002,,FALSE,FALSE,REF-844003,First Continental Bank,***7998,Globex EMEA Manufacturing Ltd.,IE,5617236.59
12/02/2024,12/02/2024,Client Receipt - Aurora Electronics GmbH #12,Sales Receipt,CEM-EMEA,0,26021.23,EUR,SEPA SCT,Aurora Electronics GmbH #12,***2154,INV-202402-CEM-EMEA-0004,,FALSE,FALSE,REF-773919,First Continental Bank,***7039,Globex EMEA Manufacturing Ltd.,IE,5643257.82
12/02/2024,12/02/2024,Client Receipt - CloudBridge Co. #20,Sales Receipt,SaaS-GL,0,48386.55,EUR,SEPA SCT,CloudBridge Co. #20,***1815,INV-202402-SaaS-GL-0019,,FALSE,FALSE,REF-375906,First Continental Bank,***6221,Globex EMEA Manufacturing Ltd.,IE,5691644.37
12/02/2024,12/02/2024,Client Receipt - Vertex Advisory Client #17,Sales Receipt,PS-GL,0,95398.8,EUR,SEPA SCT,Vertex Advisory Client #17,***6496,INV-202402-PS-GL-0007,,FALSE,FALSE,REF-599321,First Continental Bank,***1854,Globex EMEA Manufacturing Ltd.,IE,5787043.17
13/02/2024,13/02/2024,Supplier Payment - Stelliform Parts BV #24,Supplier Payment,CEM-EMEA,119351.05,0,EUR,SEPA Credit Transfer,Stelliform Parts BV #24,***4759,,PO-202402-CEM-EMEA-0007,FALSE,FALSE,REF-640701,First Continental Bank,***6781,Globex EMEA Manufacturing Ltd.,IE,5667692.12
13/02/2024,13/02/2024,Client Receipt - Novatek Components Ltd #3,Sales Receipt,CEM-EMEA,0,17212.07,EUR,SEPA SCT Inst,Novatek Components Ltd #3,***8913,INV-202402-CEM-EMEA-0016,,FALSE,FALSE,REF-590493,First Continental Bank,***6343,Globex EMEA Manufacturing Ltd.,IE,5684904.19
13/02/2024,13/02/2024,Client Receipt - Vertex Advisory Client #11,Sales Receipt,PS-GL,0,75080.57,EUR,SEPA SCT,Vertex Advisory Client #11,***9635,INV-202402-PS-GL-0004,,FALSE,FALSE,REF-156218,First Continental Bank,***4520,Globex EMEA Manufacturing Ltd.,IE,5759984.76
14/02/2024,14/02/2024,Supplier Payment - ExpertNet Subcontractors #17,Supplier Payment,PS-GL,850.33,0,EUR,SWIFT MT103,ExpertNet Subcontractors #17,***3302,,PO-202402-PS-GL-0006,FALSE,FALSE,REF-395309,First Continental Bank,***1425,Globex EMEA Manufacturing Ltd.,IE,5759134.43
14/02/2024,14/02/2024,Supplier Payment - ExpertNet Subcontractors #18,Supplier Payment,PS-GL,4586.03,0,EUR,SWIFT MT103,ExpertNet Subcontractors #18,***5904,,PO-202402-PS-GL-0002,FALSE,FALSE,REF-854580,First Continental Bank,***8200,Globex EMEA Manufacturing Ltd.,IE,5754548.4
14/02/2024,14/02/2024,Supplier Payment - Stelliform Parts BV #18,Supplier Payment,CEM-EMEA,4689,0,EUR,SWIFT MT103,Stelliform Parts BV #18,***6383,,PO-202402-CEM-EMEA-0011,FALSE,FALSE,REF-941395,First Continental Bank,***4712,Globex EMEA Manufacturing Ltd.,IE,5749859.4
14/02/2024,14/02/2024,Marketing - Beacon Digital #5,Marketing,ALL,5368.07,0,EUR,SWIFT MT103,Beacon Digital #5,***3224,,,FALSE,FALSE,REF-907911,First Continental Bank,***5813,Globex EMEA Manufacturing Ltd.,IE,5744491.33
14/02/2024,14/02/2024,Client Receipt - Aurora Electronics GmbH #12,Sales Receipt,CEM-EMEA,0,66455.26,EUR,SEPA SCT Inst,Aurora Electronics GmbH #12,***9930,INV-202402-CEM-EMEA-0001,,FALSE,FALSE,REF-882029,First Continental Bank,***8853,Globex EMEA Manufacturing Ltd.,IE,5810946.59
15/02/2024,15/02/2024,Supplier Payment - HyperCloud Infra #13,Supplier Payment,SaaS-GL,21500.58,0,EUR,SWIFT MT103,HyperCloud Infra #13,***2133,,PO-202402-SaaS-GL-0008,FALSE,FALSE,REF-872922,First Continental Bank,***3470,Globex EMEA Manufacturing Ltd.,IE,5789446.01
15/02/2024,15/02/2024,Loan Interest Payment,Loan Interest,ALL,85000,0,EUR,SEPA Debit,First Continental Bank - Corporate Lending,***5093,,,FALSE,FALSE,REF-706436,First Continental Bank,***1909,Globex EMEA Manufacturing Ltd.,IE,5704446.01
15/02/2024,15/02/2024,Loan Principal Repayment,Loan Principal,ALL,500000,0,EUR,SEPA Debit,First Continental Bank - Corporate Lending,***3965,,,FALSE,FALSE,REF-561898,First Continental Bank,***9658,Globex EMEA Manufacturing Ltd.,IE,5204446.01
15/02/2024,15/02/2024,Client Receipt - CloudBridge Co. #1,Sales Receipt,SaaS-GL,0,10455.83,EUR,Card Settlement,CloudBridge Co. #1,***4345,INV-202402-SaaS-GL-0008,,FALSE,FALSE,REF-744396,First Continental Bank,***2438,Globex EMEA Manufacturing Ltd.,IE,5214901.84
15/02/2024,15/02/2024,Client Receipt - CloudBridge Co. #74,Sales Receipt,SaaS-GL,0,15826.24,EUR,Card Settlement,CloudBridge Co. #74,***9290,INV-202402-SaaS-GL-0003,,FALSE,FALSE,REF-791104,First Continental Bank,***6947,Globex EMEA Manufacturing Ltd.,IE,5230728.08
15/02/2024,15/02/2024,Client Receipt - Vertex Advisory Client #43,Sales Receipt,PS-GL,0,27226.11,EUR,SEPA SCT Inst,Vertex Advisory Client #43,***5362,INV-202402-PS-GL-0008,,FALSE,FALSE,REF-216447,First Continental Bank,***8371,Globex EMEA Manufacturing Ltd.,IE,5257954.19
16/02/2024,16/02/2024,Supplier Payment - CodeCraft Contractors #10,Supplier Payment,SaaS-GL,35248.57,0,EUR,SEPA Debit,CodeCraft Contractors #10,***3620,,PO-202402-SaaS-GL-0006,FALSE,FALSE,REF-252396,First Continental Bank,***7470,Globex EMEA Manufacturing Ltd.,IE,5222705.62
16/02/2024,16/02/2024,Client Receipt - CloudBridge Co. #12,Sales Receipt,SaaS-GL,0,37370.94,EUR,Card Settlement,CloudBridge Co. #12,***7458,INV-202402-SaaS-GL-0017,,FALSE,FALSE,REF-734428,First Continental Bank,***5100,Globex EMEA Manufacturing Ltd.,IE,5260076.56
16/02/2024,16/02/2024,Client Receipt - Vertex Advisory Client #32,Sales Receipt,PS-GL,0,48093.4,EUR,SEPA SCT,Vertex Advisory Client #32,***4410,INV-202402-PS-GL-0003,,FALSE,FALSE,REF-542941,First Continental Bank,***2198,Globex EMEA Manufacturing Ltd.,IE,5308169.96
17/02/2024,17/02/2024,Supplier Payment - Stelliform Parts BV #32,Supplier Payment,CEM-EMEA,165218.45,0,EUR,SWIFT MT103,Stelliform Parts BV #32,***8344,,PO-202402-CEM-EMEA-0006,FALSE,FALSE,REF-868843,First Continental Bank,***8350,Globex EMEA Manufacturing Ltd.,IE,5142951.51
18/02/2024,18/02/2024,Client Receipt - CloudBridge Co. #14,Sales Receipt,SaaS-GL,0,35874.77,EUR,Card Settlement,CloudBridge Co. #14,***5585,INV-202402-SaaS-GL-0022,,FALSE,FALSE,REF-656199,First Continental Bank,***7427,Globex EMEA Manufacturing Ltd.,IE,5178826.28
19/02/2024,19/02/2024,Supplier Payment - CodeCraft Contractors #6,Supplier Payment,SaaS-GL,7649.38,0,EUR,SEPA Credit Transfer,CodeCraft Contractors #6,***9629,,PO-202402-SaaS-GL-0005,FALSE,FALSE,REF-368686,First Continental Bank,***1166,Globex EMEA Manufacturing Ltd.,IE,5171176.9
19/02/2024,19/02/2024,Supplier Payment - Stelliform Parts BV #30,Supplier Payment,CEM-EMEA,21327.83,0,EUR,SEPA Debit,Stelliform Parts BV #30,***2408,,PO-202402-CEM-EMEA-0010,FALSE,FALSE,REF-931864,First Continental Bank,***3322,Globex EMEA Manufacturing Ltd.,IE,5149849.07
19/02/2024,19/02/2024,VAT/GST Remittance - Revenue Ireland,Tax Payment,ALL,107113.88,0,EUR,SEPA Credit Transfer,Revenue Ireland,***1771,,,FALSE,FALSE,REF-991761,First Continental Bank,***8365,Globex EMEA Manufacturing Ltd.,IE,5042735.19
19/02/2024,19/02/2024,Client Receipt - CloudBridge Co. #3,Sales Receipt,SaaS-GL,0,4483.32,EUR,SEPA SCT Inst,CloudBridge Co. #3,***9310,INV-202402-SaaS-GL-0010,,FALSE,FALSE,REF-189391,First Continental Bank,***3375,Globex EMEA Manufacturing Ltd.,IE,5047218.51
20/02/2024,20/02/2024,Client Receipt - CloudBridge Co. #12,Sales Receipt,SaaS-GL,0,294.84,EUR,SEPA SCT,CloudBridge Co. #12,***8007,INV-202402-SaaS-GL-0020,,FALSE,FALSE,REF-207228,First Continental Bank,***5338,Globex EMEA Manufacturing Ltd.,IE,5047513.35
20/02/2024,20/02/2024,Client Receipt - Novatek Components Ltd #14,Sales Receipt,CEM-EMEA,0,5711.29,EUR,Card Settlement,Novatek Components Ltd #14,***8949,INV-202402-CEM-EMEA-0003,,FALSE,FALSE,REF-538438,First Continental Bank,***9358,Globex EMEA Manufacturing Ltd.,IE,5053224.64
20/02/2024,20/02/2024,Client Receipt - Aurora Electronics GmbH #1,Sales Receipt,CEM-EMEA,0,98510.95,EUR,SEPA SCT,Aurora Electronics GmbH #1,***5457,INV-202402-CEM-EMEA-0011,,FALSE,FALSE,REF-175469,First Continental Bank,***1569,Globex EMEA Manufacturing Ltd.,IE,5151735.59
21/02/2024,21/02/2024,Marketing - Beacon Digital #9,Marketing,ALL,5385.59,0,EUR,SEPA Credit Transfer,Beacon Digital #9,***3296,,,FALSE,FALSE,REF-420524,First Continental Bank,***1815,Globex EMEA Manufacturing Ltd.,IE,5146350
21/02/2024,21/02/2024,Client Receipt - Aurora Electronics GmbH #1,Sales Receipt,CEM-EMEA,0,3457.59,EUR,Card Settlement,Aurora Electronics GmbH #1,***5860,INV-202402-CEM-EMEA-0002,,FALSE,FALSE,REF-425599,First Continental Bank,***6871,Globex EMEA Manufacturing Ltd.,IE,5149807.59
21/02/2024,21/02/2024,Client Receipt - CloudBridge Co. #31,Sales Receipt,SaaS-GL,0,3930.75,EUR,SEPA SCT Inst,CloudBridge Co. #31,***8811,INV-202402-SaaS-GL-0021,,FALSE,FALSE,REF-694043,First Continental Bank,***7255,Globex EMEA Manufacturing Ltd.,IE,5153738.34
22/02/2024,22/02/2024,Supplier Payment - HyperCloud Infra #12,Supplier Payment,SaaS-GL,12055.03,0,EUR,SEPA Credit Transfer,HyperCloud Infra #12,***4147,,PO-202402-SaaS-GL-0004,FALSE,FALSE,REF-430292,First Continental Bank,***5679,Globex EMEA Manufacturing Ltd.,IE,5141683.31
22/02/2024,22/02/2024,Client Receipt - CloudBridge Co. #63,Sales Receipt,SaaS-GL,0,28741.23,EUR,SEPA SCT,CloudBridge Co. #63,***1118,INV-202402-SaaS-GL-0006,,FALSE,FALSE,REF-334646,First Continental Bank,***6203,Globex EMEA Manufacturing Ltd.,IE,5170424.54
22/02/2024,22/02/2024,Client Receipt - Vertex Advisory Client #44,Sales Receipt,PS-GL,0,45130.85,EUR,Card Settlement,Vertex Advisory Client #44,***1527,INV-202402-PS-GL-0006,,FALSE,FALSE,REF-809088,First Continental Bank,***3165,Globex EMEA Manufacturing Ltd.,IE,5215555.39
22/02/2024,22/02/2024,Client Receipt - Aurora Electronics GmbH #9,Sales Receipt,CEM-EMEA,0,87049.8,EUR,Card Settlement,Aurora Electronics GmbH #9,***8134,INV-202402-CEM-EMEA-0010,,FALSE,FALSE,REF-843498,First Continental Bank,***2108,Globex EMEA Manufacturing Ltd.,IE,5302605.19
23/02/2024,23/02/2024,Client Receipt - Vertex Advisory Client #44,Sales Receipt,PS-GL,0,23960.67,EUR,SEPA SCT,Vertex Advisory Client #44,***9248,INV-202402-PS-GL-0005,,FALSE,FALSE,REF-307164,First Continental Bank,***2925,Globex EMEA Manufacturing Ltd.,IE,5326565.86
23/02/2024,23/02/2024,Client Receipt - CloudBridge Co. #32,Sales Receipt,SaaS-GL,0,26972.58,EUR,SEPA SCT,CloudBridge Co. #32,***4636,INV-202402-SaaS-GL-0018,,FALSE,FALSE,REF-434057,First Continental Bank,***9328,Globex EMEA Manufacturing Ltd.,IE,5353538.44
24/02/2024,24/02/2024,Client Receipt - CloudBridge Co. #66,Sales Receipt,SaaS-GL,0,34035.15,EUR,Card Settlement,CloudBridge Co. #66,***6760,INV-202402-SaaS-GL-0007,,FALSE,FALSE,REF-454581,First Continental Bank,***6658,Globex EMEA Manufacturing Ltd.,IE,5387573.59
26/02/2024,26/02/2024,Supplier Payment - ExpertNet Subcontractors #10,Supplier Payment,PS-GL,3457.09,0,EUR,SWIFT MT103,ExpertNet Subcontractors #10,***5073,,PO-202402-PS-GL-0004,FALSE,FALSE,REF-728680,First Continental Bank,***9395,Globex EMEA Manufacturing Ltd.,IE,5384116.5
26/02/2024,26/02/2024,Supplier Payment - EuroFab Assembly #18,Supplier Payment,CEM-EMEA,15712.3,0,EUR,SEPA Debit,EuroFab Assembly #18,***5893,,PO-202402-CEM-EMEA-0003,FALSE,FALSE,REF-640960,First Continental Bank,***5992,Globex EMEA Manufacturing Ltd.,IE,5368404.2
26/02/2024,26/02/2024,Marketing - Aurelia Media #1,Marketing,ALL,32945.02,0,EUR,SWIFT MT103,Aurelia Media #1,***9813,,,FALSE,FALSE,REF-980107,First Continental Bank,***1530,Globex EMEA Manufacturing Ltd.,IE,5335459.18
26/02/2024,26/02/2024,Payroll - GlobalPay Services Ltd,Payroll,ALL,137305.59,0,EUR,SEPA Debit,GlobalPay Services Ltd,***3429,,,FALSE,FALSE,REF-100569,First Continental Bank,***5977,Globex EMEA Manufacturing Ltd.,IE,5198153.59
26/02/2024,26/02/2024,"Intercompany Settlement - Globex International Holdings, Inc.",Intercompany Transfer,ALL,794044,0,EUR,Internal Transfer,"Globex International Holdings, Inc.",***2474,,,TRUE,TRUE,REF-129964,First Continental Bank,***4000,Globex EMEA Manufacturing Ltd.,IE,4404109.59
26/02/2024,26/02/2024,Client Receipt - CloudBridge Co. #5,Sales Receipt,SaaS-GL,0,27632.87,EUR,SEPA SCT,CloudBridge Co. #5,***1579,INV-202402-SaaS-GL-0005,,FALSE,FALSE,REF-726084,First Continental Bank,***7544,Globex EMEA Manufacturing Ltd.,IE,4431742.46
27/02/2024,27/02/2024,Client Receipt - CloudBridge Co. #19,Sales Receipt,SaaS-GL,0,7766.49,EUR,Card Settlement,CloudBridge Co. #19,***2455,INV-202402-SaaS-GL-0011,,FALSE,FALSE,REF-909837,First Continental Bank,***5315,Globex EMEA Manufacturing Ltd.,IE,4439508.95
27/02/2024,27/02/2024,Client Receipt - CloudBridge Co. #17,Sales Receipt,SaaS-GL,0,23526.71,EUR,SEPA SCT,CloudBridge Co. #17,***7329,INV-202402-SaaS-GL-0004,,FALSE,FALSE,REF-615122,First Continental Bank,***8917,Globex EMEA Manufacturing Ltd.,IE,4463035.66
27/02/2024,27/02/2024,Client Receipt - Novatek Components Ltd #9,Sales Receipt,CEM-EMEA,0,215007.79,EUR,SEPA SCT,Novatek Components Ltd #9,***1931,INV-202402-CEM-EMEA-0007,,FALSE,FALSE,REF-834394,First Continental Bank,***4163,Globex EMEA Manufacturing Ltd.,IE,4678043.45
28/02/2024,28/02/2024,Supplier Payment - CodeCraft Contractors #2,Supplier Payment,SaaS-GL,19004.22,0,EUR,SEPA Debit,CodeCraft Contractors #2,***9349,,PO-202402-SaaS-GL-0001,FALSE,FALSE,REF-386716,First Continental Bank,***3665,Globex EMEA Manufacturing Ltd.,IE,4659039.23
28/02/2024,28/02/2024,Supplier Payment - EuroFab Assembly #19,Supplier Payment,CEM-EMEA,41760.3,0,EUR,SWIFT MT103,EuroFab Assembly #19,***6918,,PO-202402-CEM-EMEA-0002,FALSE,FALSE,REF-117297,First Continental Bank,***4659,Globex EMEA Manufacturing Ltd.,IE,4617278.93
28/02/2024,28/02/2024,Client Receipt - CloudBridge Co. #2,Sales Receipt,SaaS-GL,0,3912.96,EUR,SEPA SCT Inst,CloudBridge Co. #2,***2999,INV-202402-SaaS-GL-0012,,FALSE,FALSE,REF-645450,First Continental Bank,***7830,Globex EMEA Manufacturing Ltd.,IE,4621191.89
28/02/2024,28/02/2024,Client Receipt - CloudBridge Co. #22,Sales Receipt,SaaS-GL,0,6059.4,EUR,SEPA SCT Inst,CloudBridge Co. #22,***4497,INV-202402-SaaS-GL-0014,,FALSE,FALSE,REF-543206,First Continental Bank,***3905,Globex EMEA Manufacturing Ltd.,IE,4627251.29
28/02/2024,28/02/2024,Client Receipt - Novatek Components Ltd #6,Sales Receipt,CEM-EMEA,0,55636.76,EUR,Card Settlement,Novatek Components Ltd #6,***1124,INV-202402-CEM-EMEA-0012,,FALSE,FALSE,REF-949268,First Continental Bank,***8998,Globex EMEA Manufacturing Ltd.,IE,4682888.05
29/02/2024,29/02/2024,Alphagrid Utilities,Rent & Utilities,ALL,13910.73,0,EUR,SEPA Debit,Alphagrid Utilities,***3938,,,FALSE,FALSE,REF-160408,First Continental Bank,***9370,Globex EMEA Manufacturing Ltd.,IE,4668977.32
29/02/2024,29/02/2024,Payroll - GlobalPay Services Ltd,Payroll,ALL,137305.59,0,EUR,SEPA Credit Transfer,GlobalPay Services Ltd,***9843,,,FALSE,FALSE,REF-880373,First Continental Bank,***3616,Globex EMEA Manufacturing Ltd.,IE,4531671.73
29/02/2024,29/02/2024,Interest Earned,Interest Income,ALL,0,12545.15,EUR,Card Settlement,First Continental Bank,***3319,,,FALSE,FALSE,REF-941569,First Continental Bank,***8798,Globex EMEA Manufacturing Ltd.,IE,4544216.88
29/02/2024,29/02/2024,Client Receipt - Novatek Components Ltd #7,Sales Receipt,CEM-EMEA,0,20124.76,EUR,Card Settlement,Novatek Components Ltd #7,***9908,INV-202402-CEM-EMEA-0006,,FALSE,FALSE,REF-530095,First Continental Bank,***7194,Globex EMEA Manufacturing Ltd.,IE,4564341.64
29/02/2024,29/02/2024,Client Receipt - Aurora Electronics GmbH #5,Sales Receipt,CEM-EMEA,0,23261.62,EUR,SEPA SCT Inst,Aurora Electronics GmbH #5,***4801,INV-202402-CEM-EMEA-0013,,FALSE,FALSE,REF-807641,First Continental Bank,***1661,Globex EMEA Manufacturing Ltd.,IE,4587603.26
29/02/2024,29/02/2024,Client Receipt - CloudBridge Co. #63,Sales Receipt,SaaS-GL,0,29263.81,EUR,Card Settlement,CloudBridge Co. #63,***9687,INV-202402-SaaS-GL-0015,,FALSE,FALSE,REF-944415,First Continental Bank,***8611,Globex EMEA Manufacturing Ltd.,IE,4616867.07
01/03/2024,01/03/2024,Account Maintenance Fee,Bank/Merchant Fees,ALL,2500,0,EUR,SEPA Credit Transfer,First Continental Bank,***8047,,,FALSE,FALSE,REF-586533,First Continental Bank,***6951,Globex EMEA Manufacturing Ltd.,IE,4614367.07
01/03/2024,01/03/2024,Supplier Payment - Stelliform Parts BV #17,Supplier Payment,CEM-EMEA,103826.15,0,EUR,SWIFT MT103,Stelliform Parts BV #17,***2172,,PO-202403-CEM-EMEA-0005,FALSE,FALSE,REF-211038,First Continental Bank,***7351,Globex EMEA Manufacturing Ltd.,IE,4510540.92
01/03/2024,01/03/2024,Client Receipt - CloudBridge Co. #41,Sales Receipt,SaaS-GL,0,49067.4,EUR,SEPA SCT,CloudBridge Co. #41,***7999,INV-202403-SaaS-GL-0024,,FALSE,FALSE,REF-994736,First Continental Bank,***9280,Globex EMEA Manufacturing Ltd.,IE,4559608.32
02/03/2024,02/03/2024,Marketing - Aurelia Media #4,Marketing,ALL,13629.64,0,EUR,SEPA Debit,Aurelia Media #4,***7187,,,FALSE,FALSE,REF-510044,First Continental Bank,***9872,Globex EMEA Manufacturing Ltd.,IE,4545978.68
03/03/2024,03/03/2024,Supplier Payment - Stelliform Parts BV #1,Supplier Payment,CEM-EMEA,47343.87,0,EUR,SEPA Debit,Stelliform Parts BV #1,***9141,,PO-202403-CEM-EMEA-0001,FALSE,FALSE,REF-468240,First Continental Bank,***7762,Globex EMEA Manufacturing Ltd.,IE,4498634.81
04/03/2024,04/03/2024,Supplier Payment - ExpertNet Subcontractors #1,Supplier Payment,PS-GL,2284.47,0,EUR,SEPA Debit,ExpertNet Subcontractors #1,***7441,,PO-202403-PS-GL-0009,FALSE,FALSE,REF-812157,First Continental Bank,***7137,Globex EMEA Manufacturing Ltd.,IE,4496350.34
04/03/2024,04/03/2024,Marketing - Aurelia Media #9,Marketing,ALL,23229.07,0,EUR,SWIFT MT103,Aurelia Media #9,***9439,,,FALSE,FALSE,REF-134832,First Continental Bank,***7648,Globex EMEA Manufacturing Ltd.,IE,4473121.27
05/03/2024,05/03/2024,Supplier Payment - ExpertNet Subcontractors #18,Supplier Payment,PS-GL,10671.16,0,EUR,SWIFT MT103,ExpertNet Subcontractors #18,***9905,,PO-202403-PS-GL-0003,FALSE,FALSE,REF-915573,First Continental Bank,***4949,Globex EMEA Manufacturing Ltd.,IE,4462450.11
05/03/2024,05/03/2024,Supplier Payment - CodeCraft Contractors #12,Supplier Payment,SaaS-GL,11736.01,0,EUR,SEPA Debit,CodeCraft Contractors #12,***1891,,PO-202403-SaaS-GL-0007,FALSE,FALSE,REF-229645,First Continental Bank,***1485,Globex EMEA Manufacturing Ltd.,IE,4450714.1
05/03/2024,05/03/2024,Supplier Payment - HyperCloud Infra #10,Supplier Payment,SaaS-GL,22262.46,0,EUR,SEPA Credit Transfer,HyperCloud Infra #10,***1191,,PO-202403-SaaS-GL-0009,FALSE,FALSE,REF-510962,First Continental Bank,***4809,Globex EMEA Manufacturing Ltd.,IE,4428451.64
05/03/2024,05/03/2024,Supplier Payment - Stelliform Parts BV #3,Supplier Payment,CEM-EMEA,27617.02,0,EUR,SEPA Debit,Stelliform Parts BV #3,***9472,,PO-202403-CEM-EMEA-0003,FALSE,FALSE,REF-178811,First Continental Bank,***6360,Globex EMEA Manufacturing Ltd.,IE,4400834.62
05/03/2024,05/03/2024,Client Receipt - CloudBridge Co. #13,Sales Receipt,SaaS-GL,0,15926.01,EUR,Card Settlement,CloudBridge Co. #13,***7738,INV-202403-SaaS-GL-0019,,FALSE,FALSE,REF-951271,First Continental Bank,***8732,Globex EMEA Manufacturing Ltd.,IE,4416760.63
05/03/2024,05/03/2024,Client Receipt - Vertex Advisory Client #14,Sales Receipt,PS-GL,0,26732.91,EUR,SEPA SCT Inst,Vertex Advisory Client #14,***2145,INV-202403-PS-GL-0002,,FALSE,FALSE,REF-521233,First Continental Bank,***5760,Globex EMEA Manufacturing Ltd.,IE,4443493.54
06/03/2024,06/03/2024,Supplier Payment - CodeCraft Contractors #8,Supplier Payment,SaaS-GL,3068.25,0,EUR,SEPA Debit,CodeCraft Contractors #8,***5610,,PO-202403-SaaS-GL-0005,FALSE,FALSE,REF-463050,First Continental Bank,***4980,Globex EMEA Manufacturing Ltd.,IE,4440425.29
06/03/2024,06/03/2024,Client Receipt - Novatek Components Ltd #3,Sales Receipt,CEM-EMEA,0,3209.97,EUR,Card Settlement,Novatek Components Ltd #3,***1173,INV-202403-CEM-EMEA-0012,,FALSE,FALSE,REF-259237,First Continental Bank,***6187,Globex EMEA Manufacturing Ltd.,IE,4443635.26
06/03/2024,06/03/2024,Client Receipt - CloudBridge Co. #45,Sales Receipt,SaaS-GL,0,95298.11,EUR,Card Settlement,CloudBridge Co. #45,***1873,INV-202403-SaaS-GL-0016,,FALSE,FALSE,REF-925510,First Continental Bank,***6032,Globex EMEA Manufacturing Ltd.,IE,4538933.37
07/03/2024,07/03/2024,Supplier Payment - ExpertNet Subcontractors #12,Supplier Payment,PS-GL,2308.4,0,EUR,SEPA Credit Transfer,ExpertNet Subcontractors #12,***3995,,PO-202403-PS-GL-0007,FALSE,FALSE,REF-126198,First Continental Bank,***2315,Globex EMEA Manufacturing Ltd.,IE,4536624.97
07/03/2024,07/03/2024,Supplier Payment - HyperCloud Infra #1,Supplier Payment,SaaS-GL,6010.29,0,EUR,SEPA Debit,HyperCloud Infra #1,***4122,,PO-202403-SaaS-GL-0003,FALSE,FALSE,REF-677543,First Continental Bank,***2089,Globex EMEA Manufacturing Ltd.,IE,4530614.68
07/03/2024,07/03/2024,Client Receipt - Aurora Electronics GmbH #1,Sales Receipt,CEM-EMEA,0,254356.2,EUR,SEPA SCT Inst,Aurora Electronics GmbH #1,***5957,INV-202403-CEM-EMEA-0010,,FALSE,FALSE,REF-321773,First Continental Bank,***4769,Globex EMEA Manufacturing Ltd.,IE,4784970.88
08/03/2024,08/03/2024,Supplier Payment - CodeCraft Contractors #5,Supplier Payment,SaaS-GL,9165.05,0,EUR,SEPA Debit,CodeCraft Contractors #5,***2325,,PO-202403-SaaS-GL-0002,FALSE,FALSE,REF-100308,First Continental Bank,***4773,Globex EMEA Manufacturing Ltd.,IE,4775805.83
08/03/2024,08/03/2024,Client Receipt - CloudBridge Co. #50,Sales Receipt,SaaS-GL,0,3665.67,EUR,SEPA SCT,CloudBridge Co. #50,***3447,INV-202403-SaaS-GL-0021,,FALSE,FALSE,REF-101035,First Continental Bank,***4097,Globex EMEA Manufacturing Ltd.,IE,4779471.5
08/03/2024,08/03/2024,Client Receipt - CloudBridge Co. #29,Sales Receipt,SaaS-GL,0,4940.3,EUR,SEPA SCT Inst,CloudBridge Co. #29,***1070,INV-202403-SaaS-GL-0007,,FALSE,FALSE,REF-142740,First Continental Bank,***2358,Globex EMEA Manufacturing Ltd.,IE,4784411.8
09/03/2024,09/03/2024,Supplier Payment - CodeCraft Contractors #3,Supplier Payment,SaaS-GL,20994.96,0,EUR,SEPA Debit,CodeCraft Contractors #3,***4438,,PO-202403-SaaS-GL-0006,FALSE,FALSE,REF-715753,First Continental Bank,***6184,Globex EMEA Manufacturing Ltd.,IE,4763416.84
10/03/2024,10/03/2024,Supplier Payment - ExpertNet Subcontractors #19,Supplier Payment,PS-GL,4585.81,0,EUR,SWIFT MT103,ExpertNet Subcontractors #19,***2534,,PO-202403-PS-GL-0010,FALSE,FALSE,REF-355592,First Continental Bank,***1067,Globex EMEA Manufacturing Ltd.,IE,4758831.03
10/03/2024,10/03/2024,Client Receipt - CloudBridge Co. #9,Sales Receipt,SaaS-GL,0,52507.2,EUR,SEPA SCT Inst,CloudBridge Co. #9,***2536,INV-202403-SaaS-GL-0014,,FALSE,FALSE,REF-561212,First Continental Bank,***4890,Globex EMEA Manufacturing Ltd.,IE,4811338.23
10/03/2024,10/03/2024,Client Receipt - Vertex Advisory Client #53,Sales Receipt,PS-GL,0,56567.68,EUR,Card Settlement,Vertex Advisory Client #53,***4641,INV-202403-PS-GL-0008,,FALSE,FALSE,REF-280154,First Continental Bank,***6733,Globex EMEA Manufacturing Ltd.,IE,4867905.91
11/03/2024,11/03/2024,Client Receipt - CloudBridge Co. #45,Sales Receipt,SaaS-GL,0,5640.27,EUR,Card Settlement,CloudBridge Co. #45,***7563,INV-202403-SaaS-GL-0010,,FALSE,FALSE,REF-794917,First Continental Bank,***5324,Globex EMEA Manufacturing Ltd.,IE,4873546.18
12/03/2024,12/03/2024,Supplier Payment - EuroFab Assembly #6,Supplier Payment,CEM-EMEA,7852.31,0,EUR,SEPA Debit,EuroFab Assembly #6,***9306,,PO-202403-CEM-EMEA-0007,FALSE,FALSE,REF-103825,First Continental Bank,***4942,Globex EMEA Manufacturing Ltd.,IE,4865693.87
12/03/2024,12/03/2024,Supplier Payment - CodeCraft Contractors #3,Supplier Payment,SaaS-GL,27555.25,0,EUR,SEPA Credit Transfer,CodeCraft Contractors #3,***6097,,PO-202403-SaaS-GL-0010,FALSE,FALSE,REF-720502,First Continental Bank,***1653,Globex EMEA Manufacturing Ltd.,IE,4838138.62
12/03/2024,12/03/2024,Intercompany Settlement - Globex Consulting UK Ltd.,Intercompany Transfer,ALL,747741,0,EUR,Internal Transfer,Globex Consulting UK Ltd.,***5279,,,TRUE,TRUE,REF-202900,First Continental Bank,***1457,Globex EMEA Manufacturing Ltd.,IE,4090397.62
12/03/2024,12/03/2024,Client Receipt - CloudBridge Co. #72,Sales Receipt,SaaS-GL,0,4617.78,EUR,SEPA SCT Inst,CloudBridge Co. #72,***2257,INV-202403-SaaS-GL-0025,,FALSE,FALSE,REF-510244,First Continental Bank,***6571,Globex EMEA Manufacturing Ltd.,IE,4095015.4
12/03/2024,12/03/2024,Client Receipt - Aurora Electronics GmbH #12,Sales Receipt,CEM-EMEA,0,31387.95,EUR,Card Settlement,Aurora Electronics GmbH #12,***1154,INV-202403-CEM-EMEA-0005,,FALSE,FALSE,REF-294002,First Continental Bank,***9713,Globex EMEA Manufacturing Ltd.,IE,4126403.35
12/03/2024,12/03/2024,Client Receipt - CloudBridge Co. #76,Sales Receipt,SaaS-GL,0,52156.16,EUR,Card Settlement,CloudBridge Co. #76,***4530,INV-202403-SaaS-GL-0004,,FALSE,FALSE,REF-541317,First Continental Bank,***9221,Globex EMEA Manufacturing Ltd.,IE,4178559.51
12/03/2024,12/03/2024,Client Receipt - Vertex Advisory Client #31,Sales Receipt,PS-GL,0,98373.55,EUR,SEPA SCT,Vertex Advisory Client #31,***8548,INV-202403-PS-GL-0006,,FALSE,FALSE,REF-419558,First Continental Bank,***3607,Globex EMEA Manufacturing Ltd.,IE,4276933.06
12/03/2024,12/03/2024,Client Receipt - Novatek Components Ltd #9,Sales Receipt,CEM-EMEA,0,162633.93,EUR,SEPA SCT Inst,Novatek Components Ltd #9,***3879,INV-202403-CEM-EMEA-0008,,FALSE,FALSE,REF-718347,First Continental Bank,***7477,Globex EMEA Manufacturing Ltd.,IE,4439566.99
13/03/2024,13/03/2024,Supplier Payment - ExpertNet Subcontractors #16,Supplier Payment,PS-GL,3769.22,0,EUR,SWIFT MT103,ExpertNet Subcontractors #16,***7307,,PO-202403-PS-GL-0006,FALSE,FALSE,REF-142205,First Continental Bank,***5294,Globex EMEA Manufacturing Ltd.,IE,4435797.77
13/03/2024,13/03/2024,Client Receipt - Novatek Components Ltd #11,Sales Receipt,CEM-EMEA,0,22488.64,EUR,SEPA SCT Inst,Novatek Components Ltd #11,***8216,INV-202403-CEM-EMEA-0003,,FALSE,FALSE,REF-476044,First Continental Bank,***4158,Globex EMEA Manufacturing Ltd.,IE,4458286.41
13/03/2024,13/03/2024,Client Receipt - CloudBridge Co. #5,Sales Receipt,SaaS-GL,0,26422.72,EUR,SEPA SCT,CloudBridge Co. #5,***9056,INV-202403-SaaS-GL-0011,,FALSE,FALSE,REF-529093,First Continental Bank,***2039,Globex EMEA Manufacturing Ltd.,IE,4484709.13
14/03/2024,14/03/2024,Supplier Payment - Stelliform Parts BV #30,Supplier Payment,CEM-EMEA,66053.84,0,EUR,SEPA Debit,Stelliform Parts BV #30,***6239,,PO-202403-CEM-EMEA-0008,FALSE,FALSE,REF-444059,First Continental Bank,***1283,Globex EMEA Manufacturing Ltd.,IE,4418655.29
14/03/2024,14/03/2024,Client Receipt - CloudBridge Co. #16,Sales Receipt,SaaS-GL,0,27822.11,EUR,SEPA SCT Inst,CloudBridge Co. #16,***5082,INV-202403-SaaS-GL-0002,,FALSE,FALSE,REF-814204,First Continental Bank,***4179,Globex EMEA Manufacturing Ltd.,IE,4446477.4
14/03/2024,14/03/2024,Client Receipt - Vertex Advisory Client #55,Sales Receipt,PS-GL,0,30389.26,EUR,Card Settlement,Vertex Advisory Client #55,***2194,INV-202403-PS-GL-0005,,FALSE,FALSE,REF-251220,First Continental Bank,***1765,Globex EMEA Manufacturing Ltd.,IE,4476866.66
15/03/2024,15/03/2024,Supplier Payment - CodeCraft Contractors #4,Supplier Payment,SaaS-GL,1098.45,0,EUR,SWIFT MT103,CodeCraft Contractors #4,***1322,,PO-202403-SaaS-GL-0001,FALSE,FALSE,REF-102635,First Continental Bank,***9415,Globex EMEA Manufacturing Ltd.,IE,4475768.21
15/03/2024,15/03/2024,Supplier Payment - ExpertNet Subcontractors #9,Supplier Payment,PS-GL,19589.98,0,EUR,SEPA Debit,ExpertNet Subcontractors #9,***7161,,PO-202403-PS-GL-0011,FALSE,FALSE,REF-171517,First Continental Bank,***3766,Globex EMEA Manufacturing Ltd.,IE,4456178.23
15/03/2024,15/03/2024,Supplier Payment - ExpertNet Subcontractors #2,Supplier Payment,PS-GL,39882.66,0,EUR,SEPA Debit,ExpertNet Subcontractors #2,***2539,,PO-202403-PS-GL-0005,FALSE,FALSE,REF-240862,First Continental Bank,***5649,Globex EMEA Manufacturing Ltd.,IE,4416295.57
15/03/2024,15/03/2024,Loan Interest Payment,Loan Interest,ALL,85000,0,EUR,SWIFT MT103,First Continental Bank - Corporate Lending,***1024,,,FALSE,FALSE,REF-542530,First Continental Bank,***3490,Globex EMEA Manufacturing Ltd.,IE,4331295.57
15/03/2024,15/03/2024,Loan Principal Repayment,Loan Principal,ALL,500000,0,EUR,SEPA Debit,First Continental Bank - Corporate Lending,***7910,,,FALSE,FALSE,REF-100971,First Continental Bank,***5935,Globex EMEA Manufacturing Ltd.,IE,3831295.57
15/03/2024,15/03/2024,Client Receipt - CloudBridge Co. #55,Sales Receipt,SaaS-GL,0,862.44,EUR,SEPA SCT,CloudBridge Co. #55,***8890,INV-202403-SaaS-GL-0001,,FALSE,FALSE,REF-125094,First Continental Bank,***8085,Globex EMEA Manufacturing Ltd.,IE,3832158.01
15/03/2024,15/03/2024,Client Receipt - CloudBridge Co. #47,Sales Receipt,SaaS-GL,0,41322.63,EUR,Card Settlement,CloudBridge Co. #47,***9588,INV-202403-SaaS-GL-0015,,FALSE,FALSE,REF-437427,First Continental Bank,***7518,Globex EMEA Manufacturing Ltd.,IE,3873480.64
16/03/2024,16/03/2024,Client Receipt - CloudBridge Co. #24,Sales Receipt,SaaS-GL,0,23945.86,EUR,SEPA SCT,CloudBridge Co. #24,***7072,INV-202403-SaaS-GL-0006,,FALSE,FALSE,REF-143325,First Continental Bank,***8108,Globex EMEA Manufacturing Ltd.,IE,3897426.5
18/03/2024,18/03/2024,Client Receipt - CloudBridge Co. #45,Sales Receipt,SaaS-GL,0,34736.6,EUR,Card Settlement,CloudBridge Co. #45,***5717,INV-202403-SaaS-GL-0012,,FALSE,FALSE,REF-360718,First Continental Bank,***5173,Globex EMEA Manufacturing Ltd.,IE,3932163.1
18/03/2024,18/03/2024,Client Receipt - Novatek Components Ltd #2,Sales Receipt,CEM-EMEA,0,41302.41,EUR,SEPA SCT,Novatek Components Ltd #2,***5583,INV-202403-CEM-EMEA-0002,,FALSE,FALSE,REF-734346,First Continental Bank,***8310,Globex EMEA Manufacturing Ltd.,IE,3973465.51
18/03/2024,18/03/2024,Client Receipt - Aurora Electronics GmbH #9,Sales Receipt,CEM-EMEA,0,43228.31,EUR,Card Settlement,Aurora Electronics GmbH #9,***9218,INV-202403-CEM-EMEA-0013,,FALSE,FALSE,REF-490495,First Continental Bank,***4651,Globex EMEA Manufacturing Ltd.,IE,4016693.82
18/03/2024,18/03/2024,Client Receipt - Aurora Electronics GmbH #15,Sales Receipt,CEM-EMEA,0,108782.76,EUR,SEPA SCT Inst,Aurora Electronics GmbH #15,***1166,INV-202403-CEM-EMEA-0006,,FALSE,FALSE,REF-828643,First Continental Bank,***5922,Globex EMEA Manufacturing Ltd.,IE,4125476.58
19/03/2024,19/03/2024,Metro Water & Waste,Rent & Utilities,ALL,15306.76,0,EUR,SEPA Debit,Metro Water & Waste,***6702,,,FALSE,FALSE,REF-600775,First Continental Bank,***4031,Globex EMEA Manufacturing Ltd.,IE,4110169.82
19/03/2024,19/03/2024,Supplier Payment - EuroFab Assembly #21,Supplier Payment,CEM-EMEA,89212.31,0,EUR,SEPA Credit Transfer,EuroFab Assembly #21,***5763,,PO-202403-CEM-EMEA-0002,FALSE,FALSE,REF-999567,First Continental Bank,***3922,Globex EMEA Manufacturing Ltd.,IE,4020957.51
19/03/2024,19/03/2024,Client Receipt - CloudBridge Co. #67,Sales Receipt,SaaS-GL,0,383.84,EUR,SEPA SCT Inst,CloudBridge Co. #67,***5427,INV-202403-SaaS-GL-0018,,FALSE,FALSE,REF-675748,First Continental Bank,***2971,Globex EMEA Manufacturing Ltd.,IE,4021341.35
19/03/2024,19/03/2024,Client Receipt - CloudBridge Co. #16,Sales Receipt,SaaS-GL,0,8750.8,EUR,Card Settlement,CloudBridge Co. #16,***7961,INV-202403-SaaS-GL-0009,,FALSE,FALSE,REF-260020,First Continental Bank,***6845,Globex EMEA Manufacturing Ltd.,IE,4030092.15
20/03/2024,20/03/2024,Marketing - Beacon Digital #9,Marketing,ALL,10934.26,0,EUR,SEPA Debit,Beacon Digital #9,***8653,,,FALSE,FALSE,REF-298180,First Continental Bank,***4851,Globex EMEA Manufacturing Ltd.,IE,4019157.89
20/03/2024,20/03/2024,Supplier Payment - HyperCloud Infra #14,Supplier Payment,SaaS-GL,17122.74,0,EUR,SWIFT MT103,HyperCloud Infra #14,***2519,,PO-202403-SaaS-GL-0011,FALSE,FALSE,REF-147425,First Continental Bank,***3287,Globex EMEA Manufacturing Ltd.,IE,4002035.15
20/03/2024,20/03/2024,Client Receipt - CloudBridge Co. #53,Sales Receipt,SaaS-GL,0,4048.23,EUR,SEPA SCT Inst,CloudBridge Co. #53,***9007,INV-202403-SaaS-GL-0023,,FALSE,FALSE,REF-315917,First Continental Bank,***3113,Globex EMEA Manufacturing Ltd.,IE,4006083.38
20/03/2024,20/03/2024,Client Receipt - Vertex Advisory Client #47,Sales Receipt,PS-GL,0,13661.3,EUR,SEPA SCT Inst,Vertex Advisory Client #47,***3584,INV-202403-PS-GL-0004,,FALSE,FALSE,REF-750264,First Continental Bank,***8796,Globex EMEA Manufacturing Ltd.,IE,4019744.68
20/03/2024,20/03/2024,Client Receipt - CloudBridge Co. #14,Sales Receipt,SaaS-GL,0,20899.54,EUR,SEPA SCT,CloudBridge Co. #14,***6052,INV-202403-SaaS-GL-0022,,FALSE,FALSE,REF-883199,First Continental Bank,***9471,Globex EMEA Manufacturing Ltd.,IE,4040644.22
21/03/2024,21/03/2024,Supplier Payment - ExpertNet Subcontractors #10,Supplier Payment,PS-GL,694.04,0,EUR,SEPA Credit Transfer,ExpertNet Subcontractors #10,***4194,,PO-202403-PS-GL-0008,FALSE,FALSE,REF-902657,First Continental Bank,***6763,Globex EMEA Manufacturing Ltd.,IE,4039950.18
21/03/2024,21/03/2024,Supplier Payment - CodeCraft Contractors #14,Supplier Payment,SaaS-GL,5160.73,0,EUR,SEPA Credit Transfer,CodeCraft Contractors #14,***9696,,PO-202403-SaaS-GL-0004,FALSE,FALSE,REF-206537,First Continental Bank,***8507,Globex EMEA Manufacturing Ltd.,IE,4034789.45
21/03/2024,21/03/2024,VAT/GST Remittance - Revenue Ireland,Tax Payment,ALL,122770.79,0,EUR,SEPA Credit Transfer,Revenue Ireland,***2597,,,FALSE,FALSE,REF-173497,First Continental Bank,***5193,Globex EMEA Manufacturing Ltd.,IE,3912018.66
21/03/2024,21/03/2024,Client Receipt - CloudBridge Co. #40,Sales Receipt,SaaS-GL,0,8440.31,EUR,SEPA SCT Inst,CloudBridge Co. #40,***3571,INV-202403-SaaS-GL-0026,,FALSE,FALSE,REF-950980,First Continental Bank,***2426,Globex EMEA Manufacturing Ltd.,IE,3920458.97
21/03/2024,21/03/2024,Client Receipt - CloudBridge Co. #54,Sales Receipt,SaaS-GL,0,8576.35,EUR,SEPA SCT,CloudBridge Co. #54,***9382,INV-202403-SaaS-GL-0027,,FALSE,FALSE,REF-441025,First Continental Bank,***7910,Globex EMEA Manufacturing Ltd.,IE,3929035.32
21/03/2024,21/03/2024,Client Receipt - Novatek Components Ltd #9,Sales Receipt,CEM-EMEA,0,52627.01,EUR,Card Settlement,Novatek Components Ltd #9,***2597,INV-202403-CEM-EMEA-0009,,FALSE,FALSE,REF-358905,First Continental Bank,***1497,Globex EMEA Manufacturing Ltd.,IE,3981662.33
22/03/2024,22/03/2024,Supplier Payment - ExpertNet Subcontractors #17,Supplier Payment,PS-GL,28978.79,0,EUR,SEPA Debit,ExpertNet Subcontractors #17,***7082,,PO-202403-PS-GL-0004,FALSE,FALSE,REF-847845,First Continental Bank,***6719,Globex EMEA Manufacturing Ltd.,IE,3952683.54
22/03/2024,22/03/2024,Client Receipt - CloudBridge Co. #56,Sales Receipt,SaaS-GL,0,15175.67,EUR,SEPA SCT Inst,CloudBridge Co. #56,***5647,INV-202403-SaaS-GL-0028,,FALSE,FALSE,REF-582574,First Continental Bank,***6978,Globex EMEA Manufacturing Ltd.,IE,3967859.21
22/03/2024,22/03/2024,Client Receipt - CloudBridge Co. #71,Sales Receipt,SaaS-GL,0,25425.02,EUR,Card Settlement,CloudBridge Co. #71,***7663,INV-202403-SaaS-GL-0020,,FALSE,FALSE,REF-342728,First Continental Bank,***7762,Globex EMEA Manufacturing Ltd.,IE,3993284.23
24/03/2024,24/03/2024,Supplier Payment - ExpertNet Subcontractors #7,Supplier Payment,PS-GL,1993.4,0,EUR,SEPA Debit,ExpertNet Subcontractors #7,***8330,,PO-202403-PS-GL-0001,FALSE,FALSE,REF-830439,First Continental Bank,***3051,Globex EMEA Manufacturing Ltd.,IE,3991290.83
25/03/2024,25/03/2024,Supplier Payment - ExpertNet Subcontractors #14,Supplier Payment,PS-GL,5090.68,0,EUR,SEPA Debit,ExpertNet Subcontractors #14,***6560,,PO-202403-PS-GL-0002,FALSE,FALSE,REF-152108,First Continental Bank,***1242,Globex EMEA Manufacturing Ltd.,IE,3986200.15
25/03/2024,25/03/2024,Supplier Payment - Stelliform Parts BV #25,Supplier Payment,CEM-EMEA,117698.05,0,EUR,SEPA Debit,Stelliform Parts BV #25,***8295,,PO-202403-CEM-EMEA-0004,FALSE,FALSE,REF-312108,First Continental Bank,***2472,Globex EMEA Manufacturing Ltd.,IE,3868502.1
25/03/2024,25/03/2024,Payroll - GlobalPay Services Ltd,Payroll,ALL,154734.64,0,EUR,SEPA Credit Transfer,GlobalPay Services Ltd,***1216,,,FALSE,FALSE,REF-794474,First Continental Bank,***2989,Globex EMEA Manufacturing Ltd.,IE,3713767.46
25/03/2024,25/03/2024,Payroll - GlobalPay Services Ltd,Payroll,ALL,154734.64,0,EUR,SEPA Credit Transfer,GlobalPay Services Ltd,***7189,,,FALSE,FALSE,REF-816857,First Continental Bank,***3400,Globex EMEA Manufacturing Ltd.,IE,3559032.82
25/03/2024,25/03/2024,Client Receipt - CloudBridge Co. #79,Sales Receipt,SaaS-GL,0,4908.8,EUR,SEPA SCT Inst,CloudBridge Co. #79,***4266,INV-202403-SaaS-GL-0005,,FALSE,FALSE,REF-846479,First Continental Bank,***3182,Globex EMEA Manufacturing Ltd.,IE,3563941.62
25/03/2024,25/03/2024,Client Receipt - Vertex Advisory Client #19,Sales Receipt,PS-GL,0,23914.76,EUR,SEPA SCT Inst,Vertex Advisory Client #19,***6487,INV-202403-PS-GL-0007,,FALSE,FALSE,REF-452967,First Continental Bank,***2152,Globex EMEA Manufacturing Ltd.,IE,3587856.38
25/03/2024,25/03/2024,Client Receipt - Aurora Electronics GmbH #2,Sales Receipt,CEM-EMEA,0,95823.25,EUR,SEPA SCT,Aurora Electronics GmbH #2,***4191,INV-202403-CEM-EMEA-0015,,FALSE,FALSE,REF-440778,First Continental Bank,***8092,Globex EMEA Manufacturing Ltd.,IE,3683679.63
26/03/2024,26/03/2024,Supplier Payment - CodeCraft Contractors #13,Supplier Payment,SaaS-GL,7659.28,0,EUR,SEPA Debit,CodeCraft Contractors #13,***3150,,PO-202403-SaaS-GL-0008,FALSE,FALSE,REF-520290,First Continental Bank,***5567,Globex EMEA Manufacturing Ltd.,IE,3676020.35
26/03/2024,26/03/2024,Intercompany Settlement - Globex Consulting UK Ltd.,Intercompany Transfer,ALL,246079,0,EUR,Internal Transfer,Globex Consulting UK Ltd.,***9351,,,TRUE,TRUE,REF-784619,First Continental Bank,***2656,Globex EMEA Manufacturing Ltd.,IE,3429941.35
26/03/2024,26/03/2024,Client Receipt - CloudBridge Co. #21,Sales Receipt,SaaS-GL,0,2803.64,EUR,Card Settlement,CloudBridge Co. #21,***6313,INV-202403-SaaS-GL-0008,,FALSE,FALSE,REF-270403,First Continental Bank,***1781,Globex EMEA Manufacturing Ltd.,IE,3432744.99
26/03/2024,26/03/2024,Client Receipt - Novatek Components Ltd #6,Sales Receipt,CEM-EMEA,0,14233.37,EUR,SEPA SCT,Novatek Components Ltd #6,***6342,INV-202403-CEM-EMEA-0007,,FALSE,FALSE,REF-567119,First Continental Bank,***5180,Globex EMEA Manufacturing Ltd.,IE,3446978.36
26/03/2024,26/03/2024,Client Receipt - CloudBridge Co. #19,Sales Receipt,SaaS-GL,0,16221.71,EUR,SEPA SCT Inst,CloudBridge Co. #19,***7211,INV-202403-SaaS-GL-0003,,FALSE,FALSE,REF-774509,First Continental Bank,***7935,Globex EMEA Manufacturing Ltd.,IE,3463200.07
27/03/2024,27/03/2024,Client Receipt - CloudBridge Co. #29,Sales Receipt,SaaS-GL,0,12080.78,EUR,SEPA SCT Inst,CloudBridge Co. #29,***1275,INV-202403-SaaS-GL-0017,,FALSE,FALSE,REF-215161,First Continental Bank,***2129,Globex EMEA Manufacturing Ltd.,IE,3475280.85
27/03/2024,27/03/2024,Client Receipt - Aurora Electronics GmbH #1,Sales Receipt,CEM-EMEA,0,12743.85,EUR,SEPA SCT,Aurora Electronics GmbH #1,***9282,INV-202403-CEM-EMEA-0001,,FALSE,FALSE,REF-887691,First Continental Bank,***1106,Globex EMEA Manufacturing Ltd.,IE,3488024.7
27/03/2024,27/03/2024,Client Receipt - Vertex Advisory Client #33,Sales Receipt,PS-GL,0,49705.18,EUR,SEPA SCT,Vertex Advisory Client #33,***8076,INV-202403-PS-GL-0001,,FALSE,FALSE,REF-259182,First Continental Bank,***5247,Globex EMEA Manufacturing Ltd.,IE,3537729.88
28/03/2024,28/03/2024,Merchant Processing Fees,Bank/Merchant Fees,ALL,1028.68,0,EUR,SWIFT MT103,First Continental Bank,***1567,,,FALSE,FALSE,REF-200591,First Continental Bank,***2826,Globex EMEA Manufacturing Ltd.,IE,3536701.2
28/03/2024,28/03/2024,Merchant Processing Fees,Bank/Merchant Fees,ALL,4840.83,0,EUR,SWIFT MT103,First Continental Bank,***5230,,,FALSE,FALSE,REF-101724,First Continental Bank,***3102,Globex EMEA Manufacturing Ltd.,IE,3531860.37
28/03/2024,28/03/2024,Client Receipt - CloudBridge Co. #52,Sales Receipt,SaaS-GL,0,3882.75,EUR,SEPA SCT,CloudBridge Co. #52,***3051,INV-202403-SaaS-GL-0029,,FALSE,FALSE,REF-995516,First Continental Bank,***7769,Globex EMEA Manufacturing Ltd.,IE,3535743.12
28/03/2024,28/03/2024,Client Receipt - Novatek Components Ltd #2,Sales Receipt,CEM-EMEA,0,19319.14,EUR,Card Settlement,Novatek Components Ltd #2,***4340,INV-202403-CEM-EMEA-0011,,FALSE,FALSE,REF-595448,First Continental Bank,***6228,Globex EMEA Manufacturing Ltd.,IE,3555062.26
29/03/2024,29/03/2024,Supplier Payment - Stelliform Parts BV #14,Supplier Payment,CEM-EMEA,99689.97,0,EUR,SEPA Debit,Stelliform Parts BV #14,***7711,,PO-202403-CEM-EMEA-0006,FALSE,FALSE,REF-971735,First Continental Bank,***9662,Globex EMEA Manufacturing Ltd.,IE,3455372.29
30/03/2024,30/03/2024,Interest Earned,Interest Income,ALL,0,9125.19,EUR,SEPA SCT,First Continental Bank,***7242,,,FALSE,FALSE,REF-325205,First Continental Bank,***8932,Globex EMEA Manufacturing Ltd.,IE,3464497.48
30/03/2024,30/03/2024,Client Receipt - Vertex Advisory Client #57,Sales Receipt,PS-GL,0,100150.73,EUR,SEPA SCT Inst,Vertex Advisory Client #57,***6113,INV-202403-PS-GL-0003,,FALSE,FALSE,REF-253528,First Continental Bank,***6022,Globex EMEA Manufacturing Ltd.,IE,3564648.21
31/03/2024,31/03/2024,Client Receipt - Aurora Electronics GmbH #7,Sales Receipt,CEM-EMEA,0,20732.63,EUR,Card Settlement,Aurora Electronics GmbH #7,***4828,INV-202403-CEM-EMEA-0004,,FALSE,FALSE,REF-937799,First Continental Bank,***2363,Globex EMEA Manufacturing Ltd.,IE,3585380.84
31/03/2024,31/03/2024,Client Receipt - CloudBridge Co. #62,Sales Receipt,SaaS-GL,0,28714.36,EUR,Card Settlement,CloudBridge Co. #62,***1783,INV-202403-SaaS-GL-0013,,FALSE,FALSE,REF-356538,First Continental Bank,***2682,Globex EMEA Manufacturing Ltd.,IE,3614095.2
31/03/2024,31/03/2024,Client Receipt - Novatek Components Ltd #7,Sales Receipt,CEM-EMEA,0,49286.45,EUR,Card Settlement,Novatek Components Ltd #7,***6469,INV-202403-CEM-EMEA-0014,,FALSE,FALSE,REF-973631,First Continental Bank,***6442,Globex EMEA Manufacturing Ltd.,IE,3663381.65
01/04/2024,01/04/2024,Account Maintenance Fee,Bank/Merchant Fees,ALL,2500,0,EUR,SEPA Credit Transfer,First Continental Bank,***2786,,,FALSE,FALSE,REF-585195,First Continental Bank,***5564,Globex EMEA Manufacturing Ltd.,IE,3660881.65
02/04/2024,02/04/2024,Supplier Payment - EuroFab Assembly #2,Supplier Payment,CEM-EMEA,7564.13,0,EUR,SWIFT MT103,EuroFab Assembly #2,***7933,,PO-202404-CEM-EMEA-0009,FALSE,FALSE,REF-725662,First Continental Bank,***6272,Globex EMEA Manufacturing Ltd.,IE,3653317.52
02/04/2024,02/04/2024,Supplier Payment - EuroFab Assembly #13,Supplier Payment,CEM-EMEA,12544.12,0,EUR,SEPA Credit Transfer,EuroFab Assembly #13,***3832,,PO-202404-CEM-EMEA-0011,FALSE,FALSE,REF-518237,First Continental Bank,***3861,Globex EMEA Manufacturing Ltd.,IE,3640773.4
02/04/2024,02/04/2024,Supplier Payment - ExpertNet Subcontractors #10,Supplier Payment,PS-GL,17438.02,0,EUR,SWIFT MT103,ExpertNet Subcontractors #10,***4574,,PO-202404-PS-GL-0001,FALSE,FALSE,REF-300157,First Continental Bank,***9776,Globex EMEA Manufacturing Ltd.,IE,3623335.38
02/04/2024,02/04/2024,Client Receipt - CloudBridge Co. #40,Sales Receipt,SaaS-GL,0,3573.77,EUR,Card Settlement,CloudBridge Co. #40,***7871,INV-202404-SaaS-GL-0004,,FALSE,FALSE,REF-697914,First Continental Bank,***3712,Globex EMEA Manufacturing Ltd.,IE,3626909.15
02/04/2024,02/04/2024,Client Receipt - Vertex Advisory Client #13,Sales Receipt,PS-GL,0,52070.23,EUR,SEPA SCT Inst,Vertex Advisory Client #13,***3534,INV-202404-PS-GL-0005,,FALSE,FALSE,REF-242133,First Continental Bank,***7615,Globex EMEA Manufacturing Ltd.,IE,3678979.38
03/04/2024,03/04/2024,Supplier Payment - ExpertNet Subcontractors #8,Supplier Payment,PS-GL,7250.03,0,EUR,SEPA Credit Transfer,ExpertNet Subcontractors #8,***7308,,PO-202404-PS-GL-0007,FALSE,FALSE,REF-719047,First Continental Bank,***9248,Globex EMEA Manufacturing Ltd.,IE,3671729.35
03/04/2024,03/04/2024,Supplier Payment - EuroFab Assembly #7,Supplier Payment,CEM-EMEA,35446.03,0,EUR,SEPA Credit Transfer,EuroFab Assembly #7,***2572,,PO-202404-CEM-EMEA-0012,FALSE,FALSE,REF-897525,First Continental Bank,***4618,Globex EMEA Manufacturing Ltd.,IE,3636283.32
03/04/2024,03/04/2024,Client Receipt - CloudBridge Co. #35,Sales Receipt,SaaS-GL,0,30547.13,EUR,Card Settlement,CloudBridge Co. #35,***5303,INV-202404-SaaS-GL-0025,,FALSE,FALSE,REF-323357,First Continental Bank,***7307,Globex EMEA Manufacturing Ltd.,IE,3666830.45
03/04/2024,03/04/2024,Client Receipt - CloudBridge Co. #21,Sales Receipt,SaaS-GL,0,62342.97,EUR,Card Settlement,CloudBridge Co. #21,***5709,INV-202404-SaaS-GL-0021,,FALSE,FALSE,REF-540914,First Continental Bank,***8568,Globex EMEA Manufacturing Ltd.,IE,3729173.42
04/04/2024,04/04/2024,Supplier Payment - Stelliform Parts BV #31,Supplier Payment,CEM-EMEA,2739.78,0,EUR,SEPA Debit,Stelliform Parts BV #31,***5122,,PO-202404-CEM-EMEA-0004,FALSE,FALSE,REF-876139,First Continental Bank,***4649,Globex EMEA Manufacturing Ltd.,IE,3726433.64
04/04/2024,04/04/2024,Marketing - Beacon Digital #7,Marketing,ALL,21228.11,0,EUR,SEPA Credit Transfer,Beacon Digital #7,***3932,,,FALSE,FALSE,REF-645624,First Continental Bank,***4132,Globex EMEA Manufacturing Ltd.,IE,3705205.53
04/04/2024,04/04/2024,Client Receipt - CloudBridge Co. #68,Sales Receipt,SaaS-GL,0,601.86,EUR,Card Settlement,CloudBridge Co. #68,***5132,INV-202404-SaaS-GL-0026,,FALSE,FALSE,REF-854098,First Continental Bank,***3808,Globex EMEA Manufacturing Ltd.,IE,3705807.39
04/04/2024,04/04/2024,Client Receipt - CloudBridge Co. #46,Sales Receipt,SaaS-GL,0,1973.72,EUR,SEPA SCT Inst,CloudBridge Co. #46,***5007,INV-202404-SaaS-GL-0014,,FALSE,FALSE,REF-175272,First Continental Bank,***7702,Globex EMEA Manufacturing Ltd.,IE,3707781.11
04/04/2024,04/04/2024,Client Receipt - CloudBridge Co. #12,Sales Receipt,SaaS-GL,0,3754.83,EUR,SEPA SCT,CloudBridge Co. #12,***8213,INV-202404-SaaS-GL-0010,,FALSE,FALSE,REF-362862,First Continental Bank,***5710,Globex EMEA Manufacturing Ltd.,IE,3711535.94
04/04/2024,04/04/2024,Client Receipt - CloudBridge Co. #4,Sales Receipt,SaaS-GL,0,10691.38,EUR,SEPA SCT Inst,CloudBridge Co. #4,***7196,INV-202404-SaaS-GL-0022,,FALSE,FALSE,REF-950600,First Continental Bank,***3452,Globex EMEA Manufacturing Ltd.,IE,3722227.32
04/04/2024,04/04/2024,Client Receipt - CloudBridge Co. #15,Sales Receipt,SaaS-GL,0,28319.16,EUR,Card Settlement,CloudBridge Co. #15,***9386,INV-202404-SaaS-GL-0016,,FALSE,FALSE,REF-619913,First Continental Bank,***6590,Globex EMEA Manufacturing Ltd.,IE,3750546.48
05/04/2024,05/04/2024,Supplier Payment - HyperCloud Infra #7,Supplier Payment,SaaS-GL,8259.27,0,EUR,SEPA Debit,HyperCloud Infra #7,***5591,,PO-202404-SaaS-GL-0008,FALSE,FALSE,REF-492062,First Continental Bank,***1059,Globex EMEA Manufacturing Ltd.,IE,3742287.21
06/04/2024,06/04/2024,Northshore Power,Rent & Utilities,ALL,7080.73,0,EUR,SEPA Debit,Northshore Power,***4699,,,FALSE,FALSE,REF-402392,First Continental Bank,***3125,Globex EMEA Manufacturing Ltd.,IE,3735206.48
06/04/2024,06/04/2024,Client Receipt - Vertex Advisory Client #54,Sales Receipt,PS-GL,0,49857.09,EUR,SEPA SCT Inst,Vertex Advisory Client #54,***1734,INV-202404-PS-GL-0011,,FALSE,FALSE,REF-606424,First Continental Bank,***6299,Globex EMEA Manufacturing Ltd.,IE,3785063.57
07/04/2024,07/04/2024,Client Receipt - CloudBridge Co. #41,Sales Receipt,SaaS-GL,0,4467.25,EUR,SEPA SCT,CloudBridge Co. #41,***2128,INV-202404-SaaS-GL-0003,,FALSE,FALSE,REF-884418,First Continental Bank,***5830,Globex EMEA Manufacturing Ltd.,IE,3789530.82
07/04/2024,07/04/2024,Client Receipt - CloudBridge Co. #48,Sales Receipt,SaaS-GL,0,13784.14,EUR,Card Settlement,CloudBridge Co. #48,***4774,INV-202404-SaaS-GL-0017,,FALSE,FALSE,REF-828592,First Continental Bank,***6030,Globex EMEA Manufacturing Ltd.,IE,3803314.96
08/04/2024,08/04/2024,Supplier Payment - ExpertNet Subcontractors #11,Supplier Payment,PS-GL,35120.27,0,EUR,SEPA Credit Transfer,ExpertNet Subcontractors #11,***9356,,PO-202404-PS-GL-0004,FALSE,FALSE,REF-263155,First Continental Bank,***9984,Globex EMEA Manufacturing Ltd.,IE,3768194.69
08/04/2024,08/04/2024,Client Receipt - Vertex Advisory Client #57,Sales Receipt,PS-GL,0,6999.36,EUR,SEPA SCT Inst,Vertex Advisory Client #57,***7565,INV-202404-PS-GL-0010,,FALSE,FALSE,REF-485127,First Continental Bank,***8365,Globex EMEA Manufacturing Ltd.,IE,3775194.05
08/04/2024,08/04/2024,Client Receipt - CloudBridge Co. #31,Sales Receipt,SaaS-GL,0,8972.73,EUR,Card Settlement,CloudBridge Co. #31,***9428,INV-202404-SaaS-GL-0007,,FALSE,FALSE,REF-692673,First Continental Bank,***1830,Globex EMEA Manufacturing Ltd.,IE,3784166.78
09/04/2024,09/04/2024,Supplier Payment - ExpertNet Subcontractors #10,Supplier Payment,PS-GL,12322.62,0,EUR,SEPA Debit,ExpertNet Subcontractors #10,***3481,,PO-202404-PS-GL-0003,FALSE,FALSE,REF-402547,First Continental Bank,***1445,Globex EMEA Manufacturing Ltd.,IE,3771844.16
09/04/2024,09/04/2024,Supplier Payment - HyperCloud Infra #6,Supplier Payment,SaaS-GL,35388.95,0,EUR,SEPA Debit,HyperCloud Infra #6,***7345,,PO-202404-SaaS-GL-0001,FALSE,FALSE,REF-254841,First Continental Bank,***3102,Globex EMEA Manufacturing Ltd.,IE,3736455.21
10/04/2024,10/04/2024,Supplier Payment - Stelliform Parts BV #18,Supplier Payment,CEM-EMEA,88952.86,0,EUR,SEPA Debit,Stelliform Parts BV #18,***5623,,PO-202404-CEM-EMEA-0005,FALSE,FALSE,REF-426368,First Continental Bank,***5524,Globex EMEA Manufacturing Ltd.,IE,3647502.35
10/04/2024,10/04/2024,Client Receipt - Vertex Advisory Client #45,Sales Receipt,PS-GL,0,20553.56,EUR,SEPA SCT,Vertex Advisory Client #45,***1158,INV-202404-PS-GL-0008,,FALSE,FALSE,REF-686250,First Continental Bank,***2066,Globex EMEA Manufacturing Ltd.,IE,3668055.91
10/04/2024,10/04/2024,Client Receipt - CloudBridge Co. #68,Sales Receipt,SaaS-GL,0,22603.25,EUR,SEPA SCT,CloudBridge Co. #68,***9860,INV-202404-SaaS-GL-0005,,FALSE,FALSE,REF-809813,First Continental Bank,***4323,Globex EMEA Manufacturing Ltd.,IE,3690659.16
10/04/2024,10/04/2024,Client Receipt - CloudBridge Co. #74,Sales Receipt,SaaS-GL,0,61793.33,EUR,SEPA SCT,CloudBridge Co. #74,***7926,INV-202404-SaaS-GL-0012,,FALSE,FALSE,REF-875491,First Continental Bank,***4051,Globex EMEA Manufacturing Ltd.,IE,3752452.49
10/04/2024,10/04/2024,Client Receipt - CloudBridge Co. #21,Sales Receipt,SaaS-GL,0,119030.39,EUR,SEPA SCT Inst,CloudBridge Co. #21,***2449,INV-202404-SaaS-GL-0006,,FALSE,FALSE,REF-958785,First Continental Bank,***5795,Globex EMEA Manufacturing Ltd.,IE,3871482.88
11/04/2024,11/04/2024,Marketing - Beacon Digital #9,Marketing,ALL,10096.06,0,EUR,SEPA Credit Transfer,Beacon Digital #9,***6190,,,FALSE,FALSE,REF-388422,First Continental Bank,***8907,Globex EMEA Manufacturing Ltd.,IE,3861386.82
11/04/2024,11/04/2024,Supplier Payment - ExpertNet Subcontractors #8,Supplier Payment,PS-GL,16554.12,0,EUR,SWIFT MT103,ExpertNet Subcontractors #8,***1708,,PO-202404-PS-GL-0005,FALSE,FALSE,REF-175488,First Continental Bank,***8919,Globex EMEA Manufacturing Ltd.,IE,3844832.7
11/04/2024,11/04/2024,Client Receipt - CloudBridge Co. #13,Sales Receipt,SaaS-GL,0,5528.9,EUR,SEPA SCT,CloudBridge Co. #13,***6586,INV-202404-SaaS-GL-0002,,FALSE,FALSE,REF-393726,First Continental Bank,***5442,Globex EMEA Manufacturing Ltd.,IE,3850361.6
11/04/2024,11/04/2024,Client Receipt - CloudBridge Co. #8,Sales Receipt,SaaS-GL,0,6600.41,EUR,Card Settlement,CloudBridge Co. #8,***9038,INV-202404-SaaS-GL-0011,,FALSE,FALSE,REF-587688,First Continental Bank,***2466,Globex EMEA Manufacturing Ltd.,IE,3856962.01
11/04/2024,11/04/2024,Client Receipt - Vertex Advisory Client #54,Sales Receipt,PS-GL,0,17389.49,EUR,SEPA SCT,Vertex Advisory Client #54,***1184,INV-202404-PS-GL-0001,,FALSE,FALSE,REF-117838,First Continental Bank,***2229,Globex EMEA Manufacturing Ltd.,IE,3874351.5
12/04/2024,12/04/2024,Merchant Processing Fees,Bank/Merchant Fees,ALL,1474.98,0,EUR,SEPA Debit,First Continental Bank,***1606,,,FALSE,FALSE,REF-110577,First Continental Bank,***8214,Globex EMEA Manufacturing Ltd.,IE,3872876.52
12/04/2024,12/04/2024,Intercompany Settlement - Globex Consulting UK Ltd.,Intercompany Transfer,ALL,357421,0,EUR,Internal Transfer,Globex Consulting UK Ltd.,***2779,,,TRUE,TRUE,REF-646449,First Continental Bank,***7957,Globex EMEA Manufacturing Ltd.,IE,3515455.52
12/04/2024,12/04/2024,Client Receipt - CloudBridge Co. #76,Sales Receipt,SaaS-GL,0,23172.39,EUR,SEPA SCT,CloudBridge Co. #76,***7913,INV-202404-SaaS-GL-0001,,FALSE,FALSE,REF-157634,First Continental Bank,***8614,Globex EMEA Manufacturing Ltd.,IE,3538627.91
12/04/2024,12/04/2024,Client Receipt - Aurora Electronics GmbH #15,Sales Receipt,CEM-EMEA,0,28087.71,EUR,Card Settlement,Aurora Electronics GmbH #15,***3064,INV-202404-CEM-EMEA-0006,,FALSE,FALSE,REF-494302,First Continental Bank,***5938,Globex EMEA Manufacturing Ltd.,IE,3566715.62
12/04/2024,12/04/2024,Intercompany Reimbursement - Globex Consulting UK Ltd.,Intercompany Transfer,ALL,0,142968.4,EUR,Internal Transfer,Globex Consulting UK Ltd.,***1546,,,TRUE,TRUE,REF-919975,First Continental Bank,***6792,Globex EMEA Manufacturing Ltd.,IE,3709684.02
13/04/2024,13/04/2024,Client Receipt - Vertex Advisory Client #3,Sales Receipt,PS-GL,0,136296.64,EUR,SEPA SCT,Vertex Advisory Client #3,***6587,INV-202404-PS-GL-0007,,FALSE,FALSE,REF-627650,First Continental Bank,***9998,Globex EMEA Manufacturing Ltd.,IE,3845980.66
14/04/2024,14/04/2024,Client Receipt - Aurora Electronics GmbH #3,Sales Receipt,CEM-EMEA,0,19654.39,EUR,SEPA SCT Inst,Aurora Electronics GmbH #3,***6288,INV-202404-CEM-EMEA-0009,,FALSE,FALSE,REF-602532,First Continental Bank,***2732,Globex EMEA Manufacturing Ltd.,IE,3865635.05
15/04/2024,15/04/2024,Supplier Payment - Stelliform Parts BV #25,Supplier Payment,CEM-EMEA,26734.05,0,EUR,SEPA Credit Transfer,Stelliform Parts BV #25,***2065,,PO-202404-CEM-EMEA-0003,FALSE,FALSE,REF-146790,First Continental Bank,***4392,Globex EMEA Manufacturing Ltd.,IE,3838901
15/04/2024,15/04/2024,Loan Interest Payment,Loan Interest,ALL,85000,0,EUR,SEPA Credit Transfer,First Continental Bank - Corporate Lending,***2137,,,FALSE,FALSE,REF-280538,First Continental Bank,***2187,Globex EMEA Manufacturing Ltd.,IE,3753901
15/04/2024,15/04/2024,Loan Principal Repayment,Loan Principal,ALL,500000,0,EUR,SEPA Credit Transfer,First Continental Bank - Corporate Lending,***2270,,,FALSE,FALSE,REF-972864,First Continental Bank,***5138,Globex EMEA Manufacturing Ltd.,IE,3253901
15/04/2024,15/04/2024,Client Receipt - Vertex Advisory Client #59,Sales Receipt,PS-GL,0,10455.73,EUR,SEPA SCT,Vertex Advisory Client #59,***3704,INV-202404-PS-GL-0004,,FALSE,FALSE,REF-241085,First Continental Bank,***2149,Globex EMEA Manufacturing Ltd.,IE,3264356.73
15/04/2024,15/04/2024,Client Receipt - Vertex Advisory Client #58,Sales Receipt,PS-GL,0,22627.56,EUR,Card Settlement,Vertex Advisory Client #58,***7861,INV-202404-PS-GL-0002,,FALSE,FALSE,REF-526211,First Continental Bank,***6430,Globex EMEA Manufacturing Ltd.,IE,3286984.29
16/04/2024,16/04/2024,Supplier Payment - Stelliform Parts BV #3,Supplier Payment,CEM-EMEA,125791.03,0,EUR,SEPA Debit,Stelliform Parts BV #3,***8485,,PO-202404-CEM-EMEA-0002,FALSE,FALSE,REF-108041,First Continental Bank,***7929,Globex EMEA Manufacturing Ltd.,IE,3161193.26
16/04/2024,16/04/2024,Client Receipt - CloudBridge Co. #37,Sales Receipt,SaaS-GL,0,4309.84,EUR,Card Settlement,CloudBridge Co. #37,***1196,INV-202404-SaaS-GL-0018,,FALSE,FALSE,REF-744146,First Continental Bank,***5031,Globex EMEA Manufacturing Ltd.,IE,3165503.1
16/04/2024,16/04/2024,Client Receipt - Aurora Electronics GmbH #13,Sales Receipt,CEM-EMEA,0,156901,EUR,SEPA SCT Inst,Aurora Electronics GmbH #13,***5458,INV-202404-CEM-EMEA-0003,,FALSE,FALSE,REF-336850,First Continental Bank,***4998,Globex EMEA Manufacturing Ltd.,IE,3322404.1
17/04/2024,17/04/2024,Supplier Payment - EuroFab Assembly #2,Supplier Payment,CEM-EMEA,27379.96,0,EUR,SEPA Debit,EuroFab Assembly #2,***8588,,PO-202404-CEM-EMEA-0006,FALSE,FALSE,REF-667334,First Continental Bank,***2309,Globex EMEA Manufacturing Ltd.,IE,3295024.14
17/04/2024,17/04/2024,Client Receipt - Vertex Advisory Client #16,Sales Receipt,PS-GL,0,20252.09,EUR,SEPA SCT,Vertex Advisory Client #16,***2660,INV-202404-PS-GL-0003,,FALSE,FALSE,REF-185481,First Continental Bank,***6558,Globex EMEA Manufacturing Ltd.,IE,3315276.23
17/04/2024,17/04/2024,Client Receipt - Aurora Electronics GmbH #3,Sales Receipt,CEM-EMEA,0,128740.39,EUR,Card Settlement,Aurora Electronics GmbH #3,***7319,INV-202404-CEM-EMEA-0001,,FALSE,FALSE,REF-113731,First Continental Bank,***4531,Globex EMEA Manufacturing Ltd.,IE,3444016.62
18/04/2024,18/04/2024,Marketing - Beacon Digital #8,Marketing,ALL,18991.86,0,EUR,SEPA Credit Transfer,Beacon Digital #8,***9147,,,FALSE,FALSE,REF-177899,First Continental Bank,***5081,Globex EMEA Manufacturing Ltd.,IE,3425024.76
18/04/2024,18/04/2024,Client Receipt - CloudBridge Co. #46,Sales Receipt,SaaS-GL,0,69414.09,EUR,Card Settlement,CloudBridge Co. #46,***2458,INV-202404-SaaS-GL-0019,,FALSE,FALSE,REF-767669,First Continental Bank,***8489,Globex EMEA Manufacturing Ltd.,IE,3494438.85
18/04/2024,18/04/2024,Client Receipt - Aurora Electronics GmbH #2,Sales Receipt,CEM-EMEA,0,86823.99,EUR,Card Settlement,Aurora Electronics GmbH #2,***3730,INV-202404-CEM-EMEA-0005,,FALSE,FALSE,REF-586051,First Continental Bank,***2194,Globex EMEA Manufacturing Ltd.,IE,3581262.84
19/04/2024,19/04/2024,VAT/GST Remittance - Revenue Ireland,Tax Payment,ALL,125856.25,0,EUR,SWIFT MT103,Revenue Ireland,***7831,,,FALSE,FALSE,REF-322363,First Continental Bank,***4306,Globex EMEA Manufacturing Ltd.,IE,3455406.59
19/04/2024,19/04/2024,Supplier Payment - Stelliform Parts BV #10,Supplier Payment,CEM-EMEA,127896.87,0,EUR,SEPA Credit Transfer,Stelliform Parts BV #10,***5986,,PO-202404-CEM-EMEA-0007,FALSE,FALSE,REF-122356,First Continental Bank,***8864,Globex EMEA Manufacturing Ltd.,IE,3327509.72
19/04/2024,19/04/2024,Client Receipt - Aurora Electronics GmbH #10,Sales Receipt,CEM-EMEA,0,362733.4,EUR,SEPA SCT,Aurora Electronics GmbH #10,***8169,INV-202404-CEM-EMEA-0010,,FALSE,FALSE,REF-477587,First Continental Bank,***1871,Globex EMEA Manufacturing Ltd.,IE,3690243.12
20/04/2024,20/04/2024,BluePeak Property Mgmt,Rent & Utilities,ALL,9100.52,0,EUR,SEPA Credit Transfer,BluePeak Property Mgmt,***6382,,,FALSE,FALSE,REF-808065,First Continental Bank,***1263,Globex EMEA Manufacturing Ltd.,IE,3681142.6
20/04/2024,20/04/2024,Supplier Payment - HyperCloud Infra #3,Supplier Payment,SaaS-GL,24664.3,0,EUR,SEPA Debit,HyperCloud Infra #3,***7384,,PO-202404-SaaS-GL-0009,FALSE,FALSE,REF-105531,First Continental Bank,***6243,Globex EMEA Manufacturing Ltd.,IE,3656478.3
20/04/2024,20/04/2024,Supplier Payment - CodeCraft Contractors #2,Supplier Payment,SaaS-GL,28697.91,0,EUR,SWIFT MT103,CodeCraft Contractors #2,***5310,,PO-202404-SaaS-GL-0005,FALSE,FALSE,REF-426750,First Continental Bank,***3274,Globex EMEA Manufacturing Ltd.,IE,3627780.39
20/04/2024,20/04/2024,Client Receipt - CloudBridge Co. #70,Sales Receipt,SaaS-GL,0,267.65,EUR,SEPA SCT Inst,CloudBridge Co. #70,***1561,INV-202404-SaaS-GL-0023,,FALSE,FALSE,REF-294591,First Continental Bank,***9082,Globex EMEA Manufacturing Ltd.,IE,3628048.04
20/04/2024,20/04/2024,Client Receipt - CloudBridge Co. #3,Sales Receipt,SaaS-GL,0,23566.62,EUR,SEPA SCT Inst,CloudBridge Co. #3,***7931,INV-202404-SaaS-GL-0020,,FALSE,FALSE,REF-275213,First Continental Bank,***4376,Globex EMEA Manufacturing Ltd.,IE,3651614.66
21/04/2024,21/04/2024,Client Receipt - Aurora Electronics GmbH #4,Sales Receipt,CEM-EMEA,0,123261.08,EUR,SEPA SCT Inst,Aurora Electronics GmbH #4,***2594,INV-202404-CEM-EMEA-0008,,FALSE,FALSE,REF-880234,First Continental Bank,***6255,Globex EMEA Manufacturing Ltd.,IE,3774875.74
22/04/2024,22/04/2024,Supplier Payment - ExpertNet Subcontractors #19,Supplier Payment,PS-GL,5101.88,0,EUR,SWIFT MT103,ExpertNet Subcontractors #19,***9468,,PO-202404-PS-GL-0008,FALSE,FALSE,REF-504700,First Continental Bank,***9311,Globex EMEA Manufacturing Ltd.,IE,3769773.86
22/04/2024,22/04/2024,Supplier Payment - EuroFab Assembly #24,Supplier Payment,CEM-EMEA,34673.93,0,EUR,SWIFT MT103,EuroFab Assembly #24,***2083,,PO-202404-CEM-EMEA-0010,FALSE,FALSE,REF-951517,First Continental Bank,***5737,Globex EMEA Manufacturing Ltd.,IE,3735099.93
22/04/2024,22/04/2024,Client Receipt - CloudBridge Co. #49,Sales Receipt,SaaS-GL,0,26866.95,EUR,SEPA SCT,CloudBridge Co. #49,***7335,INV-202404-SaaS-GL-0024,,FALSE,FALSE,REF-348533,First Continental Bank,***3670,Globex EMEA Manufacturing Ltd.,IE,3761966.88
23/04/2024,23/04/2024,Supplier Payment - CodeCraft Contractors #9,Supplier Payment,SaaS-GL,3683.68,0,EUR,SEPA Debit,CodeCraft Contractors #9,***9734,,PO-202404-SaaS-GL-0004,FALSE,FALSE,REF-754892,First Continental Bank,***2707,Globex EMEA Manufacturing Ltd.,IE,3758283.2
23/04/2024,23/04/2024,Supplier Payment - CodeCraft Contractors #13,Supplier Payment,SaaS-GL,10489.66,0,EUR,SEPA Debit,CodeCraft Contractors #13,***8130,,PO-202404-SaaS-GL-0003,FALSE,FALSE,REF-961534,First Continental Bank,***3982,Globex EMEA Manufacturing Ltd.,IE,3747793.54
24/04/2024,24/04/2024,Merchant Processing Fees,Bank/Merchant Fees,ALL,4520.82,0,EUR,SWIFT MT103,First Continental Bank,***4791,,,FALSE,FALSE,REF-568141,First Continental Bank,***3535,Globex EMEA Manufacturing Ltd.,IE,3743272.72
24/04/2024,24/04/2024,Supplier Payment - ExpertNet Subcontractors #7,Supplier Payment,PS-GL,14340.25,0,EUR,SEPA Debit,ExpertNet Subcontractors #7,***9715,,PO-202404-PS-GL-0006,FALSE,FALSE,REF-326951,First Continental Bank,***7906,Globex EMEA Manufacturing Ltd.,IE,3728932.47
24/04/2024,24/04/2024,Supplier Payment - EuroFab Assembly #20,Supplier Payment,CEM-EMEA,80531.35,0,EUR,SEPA Credit Transfer,EuroFab Assembly #20,***5401,,PO-202404-CEM-EMEA-0008,FALSE,FALSE,REF-858565,First Continental Bank,***8659,Globex EMEA Manufacturing Ltd.,IE,3648401.12
24/04/2024,24/04/2024,Client Receipt - Vertex Advisory Client #52,Sales Receipt,PS-GL,0,4265.55,EUR,SEPA SCT Inst,Vertex Advisory Client #52,***5009,INV-202404-PS-GL-0006,,FALSE,FALSE,REF-940384,First Continental Bank,***6031,Globex EMEA Manufacturing Ltd.,IE,3652666.67
24/04/2024,24/04/2024,Client Receipt - Vertex Advisory Client #46,Sales Receipt,PS-GL,0,35673.96,EUR,SEPA SCT,Vertex Advisory Client #46,***4870,INV-202404-PS-GL-0009,,FALSE,FALSE,REF-689243,First Continental Bank,***6710,Globex EMEA Manufacturing Ltd.,IE,3688340.63
24/04/2024,24/04/2024,Client Receipt - CloudBridge Co. #57,Sales Receipt,SaaS-GL,0,58177.78,EUR,SEPA SCT Inst,CloudBridge Co. #57,***3770,INV-202404-SaaS-GL-0008,,FALSE,FALSE,REF-498175,First Continental Bank,***8983,Globex EMEA Manufacturing Ltd.,IE,3746518.41
25/04/2024,25/04/2024,Supplier Payment - HyperCloud Infra #19,Supplier Payment,SaaS-GL,16203.99,0,EUR,SWIFT MT103,HyperCloud Infra #19,***9057,,PO-202404-SaaS-GL-0006,FALSE,FALSE,REF-666788,First Continental Bank,***8548,Globex EMEA Manufacturing Ltd.,IE,3730314.42
25/04/2024,25/04/2024,Supplier Payment - Stelliform Parts BV #29,Supplier Payment,CEM-EMEA,18475.92,0,EUR,SEPA Debit,Stelliform Parts BV #29,***9724,,PO-202404-CEM-EMEA-0001,FALSE,FALSE,REF-716672,First Continental Bank,***8030,Globex EMEA Manufacturing Ltd.,IE,3711838.5
25/04/2024,25/04/2024,Client Receipt - CloudBridge Co. #51,Sales Receipt,SaaS-GL,0,1291.92,EUR,SEPA SCT,CloudBridge Co. #51,***1897,INV-202404-SaaS-GL-0015,,FALSE,FALSE,REF-893436,First Continental Bank,***4629,Globex EMEA Manufacturing Ltd.,IE,3713130.42
25/04/2024,25/04/2024,Client Receipt - Aurora Electronics GmbH #5,Sales Receipt,CEM-EMEA,0,14716.55,EUR,SEPA SCT,Aurora Electronics GmbH #5,***2119,INV-202404-CEM-EMEA-0002,,FALSE,FALSE,REF-698747,First Continental Bank,***2592,Globex EMEA Manufacturing Ltd.,IE,3727846.97
25/04/2024,25/04/2024,Client Receipt - Novatek Components Ltd #5,Sales Receipt,CEM-EMEA,0,56327.86,EUR,SEPA SCT,Novatek Components Ltd #5,***4882,INV-202404-CEM-EMEA-0004,,FALSE,FALSE,REF-713242,First Continental Bank,***8017,Globex EMEA Manufacturing Ltd.,IE,3784174.83
26/04/2024,26/04/2024,Supplier Payment - ExpertNet Subcontractors #19,Supplier Payment,PS-GL,18029.24,0,EUR,SEPA Credit Transfer,ExpertNet Subcontractors #19,***5875,,PO-202404-PS-GL-0002,FALSE,FALSE,REF-224693,First Continental Bank,***1985,Globex EMEA Manufacturing Ltd.,IE,3766145.59
26/04/2024,26/04/2024,Payroll - GlobalPay Services Ltd,Payroll,ALL,165036.64,0,EUR,SEPA Credit Transfer,GlobalPay Services Ltd,***2629,,,FALSE,FALSE,REF-508673,First Continental Bank,***9779,Globex EMEA Manufacturing Ltd.,IE,3601108.95
26/04/2024,26/04/2024,Intercompany Settlement - Globex APAC Logistics Pte. Ltd.,Intercompany Transfer,ALL,768508,0,EUR,Internal Transfer,Globex APAC Logistics Pte. Ltd.,***4391,,,TRUE,TRUE,REF-980081,First Continental Bank,***5625,Globex EMEA Manufacturing Ltd.,IE,2832600.95
26/04/2024,26/04/2024,Client Receipt - Aurora Electronics GmbH #6,Sales Receipt,CEM-EMEA,0,3970.34,EUR,SEPA SCT,Aurora Electronics GmbH #6,***9404,INV-202404-CEM-EMEA-0007,,FALSE,FALSE,REF-205326,First Continental Bank,***2288,Globex EMEA Manufacturing Ltd.,IE,2836571.29
28/04/2024,28/04/2024,Corporate Tax Estimate,Tax Payment,ALL,90243.21,0,EUR,SWIFT MT103,Revenue Ireland,***5434,,,FALSE,FALSE,REF-558580,First Continental Bank,***9261,Globex EMEA Manufacturing Ltd.,IE,2746328.08
29/04/2024,29/04/2024,Supplier Payment - CodeCraft Contractors #8,Supplier Payment,SaaS-GL,3067.71,0,EUR,SWIFT MT103,CodeCraft Contractors #8,***7380,,PO-202404-SaaS-GL-0007,FALSE,FALSE,REF-698153,First Continental Bank,***8789,Globex EMEA Manufacturing Ltd.,IE,2743260.37
29/04/2024,29/04/2024,Supplier Payment - HyperCloud Infra #17,Supplier Payment,SaaS-GL,8316.61,0,EUR,SEPA Debit,HyperCloud Infra #17,***3493,,PO-202404-SaaS-GL-0002,FALSE,FALSE,REF-724984,First Continental Bank,***9402,Globex EMEA Manufacturing Ltd.,IE,2734943.76
30/04/2024,30/04/2024,Payroll - GlobalPay Services Ltd,Payroll,ALL,165036.64,0,EUR,SEPA Debit,GlobalPay Services Ltd,***1862,,,FALSE,FALSE,REF-218952,First Continental Bank,***1019,Globex EMEA Manufacturing Ltd.,IE,2569907.12
30/04/2024,30/04/2024,Interest Earned,Interest Income,ALL,0,10514.9,EUR,SEPA SCT Inst,First Continental Bank,***6121,,,FALSE,FALSE,REF-364011,First Continental Bank,***5262,Globex EMEA Manufacturing Ltd.,IE,2580422.02
30/04/2024,30/04/2024,Client Receipt - CloudBridge Co. #41,Sales Receipt,SaaS-GL,0,16142.18,EUR,SEPA SCT Inst,CloudBridge Co. #41,***1905,INV-202404-SaaS-GL-0009,,FALSE,FALSE,REF-821297,First Continental Bank,***9764,Globex EMEA Manufacturing Ltd.,IE,2596564.2
30/04/2024,30/04/2024,Client Receipt - CloudBridge Co. #18,Sales Receipt,SaaS-GL,0,22987.53,EUR,SEPA SCT,CloudBridge Co. #18,***3182,INV-202404-SaaS-GL-0013,,FALSE,FALSE,REF-596253,First Continental Bank,***4354,Globex EMEA Manufacturing Ltd.,IE,2619551.73
30/04/2024,30/04/2024,Client Receipt - Vertex Advisory Client #26,Sales Receipt,PS-GL,0,44080.19,EUR,SEPA SCT,Vertex Advisory Client #26,***6617,INV-202404-PS-GL-0012,,FALSE,FALSE,REF-294178,First Continental Bank,***7090,Globex EMEA Manufacturing Ltd.,IE,2663631.92
01/05/2024,01/05/2024,Account Maintenance Fee,Bank/Merchant Fees,ALL,2500,0,EUR,SEPA Credit Transfer,First Continental Bank,***5007,,,FALSE,FALSE,REF-252557,First Continental Bank,***6193,Globex EMEA Manufacturing Ltd.,IE,2661131.92
01/05/2024,01/05/2024,Supplier Payment - ExpertNet Subcontractors #14,Supplier Payment,PS-GL,15401.97,0,EUR,SEPA Credit Transfer,ExpertNet Subcontractors #14,***7988,,PO-202405-PS-GL-0003,FALSE,FALSE,REF-108786,First Continental Bank,***1926,Globex EMEA Manufacturing Ltd.,IE,2645729.95
01/05/2024,01/05/2024,Client Receipt - Vertex Advisory Client #37,Sales Receipt,PS-GL,0,20162.87,EUR,SEPA SCT,Vertex Advisory Client #37,***7185,INV-202405-PS-GL-0001,,FALSE,FALSE,REF-807733,First Continental Bank,***6895,Globex EMEA Manufacturing Ltd.,IE,2665892.82
01/05/2024,01/05/2024,Client Receipt - Aurora Electronics GmbH #16,Sales Receipt,CEM-EMEA,0,48042.46,EUR,SEPA SCT,Aurora Electronics GmbH #16,***4548,INV-202405-CEM-EMEA-0002,,FALSE,FALSE,REF-100834,First Continental Bank,***6741,Globex EMEA Manufacturing Ltd.,IE,2713935.28
01/05/2024,01/05/2024,Client Receipt - Vertex Advisory Client #43,Sales Receipt,PS-GL,0,48305.03,EUR,SEPA SCT,Vertex Advisory Client #43,***3165,INV-202405-PS-GL-0005,,FALSE,FALSE,REF-928186,First Continental Bank,***4781,Globex EMEA Manufacturing Ltd.,IE,2762240.31
02/05/2024,02/05/2024,Supplier Payment - CodeCraft Contractors #9,Supplier Payment,SaaS-GL,3779.79,0,EUR,SEPA Debit,CodeCraft Contractors #9,***5260,,PO-202405-SaaS-GL-0008,FALSE,FALSE,REF-887765,First Continental Bank,***3923,Globex EMEA Manufacturing Ltd.,IE,2758460.52
03/05/2024,03/05/2024,Merchant Processing Fees,Bank/Merchant Fees,ALL,651.47,0,EUR,SWIFT MT103,First Continental Bank,***8693,,,FALSE,FALSE,REF-158436,First Continental Bank,***2939,Globex EMEA Manufacturing Ltd.,IE,2757809.05
03/05/2024,03/05/2024,Client Receipt - CloudBridge Co. #35,Sales Receipt,SaaS-GL,0,14903.33,EUR,SEPA SCT,CloudBridge Co. #35,***9077,INV-202405-SaaS-GL-0028,,FALSE,FALSE,REF-328222,First Continental Bank,***8559,Globex EMEA Manufacturing Ltd.,IE,2772712.38
03/05/2024,03/05/2024,Client Receipt - CloudBridge Co. #44,Sales Receipt,SaaS-GL,0,30936.59,EUR,SEPA SCT Inst,CloudBridge Co. #44,***9513,INV-202405-SaaS-GL-0020,,FALSE,FALSE,REF-387257,First Continental Bank,***2767,Globex EMEA Manufacturing Ltd.,IE,2803648.97
03/05/2024,03/05/2024,Client Receipt - Novatek Components Ltd #10,Sales Receipt,CEM-EMEA,0,43937.64,EUR,Card Settlement,Novatek Components Ltd #10,***6535,INV-202405-CEM-EMEA-0014,,FALSE,FALSE,REF-726596,First Continental Bank,***7362,Globex EMEA Manufacturing Ltd.,IE,2847586.61
04/05/2024,04/05/2024,Merchant Processing Fees,Bank/Merchant Fees,ALL,5714.29,0,EUR,SEPA Debit,First Continental Bank,***1947,,,FALSE,FALSE,REF-353859,First Continental Bank,***1614,Globex EMEA Manufacturing Ltd.,IE,2841872.32
04/05/2024,04/05/2024,Client Receipt - CloudBridge Co. #18,Sales Receipt,SaaS-GL,0,19215.47,EUR,SEPA SCT,CloudBridge Co. #18,***3926,INV-202405-SaaS-GL-0013,,FALSE,FALSE,REF-614233,First Continental Bank,***8076,Globex EMEA Manufacturing Ltd.,IE,2861087.79
04/05/2024,04/05/2024,Client Receipt - Aurora Electronics GmbH #14,Sales Receipt,CEM-EMEA,0,64766.78,EUR,SEPA SCT Inst,Aurora Electronics GmbH #14,***7201,INV-202405-CEM-EMEA-0003,,FALSE,FALSE,REF-164561,First Continental Bank,***1544,Globex EMEA Manufacturing Ltd.,IE,2925854.57
05/05/2024,05/05/2024,Supplier Payment - EuroFab Assembly #21,Supplier Payment,CEM-EMEA,40558.54,0,EUR,SWIFT MT103,EuroFab Assembly #21,***8009,,PO-202405-CEM-EMEA-0006,FALSE,FALSE,REF-802618,First Continental Bank,***2952,Globex EMEA Manufacturing Ltd.,IE,2885296.03
06/05/2024,06/05/2024,Supplier Payment - HyperCloud Infra #9,Supplier Payment,SaaS-GL,2185.67,0,EUR,SEPA Debit,HyperCloud Infra #9,***4410,,PO-202405-SaaS-GL-0005,FALSE,FALSE,REF-511804,First Continental Bank,***1283,Globex EMEA Manufacturing Ltd.,IE,2883110.36
06/05/2024,06/05/2024,Client Receipt - Novatek Components Ltd #5,Sales Receipt,CEM-EMEA,0,32303.44,EUR,SEPA SCT,Novatek Components Ltd #5,***8584,INV-202405-CEM-EMEA-0016,,FALSE,FALSE,REF-514226,First Continental Bank,***4872,Globex EMEA Manufacturing Ltd.,IE,2915413.8
06/05/2024,06/05/2024,Client Receipt - Vertex Advisory Client #32,Sales Receipt,PS-GL,0,69267.99,EUR,Card Settlement,Vertex Advisory Client #32,***3777,INV-202405-PS-GL-0011,,FALSE,FALSE,REF-378038,First Continental Bank,***6521,Globex EMEA Manufacturing Ltd.,IE,2984681.79
07/05/2024,07/05/2024,Client Receipt - CloudBridge Co. #74,Sales Receipt,SaaS-GL,0,40925.11,EUR,Card Settlement,CloudBridge Co. #74,***5173,INV-202405-SaaS-GL-0007,,FALSE,FALSE,REF-229065,First Continental Bank,***7649,Globex EMEA Manufacturing Ltd.,IE,3025606.9
07/05/2024,07/05/2024,Client Receipt - Novatek Components Ltd #12,Sales Receipt,CEM-EMEA,0,100768,EUR,Card Settlement,Novatek Components Ltd #12,***4136,INV-202405-CEM-EMEA-0013,,FALSE,FALSE,REF-812261,First Continental Bank,***2992,Globex EMEA Manufacturing Ltd.,IE,3126374.9
08/05/2024,08/05/2024,Supplier Payment - EuroFab Assembly #3,Supplier Payment,CEM-EMEA,29713.91,0,EUR,SWIFT MT103,EuroFab Assembly #3,***3501,,PO-202405-CEM-EMEA-0009,FALSE,FALSE,REF-604628,First Continental Bank,***7357,Globex EMEA Manufacturing Ltd.,IE,3096660.99
08/05/2024,08/05/2024,Supplier Payment - EuroFab Assembly #9,Supplier Payment,CEM-EMEA,58965.51,0,EUR,SEPA Debit,EuroFab Assembly #9,***3484,,PO-202405-CEM-EMEA-0005,FALSE,FALSE,REF-761053,First Continental Bank,***6357,Globex EMEA Manufacturing Ltd.,IE,3037695.48
08/05/2024,08/05/2024,Client Receipt - CloudBridge Co. #53,Sales Receipt,SaaS-GL,0,1510.54,EUR,SEPA SCT Inst,CloudBridge Co. #53,***9530,INV-202405-SaaS-GL-0030,,FALSE,FALSE,REF-141890,First Continental Bank,***5995,Globex EMEA Manufacturing Ltd.,IE,3039206.02
08/05/2024,08/05/2024,Client Receipt - CloudBridge Co. #19,Sales Receipt,SaaS-GL,0,16089.12,EUR,Card Settlement,CloudBridge Co. #19,***7313,INV-202405-SaaS-GL-0003,,FALSE,FALSE,REF-334576,First Continental Bank,***9736,Globex EMEA Manufacturing Ltd.,IE,3055295.14
08/05/2024,08/05/2024,Client Receipt - CloudBridge Co. #58,Sales Receipt,SaaS-GL,0,36780.35,EUR,SEPA SCT Inst,CloudBridge Co. #58,***4149,INV-202405-SaaS-GL-0011,,FALSE,FALSE,REF-778333,First Continental Bank,***6354,Globex EMEA Manufacturing Ltd.,IE,3092075.49
08/05/2024,08/05/2024,Client Receipt - Aurora Electronics GmbH #19,Sales Receipt,CEM-EMEA,0,59747.52,EUR,SEPA SCT,Aurora Electronics GmbH #19,***9307,INV-202405-CEM-EMEA-0015,,FALSE,FALSE,REF-768176,First Continental Bank,***3153,Globex EMEA Manufacturing Ltd.,IE,3151823.01
09/05/2024,09/05/2024,Supplier Payment - ExpertNet Subcontractors #2,Supplier Payment,PS-GL,2617.34,0,EUR,SWIFT MT103,ExpertNet Subcontractors #2,***6304,,PO-202405-PS-GL-0001,FALSE,FALSE,REF-635699,First Continental Bank,***2363,Globex EMEA Manufacturing Ltd.,IE,3149205.67
09/05/2024,09/05/2024,Supplier Payment - EuroFab Assembly #10,Supplier Payment,CEM-EMEA,9660.72,0,EUR,SEPA Credit Transfer,EuroFab Assembly #10,***4298,,PO-202405-CEM-EMEA-0008,FALSE,FALSE,REF-248352,First Continental Bank,***7716,Globex EMEA Manufacturing Ltd.,IE,3139544.95
09/05/2024,09/05/2024,Supplier Payment - Stelliform Parts BV #2,Supplier Payment,CEM-EMEA,135232.76,0,EUR,SWIFT MT103,Stelliform Parts BV #2,***2496,,PO-202405-CEM-EMEA-0003,FALSE,FALSE,REF-837427,First Continental Bank,***4876,Globex EMEA Manufacturing Ltd.,IE,3004312.19
09/05/2024,09/05/2024,Client Receipt - CloudBridge Co. #70,Sales Receipt,SaaS-GL,0,3562.75,EUR,SEPA SCT Inst,CloudBridge Co. #70,***1221,INV-202405-SaaS-GL-0002,,FALSE,FALSE,REF-972284,First Continental Bank,***5907,Globex EMEA Manufacturing Ltd.,IE,3007874.94
10/05/2024,10/05/2024,Supplier Payment - ExpertNet Subcontractors #1,Supplier Payment,PS-GL,2416.07,0,EUR,SWIFT MT103,ExpertNet Subcontractors #1,***8017,,PO-202405-PS-GL-0010,FALSE,FALSE,REF-377204,First Continental Bank,***6365,Globex EMEA Manufacturing Ltd.,IE,3005458.87
10/05/2024,10/05/2024,Skyline Internet Services,Rent & Utilities,ALL,13181.17,0,EUR,SWIFT MT103,Skyline Internet Services,***3970,,,FALSE,FALSE,REF-294713,First Continental Bank,***1070,Globex EMEA Manufacturing Ltd.,IE,2992277.7
10/05/2024,10/05/2024,Marketing - Aurelia Media #2,Marketing,ALL,16954.55,0,EUR,SWIFT MT103,Aurelia Media #2,***9471,,,FALSE,FALSE,REF-288755,First Continental Bank,***5420,Globex EMEA Manufacturing Ltd.,IE,2975323.15
10/05/2024,10/05/2024,Client Receipt - CloudBridge Co. #26,Sales Receipt,SaaS-GL,0,15111.09,EUR,SEPA SCT,CloudBridge Co. #26,***9845,INV-202405-SaaS-GL-0015,,FALSE,FALSE,REF-986842,First Continental Bank,***8813,Globex EMEA Manufacturing Ltd.,IE,2990434.24
10/05/2024,10/05/2024,Client Receipt - Vertex Advisory Client #14,Sales Receipt,PS-GL,0,17240.97,EUR,SEPA SCT,Vertex Advisory Client #14,***4332,INV-202405-PS-GL-0006,,FALSE,FALSE,REF-759019,First Continental Bank,***8933,Globex EMEA Manufacturing Ltd.,IE,3007675.21
11/05/2024,11/05/2024,Supplier Payment - HyperCloud Infra #13,Supplier Payment,SaaS-GL,29748.75,0,EUR,SEPA Debit,HyperCloud Infra #13,***9423,,PO-202405-SaaS-GL-0001,FALSE,FALSE,REF-358662,First Continental Bank,***5167,Globex EMEA Manufacturing Ltd.,IE,2977926.46
11/05/2024,11/05/2024,Client Receipt - CloudBridge Co. #20,Sales Receipt,SaaS-GL,0,27686.81,EUR,SEPA SCT,CloudBridge Co. #20,***1401,INV-202405-SaaS-GL-0029,,FALSE,FALSE,REF-165392,First Continental Bank,***9917,Globex EMEA Manufacturing Ltd.,IE,3005613.27
12/05/2024,12/05/2024,Supplier Payment - ExpertNet Subcontractors #6,Supplier Payment,PS-GL,1026.37,0,EUR,SWIFT MT103,ExpertNet Subcontractors #6,***1198,,PO-202405-PS-GL-0011,FALSE,FALSE,REF-141150,First Continental Bank,***5437,Globex EMEA Manufacturing Ltd.,IE,3004586.9
12/05/2024,12/05/2024,Intercompany Settlement - Globex Retail NA LLC,Intercompany Transfer,ALL,367160,0,EUR,Internal Transfer,Globex Retail NA LLC,***8670,,,TRUE,TRUE,REF-664834,First Continental Bank,***2290,Globex EMEA Manufacturing Ltd.,IE,2637426.9
12/05/2024,12/05/2024,Intercompany Reimbursement - Globex Retail NA LLC,Intercompany Transfer,ALL,0,146864,EUR,Internal Transfer,Globex Retail NA LLC,***7209,,,TRUE,TRUE,REF-771555,First Continental Bank,***8610,Globex EMEA Manufacturing Ltd.,IE,2784290.9
13/05/2024,13/05/2024,Client Receipt - CloudBridge Co. #13,Sales Receipt,SaaS-GL,0,2340.87,EUR,Card Settlement,CloudBridge Co. #13,***3377,INV-202405-SaaS-GL-0022,,FALSE,FALSE,REF-295870,First Continental Bank,***4980,Globex EMEA Manufacturing Ltd.,IE,2786631.77
13/05/2024,13/05/2024,Client Receipt - Vertex Advisory Client #4,Sales Receipt,PS-GL,0,5977.54,EUR,SEPA SCT Inst,Vertex Advisory Client #4,***5957,INV-202405-PS-GL-0002,,FALSE,FALSE,REF-788191,First Continental Bank,***7261,Globex EMEA Manufacturing Ltd.,IE,2792609.31
14/05/2024,14/05/2024,Supplier Payment - HyperCloud Infra #4,Supplier Payment,SaaS-GL,10529.61,0,EUR,SEPA Debit,HyperCloud Infra #4,***6137,,PO-202405-SaaS-GL-0002,FALSE,FALSE,REF-926029,First Continental Bank,***2003,Globex EMEA Manufacturing Ltd.,IE,2782079.7
14/05/2024,14/05/2024,Client Receipt - CloudBridge Co. #12,Sales Receipt,SaaS-GL,0,2812.26,EUR,SEPA SCT,CloudBridge Co. #12,***4106,INV-202405-SaaS-GL-0017,,FALSE,FALSE,REF-806772,First Continental Bank,***9958,Globex EMEA Manufacturing Ltd.,IE,2784891.96
14/05/2024,14/05/2024,Client Receipt - CloudBridge Co. #43,Sales Receipt,SaaS-GL,0,8032.45,EUR,SEPA SCT,CloudBridge Co. #43,***2552,INV-202405-SaaS-GL-0026,,FALSE,FALSE,REF-619173,First Continental Bank,***3811,Globex EMEA Manufacturing Ltd.,IE,2792924.41
14/05/2024,14/05/2024,Client Receipt - Aurora Electronics GmbH #15,Sales Receipt,CEM-EMEA,0,48103.77,EUR,SEPA SCT,Aurora Electronics GmbH #15,***1474,INV-202405-CEM-EMEA-0005,,FALSE,FALSE,REF-949967,First Continental Bank,***1263,Globex EMEA Manufacturing Ltd.,IE,2841028.18
15/05/2024,15/05/2024,Supplier Payment - ExpertNet Subcontractors #2,Supplier Payment,PS-GL,1172,0,EUR,SEPA Credit Transfer,ExpertNet Subcontractors #2,***5687,,PO-202405-PS-GL-0007,FALSE,FALSE,REF-472032,First Continental Bank,***4426,Globex EMEA Manufacturing Ltd.,IE,2839856.18
15/05/2024,15/05/2024,Supplier Payment - Stelliform Parts BV #24,Supplier Payment,CEM-EMEA,13092.9,0,EUR,SEPA Debit,Stelliform Parts BV #24,***7725,,PO-202405-CEM-EMEA-0012,FALSE,FALSE,REF-155336,First Continental Bank,***3495,Globex EMEA Manufacturing Ltd.,IE,2826763.28
15/05/2024,15/05/2024,Supplier Payment - Stelliform Parts BV #6,Supplier Payment,CEM-EMEA,15802.05,0,EUR,SEPA Credit Transfer,Stelliform Parts BV #6,***7994,,PO-202405-CEM-EMEA-0002,FALSE,FALSE,REF-129189,First Continental Bank,***6074,Globex EMEA Manufacturing Ltd.,IE,2810961.23
15/05/2024,15/05/2024,Supplier Payment - EuroFab Assembly #3,Supplier Payment,CEM-EMEA,41152.27,0,EUR,SEPA Debit,EuroFab Assembly #3,***8862,,PO-202405-CEM-EMEA-0010,FALSE,FALSE,REF-759356,First Continental Bank,***8048,Globex EMEA Manufacturing Ltd.,IE,2769808.96
15/05/2024,15/05/2024,Loan Interest Payment,Loan Interest,ALL,85000,0,EUR,SEPA Debit,First Continental Bank - Corporate Lending,***8912,,,FALSE,FALSE,REF-789029,First Continental Bank,***1994,Globex EMEA Manufacturing Ltd.,IE,2684808.96
15/05/2024,15/05/2024,Supplier Payment - EuroFab Assembly #2,Supplier Payment,CEM-EMEA,145990.5,0,EUR,SEPA Debit,EuroFab Assembly #2,***4720,,PO-202405-CEM-EMEA-0001,FALSE,FALSE,REF-843628,First Continental Bank,***4321,Globex EMEA Manufacturing Ltd.,IE,2538818.46
15/05/2024,15/05/2024,Loan Principal Repayment,Loan Principal,ALL,500000,0,EUR,SEPA Credit Transfer,First Continental Bank - Corporate Lending,***9712,,,FALSE,FALSE,REF-765784,First Continental Bank,***7976,Globex EMEA Manufacturing Ltd.,IE,2038818.46
15/05/2024,15/05/2024,Client Receipt - CloudBridge Co. #77,Sales Receipt,SaaS-GL,0,107872.1,EUR,SEPA SCT Inst,CloudBridge Co. #77,***6334,INV-202405-SaaS-GL-0012,,FALSE,FALSE,REF-297106,First Continental Bank,***3836,Globex EMEA Manufacturing Ltd.,IE,2146690.56
16/05/2024,16/05/2024,Supplier Payment - CodeCraft Contractors #7,Supplier Payment,SaaS-GL,12060.81,0,EUR,SEPA Debit,CodeCraft Contractors #7,***6404,,PO-202405-SaaS-GL-0003,FALSE,FALSE,REF-355893,First Continental Bank,***1667,Globex EMEA Manufacturing Ltd.,IE,2134629.75
16/05/2024,16/05/2024,Client Receipt - CloudBridge Co. #18,Sales Receipt,SaaS-GL,0,21108.18,EUR,SEPA SCT,CloudBridge Co. #18,***3255,INV-202405-SaaS-GL-0031,,FALSE,FALSE,REF-910209,First Continental Bank,***4361,Globex EMEA Manufacturing Ltd.,IE,2155737.93
16/05/2024,16/05/2024,Client Receipt - Aurora Electronics GmbH #18,Sales Receipt,CEM-EMEA,0,74132.05,EUR,SEPA SCT Inst,Aurora Electronics GmbH #18,***7176,INV-202405-CEM-EMEA-0011,,FALSE,FALSE,REF-348923,First Continental Bank,***4493,Globex EMEA Manufacturing Ltd.,IE,2229869.98
17/05/2024,17/05/2024,Supplier Payment - HyperCloud Infra #17,Supplier Payment,SaaS-GL,20062.38,0,EUR,SWIFT MT103,HyperCloud Infra #17,***3904,,PO-202405-SaaS-GL-0006,FALSE,FALSE,REF-962889,First Continental Bank,***2465,Globex EMEA Manufacturing Ltd.,IE,2209807.6
17/05/2024,17/05/2024,Client Receipt - Aurora Electronics GmbH #13,Sales Receipt,CEM-EMEA,0,4991.97,EUR,SEPA SCT,Aurora Electronics GmbH #13,***1791,INV-202405-CEM-EMEA-0009,,FALSE,FALSE,REF-794239,First Continental Bank,***3261,Globex EMEA Manufacturing Ltd.,IE,2214799.57
17/05/2024,17/05/2024,Client Receipt - CloudBridge Co. #70,Sales Receipt,SaaS-GL,0,5819.04,EUR,SEPA SCT Inst,CloudBridge Co. #70,***2154,INV-202405-SaaS-GL-0008,,FALSE,FALSE,REF-814270,First Continental Bank,***9713,Globex EMEA Manufacturing Ltd.,IE,2220618.61
17/05/2024,17/05/2024,Client Receipt - CloudBridge Co. #20,Sales Receipt,SaaS-GL,0,29905.16,EUR,SEPA SCT,CloudBridge Co. #20,***7274,INV-202405-SaaS-GL-0024,,FALSE,FALSE,REF-944856,First Continental Bank,***1243,Globex EMEA Manufacturing Ltd.,IE,2250523.77
17/05/2024,17/05/2024,Client Receipt - Vertex Advisory Client #42,Sales Receipt,PS-GL,0,96400.38,EUR,SEPA SCT,Vertex Advisory Client #42,***5816,INV-202405-PS-GL-0009,,FALSE,FALSE,REF-381389,First Continental Bank,***1839,Globex EMEA Manufacturing Ltd.,IE,2346924.15
18/05/2024,18/05/2024,Supplier Payment - Stelliform Parts BV #30,Supplier Payment,CEM-EMEA,56675.28,0,EUR,SEPA Debit,Stelliform Parts BV #30,***2116,,PO-202405-CEM-EMEA-0004,FALSE,FALSE,REF-392098,First Continental Bank,***9097,Globex EMEA Manufacturing Ltd.,IE,2290248.87
19/05/2024,19/05/2024,Supplier Payment - ExpertNet Subcontractors #3,Supplier Payment,PS-GL,995.61,0,EUR,SEPA Debit,ExpertNet Subcontractors #3,***1361,,PO-202405-PS-GL-0002,FALSE,FALSE,REF-829713,First Continental Bank,***5089,Globex EMEA Manufacturing Ltd.,IE,2289253.26
19/05/2024,19/05/2024,Supplier Payment - Stelliform Parts BV #32,Supplier Payment,CEM-EMEA,53923.19,0,EUR,SWIFT MT103,Stelliform Parts BV #32,***1614,,PO-202405-CEM-EMEA-0007,FALSE,FALSE,REF-147790,First Continental Bank,***9234,Globex EMEA Manufacturing Ltd.,IE,2235330.07
19/05/2024,19/05/2024,VAT/GST Remittance - Revenue Ireland,Tax Payment,ALL,124857.02,0,EUR,SWIFT MT103,Revenue Ireland,***3402,,,FALSE,FALSE,REF-846361,First Continental Bank,***4691,Globex EMEA Manufacturing Ltd.,IE,2110473.05
20/05/2024,20/05/2024,Supplier Payment - HyperCloud Infra #5,Supplier Payment,SaaS-GL,27748.47,0,EUR,SWIFT MT103,HyperCloud Infra #5,***5315,,PO-202405-SaaS-GL-0007,FALSE,FALSE,REF-868277,First Continental Bank,***6575,Globex EMEA Manufacturing Ltd.,IE,2082724.58
20/05/2024,20/05/2024,Client Receipt - CloudBridge Co. #3,Sales Receipt,SaaS-GL,0,12220.04,EUR,Card Settlement,CloudBridge Co. #3,***5114,INV-202405-SaaS-GL-0001,,FALSE,FALSE,REF-983804,First Continental Bank,***4905,Globex EMEA Manufacturing Ltd.,IE,2094944.62
20/05/2024,20/05/2024,Client Receipt - CloudBridge Co. #33,Sales Receipt,SaaS-GL,0,15083.97,EUR,Card Settlement,CloudBridge Co. #33,***6065,INV-202405-SaaS-GL-0009,,FALSE,FALSE,REF-107972,First Continental Bank,***2569,Globex EMEA Manufacturing Ltd.,IE,2110028.59
20/05/2024,20/05/2024,Client Receipt - Novatek Components Ltd #12,Sales Receipt,CEM-EMEA,0,39322.09,EUR,SEPA SCT Inst,Novatek Components Ltd #12,***4040,INV-202405-CEM-EMEA-0017,,FALSE,FALSE,REF-814687,First Continental Bank,***5483,Globex EMEA Manufacturing Ltd.,IE,2149350.68
21/05/2024,21/05/2024,Client Receipt - CloudBridge Co. #8,Sales Receipt,SaaS-GL,0,3403.04,EUR,SEPA SCT,CloudBridge Co. #8,***9685,INV-202405-SaaS-GL-0010,,FALSE,FALSE,REF-823448,First Continental Bank,***3239,Globex EMEA Manufacturing Ltd.,IE,2152753.72
21/05/2024,21/05/2024,Client Receipt - Vertex Advisory Client #36,Sales Receipt,PS-GL,0,33240.73,EUR,SEPA SCT,Vertex Advisory Client #36,***4746,INV-202405-PS-GL-0007,,FALSE,FALSE,REF-557368,First Continental Bank,***7490,Globex EMEA Manufacturing Ltd.,IE,2185994.45
21/05/2024,21/05/2024,Client Receipt - CloudBridge Co. #35,Sales Receipt,SaaS-GL,0,38019.82,EUR,Card Settlement,CloudBridge Co. #35,***3987,INV-202405-SaaS-GL-0004,,FALSE,FALSE,REF-825901,First Continental Bank,***1111,Globex EMEA Manufacturing Ltd.,IE,2224014.27
22/05/2024,22/05/2024,Supplier Payment - CodeCraft Contractors #4,Supplier Payment,SaaS-GL,3275.19,0,EUR,SWIFT MT103,CodeCraft Contractors #4,***6701,,PO-202405-SaaS-GL-0011,FALSE,FALSE,REF-872166,First Continental Bank,***7996,Globex EMEA Manufacturing Ltd.,IE,2220739.08
22/05/2024,22/05/2024,Supplier Payment - ExpertNet Subcontractors #6,Supplier Payment,PS-GL,6567.43,0,EUR,SEPA Debit,ExpertNet Subcontractors #6,***5493,,PO-202405-PS-GL-0009,FALSE,FALSE,REF-596995,First Continental Bank,***6036,Globex EMEA Manufacturing Ltd.,IE,2214171.65
22/05/2024,22/05/2024,Client Receipt - CloudBridge Co. #72,Sales Receipt,SaaS-GL,0,7316.28,EUR,Card Settlement,CloudBridge Co. #72,***1038,INV-202405-SaaS-GL-0019,,FALSE,FALSE,REF-906187,First Continental Bank,***1955,Globex EMEA Manufacturing Ltd.,IE,2221487.93
22/05/2024,22/05/2024,Client Receipt - CloudBridge Co. #64,Sales Receipt,SaaS-GL,0,16758.28,EUR,Card Settlement,CloudBridge Co. #64,***1686,INV-202405-SaaS-GL-0018,,FALSE,FALSE,REF-572527,First Continental Bank,***8923,Globex EMEA Manufacturing Ltd.,IE,2238246.21
22/05/2024,22/05/2024,Client Receipt - Aurora Electronics GmbH #3,Sales Receipt,CEM-EMEA,0,34168.17,EUR,Card Settlement,Aurora Electronics GmbH #3,***5896,INV-202405-CEM-EMEA-0001,,FALSE,FALSE,REF-159270,First Continental Bank,***2923,Globex EMEA Manufacturing Ltd.,IE,2272414.38
23/05/2024,23/05/2024,Client Receipt - CloudBridge Co. #45,Sales Receipt,SaaS-GL,0,7879.04,EUR,SEPA SCT,CloudBridge Co. #45,***5638,INV-202405-SaaS-GL-0021,,FALSE,FALSE,REF-143840,First Continental Bank,***7557,Globex EMEA Manufacturing Ltd.,IE,2280293.42
23/05/2024,23/05/2024,Client Receipt - CloudBridge Co. #42,Sales Receipt,SaaS-GL,0,45243.78,EUR,SEPA SCT Inst,CloudBridge Co. #42,***7116,INV-202405-SaaS-GL-0023,,FALSE,FALSE,REF-962818,First Continental Bank,***3006,Globex EMEA Manufacturing Ltd.,IE,2325537.2
23/05/2024,23/05/2024,Client Receipt - Vertex Advisory Client #18,Sales Receipt,PS-GL,0,86285.63,EUR,Card Settlement,Vertex Advisory Client #18,***7816,INV-202405-PS-GL-0004,,FALSE,FALSE,REF-775348,First Continental Bank,***9105,Globex EMEA Manufacturing Ltd.,IE,2411822.83
23/05/2024,23/05/2024,Client Receipt - Aurora Electronics GmbH #9,Sales Receipt,CEM-EMEA,0,167875.71,EUR,Card Settlement,Aurora Electronics GmbH #9,***2304,INV-202405-CEM-EMEA-0012,,FALSE,FALSE,REF-850898,First Continental Bank,***9681,Globex EMEA Manufacturing Ltd.,IE,2579698.54
24/05/2024,24/05/2024,Supplier Payment - CodeCraft Contractors #14,Supplier Payment,SaaS-GL,22865.54,0,EUR,SEPA Credit Transfer,CodeCraft Contractors #14,***7519,,PO-202405-SaaS-GL-0009,FALSE,FALSE,REF-506946,First Continental Bank,***8441,Globex EMEA Manufacturing Ltd.,IE,2556833
24/05/2024,24/05/2024,Client Receipt - CloudBridge Co. #46,Sales Receipt,SaaS-GL,0,9569.45,EUR,Card Settlement,CloudBridge Co. #46,***5983,INV-202405-SaaS-GL-0006,,FALSE,FALSE,REF-428149,First Continental Bank,***1927,Globex EMEA Manufacturing Ltd.,IE,2566402.45
25/05/2024,25/05/2024,Supplier Payment - HyperCloud Infra #2,Supplier Payment,SaaS-GL,10809.74,0,EUR,SEPA Credit Transfer,HyperCloud Infra #2,***9934,,PO-202405-SaaS-GL-0004,FALSE,FALSE,REF-711650,First Continental Bank,***2782,Globex EMEA Manufacturing Ltd.,IE,2555592.71
25/05/2024,25/05/2024,Payroll - GlobalPay Services Ltd,Payroll,ALL,166705.94,0,EUR,SWIFT MT103,GlobalPay Services Ltd,***7413,,,FALSE,FALSE,REF-647626,First Continental Bank,***3740,Globex EMEA Manufacturing Ltd.,IE,2388886.77
25/05/2024,25/05/2024,Client Receipt - Vertex Advisory Client #27,Sales Receipt,PS-GL,0,11335.35,EUR,SEPA SCT,Vertex Advisory Client #27,***3509,INV-202405-PS-GL-0003,,FALSE,FALSE,REF-765204,First Continental Bank,***6160,Globex EMEA Manufacturing Ltd.,IE,2400222.12
25/05/2024,25/05/2024,Client Receipt - Novatek Components Ltd #12,Sales Receipt,CEM-EMEA,0,16557.89,EUR,Card Settlement,Novatek Components Ltd #12,***9274,INV-202405-CEM-EMEA-0008,,FALSE,FALSE,REF-169028,First Continental Bank,***6963,Globex EMEA Manufacturing Ltd.,IE,2416780.01
26/05/2024,26/05/2024,Supplier Payment - HyperCloud Infra #15,Supplier Payment,SaaS-GL,2644.73,0,EUR,SEPA Credit Transfer,HyperCloud Infra #15,***4814,,PO-202405-SaaS-GL-0010,FALSE,FALSE,REF-902766,First Continental Bank,***5785,Globex EMEA Manufacturing Ltd.,IE,2414135.28
26/05/2024,26/05/2024,Supplier Payment - ExpertNet Subcontractors #7,Supplier Payment,PS-GL,6635.99,0,EUR,SWIFT MT103,ExpertNet Subcontractors #7,***1536,,PO-202405-PS-GL-0008,FALSE,FALSE,REF-429493,First Continental Bank,***6867,Globex EMEA Manufacturing Ltd.,IE,2407499.29
26/05/2024,26/05/2024,Intercompany Settlement - Globex Consulting UK Ltd.,Intercompany Transfer,ALL,718861,0,EUR,Internal Transfer,Globex Consulting UK Ltd.,***3498,,,TRUE,TRUE,REF-518003,First Continental Bank,***2951,Globex EMEA Manufacturing Ltd.,IE,1688638.29
27/05/2024,27/05/2024,Supplier Payment - ExpertNet Subcontractors #4,Supplier Payment,PS-GL,13937.21,0,EUR,SWIFT MT103,ExpertNet Subcontractors #4,***7298,,PO-202405-PS-GL-0006,FALSE,FALSE,REF-476878,First Continental Bank,***6792,Globex EMEA Manufacturing Ltd.,IE,1674701.08
27/05/2024,27/05/2024,Client Receipt - CloudBridge Co. #79,Sales Receipt,SaaS-GL,0,6582.4,EUR,SEPA SCT,CloudBridge Co. #79,***6232,INV-202405-SaaS-GL-0016,,FALSE,FALSE,REF-218483,First Continental Bank,***5394,Globex EMEA Manufacturing Ltd.,IE,1681283.48
27/05/2024,27/05/2024,Client Receipt - CloudBridge Co. #17,Sales Receipt,SaaS-GL,0,50834.23,EUR,SEPA SCT Inst,CloudBridge Co. #17,***9639,INV-202405-SaaS-GL-0025,,FALSE,FALSE,REF-797809,First Continental Bank,***9856,Globex EMEA Manufacturing Ltd.,IE,1732117.71
28/05/2024,28/05/2024,Client Receipt - CloudBridge Co. #30,Sales Receipt,SaaS-GL,0,13686.89,EUR,SEPA SCT Inst,CloudBridge Co. #30,***3010,INV-202405-SaaS-GL-0014,,FALSE,FALSE,REF-129314,First Continental Bank,***5986,Globex EMEA Manufacturing Ltd.,IE,1745804.6
28/05/2024,28/05/2024,Client Receipt - Aurora Electronics GmbH #18,Sales Receipt,CEM-EMEA,0,31397.91,EUR,Card Settlement,Aurora Electronics GmbH #18,***7526,INV-202405-CEM-EMEA-0007,,FALSE,FALSE,REF-615261,First Continental Bank,***6215,Globex EMEA Manufacturing Ltd.,IE,1777202.51
28/05/2024,28/05/2024,Client Receipt - Novatek Components Ltd #8,Sales Receipt,CEM-EMEA,0,125192.06,EUR,Card Settlement,Novatek Components Ltd #8,***6531,INV-202405-CEM-EMEA-0004,,FALSE,FALSE,REF-519658,First Continental Bank,***9650,Globex EMEA Manufacturing Ltd.,IE,1902394.57
29/05/2024,29/05/2024,Alphagrid Utilities,Rent & Utilities,ALL,4082.16,0,EUR,SEPA Credit Transfer,Alphagrid Utilities,***9689,,,FALSE,FALSE,REF-248794,First Continental Bank,***7769,Globex EMEA Manufacturing Ltd.,IE,1898312.41
29/05/2024,29/05/2024,Marketing - Aurelia Media #7,Marketing,ALL,35582.24,0,EUR,SWIFT MT103,Aurelia Media #7,***2757,,,FALSE,FALSE,REF-801295,First Continental Bank,***2096,Globex EMEA Manufacturing Ltd.,IE,1862730.17
29/05/2024,29/05/2024,Client Receipt - Aurora Electronics GmbH #14,Sales Receipt,CEM-EMEA,0,103758,EUR,SEPA SCT Inst,Aurora Electronics GmbH #14,***1838,INV-202405-CEM-EMEA-0006,,FALSE,FALSE,REF-541264,First Continental Bank,***7098,Globex EMEA Manufacturing Ltd.,IE,1966488.17
30/05/2024,30/05/2024,Supplier Payment - Stelliform Parts BV #33,Supplier Payment,CEM-EMEA,17398.9,0,EUR,SEPA Debit,Stelliform Parts BV #33,***5647,,PO-202405-CEM-EMEA-0011,FALSE,FALSE,REF-905081,First Continental Bank,***1612,Globex EMEA Manufacturing Ltd.,IE,1949089.27
30/05/2024,30/05/2024,Supplier Payment - ExpertNet Subcontractors #7,Supplier Payment,PS-GL,26341.96,0,EUR,SEPA Debit,ExpertNet Subcontractors #7,***4148,,PO-202405-PS-GL-0005,FALSE,FALSE,REF-276024,First Continental Bank,***1489,Globex EMEA Manufacturing Ltd.,IE,1922747.31
30/05/2024,30/05/2024,Payroll - GlobalPay Services Ltd,Payroll,ALL,166705.94,0,EUR,SWIFT MT103,GlobalPay Services Ltd,***2816,,,FALSE,FALSE,REF-552122,First Continental Bank,***1423,Globex EMEA Manufacturing Ltd.,IE,1756041.37
30/05/2024,30/05/2024,Interest Earned,Interest Income,ALL,0,11593.24,EUR,SEPA SCT Inst,First Continental Bank,***6273,,,FALSE,FALSE,REF-845793,First Continental Bank,***6281,Globex EMEA Manufacturing Ltd.,IE,1767634.61
30/05/2024,30/05/2024,Client Receipt - Vertex Advisory Client #3,Sales Receipt,PS-GL,0,17619.71,EUR,Card Settlement,Vertex Advisory Client #3,***1901,INV-202405-PS-GL-0008,,FALSE,FALSE,REF-169026,First Continental Bank,***9347,Globex EMEA Manufacturing Ltd.,IE,1785254.32
30/05/2024,30/05/2024,Client Receipt - Novatek Components Ltd #8,Sales Receipt,CEM-EMEA,0,35212.08,EUR,Card Settlement,Novatek Components Ltd #8,***2765,INV-202405-CEM-EMEA-0010,,FALSE,FALSE,REF-702498,First Continental Bank,***9159,Globex EMEA Manufacturing Ltd.,IE,1820466.4
31/05/2024,31/05/2024,Supplier Payment - ExpertNet Subcontractors #10,Supplier Payment,PS-GL,55352.31,0,EUR,SWIFT MT103,ExpertNet Subcontractors #10,***8023,,PO-202405-PS-GL-0004,FALSE,FALSE,REF-207001,First Continental Bank,***3749,Globex EMEA Manufacturing Ltd.,IE,1765114.09
31/05/2024,31/05/2024,Client Receipt - CloudBridge Co. #75,Sales Receipt,SaaS-GL,0,15461.28,EUR,Card Settlement,CloudBridge Co. #75,***4789,INV-202405-SaaS-GL-0005,,FALSE,FALSE,REF-454487,First Continental Bank,***4676,Globex EMEA Manufacturing Ltd.,IE,1780575.37
31/05/2024,31/05/2024,Client Receipt - CloudBridge Co. #36,Sales Receipt,SaaS-GL,0,35651.56,EUR,SEPA SCT Inst,CloudBridge Co. #36,***3223,INV-202405-SaaS-GL-0027,,FALSE,FALSE,REF-424772,First Continental Bank,***7864,Globex EMEA Manufacturing Ltd.,IE,1816226.93
31/05/2024,31/05/2024,Client Receipt - Vertex Advisory Client #34,Sales Receipt,PS-GL,0,35711.32,EUR,SEPA SCT,Vertex Advisory Client #34,***7357,INV-202405-PS-GL-0010,,FALSE,FALSE,REF-299868,First Continental Bank,***5715,Globex EMEA Manufacturing Ltd.,IE,1851938.25
01/06/2024,01/06/2024,Account Maintenance Fee,Bank/Merchant Fees,ALL,2500,0,EUR,SEPA Credit Transfer,First Continental Bank,***4321,,,FALSE,FALSE,REF-868882,First Continental Bank,***7324,Globex EMEA Manufacturing Ltd.,IE,1849438.25
02/06/2024,02/06/2024,Skyline Internet Services,Rent & Utilities,ALL,16877.18,0,EUR,SEPA Debit,Skyline Internet Services,***3829,,,FALSE,FALSE,REF-296541,First Continental Bank,***5484,Globex EMEA Manufacturing Ltd.,IE,1832561.07
02/06/2024,02/06/2024,Client Receipt - Aurora Electronics GmbH #1,Sales Receipt,CEM-EMEA,0,18372.28,EUR,SEPA SCT Inst,Aurora Electronics GmbH #1,***5399,INV-202406-CEM-EMEA-0003,,FALSE,FALSE,REF-944555,First Continental Bank,***7959,Globex EMEA Manufacturing Ltd.,IE,1850933.35
03/06/2024,03/06/2024,Supplier Payment - CodeCraft Contractors #4,Supplier Payment,SaaS-GL,13059.53,0,EUR,SWIFT MT103,CodeCraft Contractors #4,***1654,,PO-202406-SaaS-GL-0001,FALSE,FALSE,REF-289045,First Continental Bank,***8626,Globex EMEA Manufacturing Ltd.,IE,1837873.82
03/06/2024,03/06/2024,Supplier Payment - HyperCloud Infra #6,Supplier Payment,SaaS-GL,34847.22,0,EUR,SEPA Credit Transfer,HyperCloud Infra #6,***8205,,PO-202406-SaaS-GL-0007,FALSE,FALSE,REF-517231,First Continental Bank,***6447,Globex EMEA Manufacturing Ltd.,IE,1803026.6
04/06/2024,04/06/2024,Supplier Payment - ExpertNet Subcontractors #7,Supplier Payment,PS-GL,11251.04,0,EUR,SEPA Credit Transfer,ExpertNet Subcontractors #7,***8321,,PO-202406-PS-GL-0011,FALSE,FALSE,REF-808612,First Continental Bank,***3687,Globex EMEA Manufacturing Ltd.,IE,1791775.56
04/06/2024,04/06/2024,Supplier Payment - CodeCraft Contractors #12,Supplier Payment,SaaS-GL,21514.34,0,EUR,SWIFT MT103,CodeCraft Contractors #12,***6770,,PO-202406-SaaS-GL-0011,FALSE,FALSE,REF-487519,First Continental Bank,***4942,Globex EMEA Manufacturing Ltd.,IE,1770261.22
04/06/2024,04/06/2024,Client Receipt - CloudBridge Co. #40,Sales Receipt,SaaS-GL,0,11851.34,EUR,Card Settlement,CloudBridge Co. #40,***7512,INV-202406-SaaS-GL-0020,,FALSE,FALSE,REF-149903,First Continental Bank,***3263,Globex EMEA Manufacturing Ltd.,IE,1782112.56
05/06/2024,05/06/2024,Merchant Processing Fees,Bank/Merchant Fees,ALL,64.15,0,EUR,SEPA Debit,First Continental Bank,***5544,,,FALSE,FALSE,REF-511684,First Continental Bank,***8265,Globex EMEA Manufacturing Ltd.,IE,1782048.41
05/06/2024,05/06/2024,Client Receipt - CloudBridge Co. #47,Sales Receipt,SaaS-GL,0,64460.19,EUR,SEPA SCT Inst,CloudBridge Co. #47,***8572,INV-202406-SaaS-GL-0030,,FALSE,FALSE,REF-961371,First Continental Bank,***4947,Globex EMEA Manufacturing Ltd.,IE,1846508.6
06/06/2024,06/06/2024,Client Receipt - CloudBridge Co. #20,Sales Receipt,SaaS-GL,0,6312.91,EUR,SEPA SCT Inst,CloudBridge Co. #20,***1639,INV-202406-SaaS-GL-0025,,FALSE,FALSE,REF-198629,First Continental Bank,***6404,Globex EMEA Manufacturing Ltd.,IE,1852821.51
06/06/2024,06/06/2024,Client Receipt - Novatek Components Ltd #9,Sales Receipt,CEM-EMEA,0,62014.16,EUR,SEPA SCT Inst,Novatek Components Ltd #9,***1140,INV-202406-CEM-EMEA-0007,,FALSE,FALSE,REF-974581,First Continental Bank,***4236,Globex EMEA Manufacturing Ltd.,IE,1914835.67
07/06/2024,07/06/2024,Client Receipt - Vertex Advisory Client #3,Sales Receipt,PS-GL,0,10412.53,EUR,Card Settlement,Vertex Advisory Client #3,***4106,INV-202406-PS-GL-0007,,FALSE,FALSE,REF-604130,First Continental Bank,***5298,Globex EMEA Manufacturing Ltd.,IE,1925248.2
07/06/2024,07/06/2024,Client Receipt - Vertex Advisory Client #45,Sales Receipt,PS-GL,0,46956.86,EUR,SEPA SCT,Vertex Advisory Client #45,***6616,INV-202406-PS-GL-0003,,FALSE,FALSE,REF-653294,First Continental Bank,***7035,Globex EMEA Manufacturing Ltd.,IE,1972205.06
07/06/2024,07/06/2024,Client Receipt - Aurora Electronics GmbH #7,Sales Receipt,CEM-EMEA,0,111024.18,EUR,Card Settlement,Aurora Electronics GmbH #7,***9182,INV-202406-CEM-EMEA-0010,,FALSE,FALSE,REF-662156,First Continental Bank,***1147,Globex EMEA Manufacturing Ltd.,IE,2083229.24
08/06/2024,08/06/2024,Supplier Payment - HyperCloud Infra #6,Supplier Payment,SaaS-GL,5763.63,0,EUR,SWIFT MT103,HyperCloud Infra #6,***3212,,PO-202406-SaaS-GL-0004,FALSE,FALSE,REF-775737,First Continental Bank,***9519,Globex EMEA Manufacturing Ltd.,IE,2077465.61
09/06/2024,09/06/2024,Client Receipt - CloudBridge Co. #34,Sales Receipt,SaaS-GL,0,14583.49,EUR,Card Settlement,CloudBridge Co. #34,***2632,INV-202406-SaaS-GL-0022,,FALSE,FALSE,REF-122712,First Continental Bank,***7796,Globex EMEA Manufacturing Ltd.,IE,2092049.1
10/06/2024,10/06/2024,Supplier Payment - HyperCloud Infra #3,Supplier Payment,SaaS-GL,586.01,0,EUR,SEPA Credit Transfer,HyperCloud Infra #3,***6256,,PO-202406-SaaS-GL-0009,FALSE,FALSE,REF-561314,First Continental Bank,***1083,Globex EMEA Manufacturing Ltd.,IE,2091463.09
10/06/2024,10/06/2024,Client Receipt - CloudBridge Co. #47,Sales Receipt,SaaS-GL,0,15891.57,EUR,Card Settlement,CloudBridge Co. #47,***1203,INV-202406-SaaS-GL-0004,,FALSE,FALSE,REF-763079,First Continental Bank,***8409,Globex EMEA Manufacturing Ltd.,IE,2107354.66
10/06/2024,10/06/2024,Client Receipt - CloudBridge Co. #70,Sales Receipt,SaaS-GL,0,23809.91,EUR,SEPA SCT,CloudBridge Co. #70,***1431,INV-202406-SaaS-GL-0003,,FALSE,FALSE,REF-276908,First Continental Bank,***9711,Globex EMEA Manufacturing Ltd.,IE,2131164.57
11/06/2024,11/06/2024,Supplier Payment - ExpertNet Subcontractors #6,Supplier Payment,PS-GL,211.35,0,EUR,SEPA Credit Transfer,ExpertNet Subcontractors #6,***8977,,PO-202406-PS-GL-0005,FALSE,FALSE,REF-961332,First Continental Bank,***3713,Globex EMEA Manufacturing Ltd.,IE,2130953.22
11/06/2024,11/06/2024,Supplier Payment - ExpertNet Subcontractors #5,Supplier Payment,PS-GL,1163.11,0,EUR,SEPA Debit,ExpertNet Subcontractors #5,***8825,,PO-202406-PS-GL-0008,FALSE,FALSE,REF-510035,First Continental Bank,***9958,Globex EMEA Manufacturing Ltd.,IE,2129790.11
11/06/2024,11/06/2024,Supplier Payment - ExpertNet Subcontractors #10,Supplier Payment,PS-GL,19669.06,0,EUR,SWIFT MT103,ExpertNet Subcontractors #10,***1723,,PO-202406-PS-GL-0002,FALSE,FALSE,REF-922804,First Continental Bank,***9864,Globex EMEA Manufacturing Ltd.,IE,2110121.05
11/06/2024,11/06/2024,Supplier Payment - ExpertNet Subcontractors #3,Supplier Payment,PS-GL,20944.43,0,EUR,SWIFT MT103,ExpertNet Subcontractors #3,***3853,,PO-202406-PS-GL-0001,FALSE,FALSE,REF-432504,First Continental Bank,***3728,Globex EMEA Manufacturing Ltd.,IE,2089176.62
11/06/2024,11/06/2024,Client Receipt - Vertex Advisory Client #38,Sales Receipt,PS-GL,0,3714.08,EUR,Card Settlement,Vertex Advisory Client #38,***7615,INV-202406-PS-GL-0004,,FALSE,FALSE,REF-369787,First Continental Bank,***3552,Globex EMEA Manufacturing Ltd.,IE,2092890.7
11/06/2024,11/06/2024,Client Receipt - Novatek Components Ltd #1,Sales Receipt,CEM-EMEA,0,7072.95,EUR,SEPA SCT,Novatek Components Ltd #1,***9195,INV-202406-CEM-EMEA-0009,,FALSE,FALSE,REF-738654,First Continental Bank,***7322,Globex EMEA Manufacturing Ltd.,IE,2099963.65
11/06/2024,11/06/2024,Client Receipt - CloudBridge Co. #69,Sales Receipt,SaaS-GL,0,10335.78,EUR,Card Settlement,CloudBridge Co. #69,***1212,INV-202406-SaaS-GL-0019,,FALSE,FALSE,REF-815669,First Continental Bank,***5946,Globex EMEA Manufacturing Ltd.,IE,2110299.43
11/06/2024,11/06/2024,Client Receipt - CloudBridge Co. #12,Sales Receipt,SaaS-GL,0,10829.41,EUR,Card Settlement,CloudBridge Co. #12,***5233,INV-202406-SaaS-GL-0006,,FALSE,FALSE,REF-770218,First Continental Bank,***2702,Globex EMEA Manufacturing Ltd.,IE,2121128.84
11/06/2024,11/06/2024,Client Receipt - CloudBridge Co. #72,Sales Receipt,SaaS-GL,0,11563.23,EUR,Card Settlement,CloudBridge Co. #72,***8918,INV-202406-SaaS-GL-0021,,FALSE,FALSE,REF-989168,First Continental Bank,***3485,Globex EMEA Manufacturing Ltd.,IE,2132692.07
11/06/2024,11/06/2024,Client Receipt - Vertex Advisory Client #57,Sales Receipt,PS-GL,0,19295.31,EUR,SEPA SCT Inst,Vertex Advisory Client #57,***8415,INV-202406-PS-GL-0010,,FALSE,FALSE,REF-355319,First Continental Bank,***8528,Globex EMEA Manufacturing Ltd.,IE,2151987.38
11/06/2024,11/06/2024,Client Receipt - Vertex Advisory Client #47,Sales Receipt,PS-GL,0,43266.11,EUR,Card Settlement,Vertex Advisory Client #47,***7725,INV-202406-PS-GL-0009,,FALSE,FALSE,REF-487591,First Continental Bank,***3724,Globex EMEA Manufacturing Ltd.,IE,2195253.49
12/06/2024,12/06/2024,Intercompany Settlement - Globex Retail NA LLC,Intercompany Transfer,ALL,501468,0,EUR,Internal Transfer,Globex Retail NA LLC,***1747,,,TRUE,TRUE,REF-665976,First Continental Bank,***8407,Globex EMEA Manufacturing Ltd.,IE,1693785.49
12/06/2024,12/06/2024,Client Receipt - CloudBridge Co. #68,Sales Receipt,SaaS-GL,0,9698.32,EUR,SEPA SCT Inst,CloudBridge Co. #68,***9941,INV-202406-SaaS-GL-0029,,FALSE,FALSE,REF-464885,First Continental Bank,***2269,Globex EMEA Manufacturing Ltd.,IE,1703483.81
12/06/2024,12/06/2024,Client Receipt - CloudBridge Co. #53,Sales Receipt,SaaS-GL,0,53982.75,EUR,SEPA SCT,CloudBridge Co. #53,***6983,INV-202406-SaaS-GL-0027,,FALSE,FALSE,REF-785675,First Continental Bank,***6450,Globex EMEA Manufacturing Ltd.,IE,1757466.56
12/06/2024,12/06/2024,Client Receipt - Aurora Electronics GmbH #2,Sales Receipt,CEM-EMEA,0,397917.54,EUR,SEPA SCT Inst,Aurora Electronics GmbH #2,***1177,INV-202406-CEM-EMEA-0005,,FALSE,FALSE,REF-557366,First Continental Bank,***3704,Globex EMEA Manufacturing Ltd.,IE,2155384.1
13/06/2024,13/06/2024,Marketing - Aurelia Media #4,Marketing,ALL,13881.37,0,EUR,SEPA Debit,Aurelia Media #4,***8329,,,FALSE,FALSE,REF-299093,First Continental Bank,***8761,Globex EMEA Manufacturing Ltd.,IE,2141502.73
13/06/2024,13/06/2024,Supplier Payment - EuroFab Assembly #19,Supplier Payment,CEM-EMEA,238899.19,0,EUR,SEPA Debit,EuroFab Assembly #19,***1578,,PO-202406-CEM-EMEA-0006,FALSE,FALSE,REF-911498,First Continental Bank,***6905,Globex EMEA Manufacturing Ltd.,IE,1902603.54
14/06/2024,14/06/2024,Supplier Payment - Stelliform Parts BV #2,Supplier Payment,CEM-EMEA,7415.09,0,EUR,SEPA Credit Transfer,Stelliform Parts BV #2,***4387,,PO-202406-CEM-EMEA-0002,FALSE,FALSE,REF-709712,First Continental Bank,***2597,Globex EMEA Manufacturing Ltd.,IE,1895188.45
14/06/2024,14/06/2024,Supplier Payment - ExpertNet Subcontractors #1,Supplier Payment,PS-GL,11950.23,0,EUR,SWIFT MT103,ExpertNet Subcontractors #1,***7493,,PO-202406-PS-GL-0009,FALSE,FALSE,REF-634338,First Continental Bank,***2005,Globex EMEA Manufacturing Ltd.,IE,1883238.22
14/06/2024,14/06/2024,Client Receipt - CloudBridge Co. #67,Sales Receipt,SaaS-GL,0,27688.97,EUR,SEPA SCT Inst,CloudBridge Co. #67,***1171,INV-202406-SaaS-GL-0026,,FALSE,FALSE,REF-428388,First Continental Bank,***6897,Globex EMEA Manufacturing Ltd.,IE,1910927.19
14/06/2024,14/06/2024,Client Receipt - CloudBridge Co. #31,Sales Receipt,SaaS-GL,0,29022.46,EUR,SEPA SCT Inst,CloudBridge Co. #31,***2168,INV-202406-SaaS-GL-0001,,FALSE,FALSE,REF-579037,First Continental Bank,***9144,Globex EMEA Manufacturing Ltd.,IE,1939949.65
14/06/2024,14/06/2024,Client Receipt - Vertex Advisory Client #22,Sales Receipt,PS-GL,0,47124.91,EUR,SEPA SCT,Vertex Advisory Client #22,***7120,INV-202406-PS-GL-0008,,FALSE,FALSE,REF-784536,First Continental Bank,***5887,Globex EMEA Manufacturing Ltd.,IE,1987074.56
14/06/2024,14/06/2024,Client Receipt - CloudBridge Co. #17,Sales Receipt,SaaS-GL,0,88187.73,EUR,SEPA SCT Inst,CloudBridge Co. #17,***2333,INV-202406-SaaS-GL-0015,,FALSE,FALSE,REF-684160,First Continental Bank,***1367,Globex EMEA Manufacturing Ltd.,IE,2075262.29
14/06/2024,14/06/2024,Client Receipt - Vertex Advisory Client #54,Sales Receipt,PS-GL,0,167926.68,EUR,Card Settlement,Vertex Advisory Client #54,***8767,INV-202406-PS-GL-0011,,FALSE,FALSE,REF-539906,First Continental Bank,***8067,Globex EMEA Manufacturing Ltd.,IE,2243188.97
15/06/2024,15/06/2024,Loan Interest Payment,Loan Interest,ALL,85000,0,EUR,SEPA Debit,First Continental Bank - Corporate Lending,***3428,,,FALSE,FALSE,REF-111297,First Continental Bank,***1848,Globex EMEA Manufacturing Ltd.,IE,2158188.97
15/06/2024,15/06/2024,Loan Principal Repayment,Loan Principal,ALL,500000,0,EUR,SEPA Credit Transfer,First Continental Bank - Corporate Lending,***3907,,,FALSE,FALSE,REF-268096,First Continental Bank,***8274,Globex EMEA Manufacturing Ltd.,IE,1658188.97
16/06/2024,16/06/2024,Client Receipt - Novatek Components Ltd #6,Sales Receipt,CEM-EMEA,0,61304.94,EUR,SEPA SCT Inst,Novatek Components Ltd #6,***9906,INV-202406-CEM-EMEA-0006,,FALSE,FALSE,REF-269473,First Continental Bank,***9943,Globex EMEA Manufacturing Ltd.,IE,1719493.91
17/06/2024,17/06/2024,Supplier Payment - ExpertNet Subcontractors #16,Supplier Payment,PS-GL,34623.87,0,EUR,SEPA Debit,ExpertNet Subcontractors #16,***5442,,PO-202406-PS-GL-0004,FALSE,FALSE,REF-607190,First Continental Bank,***8441,Globex EMEA Manufacturing Ltd.,IE,1684870.04
17/06/2024,17/06/2024,Supplier Payment - EuroFab Assembly #2,Supplier Payment,CEM-EMEA,49604.7,0,EUR,SWIFT MT103,EuroFab Assembly #2,***6208,,PO-202406-CEM-EMEA-0001,FALSE,FALSE,REF-373826,First Continental Bank,***7024,Globex EMEA Manufacturing Ltd.,IE,1635265.34
18/06/2024,18/06/2024,Supplier Payment - EuroFab Assembly #10,Supplier Payment,CEM-EMEA,31305.78,0,EUR,SEPA Debit,EuroFab Assembly #10,***2447,,PO-202406-CEM-EMEA-0008,FALSE,FALSE,REF-194997,First Continental Bank,***7533,Globex EMEA Manufacturing Ltd.,IE,1603959.56
18/06/2024,18/06/2024,Supplier Payment - Stelliform Parts BV #18,Supplier Payment,CEM-EMEA,35234.75,0,EUR,SEPA Debit,Stelliform Parts BV #18,***5010,,PO-202406-CEM-EMEA-0007,FALSE,FALSE,REF-529293,First Continental Bank,***7573,Globex EMEA Manufacturing Ltd.,IE,1568724.81
18/06/2024,18/06/2024,VAT/GST Remittance - Revenue Ireland,Tax Payment,ALL,127699.3,0,EUR,SEPA Debit,Revenue Ireland,***6091,,,FALSE,FALSE,REF-766832,First Continental Bank,***7681,Globex EMEA Manufacturing Ltd.,IE,1441025.51
18/06/2024,18/06/2024,Client Receipt - CloudBridge Co. #63,Sales Receipt,SaaS-GL,0,45992.6,EUR,Card Settlement,CloudBridge Co. #63,***5393,INV-202406-SaaS-GL-0008,,FALSE,FALSE,REF-572503,First Continental Bank,***5755,Globex EMEA Manufacturing Ltd.,IE,1487018.11
19/06/2024,19/06/2024,Supplier Payment - HyperCloud Infra #14,Supplier Payment,SaaS-GL,2897.07,0,EUR,SWIFT MT103,HyperCloud Infra #14,***9059,,PO-202406-SaaS-GL-0006,FALSE,FALSE,REF-298912,First Continental Bank,***1376,Globex EMEA Manufacturing Ltd.,IE,1484121.04
19/06/2024,19/06/2024,Supplier Payment - ExpertNet Subcontractors #4,Supplier Payment,PS-GL,8135.69,0,EUR,SWIFT MT103,ExpertNet Subcontractors #4,***9183,,PO-202406-PS-GL-0006,FALSE,FALSE,REF-635637,First Continental Bank,***8909,Globex EMEA Manufacturing Ltd.,IE,1475985.35
19/06/2024,19/06/2024,Supplier Payment - Stelliform Parts BV #18,Supplier Payment,CEM-EMEA,32057.39,0,EUR,SWIFT MT103,Stelliform Parts BV #18,***1979,,PO-202406-CEM-EMEA-0003,FALSE,FALSE,REF-193174,First Continental Bank,***8395,Globex EMEA Manufacturing Ltd.,IE,1443927.96
20/06/2024,20/06/2024,Client Receipt - CloudBridge Co. #30,Sales Receipt,SaaS-GL,0,1655.25,EUR,Card Settlement,CloudBridge Co. #30,***9554,INV-202406-SaaS-GL-0028,,FALSE,FALSE,REF-233281,First Continental Bank,***3678,Globex EMEA Manufacturing Ltd.,IE,1445583.21
20/06/2024,20/06/2024,Client Receipt - CloudBridge Co. #2,Sales Receipt,SaaS-GL,0,5528.75,EUR,SEPA SCT,CloudBridge Co. #2,***8052,INV-202406-SaaS-GL-0024,,FALSE,FALSE,REF-895904,First Continental Bank,***2663,Globex EMEA Manufacturing Ltd.,IE,1451111.96
20/06/2024,20/06/2024,Client Receipt - Vertex Advisory Client #16,Sales Receipt,PS-GL,0,6278.22,EUR,SEPA SCT Inst,Vertex Advisory Client #16,***6616,INV-202406-PS-GL-0006,,FALSE,FALSE,REF-157281,First Continental Bank,***9330,Globex EMEA Manufacturing Ltd.,IE,1457390.18
20/06/2024,20/06/2024,Client Receipt - CloudBridge Co. #14,Sales Receipt,SaaS-GL,0,37447.33,EUR,SEPA SCT Inst,CloudBridge Co. #14,***3872,INV-202406-SaaS-GL-0005,,FALSE,FALSE,REF-987227,First Continental Bank,***6565,Globex EMEA Manufacturing Ltd.,IE,1494837.51
20/06/2024,20/06/2024,Client Receipt - Aurora Electronics GmbH #13,Sales Receipt,CEM-EMEA,0,132864.1,EUR,Card Settlement,Aurora Electronics GmbH #13,***2874,INV-202406-CEM-EMEA-0008,,FALSE,FALSE,REF-883491,First Continental Bank,***8023,Globex EMEA Manufacturing Ltd.,IE,1627701.61
21/06/2024,21/06/2024,Merchant Processing Fees,Bank/Merchant Fees,ALL,6195.25,0,EUR,SEPA Credit Transfer,First Continental Bank,***2303,,,FALSE,FALSE,REF-685072,First Continental Bank,***9755,Globex EMEA Manufacturing Ltd.,IE,1621506.36
21/06/2024,21/06/2024,Marketing - Aurelia Media #8,Marketing,ALL,39452.21,0,EUR,SEPA Debit,Aurelia Media #8,***9378,,,FALSE,FALSE,REF-403923,First Continental Bank,***3006,Globex EMEA Manufacturing Ltd.,IE,1582054.15
21/06/2024,21/06/2024,Supplier Payment - Stelliform Parts BV #11,Supplier Payment,CEM-EMEA,169977.02,0,EUR,SEPA Credit Transfer,Stelliform Parts BV #11,***2877,,PO-202406-CEM-EMEA-0005,FALSE,FALSE,REF-680959,First Continental Bank,***2090,Globex EMEA Manufacturing Ltd.,IE,1412077.13
23/06/2024,23/06/2024,Client Receipt - CloudBridge Co. #17,Sales Receipt,SaaS-GL,0,5988.96,EUR,SEPA SCT Inst,CloudBridge Co. #17,***2920,INV-202406-SaaS-GL-0023,,FALSE,FALSE,REF-689460,First Continental Bank,***3151,Globex EMEA Manufacturing Ltd.,IE,1418066.09
24/06/2024,24/06/2024,Supplier Payment - HyperCloud Infra #3,Supplier Payment,SaaS-GL,5455.91,0,EUR,SEPA Credit Transfer,HyperCloud Infra #3,***9285,,PO-202406-SaaS-GL-0003,FALSE,FALSE,REF-362465,First Continental Bank,***2552,Globex EMEA Manufacturing Ltd.,IE,1412610.18
24/06/2024,24/06/2024,Client Receipt - Novatek Components Ltd #14,Sales Receipt,CEM-EMEA,0,30537.09,EUR,SEPA SCT,Novatek Components Ltd #14,***3685,INV-202406-CEM-EMEA-0002,,FALSE,FALSE,REF-494770,First Continental Bank,***9401,Globex EMEA Manufacturing Ltd.,IE,1443147.27
24/06/2024,24/06/2024,Client Receipt - Novatek Components Ltd #8,Sales Receipt,CEM-EMEA,0,149142.65,EUR,Card Settlement,Novatek Components Ltd #8,***9695,INV-202406-CEM-EMEA-0001,,FALSE,FALSE,REF-685675,First Continental Bank,***9289,Globex EMEA Manufacturing Ltd.,IE,1592289.92
25/06/2024,25/06/2024,Supplier Payment - CodeCraft Contractors #14,Supplier Payment,SaaS-GL,18293.82,0,EUR,SWIFT MT103,CodeCraft Contractors #14,***7408,,PO-202406-SaaS-GL-0005,FALSE,FALSE,REF-613786,First Continental Bank,***7324,Globex EMEA Manufacturing Ltd.,IE,1573996.1
25/06/2024,25/06/2024,Supplier Payment - HyperCloud Infra #9,Supplier Payment,SaaS-GL,21428.89,0,EUR,SWIFT MT103,HyperCloud Infra #9,***8628,,PO-202406-SaaS-GL-0008,FALSE,FALSE,REF-897732,First Continental Bank,***1057,Globex EMEA Manufacturing Ltd.,IE,1552567.21
25/06/2024,25/06/2024,Supplier Payment - EuroFab Assembly #11,Supplier Payment,CEM-EMEA,53672.61,0,EUR,SEPA Debit,EuroFab Assembly #11,***5235,,PO-202406-CEM-EMEA-0004,FALSE,FALSE,REF-229402,First Continental Bank,***3926,Globex EMEA Manufacturing Ltd.,IE,1498894.6
25/06/2024,25/06/2024,Client Receipt - CloudBridge Co. #68,Sales Receipt,SaaS-GL,0,2231.92,EUR,Card Settlement,CloudBridge Co. #68,***1344,INV-202406-SaaS-GL-0011,,FALSE,FALSE,REF-139761,First Continental Bank,***2007,Globex EMEA Manufacturing Ltd.,IE,1501126.52
25/06/2024,25/06/2024,Client Receipt - Vertex Advisory Client #12,Sales Receipt,PS-GL,0,4488.78,EUR,SEPA SCT Inst,Vertex Advisory Client #12,***6405,INV-202406-PS-GL-0002,,FALSE,FALSE,REF-282585,First Continental Bank,***2513,Globex EMEA Manufacturing Ltd.,IE,1505615.3
25/06/2024,25/06/2024,Client Receipt - CloudBridge Co. #37,Sales Receipt,SaaS-GL,0,6479.92,EUR,SEPA SCT Inst,CloudBridge Co. #37,***6325,INV-202406-SaaS-GL-0002,,FALSE,FALSE,REF-365192,First Continental Bank,***9580,Globex EMEA Manufacturing Ltd.,IE,1512095.22
25/06/2024,25/06/2024,Client Receipt - CloudBridge Co. #23,Sales Receipt,SaaS-GL,0,27536.95,EUR,SEPA SCT Inst,CloudBridge Co. #23,***2019,INV-202406-SaaS-GL-0013,,FALSE,FALSE,REF-612110,First Continental Bank,***6351,Globex EMEA Manufacturing Ltd.,IE,1539632.17
25/06/2024,25/06/2024,Client Receipt - Novatek Components Ltd #2,Sales Receipt,CEM-EMEA,0,60027.65,EUR,SEPA SCT Inst,Novatek Components Ltd #2,***5327,INV-202406-CEM-EMEA-0004,,FALSE,FALSE,REF-193960,First Continental Bank,***1415,Globex EMEA Manufacturing Ltd.,IE,1599659.82
26/06/2024,26/06/2024,Supplier Payment - ExpertNet Subcontractors #1,Supplier Payment,PS-GL,4418.14,0,EUR,SEPA Debit,ExpertNet Subcontractors #1,***2686,,PO-202406-PS-GL-0010,FALSE,FALSE,REF-421719,First Continental Bank,***4527,Globex EMEA Manufacturing Ltd.,IE,1595241.68
26/06/2024,26/06/2024,Intercompany Settlement - Globex Retail NA LLC,Intercompany Transfer,ALL,707431,0,EUR,Internal Transfer,Globex Retail NA LLC,***4064,,,TRUE,TRUE,REF-580510,First Continental Bank,***9536,Globex EMEA Manufacturing Ltd.,IE,887810.68
26/06/2024,26/06/2024,Client Receipt - CloudBridge Co. #24,Sales Receipt,SaaS-GL,0,30757.52,EUR,SEPA SCT Inst,CloudBridge Co. #24,***8963,INV-202406-SaaS-GL-0007,,FALSE,FALSE,REF-516604,First Continental Bank,***1844,Globex EMEA Manufacturing Ltd.,IE,918568.2
26/06/2024,26/06/2024,Intercompany Reimbursement - Globex Retail NA LLC,Intercompany Transfer,ALL,0,282972.4,EUR,Internal Transfer,Globex Retail NA LLC,***4450,,,TRUE,TRUE,REF-770634,First Continental Bank,***7625,Globex EMEA Manufacturing Ltd.,IE,1201540.6
27/06/2024,27/06/2024,Supplier Payment - CodeCraft Contractors #4,Supplier Payment,SaaS-GL,4169.34,0,EUR,SWIFT MT103,CodeCraft Contractors #4,***4972,,PO-202406-SaaS-GL-0010,FALSE,FALSE,REF-263711,First Continental Bank,***9514,Globex EMEA Manufacturing Ltd.,IE,1197371.26
27/06/2024,27/06/2024,Client Receipt - CloudBridge Co. #42,Sales Receipt,SaaS-GL,0,4933.52,EUR,Card Settlement,CloudBridge Co. #42,***8955,INV-202406-SaaS-GL-0014,,FALSE,FALSE,REF-247278,First Continental Bank,***9847,Globex EMEA Manufacturing Ltd.,IE,1202304.78
27/06/2024,27/06/2024,Client Receipt - CloudBridge Co. #22,Sales Receipt,SaaS-GL,0,10458.71,EUR,SEPA SCT,CloudBridge Co. #22,***4846,INV-202406-SaaS-GL-0012,,FALSE,FALSE,REF-980217,First Continental Bank,***8265,Globex EMEA Manufacturing Ltd.,IE,1212763.49
27/06/2024,27/06/2024,Client Receipt - CloudBridge Co. #62,Sales Receipt,SaaS-GL,0,53411.6,EUR,Card Settlement,CloudBridge Co. #62,***3595,INV-202406-SaaS-GL-0018,,FALSE,FALSE,REF-304991,First Continental Bank,***2134,Globex EMEA Manufacturing Ltd.,IE,1266175.09
28/06/2024,28/06/2024,Supplier Payment - HyperCloud Infra #17,Supplier Payment,SaaS-GL,17694.92,0,EUR,SWIFT MT103,HyperCloud Infra #17,***7250,,PO-202406-SaaS-GL-0002,FALSE,FALSE,REF-975322,First Continental Bank,***4905,Globex EMEA Manufacturing Ltd.,IE,1248480.17
28/06/2024,28/06/2024,Client Receipt - CloudBridge Co. #22,Sales Receipt,SaaS-GL,0,6444.96,EUR,SEPA SCT,CloudBridge Co. #22,***3742,INV-202406-SaaS-GL-0017,,FALSE,FALSE,REF-295982,First Continental Bank,***9532,Globex EMEA Manufacturing Ltd.,IE,1254925.13
28/06/2024,28/06/2024,Client Receipt - CloudBridge Co. #65,Sales Receipt,SaaS-GL,0,10019.26,EUR,Card Settlement,CloudBridge Co. #65,***2869,INV-202406-SaaS-GL-0016,,FALSE,FALSE,REF-250510,First Continental Bank,***2440,Globex EMEA Manufacturing Ltd.,IE,1264944.39
28/06/2024,28/06/2024,Client Receipt - CloudBridge Co. #34,Sales Receipt,SaaS-GL,0,16242.02,EUR,Card Settlement,CloudBridge Co. #34,***2944,INV-202406-SaaS-GL-0010,,FALSE,FALSE,REF-879806,First Continental Bank,***2027,Globex EMEA Manufacturing Ltd.,IE,1281186.41
28/06/2024,28/06/2024,Client Receipt - CloudBridge Co. #78,Sales Receipt,SaaS-GL,0,18973.95,EUR,SEPA SCT Inst,CloudBridge Co. #78,***4308,INV-202406-SaaS-GL-0009,,FALSE,FALSE,REF-625510,First Continental Bank,***4830,Globex EMEA Manufacturing Ltd.,IE,1300160.36
28/06/2024,28/06/2024,Client Receipt - Vertex Advisory Client #21,Sales Receipt,PS-GL,0,59762.3,EUR,SEPA SCT,Vertex Advisory Client #21,***9464,INV-202406-PS-GL-0005,,FALSE,FALSE,REF-709567,First Continental Bank,***4767,Globex EMEA Manufacturing Ltd.,IE,1359922.66
29/06/2024,29/06/2024,Supplier Payment - ExpertNet Subcontractors #6,Supplier Payment,PS-GL,12781.82,0,EUR,SWIFT MT103,ExpertNet Subcontractors #6,***8084,,PO-202406-PS-GL-0007,FALSE,FALSE,REF-245408,First Continental Bank,***6315,Globex EMEA Manufacturing Ltd.,IE,1347140.84
30/06/2024,30/06/2024,Supplier Payment - ExpertNet Subcontractors #15,Supplier Payment,PS-GL,7315.52,0,EUR,SEPA Credit Transfer,ExpertNet Subcontractors #15,***7380,,PO-202406-PS-GL-0003,FALSE,FALSE,REF-540372,First Continental Bank,***5820,Globex EMEA Manufacturing Ltd.,IE,1339825.32
30/06/2024,30/06/2024,Payroll - GlobalPay Services Ltd,Payroll,ALL,344434.81,0,EUR,SWIFT MT103,GlobalPay Services Ltd,***5013,,,FALSE,FALSE,REF-287339,First Continental Bank,***7102,Globex EMEA Manufacturing Ltd.,IE,995390.51
30/06/2024,30/06/2024,Interest Earned,Interest Income,ALL,0,11275.31,EUR,Card Settlement,First Continental Bank,***1665,,,FALSE,FALSE,REF-984395,First Continental Bank,***8899,Globex EMEA Manufacturing Ltd.,IE,1006665.82
30/06/2024,30/06/2024,Client Receipt - Vertex Advisory Client #41,Sales Receipt,PS-GL,0,32321.74,EUR,SEPA SCT Inst,Vertex Advisory Client #41,***9745,INV-202406-PS-GL-0001,,FALSE,FALSE,REF-625251,First Continental Bank,***6746,Globex EMEA Manufacturing Ltd.,IE,1038987.56
01/07/2024,01/07/2024,Account Maintenance Fee,Bank/Merchant Fees,ALL,2500,0,EUR,SEPA Debit,First Continental Bank,***5764,,,FALSE,FALSE,REF-137809,First Continental Bank,***2036,Globex EMEA Manufacturing Ltd.,IE,1036487.56
01/07/2024,01/07/2024,Supplier Payment - HyperCloud Infra #1,Supplier Payment,SaaS-GL,11288.53,0,EUR,SEPA Credit Transfer,HyperCloud Infra #1,***1932,,PO-202407-SaaS-GL-0003,FALSE,FALSE,REF-809991,First Continental Bank,***8659,Globex EMEA Manufacturing Ltd.,IE,1025199.03
01/07/2024,01/07/2024,Client Receipt - CloudBridge Co. #47,Sales Receipt,SaaS-GL,0,754.99,EUR,Card Settlement,CloudBridge Co. #47,***2234,INV-202407-SaaS-GL-0018,,FALSE,FALSE,REF-728705,First Continental Bank,***8047,Globex EMEA Manufacturing Ltd.,IE,1025954.02
01/07/2024,01/07/2024,Client Receipt - CloudBridge Co. #61,Sales Receipt,SaaS-GL,0,32672.14,EUR,Card Settlement,CloudBridge Co. #61,***8922,INV-202407-SaaS-GL-0022,,FALSE,FALSE,REF-842612,First Continental Bank,***1577,Globex EMEA Manufacturing Ltd.,IE,1058626.16
01/07/2024,01/07/2024,Client Receipt - CloudBridge Co. #33,Sales Receipt,SaaS-GL,0,69792.29,EUR,SEPA SCT,CloudBridge Co. #33,***5804,INV-202407-SaaS-GL-0019,,FALSE,FALSE,REF-954475,First Continental Bank,***9309,Globex EMEA Manufacturing Ltd.,IE,1128418.45
01/07/2024,01/07/2024,Client Receipt - Aurora Electronics GmbH #12,Sales Receipt,CEM-EMEA,0,71146.72,EUR,Card Settlement,Aurora Electronics GmbH #12,***5924,INV-202407-CEM-EMEA-0003,,FALSE,FALSE,REF-247496,First Continental Bank,***6865,Globex EMEA Manufacturing Ltd.,IE,1199565.17
02/07/2024,02/07/2024,Supplier Payment - Stelliform Parts BV #32,Supplier Payment,CEM-EMEA,112173.54,0,EUR,SEPA Credit Transfer,Stelliform Parts BV #32,***8202,,PO-202407-CEM-EMEA-0006,FALSE,FALSE,REF-694540,First Continental Bank,***2579,Globex EMEA Manufacturing Ltd.,IE,1087391.63
02/07/2024,02/07/2024,Client Receipt - Aurora Electronics GmbH #4,Sales Receipt,CEM-EMEA,0,20029.74,EUR,SEPA SCT Inst,Aurora Electronics GmbH #4,***3814,INV-202407-CEM-EMEA-0013,,FALSE,FALSE,REF-322170,First Continental Bank,***3844,Globex EMEA Manufacturing Ltd.,IE,1107421.37
03/07/2024,03/07/2024,Client Receipt - CloudBridge Co. #22,Sales Receipt,SaaS-GL,0,9003.9,EUR,SEPA SCT,CloudBridge Co. #22,***3431,INV-202407-SaaS-GL-0023,,FALSE,FALSE,REF-186622,First Continental Bank,***7746,Globex EMEA Manufacturing Ltd.,IE,1116425.27
03/07/2024,03/07/2024,Client Receipt - Vertex Advisory Client #27,Sales Receipt,PS-GL,0,9067.09,EUR,SEPA SCT Inst,Vertex Advisory Client #27,***2358,INV-202407-PS-GL-0004,,FALSE,FALSE,REF-633900,First Continental Bank,***8973,Globex EMEA Manufacturing Ltd.,IE,1125492.36
03/07/2024,03/07/2024,Client Receipt - Aurora Electronics GmbH #5,Sales Receipt,CEM-EMEA,0,41614.53,EUR,Card Settlement,Aurora Electronics GmbH #5,***8189,INV-202407-CEM-EMEA-0018,,FALSE,FALSE,REF-547482,First Continental Bank,***9827,Globex EMEA Manufacturing Ltd.,IE,1167106.89
04/07/2024,04/07/2024,Merchant Processing Fees,Bank/Merchant Fees,ALL,1259.04,0,EUR,SWIFT MT103,First Continental Bank,***1462,,,FALSE,FALSE,REF-892149,First Continental Bank,***2234,Globex EMEA Manufacturing Ltd.,IE,1165847.85
04/07/2024,04/07/2024,Supplier Payment - ExpertNet Subcontractors #3,Supplier Payment,PS-GL,7782.65,0,EUR,SWIFT MT103,ExpertNet Subcontractors #3,***1267,,PO-202407-PS-GL-0010,FALSE,FALSE,REF-139868,First Continental Bank,***4196,Globex EMEA Manufacturing Ltd.,IE,1158065.2
04/07/2024,04/07/2024,Marketing - Beacon Digital #7,Marketing,ALL,39934.34,0,EUR,SEPA Credit Transfer,Beacon Digital #7,***9492,,,FALSE,FALSE,REF-648414,First Continental Bank,***8467,Globex EMEA Manufacturing Ltd.,IE,1118130.86
04/07/2024,04/07/2024,Client Receipt - Aurora Electronics GmbH #9,Sales Receipt,CEM-EMEA,0,12565.61,EUR,SEPA SCT,Aurora Electronics GmbH #9,***4022,INV-202407-CEM-EMEA-0007,,FALSE,FALSE,REF-521508,First Continental Bank,***2330,Globex EMEA Manufacturing Ltd.,IE,1130696.47
04/07/2024,04/07/2024,Client Receipt - CloudBridge Co. #46,Sales Receipt,SaaS-GL,0,24001.01,EUR,Card Settlement,CloudBridge Co. #46,***4770,INV-202407-SaaS-GL-0006,,FALSE,FALSE,REF-439529,First Continental Bank,***8625,Globex EMEA Manufacturing Ltd.,IE,1154697.48
05/07/2024,05/07/2024,Client Receipt - Aurora Electronics GmbH #16,Sales Receipt,CEM-EMEA,0,1059.84,EUR,SEPA SCT Inst,Aurora Electronics GmbH #16,***7776,INV-202407-CEM-EMEA-0004,,FALSE,FALSE,REF-322049,First Continental Bank,***4327,Globex EMEA Manufacturing Ltd.,IE,1155757.32
05/07/2024,05/07/2024,Client Receipt - CloudBridge Co. #68,Sales Receipt,SaaS-GL,0,4530.77,EUR,SEPA SCT,CloudBridge Co. #68,***6906,INV-202407-SaaS-GL-0017,,FALSE,FALSE,REF-457310,First Continental Bank,***9490,Globex EMEA Manufacturing Ltd.,IE,1160288.09
05/07/2024,05/07/2024,Client Receipt - CloudBridge Co. #62,Sales Receipt,SaaS-GL,0,5406.55,EUR,Card Settlement,CloudBridge Co. #62,***7074,INV-202407-SaaS-GL-0012,,FALSE,FALSE,REF-694233,First Continental Bank,***5639,Globex EMEA Manufacturing Ltd.,IE,1165694.64
05/07/2024,05/07/2024,Client Receipt - CloudBridge Co. #11,Sales Receipt,SaaS-GL,0,11544.21,EUR,Card Settlement,CloudBridge Co. #11,***9600,INV-202407-SaaS-GL-0016,,FALSE,FALSE,REF-202150,First Continental Bank,***3271,Globex EMEA Manufacturing Ltd.,IE,1177238.85
05/07/2024,05/07/2024,Client Receipt - Vertex Advisory Client #12,Sales Receipt,PS-GL,0,49828.64,EUR,Card Settlement,Vertex Advisory Client #12,***7563,INV-202407-PS-GL-0005,,FALSE,FALSE,REF-378826,First Continental Bank,***3296,Globex EMEA Manufacturing Ltd.,IE,1227067.49
05/07/2024,05/07/2024,Client Receipt - Aurora Electronics GmbH #3,Sales Receipt,CEM-EMEA,0,353991.23,EUR,Card Settlement,Aurora Electronics GmbH #3,***5182,INV-202407-CEM-EMEA-0017,,FALSE,FALSE,REF-567633,First Continental Bank,***8865,Globex EMEA Manufacturing Ltd.,IE,1581058.72
06/07/2024,06/07/2024,Merchant Processing Fees,Bank/Merchant Fees,ALL,4898.11,0,EUR,SEPA Debit,First Continental Bank,***3584,,,FALSE,FALSE,REF-478292,First Continental Bank,***8523,Globex EMEA Manufacturing Ltd.,IE,1576160.61
06/07/2024,06/07/2024,Client Receipt - CloudBridge Co. #6,Sales Receipt,SaaS-GL,0,41938,EUR,SEPA SCT,CloudBridge Co. #6,***5299,INV-202407-SaaS-GL-0014,,FALSE,FALSE,REF-892515,First Continental Bank,***3415,Globex EMEA Manufacturing Ltd.,IE,1618098.61
07/07/2024,07/07/2024,Client Receipt - Vertex Advisory Client #49,Sales Receipt,PS-GL,0,11298.66,EUR,Card Settlement,Vertex Advisory Client #49,***7548,INV-202407-PS-GL-0010,,FALSE,FALSE,REF-442729,First Continental Bank,***4051,Globex EMEA Manufacturing Ltd.,IE,1629397.27
07/07/2024,07/07/2024,Client Receipt - Novatek Components Ltd #3,Sales Receipt,CEM-EMEA,0,79048.17,EUR,Card Settlement,Novatek Components Ltd #3,***9917,INV-202407-CEM-EMEA-0005,,FALSE,FALSE,REF-347527,First Continental Bank,***3359,Globex EMEA Manufacturing Ltd.,IE,1708445.44
07/07/2024,07/07/2024,Client Receipt - Aurora Electronics GmbH #11,Sales Receipt,CEM-EMEA,0,120132.68,EUR,SEPA SCT Inst,Aurora Electronics GmbH #11,***9676,INV-202407-CEM-EMEA-0006,,FALSE,FALSE,REF-823250,First Continental Bank,***4293,Globex EMEA Manufacturing Ltd.,IE,1828578.12
08/07/2024,08/07/2024,Supplier Payment - ExpertNet Subcontractors #11,Supplier Payment,PS-GL,10265.52,0,EUR,SEPA Credit Transfer,ExpertNet Subcontractors #11,***9414,,PO-202407-PS-GL-0005,FALSE,FALSE,REF-507695,First Continental Bank,***7044,Globex EMEA Manufacturing Ltd.,IE,1818312.6
09/07/2024,09/07/2024,Supplier Payment - ExpertNet Subcontractors #9,Supplier Payment,PS-GL,40131.31,0,EUR,SEPA Credit Transfer,ExpertNet Subcontractors #9,***9085,,PO-202407-PS-GL-0006,FALSE,FALSE,REF-587073,First Continental Bank,***9457,Globex EMEA Manufacturing Ltd.,IE,1778181.29
09/07/2024,09/07/2024,Client Receipt - CloudBridge Co. #45,Sales Receipt,SaaS-GL,0,9728.57,EUR,SEPA SCT Inst,CloudBridge Co. #45,***1137,INV-202407-SaaS-GL-0015,,FALSE,FALSE,REF-235214,First Continental Bank,***6158,Globex EMEA Manufacturing Ltd.,IE,1787909.86
09/07/2024,09/07/2024,Client Receipt - Novatek Components Ltd #14,Sales Receipt,CEM-EMEA,0,23030.33,EUR,Card Settlement,Novatek Components Ltd #14,***2699,INV-202407-CEM-EMEA-0011,,FALSE,FALSE,REF-533118,First Continental Bank,***1509,Globex EMEA Manufacturing Ltd.,IE,1810940.19
10/07/2024,10/07/2024,Supplier Payment - EuroFab Assembly #21,Supplier Payment,CEM-EMEA,80676.11,0,EUR,SEPA Credit Transfer,EuroFab Assembly #21,***6861,,PO-202407-CEM-EMEA-0011,FALSE,FALSE,REF-467395,First Continental Bank,***9753,Globex EMEA Manufacturing Ltd.,IE,1730264.08
10/07/2024,10/07/2024,Client Receipt - Vertex Advisory Client #29,Sales Receipt,PS-GL,0,6524.08,EUR,SEPA SCT Inst,Vertex Advisory Client #29,***8606,INV-202407-PS-GL-0008,,FALSE,FALSE,REF-740107,First Continental Bank,***2199,Globex EMEA Manufacturing Ltd.,IE,1736788.16
10/07/2024,10/07/2024,Client Receipt - CloudBridge Co. #5,Sales Receipt,SaaS-GL,0,9813.13,EUR,SEPA SCT Inst,CloudBridge Co. #5,***3515,INV-202407-SaaS-GL-0005,,FALSE,FALSE,REF-969467,First Continental Bank,***1060,Globex EMEA Manufacturing Ltd.,IE,1746601.29
10/07/2024,10/07/2024,Client Receipt - CloudBridge Co. #10,Sales Receipt,SaaS-GL,0,15822.96,EUR,SEPA SCT,CloudBridge Co. #10,***7911,INV-202407-SaaS-GL-0013,,FALSE,FALSE,REF-390305,First Continental Bank,***7128,Globex EMEA Manufacturing Ltd.,IE,1762424.25
11/07/2024,11/07/2024,Supplier Payment - Stelliform Parts BV #28,Supplier Payment,CEM-EMEA,21573.36,0,EUR,SWIFT MT103,Stelliform Parts BV #28,***5093,,PO-202407-CEM-EMEA-0003,FALSE,FALSE,REF-168038,First Continental Bank,***7759,Globex EMEA Manufacturing Ltd.,IE,1740850.89
11/07/2024,11/07/2024,Client Receipt - CloudBridge Co. #17,Sales Receipt,SaaS-GL,0,4780.92,EUR,SEPA SCT Inst,CloudBridge Co. #17,***6578,INV-202407-SaaS-GL-0003,,FALSE,FALSE,REF-235179,First Continental Bank,***9790,Globex EMEA Manufacturing Ltd.,IE,1745631.81
11/07/2024,11/07/2024,Client Receipt - Novatek Components Ltd #3,Sales Receipt,CEM-EMEA,0,21715.62,EUR,SEPA SCT,Novatek Components Ltd #3,***1885,INV-202407-CEM-EMEA-0009,,FALSE,FALSE,REF-141050,First Continental Bank,***5784,Globex EMEA Manufacturing Ltd.,IE,1767347.43
11/07/2024,11/07/2024,Client Receipt - Vertex Advisory Client #5,Sales Receipt,PS-GL,0,94548.83,EUR,Card Settlement,Vertex Advisory Client #5,***2766,INV-202407-PS-GL-0007,,FALSE,FALSE,REF-579175,First Continental Bank,***1130,Globex EMEA Manufacturing Ltd.,IE,1861896.26
12/07/2024,12/07/2024,Supplier Payment - Stelliform Parts BV #10,Supplier Payment,CEM-EMEA,2348.2,0,EUR,SEPA Debit,Stelliform Parts BV #10,***3410,,PO-202407-CEM-EMEA-0007,FALSE,FALSE,REF-775204,First Continental Bank,***9473,Globex EMEA Manufacturing Ltd.,IE,1859548.06
12/07/2024,12/07/2024,Supplier Payment - EuroFab Assembly #3,Supplier Payment,CEM-EMEA,24178.1,0,EUR,SWIFT MT103,EuroFab Assembly #3,***2269,,PO-202407-CEM-EMEA-0010,FALSE,FALSE,REF-515531,First Continental Bank,***2399,Globex EMEA Manufacturing Ltd.,IE,1835369.96
12/07/2024,12/07/2024,Supplier Payment - HyperCloud Infra #1,Supplier Payment,SaaS-GL,34088.98,0,EUR,SEPA Debit,HyperCloud Infra #1,***4395,,PO-202407-SaaS-GL-0005,FALSE,FALSE,REF-113062,First Continental Bank,***8694,Globex EMEA Manufacturing Ltd.,IE,1801280.98
12/07/2024,12/07/2024,Supplier Payment - Stelliform Parts BV #8,Supplier Payment,CEM-EMEA,149118.21,0,EUR,SEPA Debit,Stelliform Parts BV #8,***9193,,PO-202407-CEM-EMEA-0004,FALSE,FALSE,REF-788935,First Continental Bank,***8572,Globex EMEA Manufacturing Ltd.,IE,1652162.77
12/07/2024,12/07/2024,"Intercompany Settlement - Globex International Holdings, Inc.",Intercompany Transfer,ALL,594342,0,EUR,Internal Transfer,"Globex International Holdings, Inc.",***3295,,,TRUE,TRUE,REF-560085,First Continental Bank,***1493,Globex EMEA Manufacturing Ltd.,IE,1057820.77
12/07/2024,12/07/2024,Client Receipt - Aurora Electronics GmbH #11,Sales Receipt,CEM-EMEA,0,7707.61,EUR,Card Settlement,Aurora Electronics GmbH #11,***6184,INV-202407-CEM-EMEA-0015,,FALSE,FALSE,REF-596429,First Continental Bank,***2746,Globex EMEA Manufacturing Ltd.,IE,1065528.38
12/07/2024,12/07/2024,Client Receipt - Aurora Electronics GmbH #7,Sales Receipt,CEM-EMEA,0,10975.1,EUR,Card Settlement,Aurora Electronics GmbH #7,***1298,INV-202407-CEM-EMEA-0014,,FALSE,FALSE,REF-207363,First Continental Bank,***8701,Globex EMEA Manufacturing Ltd.,IE,1076503.48
13/07/2024,13/07/2024,Supplier Payment - ExpertNet Subcontractors #2,Supplier Payment,PS-GL,10252.34,0,EUR,SEPA Credit Transfer,ExpertNet Subcontractors #2,***6332,,PO-202407-PS-GL-0003,FALSE,FALSE,REF-283724,First Continental Bank,***7041,Globex EMEA Manufacturing Ltd.,IE,1066251.14
13/07/2024,13/07/2024,Client Receipt - CloudBridge Co. #72,Sales Receipt,SaaS-GL,0,42395.13,EUR,SEPA SCT,CloudBridge Co. #72,***9697,INV-202407-SaaS-GL-0010,,FALSE,FALSE,REF-424446,First Continental Bank,***5588,Globex EMEA Manufacturing Ltd.,IE,1108646.27
13/07/2024,13/07/2024,Client Receipt - Aurora Electronics GmbH #15,Sales Receipt,CEM-EMEA,0,58786.05,EUR,SEPA SCT Inst,Aurora Electronics GmbH #15,***3613,INV-202407-CEM-EMEA-0001,,FALSE,FALSE,REF-779044,First Continental Bank,***7857,Globex EMEA Manufacturing Ltd.,IE,1167432.32
14/07/2024,14/07/2024,Marketing - Beacon Digital #6,Marketing,ALL,11022.19,0,EUR,SWIFT MT103,Beacon Digital #6,***9812,,,FALSE,FALSE,REF-664083,First Continental Bank,***8084,Globex EMEA Manufacturing Ltd.,IE,1156410.13
14/07/2024,14/07/2024,Client Receipt - Vertex Advisory Client #28,Sales Receipt,PS-GL,0,33487.55,EUR,SEPA SCT Inst,Vertex Advisory Client #28,***3485,INV-202407-PS-GL-0006,,FALSE,FALSE,REF-912491,First Continental Bank,***2162,Globex EMEA Manufacturing Ltd.,IE,1189897.68
15/07/2024,15/07/2024,Alphagrid Utilities,Rent & Utilities,ALL,10262.98,0,EUR,SEPA Credit Transfer,Alphagrid Utilities,***3691,,,FALSE,FALSE,REF-543861,First Continental Bank,***9080,Globex EMEA Manufacturing Ltd.,IE,1179634.7
15/07/2024,15/07/2024,Loan Interest Payment,Loan Interest,ALL,85000,0,EUR,SEPA Credit Transfer,First Continental Bank - Corporate Lending,***7280,,,FALSE,FALSE,REF-508469,First Continental Bank,***5424,Globex EMEA Manufacturing Ltd.,IE,1094634.7
15/07/2024,15/07/2024,Loan Principal Repayment,Loan Principal,ALL,500000,0,EUR,SWIFT MT103,First Continental Bank - Corporate Lending,***1274,,,FALSE,FALSE,REF-442349,First Continental Bank,***4088,Globex EMEA Manufacturing Ltd.,IE,594634.7
15/07/2024,15/07/2024,Client Receipt - CloudBridge Co. #32,Sales Receipt,SaaS-GL,0,20072.66,EUR,SEPA SCT,CloudBridge Co. #32,***6093,INV-202407-SaaS-GL-0002,,FALSE,FALSE,REF-923164,First Continental Bank,***3653,Globex EMEA Manufacturing Ltd.,IE,614707.36
15/07/2024,15/07/2024,Client Receipt - Aurora Electronics GmbH #9,Sales Receipt,CEM-EMEA,0,33801.51,EUR,SEPA SCT,Aurora Electronics GmbH #9,***6644,INV-202407-CEM-EMEA-0002,,FALSE,FALSE,REF-775096,First Continental Bank,***8979,Globex EMEA Manufacturing Ltd.,IE,648508.87
15/07/2024,15/07/2024,Client Receipt - CloudBridge Co. #2,Sales Receipt,SaaS-GL,0,47025.2,EUR,Card Settlement,CloudBridge Co. #2,***2485,INV-202407-SaaS-GL-0007,,FALSE,FALSE,REF-982823,First Continental Bank,***7904,Globex EMEA Manufacturing Ltd.,IE,695534.07
16/07/2024,16/07/2024,Supplier Payment - ExpertNet Subcontractors #12,Supplier Payment,PS-GL,2344.49,0,EUR,SEPA Debit,ExpertNet Subcontractors #12,***6528,,PO-202407-PS-GL-0004,FALSE,FALSE,REF-793604,First Continental Bank,***2592,Globex EMEA Manufacturing Ltd.,IE,693189.58
17/07/2024,17/07/2024,Client Receipt - CloudBridge Co. #48,Sales Receipt,SaaS-GL,0,21951.97,EUR,SEPA SCT Inst,CloudBridge Co. #48,***2008,INV-202407-SaaS-GL-0008,,FALSE,FALSE,REF-242947,First Continental Bank,***7591,Globex EMEA Manufacturing Ltd.,IE,715141.55
17/07/2024,17/07/2024,Client Receipt - CloudBridge Co. #19,Sales Receipt,SaaS-GL,0,43662.83,EUR,SEPA SCT Inst,CloudBridge Co. #19,***8673,INV-202407-SaaS-GL-0001,,FALSE,FALSE,REF-752602,First Continental Bank,***5734,Globex EMEA Manufacturing Ltd.,IE,758804.38
17/07/2024,17/07/2024,Client Receipt - CloudBridge Co. #60,Sales Receipt,SaaS-GL,0,67163.33,EUR,SEPA SCT Inst,CloudBridge Co. #60,***1755,INV-202407-SaaS-GL-0020,,FALSE,FALSE,REF-260949,First Continental Bank,***2931,Globex EMEA Manufacturing Ltd.,IE,825967.71
18/07/2024,18/07/2024,Supplier Payment - ExpertNet Subcontractors #12,Supplier Payment,PS-GL,24419.06,0,EUR,SEPA Debit,ExpertNet Subcontractors #12,***6248,,PO-202407-PS-GL-0009,FALSE,FALSE,REF-574394,First Continental Bank,***1388,Globex EMEA Manufacturing Ltd.,IE,801548.65
19/07/2024,19/07/2024,Supplier Payment - HyperCloud Infra #12,Supplier Payment,SaaS-GL,13781.91,0,EUR,SEPA Credit Transfer,HyperCloud Infra #12,***2784,,PO-202407-SaaS-GL-0004,FALSE,FALSE,REF-205247,First Continental Bank,***2821,Globex EMEA Manufacturing Ltd.,IE,787766.74
19/07/2024,19/07/2024,VAT/GST Remittance - Revenue Ireland,Tax Payment,ALL,130710.08,0,EUR,SEPA Credit Transfer,Revenue Ireland,***6118,,,FALSE,FALSE,REF-380058,First Continental Bank,***5528,Globex EMEA Manufacturing Ltd.,IE,657056.66
21/07/2024,21/07/2024,Northshore Power,Rent & Utilities,ALL,5937.01,0,EUR,SEPA Credit Transfer,Northshore Power,***5113,,,FALSE,FALSE,REF-255794,First Continental Bank,***1319,Globex EMEA Manufacturing Ltd.,IE,651119.65
21/07/2024,21/07/2024,Supplier Payment - Stelliform Parts BV #34,Supplier Payment,CEM-EMEA,23049.71,0,EUR,SEPA Debit,Stelliform Parts BV #34,***1972,,PO-202407-CEM-EMEA-0001,FALSE,FALSE,REF-891662,First Continental Bank,***3460,Globex EMEA Manufacturing Ltd.,IE,628069.94
22/07/2024,22/07/2024,Supplier Payment - HyperCloud Infra #14,Supplier Payment,SaaS-GL,33299.29,0,EUR,SEPA Credit Transfer,HyperCloud Infra #14,***3494,,PO-202407-SaaS-GL-0001,FALSE,FALSE,REF-435559,First Continental Bank,***2950,Globex EMEA Manufacturing Ltd.,IE,594770.65
22/07/2024,22/07/2024,Client Receipt - Aurora Electronics GmbH #10,Sales Receipt,CEM-EMEA,0,93055.5,EUR,SEPA SCT Inst,Aurora Electronics GmbH #10,***3196,INV-202407-CEM-EMEA-0012,,FALSE,FALSE,REF-377335,First Continental Bank,***3553,Globex EMEA Manufacturing Ltd.,IE,687826.15
23/07/2024,23/07/2024,Supplier Payment - ExpertNet Subcontractors #6,Supplier Payment,PS-GL,13632.26,0,EUR,SEPA Credit Transfer,ExpertNet Subcontractors #6,***5717,,PO-202407-PS-GL-0001,FALSE,FALSE,REF-125822,First Continental Bank,***1598,Globex EMEA Manufacturing Ltd.,IE,674193.89
23/07/2024,23/07/2024,Client Receipt - CloudBridge Co. #63,Sales Receipt,SaaS-GL,0,114013.32,EUR,SEPA SCT Inst,CloudBridge Co. #63,***3077,INV-202407-SaaS-GL-0011,,FALSE,FALSE,REF-988813,First Continental Bank,***7373,Globex EMEA Manufacturing Ltd.,IE,788207.21
24/07/2024,24/07/2024,Supplier Payment - EuroFab Assembly #18,Supplier Payment,CEM-EMEA,1818.33,0,EUR,SWIFT MT103,EuroFab Assembly #18,***8940,,PO-202407-CEM-EMEA-0008,FALSE,FALSE,REF-657293,First Continental Bank,***2755,Globex EMEA Manufacturing Ltd.,IE,786388.88
24/07/2024,24/07/2024,Supplier Payment - ExpertNet Subcontractors #12,Supplier Payment,PS-GL,4039.51,0,EUR,SWIFT MT103,ExpertNet Subcontractors #12,***2533,,PO-202407-PS-GL-0007,FALSE,FALSE,REF-683802,First Continental Bank,***2114,Globex EMEA Manufacturing Ltd.,IE,782349.37
24/07/2024,24/07/2024,Client Receipt - CloudBridge Co. #6,Sales Receipt,SaaS-GL,0,14141.82,EUR,Card Settlement,CloudBridge Co. #6,***6877,INV-202407-SaaS-GL-0009,,FALSE,FALSE,REF-389072,First Continental Bank,***7811,Globex EMEA Manufacturing Ltd.,IE,796491.19
24/07/2024,24/07/2024,Client Receipt - Vertex Advisory Client #21,Sales Receipt,PS-GL,0,19207.68,EUR,SEPA SCT Inst,Vertex Advisory Client #21,***1436,INV-202407-PS-GL-0001,,FALSE,FALSE,REF-217590,First Continental Bank,***7060,Globex EMEA Manufacturing Ltd.,IE,815698.87
24/07/2024,24/07/2024,Client Receipt - Vertex Advisory Client #46,Sales Receipt,PS-GL,0,101011.88,EUR,SEPA SCT,Vertex Advisory Client #46,***4957,INV-202407-PS-GL-0002,,FALSE,FALSE,REF-992352,First Continental Bank,***7475,Globex EMEA Manufacturing Ltd.,IE,916710.75
25/07/2024,25/07/2024,Supplier Payment - CodeCraft Contractors #3,Supplier Payment,SaaS-GL,3862.27,0,EUR,SWIFT MT103,CodeCraft Contractors #3,***2712,,PO-202407-SaaS-GL-0008,FALSE,FALSE,REF-555094,First Continental Bank,***6589,Globex EMEA Manufacturing Ltd.,IE,912848.48
25/07/2024,25/07/2024,Client Receipt - CloudBridge Co. #36,Sales Receipt,SaaS-GL,0,6852.02,EUR,Card Settlement,CloudBridge Co. #36,***9350,INV-202407-SaaS-GL-0024,,FALSE,FALSE,REF-396750,First Continental Bank,***3915,Globex EMEA Manufacturing Ltd.,IE,919700.5
25/07/2024,25/07/2024,Client Receipt - CloudBridge Co. #76,Sales Receipt,SaaS-GL,0,11171.09,EUR,SEPA SCT Inst,CloudBridge Co. #76,***4228,INV-202407-SaaS-GL-0021,,FALSE,FALSE,REF-698410,First Continental Bank,***5019,Globex EMEA Manufacturing Ltd.,IE,930871.59
26/07/2024,26/07/2024,Supplier Payment - ExpertNet Subcontractors #7,Supplier Payment,PS-GL,9072.9,0,EUR,SEPA Debit,ExpertNet Subcontractors #7,***8283,,PO-202407-PS-GL-0002,FALSE,FALSE,REF-518752,First Continental Bank,***4414,Globex EMEA Manufacturing Ltd.,IE,921798.69
26/07/2024,26/07/2024,Supplier Payment - CodeCraft Contractors #9,Supplier Payment,SaaS-GL,20024.49,0,EUR,SEPA Debit,CodeCraft Contractors #9,***4120,,PO-202407-SaaS-GL-0007,FALSE,FALSE,REF-155085,First Continental Bank,***1574,Globex EMEA Manufacturing Ltd.,IE,901774.2
26/07/2024,26/07/2024,Intercompany Settlement - Globex APAC Logistics Pte. Ltd.,Intercompany Transfer,ALL,309947,0,EUR,Internal Transfer,Globex APAC Logistics Pte. Ltd.,***6417,,,TRUE,TRUE,REF-878486,First Continental Bank,***6370,Globex EMEA Manufacturing Ltd.,IE,591827.2
28/07/2024,28/07/2024,Corporate Tax Estimate,Tax Payment,ALL,89310.58,0,EUR,SWIFT MT103,Revenue Ireland,***3723,,,FALSE,FALSE,REF-254295,First Continental Bank,***5868,Globex EMEA Manufacturing Ltd.,IE,502516.62
29/07/2024,29/07/2024,Supplier Payment - Stelliform Parts BV #2,Supplier Payment,CEM-EMEA,16021.96,0,EUR,SEPA Credit Transfer,Stelliform Parts BV #2,***6374,,PO-202407-CEM-EMEA-0012,FALSE,FALSE,REF-266996,First Continental Bank,***5595,Globex EMEA Manufacturing Ltd.,IE,486494.66
29/07/2024,29/07/2024,Payroll - GlobalPay Services Ltd,Payroll,ALL,164263.29,0,EUR,SEPA Debit,GlobalPay Services Ltd,***9194,,,FALSE,FALSE,REF-757089,First Continental Bank,***7663,Globex EMEA Manufacturing Ltd.,IE,322231.37
29/07/2024,29/07/2024,Payroll - GlobalPay Services Ltd,Payroll,ALL,164263.29,0,EUR,SEPA Credit Transfer,GlobalPay Services Ltd,***8854,,,FALSE,FALSE,REF-807550,First Continental Bank,***6862,Globex EMEA Manufacturing Ltd.,IE,157968.08
29/07/2024,29/07/2024,Client Receipt - Novatek Components Ltd #12,Sales Receipt,CEM-EMEA,0,3838.9,EUR,SEPA SCT,Novatek Components Ltd #12,***8644,INV-202407-CEM-EMEA-0008,,FALSE,FALSE,REF-509657,First Continental Bank,***3236,Globex EMEA Manufacturing Ltd.,IE,161806.98
29/07/2024,29/07/2024,Client Receipt - Novatek Components Ltd #3,Sales Receipt,CEM-EMEA,0,14441.99,EUR,SEPA SCT Inst,Novatek Components Ltd #3,***7079,INV-202407-CEM-EMEA-0010,,FALSE,FALSE,REF-284915,First Continental Bank,***1954,Globex EMEA Manufacturing Ltd.,IE,176248.97
30/07/2024,30/07/2024,Supplier Payment - Stelliform Parts BV #19,Supplier Payment,CEM-EMEA,2456.09,0,EUR,SEPA Debit,Stelliform Parts BV #19,***8906,,PO-202407-CEM-EMEA-0002,FALSE,FALSE,REF-679410,First Continental Bank,***5651,Globex EMEA Manufacturing Ltd.,IE,173792.88
30/07/2024,30/07/2024,Supplier Payment - HyperCloud Infra #10,Supplier Payment,SaaS-GL,7793.79,0,EUR,SEPA Credit Transfer,HyperCloud Infra #10,***5222,,PO-202407-SaaS-GL-0006,FALSE,FALSE,REF-956773,First Continental Bank,***2006,Globex EMEA Manufacturing Ltd.,IE,165999.09
30/07/2024,30/07/2024,Supplier Payment - Stelliform Parts BV #23,Supplier Payment,CEM-EMEA,18619.07,0,EUR,SWIFT MT103,Stelliform Parts BV #23,***9396,,PO-202407-CEM-EMEA-0009,FALSE,FALSE,REF-816369,First Continental Bank,***3894,Globex EMEA Manufacturing Ltd.,IE,147380.02
30/07/2024,30/07/2024,Supplier Payment - Stelliform Parts BV #12,Supplier Payment,CEM-EMEA,136697.35,0,EUR,SEPA Credit Transfer,Stelliform Parts BV #12,***4921,,PO-202407-CEM-EMEA-0005,FALSE,FALSE,REF-108250,First Continental Bank,***3190,Globex EMEA Manufacturing Ltd.,IE,10682.67
30/07/2024,30/07/2024,Client Receipt - CloudBridge Co. #55,Sales Receipt,SaaS-GL,0,2543.36,EUR,SEPA SCT,CloudBridge Co. #55,***4604,INV-202407-SaaS-GL-0004,,FALSE,FALSE,REF-647982,First Continental Bank,***6217,Globex EMEA Manufacturing Ltd.,IE,13226.03
30/07/2024,30/07/2024,Interest Earned,Interest Income,ALL,0,11980.71,EUR,SEPA SCT,First Continental Bank,***9332,,,FALSE,FALSE,REF-315183,First Continental Bank,***2480,Globex EMEA Manufacturing Ltd.,IE,25206.74
30/07/2024,30/07/2024,Client Receipt - Novatek Components Ltd #12,Sales Receipt,CEM-EMEA,0,14275.58,EUR,SEPA SCT,Novatek Components Ltd #12,***4028,INV-202407-CEM-EMEA-0016,,FALSE,FALSE,REF-192491,First Continental Bank,***7404,Globex EMEA Manufacturing Ltd.,IE,39482.32
30/07/2024,30/07/2024,Client Receipt - Vertex Advisory Client #52,Sales Receipt,PS-GL,0,77119.83,EUR,SEPA SCT,Vertex Advisory Client #52,***2931,INV-202407-PS-GL-0003,,FALSE,FALSE,REF-758664,First Continental Bank,***2747,Globex EMEA Manufacturing Ltd.,IE,116602.15
31/07/2024,31/07/2024,Supplier Payment - ExpertNet Subcontractors #17,Supplier Payment,PS-GL,4216.39,0,EUR,SWIFT MT103,ExpertNet Subcontractors #17,***7266,,PO-202407-PS-GL-0008,FALSE,FALSE,REF-562844,First Continental Bank,***7980,Globex EMEA Manufacturing Ltd.,IE,112385.76
31/07/2024,31/07/2024,Supplier Payment - HyperCloud Infra #17,Supplier Payment,SaaS-GL,14632.82,0,EUR,SEPA Credit Transfer,HyperCloud Infra #17,***9647,,PO-202407-SaaS-GL-0002,FALSE,FALSE,REF-693755,First Continental Bank,***7617,Globex EMEA Manufacturing Ltd.,IE,97752.94
31/07/2024,31/07/2024,Client Receipt - Vertex Advisory Client #18,Sales Receipt,PS-GL,0,18427.21,EUR,Card Settlement,Vertex Advisory Client #18,***6724,INV-202407-PS-GL-0009,,FALSE,FALSE,REF-868085,First Continental Bank,***8579,Globex EMEA Manufacturing Ltd.,IE,116180.15
01/08/2024,01/08/2024,Account Maintenance Fee,Bank/Merchant Fees,ALL,2500,0,EUR,SEPA Credit Transfer,First Continental Bank,***1135,,,FALSE,FALSE,REF-553329,First Continental Bank,***2271,Globex EMEA Manufacturing Ltd.,IE,113680.15
01/08/2024,01/08/2024,Client Receipt - CloudBridge Co. #13,Sales Receipt,SaaS-GL,0,30482.83,EUR,SEPA SCT,CloudBridge Co. #13,***2411,INV-202408-SaaS-GL-0011,,FALSE,FALSE,REF-626399,First Continental Bank,***8724,Globex EMEA Manufacturing Ltd.,IE,144162.98
02/08/2024,02/08/2024,Supplier Payment - ExpertNet Subcontractors #10,Supplier Payment,PS-GL,1482.8,0,EUR,SWIFT MT103,ExpertNet Subcontractors #10,***4522,,PO-202408-PS-GL-0011,FALSE,FALSE,REF-773961,First Continental Bank,***3746,Globex EMEA Manufacturing Ltd.,IE,142680.18
02/08/2024,02/08/2024,Supplier Payment - ExpertNet Subcontractors #10,Supplier Payment,PS-GL,4075.16,0,EUR,SWIFT MT103,ExpertNet Subcontractors #10,***5226,,PO-202408-PS-GL-0010,FALSE,FALSE,REF-934268,First Continental Bank,***8996,Globex EMEA Manufacturing Ltd.,IE,138605.02
02/08/2024,02/08/2024,Client Receipt - Novatek Components Ltd #10,Sales Receipt,CEM-EMEA,0,25131.7,EUR,SEPA SCT,Novatek Components Ltd #10,***5649,INV-202408-CEM-EMEA-0012,,FALSE,FALSE,REF-129872,First Continental Bank,***7077,Globex EMEA Manufacturing Ltd.,IE,163736.72
03/08/2024,03/08/2024,Marketing - Beacon Digital #9,Marketing,ALL,5231.35,0,EUR,SEPA Debit,Beacon Digital #9,***4098,,,FALSE,FALSE,REF-363785,First Continental Bank,***1063,Globex EMEA Manufacturing Ltd.,IE,158505.37
05/08/2024,05/08/2024,Supplier Payment - ExpertNet Subcontractors #3,Supplier Payment,PS-GL,8687.4,0,EUR,SEPA Credit Transfer,ExpertNet Subcontractors #3,***5209,,PO-202408-PS-GL-0003,FALSE,FALSE,REF-374950,First Continental Bank,***6038,Globex EMEA Manufacturing Ltd.,IE,149817.97
05/08/2024,05/08/2024,Supplier Payment - CodeCraft Contractors #8,Supplier Payment,SaaS-GL,13734.22,0,EUR,SEPA Credit Transfer,CodeCraft Contractors #8,***5194,,PO-202408-SaaS-GL-0007,FALSE,FALSE,REF-966629,First Continental Bank,***5893,Globex EMEA Manufacturing Ltd.,IE,136083.75
05/08/2024,05/08/2024,Supplier Payment - Stelliform Parts BV #29,Supplier Payment,CEM-EMEA,81547.36,0,EUR,SWIFT MT103,Stelliform Parts BV #29,***7860,,PO-202408-CEM-EMEA-0007,FALSE,FALSE,REF-279113,First Continental Bank,***7748,Globex EMEA Manufacturing Ltd.,IE,54536.39
05/08/2024,05/08/2024,Client Receipt - CloudBridge Co. #69,Sales Receipt,SaaS-GL,0,9830.73,EUR,SEPA SCT Inst,CloudBridge Co. #69,***3696,INV-202408-SaaS-GL-0014,,FALSE,FALSE,REF-687887,First Continental Bank,***9780,Globex EMEA Manufacturing Ltd.,IE,64367.12
05/08/2024,05/08/2024,Client Receipt - CloudBridge Co. #35,Sales Receipt,SaaS-GL,0,26499.28,EUR,SEPA SCT Inst,CloudBridge Co. #35,***5421,INV-202408-SaaS-GL-0016,,FALSE,FALSE,REF-505428,First Continental Bank,***8970,Globex EMEA Manufacturing Ltd.,IE,90866.4
05/08/2024,05/08/2024,Client Receipt - CloudBridge Co. #2,Sales Receipt,SaaS-GL,0,77428.94,EUR,SEPA SCT,CloudBridge Co. #2,***7355,INV-202408-SaaS-GL-0020,,FALSE,FALSE,REF-953486,First Continental Bank,***4737,Globex EMEA Manufacturing Ltd.,IE,168295.34
06/08/2024,06/08/2024,Supplier Payment - ExpertNet Subcontractors #13,Supplier Payment,PS-GL,9555.06,0,EUR,SEPA Credit Transfer,ExpertNet Subcontractors #13,***7301,,PO-202408-PS-GL-0004,FALSE,FALSE,REF-962001,First Continental Bank,***5408,Globex EMEA Manufacturing Ltd.,IE,158740.28
06/08/2024,06/08/2024,Supplier Payment - ExpertNet Subcontractors #8,Supplier Payment,PS-GL,12406.62,0,EUR,SWIFT MT103,ExpertNet Subcontractors #8,***8082,,PO-202408-PS-GL-0005,FALSE,FALSE,REF-584631,First Continental Bank,***2671,Globex EMEA Manufacturing Ltd.,IE,146333.66
06/08/2024,06/08/2024,Supplier Payment - Stelliform Parts BV #11,Supplier Payment,CEM-EMEA,22509.55,0,EUR,SEPA Debit,Stelliform Parts BV #11,***1867,,PO-202408-CEM-EMEA-0006,FALSE,FALSE,REF-727318,First Continental Bank,***1094,Globex EMEA Manufacturing Ltd.,IE,123824.11
06/08/2024,06/08/2024,Client Receipt - CloudBridge Co. #27,Sales Receipt,SaaS-GL,0,431.07,EUR,SEPA SCT Inst,CloudBridge Co. #27,***7673,INV-202408-SaaS-GL-0008,,FALSE,FALSE,REF-524871,First Continental Bank,***3990,Globex EMEA Manufacturing Ltd.,IE,124255.18
06/08/2024,06/08/2024,Client Receipt - Vertex Advisory Client #23,Sales Receipt,PS-GL,0,7104.99,EUR,Card Settlement,Vertex Advisory Client #23,***3548,INV-202408-PS-GL-0011,,FALSE,FALSE,REF-312904,First Continental Bank,***9821,Globex EMEA Manufacturing Ltd.,IE,131360.17
07/08/2024,07/08/2024,Client Receipt - CloudBridge Co. #11,Sales Receipt,SaaS-GL,0,11064.3,EUR,Card Settlement,CloudBridge Co. #11,***5656,INV-202408-SaaS-GL-0021,,FALSE,FALSE,REF-660703,First Continental Bank,***8087,Globex EMEA Manufacturing Ltd.,IE,142424.47
07/08/2024,07/08/2024,Client Receipt - CloudBridge Co. #11,Sales Receipt,SaaS-GL,0,34641.65,EUR,SEPA SCT,CloudBridge Co. #11,***4139,INV-202408-SaaS-GL-0024,,FALSE,FALSE,REF-972668,First Continental Bank,***9340,Globex EMEA Manufacturing Ltd.,IE,177066.12
07/08/2024,07/08/2024,Client Receipt - Vertex Advisory Client #21,Sales Receipt,PS-GL,0,40823.39,EUR,SEPA SCT,Vertex Advisory Client #21,***2659,INV-202408-PS-GL-0008,,FALSE,FALSE,REF-803991,First Continental Bank,***4245,Globex EMEA Manufacturing Ltd.,IE,217889.51
07/08/2024,07/08/2024,Client Receipt - Novatek Components Ltd #8,Sales Receipt,CEM-EMEA,0,77431.44,EUR,SEPA SCT Inst,Novatek Components Ltd #8,***1698,INV-202408-CEM-EMEA-0011,,FALSE,FALSE,REF-774252,First Continental Bank,***6204,Globex EMEA Manufacturing Ltd.,IE,295320.95
09/08/2024,09/08/2024,Client Receipt - CloudBridge Co. #55,Sales Receipt,SaaS-GL,0,4751.75,EUR,SEPA SCT,CloudBridge Co. #55,***9771,INV-202408-SaaS-GL-0004,,FALSE,FALSE,REF-195183,First Continental Bank,***6973,Globex EMEA Manufacturing Ltd.,IE,300072.7
10/08/2024,10/08/2024,Supplier Payment - HyperCloud Infra #15,Supplier Payment,SaaS-GL,5155.77,0,EUR,SWIFT MT103,HyperCloud Infra #15,***7152,,PO-202408-SaaS-GL-0009,FALSE,FALSE,REF-101960,First Continental Bank,***8906,Globex EMEA Manufacturing Ltd.,IE,294916.93
12/08/2024,12/08/2024,Supplier Payment - CodeCraft Contractors #4,Supplier Payment,SaaS-GL,19493.26,0,EUR,SEPA Credit Transfer,CodeCraft Contractors #4,***5893,,PO-202408-SaaS-GL-0010,FALSE,FALSE,REF-282234,First Continental Bank,***7420,Globex EMEA Manufacturing Ltd.,IE,275423.67
12/08/2024,12/08/2024,Supplier Payment - Stelliform Parts BV #30,Supplier Payment,CEM-EMEA,32764.37,0,EUR,SEPA Debit,Stelliform Parts BV #30,***2663,,PO-202408-CEM-EMEA-0002,FALSE,FALSE,REF-470006,First Continental Bank,***1520,Globex EMEA Manufacturing Ltd.,IE,242659.3
12/08/2024,12/08/2024,"Intercompany Settlement - Globex International Holdings, Inc.",Intercompany Transfer,ALL,667911,0,EUR,Internal Transfer,"Globex International Holdings, Inc.",***3634,,,TRUE,TRUE,REF-276350,First Continental Bank,***5204,Globex EMEA Manufacturing Ltd.,IE,-425251.7
12/08/2024,12/08/2024,Client Receipt - CloudBridge Co. #66,Sales Receipt,SaaS-GL,0,11263.61,EUR,SEPA SCT Inst,CloudBridge Co. #66,***5298,INV-202408-SaaS-GL-0013,,FALSE,FALSE,REF-996632,First Continental Bank,***3705,Globex EMEA Manufacturing Ltd.,IE,-413988.09
12/08/2024,12/08/2024,Client Receipt - CloudBridge Co. #20,Sales Receipt,SaaS-GL,0,29236.3,EUR,Card Settlement,CloudBridge Co. #20,***9816,INV-202408-SaaS-GL-0003,,FALSE,FALSE,REF-550020,First Continental Bank,***7981,Globex EMEA Manufacturing Ltd.,IE,-384751.79
12/08/2024,12/08/2024,"Intercompany Reimbursement - Globex International Holdings, Inc.",Intercompany Transfer,ALL,0,267164.4,EUR,Internal Transfer,"Globex International Holdings, Inc.",***9858,,,TRUE,TRUE,REF-545990,First Continental Bank,***2329,Globex EMEA Manufacturing Ltd.,IE,-117587.39
13/08/2024,13/08/2024,Supplier Payment - HyperCloud Infra #9,Supplier Payment,SaaS-GL,4900.41,0,EUR,SWIFT MT103,HyperCloud Infra #9,***9803,,PO-202408-SaaS-GL-0004,FALSE,FALSE,REF-117456,First Continental Bank,***8680,Globex EMEA Manufacturing Ltd.,IE,-122487.8
13/08/2024,13/08/2024,Client Receipt - Vertex Advisory Client #19,Sales Receipt,PS-GL,0,6608.6,EUR,SEPA SCT Inst,Vertex Advisory Client #19,***8428,INV-202408-PS-GL-0003,,FALSE,FALSE,REF-163643,First Continental Bank,***4872,Globex EMEA Manufacturing Ltd.,IE,-115879.2
13/08/2024,13/08/2024,Client Receipt - Vertex Advisory Client #11,Sales Receipt,PS-GL,0,32113.89,EUR,SEPA SCT Inst,Vertex Advisory Client #11,***7196,INV-202408-PS-GL-0002,,FALSE,FALSE,REF-382828,First Continental Bank,***9740,Globex EMEA Manufacturing Ltd.,IE,-83765.31
13/08/2024,13/08/2024,Client Receipt - Aurora Electronics GmbH #8,Sales Receipt,CEM-EMEA,0,51583.81,EUR,Card Settlement,Aurora Electronics GmbH #8,***3579,INV-202408-CEM-EMEA-0007,,FALSE,FALSE,REF-166373,First Continental Bank,***7843,Globex EMEA Manufacturing Ltd.,IE,-32181.5
14/08/2024,14/08/2024,Client Receipt - CloudBridge Co. #56,Sales Receipt,SaaS-GL,0,5410.42,EUR,Card Settlement,CloudBridge Co. #56,***2443,INV-202408-SaaS-GL-0001,,FALSE,FALSE,REF-911349,First Continental Bank,***9458,Globex EMEA Manufacturing Ltd.,IE,-26771.08
14/08/2024,14/08/2024,Client Receipt - CloudBridge Co. #14,Sales Receipt,SaaS-GL,0,34726.51,EUR,SEPA SCT Inst,CloudBridge Co. #14,***7166,INV-202408-SaaS-GL-0007,,FALSE,FALSE,REF-727847,First Continental Bank,***9436,Globex EMEA Manufacturing Ltd.,IE,7955.43
14/08/2024,14/08/2024,Client Receipt - Novatek Components Ltd #7,Sales Receipt,CEM-EMEA,0,61424.17,EUR,SEPA SCT,Novatek Components Ltd #7,***4603,INV-202408-CEM-EMEA-0009,,FALSE,FALSE,REF-195125,First Continental Bank,***5935,Globex EMEA Manufacturing Ltd.,IE,69379.6
14/08/2024,14/08/2024,Client Receipt - Aurora Electronics GmbH #16,Sales Receipt,CEM-EMEA,0,83695.43,EUR,SEPA SCT Inst,Aurora Electronics GmbH #16,***1216,INV-202408-CEM-EMEA-0005,,FALSE,FALSE,REF-196103,First Continental Bank,***3176,Globex EMEA Manufacturing Ltd.,IE,153075.03
15/08/2024,15/08/2024,Supplier Payment - ExpertNet Subcontractors #9,Supplier Payment,PS-GL,8602.23,0,EUR,SWIFT MT103,ExpertNet Subcontractors #9,***6247,,PO-202408-PS-GL-0002,FALSE,FALSE,REF-461779,First Continental Bank,***8416,Globex EMEA Manufacturing Ltd.,IE,144472.8
15/08/2024,15/08/2024,Supplier Payment - Stelliform Parts BV #23,Supplier Payment,CEM-EMEA,11102.47,0,EUR,SEPA Debit,Stelliform Parts BV #23,***7743,,PO-202408-CEM-EMEA-0003,FALSE,FALSE,REF-725146,First Continental Bank,***5002,Globex EMEA Manufacturing Ltd.,IE,133370.33
15/08/2024,15/08/2024,Supplier Payment - ExpertNet Subcontractors #5,Supplier Payment,PS-GL,15827.67,0,EUR,SEPA Debit,ExpertNet Subcontractors #5,***4596,,PO-202408-PS-GL-0008,FALSE,FALSE,REF-428295,First Continental Bank,***9445,Globex EMEA Manufacturing Ltd.,IE,117542.66
15/08/2024,15/08/2024,Loan Interest Payment,Loan Interest,ALL,85000,0,EUR,SEPA Credit Transfer,First Continental Bank - Corporate Lending,***4937,,,FALSE,FALSE,REF-215540,First Continental Bank,***1836,Globex EMEA Manufacturing Ltd.,IE,32542.66
15/08/2024,15/08/2024,Loan Principal Repayment,Loan Principal,ALL,500000,0,EUR,SEPA Credit Transfer,First Continental Bank - Corporate Lending,***9607,,,FALSE,FALSE,REF-598000,First Continental Bank,***8201,Globex EMEA Manufacturing Ltd.,IE,-467457.34
16/08/2024,16/08/2024,Merchant Processing Fees,Bank/Merchant Fees,ALL,5507.85,0,EUR,SEPA Credit Transfer,First Continental Bank,***3404,,,FALSE,FALSE,REF-440055,First Continental Bank,***1665,Globex EMEA Manufacturing Ltd.,IE,-472965.19
18/08/2024,18/08/2024,Client Receipt - Vertex Advisory Client #12,Sales Receipt,PS-GL,0,31299.71,EUR,Card Settlement,Vertex Advisory Client #12,***7363,INV-202408-PS-GL-0010,,FALSE,FALSE,REF-852533,First Continental Bank,***3364,Globex EMEA Manufacturing Ltd.,IE,-441665.48
18/08/2024,18/08/2024,Client Receipt - Novatek Components Ltd #11,Sales Receipt,CEM-EMEA,0,35617.42,EUR,Card Settlement,Novatek Components Ltd #11,***8050,INV-202408-CEM-EMEA-0002,,FALSE,FALSE,REF-169454,First Continental Bank,***2842,Globex EMEA Manufacturing Ltd.,IE,-406048.06
18/08/2024,18/08/2024,Client Receipt - Aurora Electronics GmbH #1,Sales Receipt,CEM-EMEA,0,73989.2,EUR,Card Settlement,Aurora Electronics GmbH #1,***6104,INV-202408-CEM-EMEA-0004,,FALSE,FALSE,REF-806201,First Continental Bank,***6886,Globex EMEA Manufacturing Ltd.,IE,-332058.86
19/08/2024,19/08/2024,Supplier Payment - HyperCloud Infra #6,Supplier Payment,SaaS-GL,3343.21,0,EUR,SEPA Credit Transfer,HyperCloud Infra #6,***8011,,PO-202408-SaaS-GL-0001,FALSE,FALSE,REF-441220,First Continental Bank,***6087,Globex EMEA Manufacturing Ltd.,IE,-335402.07
19/08/2024,19/08/2024,VAT/GST Remittance - Revenue Ireland,Tax Payment,ALL,117302.5,0,EUR,SWIFT MT103,Revenue Ireland,***6736,,,FALSE,FALSE,REF-758545,First Continental Bank,***1635,Globex EMEA Manufacturing Ltd.,IE,-452704.57
19/08/2024,19/08/2024,Client Receipt - CloudBridge Co. #65,Sales Receipt,SaaS-GL,0,38573.83,EUR,SEPA SCT Inst,CloudBridge Co. #65,***4880,INV-202408-SaaS-GL-0019,,FALSE,FALSE,REF-769913,First Continental Bank,***9119,Globex EMEA Manufacturing Ltd.,IE,-414130.74
20/08/2024,20/08/2024,Client Receipt - CloudBridge Co. #14,Sales Receipt,SaaS-GL,0,7883.86,EUR,Card Settlement,CloudBridge Co. #14,***7147,INV-202408-SaaS-GL-0018,,FALSE,FALSE,REF-624686,First Continental Bank,***6566,Globex EMEA Manufacturing Ltd.,IE,-406246.88
20/08/2024,20/08/2024,Client Receipt - CloudBridge Co. #53,Sales Receipt,SaaS-GL,0,62556.71,EUR,Card Settlement,CloudBridge Co. #53,***4384,INV-202408-SaaS-GL-0022,,FALSE,FALSE,REF-607615,First Continental Bank,***7446,Globex EMEA Manufacturing Ltd.,IE,-343690.17
21/08/2024,21/08/2024,Supplier Payment - ExpertNet Subcontractors #4,Supplier Payment,PS-GL,5102.96,0,EUR,SEPA Credit Transfer,ExpertNet Subcontractors #4,***9536,,PO-202408-PS-GL-0001,FALSE,FALSE,REF-754224,First Continental Bank,***5933,Globex EMEA Manufacturing Ltd.,IE,-348793.13
21/08/2024,21/08/2024,Client Receipt - Novatek Components Ltd #3,Sales Receipt,CEM-EMEA,0,154484.96,EUR,SEPA SCT,Novatek Components Ltd #3,***9308,INV-202408-CEM-EMEA-0001,,FALSE,FALSE,REF-847655,First Continental Bank,***1683,Globex EMEA Manufacturing Ltd.,IE,-194308.17
22/08/2024,22/08/2024,Merchant Processing Fees,Bank/Merchant Fees,ALL,359.02,0,EUR,SWIFT MT103,First Continental Bank,***6527,,,FALSE,FALSE,REF-813256,First Continental Bank,***1755,Globex EMEA Manufacturing Ltd.,IE,-194667.19
22/08/2024,22/08/2024,Supplier Payment - HyperCloud Infra #12,Supplier Payment,SaaS-GL,39476.33,0,EUR,SEPA Credit Transfer,HyperCloud Infra #12,***3231,,PO-202408-SaaS-GL-0008,FALSE,FALSE,REF-786090,First Continental Bank,***6709,Globex EMEA Manufacturing Ltd.,IE,-234143.52
22/08/2024,22/08/2024,Supplier Payment - Stelliform Parts BV #23,Supplier Payment,CEM-EMEA,275726.52,0,EUR,SEPA Debit,Stelliform Parts BV #23,***7177,,PO-202408-CEM-EMEA-0008,FALSE,FALSE,REF-353629,First Continental Bank,***5223,Globex EMEA Manufacturing Ltd.,IE,-509870.04
22/08/2024,22/08/2024,Client Receipt - CloudBridge Co. #32,Sales Receipt,SaaS-GL,0,4205.78,EUR,Card Settlement,CloudBridge Co. #32,***4122,INV-202408-SaaS-GL-0002,,FALSE,FALSE,REF-144896,First Continental Bank,***4002,Globex EMEA Manufacturing Ltd.,IE,-505664.26
22/08/2024,22/08/2024,Client Receipt - Vertex Advisory Client #26,Sales Receipt,PS-GL,0,41409.41,EUR,SEPA SCT Inst,Vertex Advisory Client #26,***6937,INV-202408-PS-GL-0005,,FALSE,FALSE,REF-651453,First Continental Bank,***1511,Globex EMEA Manufacturing Ltd.,IE,-464254.85
23/08/2024,23/08/2024,Client Receipt - CloudBridge Co. #5,Sales Receipt,SaaS-GL,0,16252.38,EUR,SEPA SCT,CloudBridge Co. #5,***3969,INV-202408-SaaS-GL-0009,,FALSE,FALSE,REF-505605,First Continental Bank,***1834,Globex EMEA Manufacturing Ltd.,IE,-448002.47
23/08/2024,23/08/2024,Client Receipt - CloudBridge Co. #17,Sales Receipt,SaaS-GL,0,25645.93,EUR,Card Settlement,CloudBridge Co. #17,***9282,INV-202408-SaaS-GL-0015,,FALSE,FALSE,REF-869972,First Continental Bank,***3099,Globex EMEA Manufacturing Ltd.,IE,-422356.54
23/08/2024,23/08/2024,Client Receipt - CloudBridge Co. #5,Sales Receipt,SaaS-GL,0,27304.02,EUR,SEPA SCT Inst,CloudBridge Co. #5,***6303,INV-202408-SaaS-GL-0012,,FALSE,FALSE,REF-801194,First Continental Bank,***8745,Globex EMEA Manufacturing Ltd.,IE,-395052.52
24/08/2024,24/08/2024,Client Receipt - CloudBridge Co. #21,Sales Receipt,SaaS-GL,0,16832.3,EUR,SEPA SCT,CloudBridge Co. #21,***4076,INV-202408-SaaS-GL-0005,,FALSE,FALSE,REF-186197,First Continental Bank,***4471,Globex EMEA Manufacturing Ltd.,IE,-378220.22
26/08/2024,26/08/2024,Intercompany Settlement - Globex Consulting UK Ltd.,Intercompany Transfer,ALL,814725,0,EUR,Internal Transfer,Globex Consulting UK Ltd.,***4624,,,TRUE,TRUE,REF-857241,First Continental Bank,***6298,Globex EMEA Manufacturing Ltd.,IE,-1192945.22
26/08/2024,26/08/2024,Client Receipt - CloudBridge Co. #75,Sales Receipt,SaaS-GL,0,30754.14,EUR,Card Settlement,CloudBridge Co. #75,***5218,INV-202408-SaaS-GL-0010,,FALSE,FALSE,REF-397587,First Continental Bank,***1433,Globex EMEA Manufacturing Ltd.,IE,-1162191.08
26/08/2024,26/08/2024,Client Receipt - Vertex Advisory Client #19,Sales Receipt,PS-GL,0,48805.91,EUR,SEPA SCT,Vertex Advisory Client #19,***2058,INV-202408-PS-GL-0006,,FALSE,FALSE,REF-402746,First Continental Bank,***3774,Globex EMEA Manufacturing Ltd.,IE,-1113385.17
26/08/2024,26/08/2024,Client Receipt - CloudBridge Co. #37,Sales Receipt,SaaS-GL,0,53316.94,EUR,SEPA SCT,CloudBridge Co. #37,***7549,INV-202408-SaaS-GL-0017,,FALSE,FALSE,REF-371893,First Continental Bank,***9144,Globex EMEA Manufacturing Ltd.,IE,-1060068.23
27/08/2024,27/08/2024,Supplier Payment - HyperCloud Infra #7,Supplier Payment,SaaS-GL,105.68,0,EUR,SEPA Credit Transfer,HyperCloud Infra #7,***3280,,PO-202408-SaaS-GL-0003,FALSE,FALSE,REF-867220,First Continental Bank,***4002,Globex EMEA Manufacturing Ltd.,IE,-1060173.91
27/08/2024,27/08/2024,Supplier Payment - ExpertNet Subcontractors #15,Supplier Payment,PS-GL,12499.5,0,EUR,SEPA Credit Transfer,ExpertNet Subcontractors #15,***8136,,PO-202408-PS-GL-0012,FALSE,FALSE,REF-821681,First Continental Bank,***7387,Globex EMEA Manufacturing Ltd.,IE,-1072673.41
27/08/2024,27/08/2024,Supplier Payment - EuroFab Assembly #18,Supplier Payment,CEM-EMEA,40283.51,0,EUR,SWIFT MT103,EuroFab Assembly #18,***4442,,PO-202408-CEM-EMEA-0001,FALSE,FALSE,REF-741568,First Continental Bank,***2984,Globex EMEA Manufacturing Ltd.,IE,-1112956.92
27/08/2024,27/08/2024,Payroll - GlobalPay Services Ltd,Payroll,ALL,155532.04,0,EUR,SWIFT MT103,GlobalPay Services Ltd,***2780,,,FALSE,FALSE,REF-316991,First Continental Bank,***9912,Globex EMEA Manufacturing Ltd.,IE,-1268488.96
27/08/2024,27/08/2024,Client Receipt - Vertex Advisory Client #58,Sales Receipt,PS-GL,0,2133.25,EUR,SEPA SCT,Vertex Advisory Client #58,***8678,INV-202408-PS-GL-0009,,FALSE,FALSE,REF-104709,First Continental Bank,***3559,Globex EMEA Manufacturing Ltd.,IE,-1266355.71
28/08/2024,28/08/2024,Supplier Payment - CodeCraft Contractors #11,Supplier Payment,SaaS-GL,12951.04,0,EUR,SEPA Debit,CodeCraft Contractors #11,***5770,,PO-202408-SaaS-GL-0002,FALSE,FALSE,REF-210885,First Continental Bank,***9251,Globex EMEA Manufacturing Ltd.,IE,-1279306.75
28/08/2024,28/08/2024,Supplier Payment - ExpertNet Subcontractors #6,Supplier Payment,PS-GL,14517.68,0,EUR,SEPA Debit,ExpertNet Subcontractors #6,***3281,,PO-202408-PS-GL-0009,FALSE,FALSE,REF-120933,First Continental Bank,***3219,Globex EMEA Manufacturing Ltd.,IE,-1293824.43
28/08/2024,28/08/2024,Supplier Payment - ExpertNet Subcontractors #12,Supplier Payment,PS-GL,14972.55,0,EUR,SEPA Debit,ExpertNet Subcontractors #12,***3988,,PO-202408-PS-GL-0006,FALSE,FALSE,REF-673526,First Continental Bank,***3478,Globex EMEA Manufacturing Ltd.,IE,-1308796.98
28/08/2024,28/08/2024,Client Receipt - Novatek Components Ltd #14,Sales Receipt,CEM-EMEA,0,49070.04,EUR,SEPA SCT,Novatek Components Ltd #14,***2985,INV-202408-CEM-EMEA-0008,,FALSE,FALSE,REF-825261,First Continental Bank,***7517,Globex EMEA Manufacturing Ltd.,IE,-1259726.94
28/08/2024,28/08/2024,Client Receipt - Novatek Components Ltd #6,Sales Receipt,CEM-EMEA,0,50201.47,EUR,Card Settlement,Novatek Components Ltd #6,***8042,INV-202408-CEM-EMEA-0006,,FALSE,FALSE,REF-289309,First Continental Bank,***7634,Globex EMEA Manufacturing Ltd.,IE,-1209525.47
28/08/2024,28/08/2024,Client Receipt - Vertex Advisory Client #30,Sales Receipt,PS-GL,0,66027.91,EUR,SEPA SCT Inst,Vertex Advisory Client #30,***8896,INV-202408-PS-GL-0001,,FALSE,FALSE,REF-754044,First Continental Bank,***7097,Globex EMEA Manufacturing Ltd.,IE,-1143497.56
29/08/2024,29/08/2024,Supplier Payment - CodeCraft Contractors #2,Supplier Payment,SaaS-GL,9069.88,0,EUR,SEPA Credit Transfer,CodeCraft Contractors #2,***9470,,PO-202408-SaaS-GL-0006,FALSE,FALSE,REF-895035,First Continental Bank,***6708,Globex EMEA Manufacturing Ltd.,IE,-1152567.44
29/08/2024,29/08/2024,Supplier Payment - ExpertNet Subcontractors #2,Supplier Payment,PS-GL,12118.98,0,EUR,SEPA Debit,ExpertNet Subcontractors #2,***3385,,PO-202408-PS-GL-0007,FALSE,FALSE,REF-645937,First Continental Bank,***5808,Globex EMEA Manufacturing Ltd.,IE,-1164686.42
29/08/2024,29/08/2024,BluePeak Property Mgmt,Rent & Utilities,ALL,15587.18,0,EUR,SWIFT MT103,BluePeak Property Mgmt,***8760,,,FALSE,FALSE,REF-665548,First Continental Bank,***7983,Globex EMEA Manufacturing Ltd.,IE,-1180273.6
29/08/2024,29/08/2024,Payroll - GlobalPay Services Ltd,Payroll,ALL,155532.04,0,EUR,SEPA Debit,GlobalPay Services Ltd,***4290,,,FALSE,FALSE,REF-400427,First Continental Bank,***1073,Globex EMEA Manufacturing Ltd.,IE,-1335805.64
29/08/2024,29/08/2024,Client Receipt - CloudBridge Co. #35,Sales Receipt,SaaS-GL,0,26797.42,EUR,SEPA SCT,CloudBridge Co. #35,***7507,INV-202408-SaaS-GL-0006,,FALSE,FALSE,REF-220887,First Continental Bank,***7840,Globex EMEA Manufacturing Ltd.,IE,-1309008.22
29/08/2024,29/08/2024,Client Receipt - Aurora Electronics GmbH #6,Sales Receipt,CEM-EMEA,0,71430.47,EUR,SEPA SCT,Aurora Electronics GmbH #6,***1098,INV-202408-CEM-EMEA-0003,,FALSE,FALSE,REF-571250,First Continental Bank,***8873,Globex EMEA Manufacturing Ltd.,IE,-1237577.75
29/08/2024,29/08/2024,Client Receipt - Vertex Advisory Client #18,Sales Receipt,PS-GL,0,91848.18,EUR,SEPA SCT,Vertex Advisory Client #18,***8168,INV-202408-PS-GL-0007,,FALSE,FALSE,REF-224771,First Continental Bank,***4726,Globex EMEA Manufacturing Ltd.,IE,-1145729.57
30/08/2024,30/08/2024,Supplier Payment - CodeCraft Contractors #10,Supplier Payment,SaaS-GL,23603.67,0,EUR,SWIFT MT103,CodeCraft Contractors #10,***2919,,PO-202408-SaaS-GL-0005,FALSE,FALSE,REF-169717,First Continental Bank,***8352,Globex EMEA Manufacturing Ltd.,IE,-1169333.24
30/08/2024,30/08/2024,Supplier Payment - Stelliform Parts BV #13,Supplier Payment,CEM-EMEA,26692.47,0,EUR,SWIFT MT103,Stelliform Parts BV #13,***1550,,PO-202408-CEM-EMEA-0004,FALSE,FALSE,REF-282291,First Continental Bank,***7126,Globex EMEA Manufacturing Ltd.,IE,-1196025.71
30/08/2024,30/08/2024,Supplier Payment - Stelliform Parts BV #29,Supplier Payment,CEM-EMEA,68667.27,0,EUR,SWIFT MT103,Stelliform Parts BV #29,***4946,,PO-202408-CEM-EMEA-0005,FALSE,FALSE,REF-873973,First Continental Bank,***9950,Globex EMEA Manufacturing Ltd.,IE,-1264692.98
30/08/2024,30/08/2024,Interest Earned,Interest Income,ALL,0,8241.74,EUR,SEPA SCT Inst,First Continental Bank,***4664,,,FALSE,FALSE,REF-706014,First Continental Bank,***7981,Globex EMEA Manufacturing Ltd.,IE,-1256451.24
30/08/2024,30/08/2024,Client Receipt - CloudBridge Co. #19,Sales Receipt,SaaS-GL,0,13352.36,EUR,SEPA SCT Inst,CloudBridge Co. #19,***5286,INV-202408-SaaS-GL-0023,,FALSE,FALSE,REF-257981,First Continental Bank,***1197,Globex EMEA Manufacturing Ltd.,IE,-1243098.88
30/08/2024,30/08/2024,Client Receipt - Vertex Advisory Client #41,Sales Receipt,PS-GL,0,31320.13,EUR,SEPA SCT Inst,Vertex Advisory Client #41,***9469,INV-202408-PS-GL-0004,,FALSE,FALSE,REF-580999,First Continental Bank,***7955,Globex EMEA Manufacturing Ltd.,IE,-1211778.75
30/08/2024,30/08/2024,Client Receipt - Aurora Electronics GmbH #12,Sales Receipt,CEM-EMEA,0,198095.76,EUR,SEPA SCT,Aurora Electronics GmbH #12,***9103,INV-202408-CEM-EMEA-0010,,FALSE,FALSE,REF-121620,First Continental Bank,***7071,Globex EMEA Manufacturing Ltd.,IE,-1013682.99
31/08/2024,31/08/2024,Marketing - Aurelia Media #9,Marketing,ALL,42048.22,0,EUR,SEPA Debit,Aurelia Media #9,***7455,,,FALSE,FALSE,REF-732179,First Continental Bank,***3705,Globex EMEA Manufacturing Ltd.,IE,-1055731.21
01/09/2024,01/09/2024,Account Maintenance Fee,Bank/Merchant Fees,ALL,2500,0,EUR,SEPA Credit Transfer,First Continental Bank,***3943,,,FALSE,FALSE,REF-613787,First Continental Bank,***5830,Globex EMEA Manufacturing Ltd.,IE,-1058231.21
01/09/2024,01/09/2024,Supplier Payment - HyperCloud Infra #9,Supplier Payment,SaaS-GL,5150.01,0,EUR,SWIFT MT103,HyperCloud Infra #9,***4706,,PO-202409-SaaS-GL-0003,FALSE,FALSE,REF-530290,First Continental Bank,***5391,Globex EMEA Manufacturing Ltd.,IE,-1063381.22
01/09/2024,01/09/2024,Supplier Payment - Stelliform Parts BV #28,Supplier Payment,CEM-EMEA,178349.63,0,EUR,SWIFT MT103,Stelliform Parts BV #28,***9405,,PO-202409-CEM-EMEA-0010,FALSE,FALSE,REF-679870,First Continental Bank,***2110,Globex EMEA Manufacturing Ltd.,IE,-1241730.85
02/09/2024,02/09/2024,Supplier Payment - HyperCloud Infra #1,Supplier Payment,SaaS-GL,15324.56,0,EUR,SEPA Debit,HyperCloud Infra #1,***7321,,PO-202409-SaaS-GL-0002,FALSE,FALSE,REF-643216,First Continental Bank,***1544,Globex EMEA Manufacturing Ltd.,IE,-1257055.41
02/09/2024,02/09/2024,Supplier Payment - Stelliform Parts BV #23,Supplier Payment,CEM-EMEA,44451.77,0,EUR,SWIFT MT103,Stelliform Parts BV #23,***3389,,PO-202409-CEM-EMEA-0008,FALSE,FALSE,REF-610218,First Continental Bank,***6315,Globex EMEA Manufacturing Ltd.,IE,-1301507.18
02/09/2024,02/09/2024,Client Receipt - CloudBridge Co. #9,Sales Receipt,SaaS-GL,0,2019.83,EUR,SEPA SCT Inst,CloudBridge Co. #9,***5410,INV-202409-SaaS-GL-0008,,FALSE,FALSE,REF-903424,First Continental Bank,***3863,Globex EMEA Manufacturing Ltd.,IE,-1299487.35
02/09/2024,02/09/2024,Client Receipt - CloudBridge Co. #77,Sales Receipt,SaaS-GL,0,157123.68,EUR,SEPA SCT Inst,CloudBridge Co. #77,***3350,INV-202409-SaaS-GL-0019,,FALSE,FALSE,REF-889453,First Continental Bank,***1455,Globex EMEA Manufacturing Ltd.,IE,-1142363.67
03/09/2024,03/09/2024,Client Receipt - CloudBridge Co. #18,Sales Receipt,SaaS-GL,0,16438.54,EUR,SEPA SCT Inst,CloudBridge Co. #18,***7615,INV-202409-SaaS-GL-0015,,FALSE,FALSE,REF-549815,First Continental Bank,***8979,Globex EMEA Manufacturing Ltd.,IE,-1125925.13
03/09/2024,03/09/2024,Client Receipt - CloudBridge Co. #8,Sales Receipt,SaaS-GL,0,21031.86,EUR,Card Settlement,CloudBridge Co. #8,***2533,INV-202409-SaaS-GL-0013,,FALSE,FALSE,REF-976366,First Continental Bank,***1407,Globex EMEA Manufacturing Ltd.,IE,-1104893.27
03/09/2024,03/09/2024,Client Receipt - Novatek Components Ltd #10,Sales Receipt,CEM-EMEA,0,23615.26,EUR,Card Settlement,Novatek Components Ltd #10,***6689,INV-202409-CEM-EMEA-0007,,FALSE,FALSE,REF-627009,First Continental Bank,***2685,Globex EMEA Manufacturing Ltd.,IE,-1081278.01
03/09/2024,03/09/2024,Client Receipt - CloudBridge Co. #11,Sales Receipt,SaaS-GL,0,49193.27,EUR,Card Settlement,CloudBridge Co. #11,***5064,INV-202409-SaaS-GL-0018,,FALSE,FALSE,REF-813592,First Continental Bank,***6973,Globex EMEA Manufacturing Ltd.,IE,-1032084.74
03/09/2024,03/09/2024,Client Receipt - Vertex Advisory Client #21,Sales Receipt,PS-GL,0,91439.53,EUR,Card Settlement,Vertex Advisory Client #21,***8791,INV-202409-PS-GL-0002,,FALSE,FALSE,REF-172614,First Continental Bank,***2276,Globex EMEA Manufacturing Ltd.,IE,-940645.21
04/09/2024,04/09/2024,Supplier Payment - ExpertNet Subcontractors #19,Supplier Payment,PS-GL,4756.78,0,EUR,SEPA Credit Transfer,ExpertNet Subcontractors #19,***4448,,PO-202409-PS-GL-0008,FALSE,FALSE,REF-477421,First Continental Bank,***9760,Globex EMEA Manufacturing Ltd.,IE,-945401.99
04/09/2024,04/09/2024,Marketing - Aurelia Media #11,Marketing,ALL,9225.91,0,EUR,SWIFT MT103,Aurelia Media #11,***6701,,,FALSE,FALSE,REF-869207,First Continental Bank,***7071,Globex EMEA Manufacturing Ltd.,IE,-954627.9
05/09/2024,05/09/2024,Supplier Payment - Stelliform Parts BV #2,Supplier Payment,CEM-EMEA,11722.62,0,EUR,SWIFT MT103,Stelliform Parts BV #2,***1353,,PO-202409-CEM-EMEA-0001,FALSE,FALSE,REF-931434,First Continental Bank,***3938,Globex EMEA Manufacturing Ltd.,IE,-966350.52
05/09/2024,05/09/2024,Supplier Payment - Stelliform Parts BV #11,Supplier Payment,CEM-EMEA,28002.46,0,EUR,SEPA Credit Transfer,Stelliform Parts BV #11,***9390,,PO-202409-CEM-EMEA-0003,FALSE,FALSE,REF-941900,First Continental Bank,***5752,Globex EMEA Manufacturing Ltd.,IE,-994352.98
05/09/2024,05/09/2024,Supplier Payment - EuroFab Assembly #9,Supplier Payment,CEM-EMEA,52401.9,0,EUR,SEPA Credit Transfer,EuroFab Assembly #9,***8018,,PO-202409-CEM-EMEA-0002,FALSE,FALSE,REF-944424,First Continental Bank,***1429,Globex EMEA Manufacturing Ltd.,IE,-1046754.88
05/09/2024,05/09/2024,Client Receipt - Vertex Advisory Client #28,Sales Receipt,PS-GL,0,1851.19,EUR,SEPA SCT Inst,Vertex Advisory Client #28,***1525,INV-202409-PS-GL-0003,,FALSE,FALSE,REF-537005,First Continental Bank,***9881,Globex EMEA Manufacturing Ltd.,IE,-1044903.69
05/09/2024,05/09/2024,Client Receipt - CloudBridge Co. #31,Sales Receipt,SaaS-GL,0,23555.65,EUR,SEPA SCT Inst,CloudBridge Co. #31,***2798,INV-202409-SaaS-GL-0017,,FALSE,FALSE,REF-589541,First Continental Bank,***7448,Globex EMEA Manufacturing Ltd.,IE,-1021348.04
05/09/2024,05/09/2024,Client Receipt - CloudBridge Co. #50,Sales Receipt,SaaS-GL,0,25415.05,EUR,SEPA SCT,CloudBridge Co. #50,***4773,INV-202409-SaaS-GL-0014,,FALSE,FALSE,REF-381602,First Continental Bank,***5642,Globex EMEA Manufacturing Ltd.,IE,-995932.99
05/09/2024,05/09/2024,Client Receipt - Aurora Electronics GmbH #12,Sales Receipt,CEM-EMEA,0,39358.6,EUR,SEPA SCT Inst,Aurora Electronics GmbH #12,***6417,INV-202409-CEM-EMEA-0005,,FALSE,FALSE,REF-559400,First Continental Bank,***8962,Globex EMEA Manufacturing Ltd.,IE,-956574.39
06/09/2024,06/09/2024,Skyline Internet Services,Rent & Utilities,ALL,7398.06,0,EUR,SWIFT MT103,Skyline Internet Services,***5246,,,FALSE,FALSE,REF-860627,First Continental Bank,***7795,Globex EMEA Manufacturing Ltd.,IE,-963972.45
06/09/2024,06/09/2024,Supplier Payment - Stelliform Parts BV #27,Supplier Payment,CEM-EMEA,59637.95,0,EUR,SEPA Debit,Stelliform Parts BV #27,***6935,,PO-202409-CEM-EMEA-0005,FALSE,FALSE,REF-275721,First Continental Bank,***7889,Globex EMEA Manufacturing Ltd.,IE,-1023610.4
06/09/2024,06/09/2024,Client Receipt - CloudBridge Co. #10,Sales Receipt,SaaS-GL,0,4429.62,EUR,SEPA SCT Inst,CloudBridge Co. #10,***7132,INV-202409-SaaS-GL-0020,,FALSE,FALSE,REF-902078,First Continental Bank,***5544,Globex EMEA Manufacturing Ltd.,IE,-1019180.78
06/09/2024,06/09/2024,Client Receipt - Aurora Electronics GmbH #12,Sales Receipt,CEM-EMEA,0,41761.76,EUR,Card Settlement,Aurora Electronics GmbH #12,***5877,INV-202409-CEM-EMEA-0012,,FALSE,FALSE,REF-868119,First Continental Bank,***9883,Globex EMEA Manufacturing Ltd.,IE,-977419.02
07/09/2024,07/09/2024,Client Receipt - Novatek Components Ltd #14,Sales Receipt,CEM-EMEA,0,136805.21,EUR,SEPA SCT,Novatek Components Ltd #14,***9333,INV-202409-CEM-EMEA-0002,,FALSE,FALSE,REF-327602,First Continental Bank,***9704,Globex EMEA Manufacturing Ltd.,IE,-840613.81
09/09/2024,09/09/2024,Supplier Payment - ExpertNet Subcontractors #1,Supplier Payment,PS-GL,13337.46,0,EUR,SWIFT MT103,ExpertNet Subcontractors #1,***2039,,PO-202409-PS-GL-0009,FALSE,FALSE,REF-490423,First Continental Bank,***4781,Globex EMEA Manufacturing Ltd.,IE,-853951.27
09/09/2024,09/09/2024,Supplier Payment - HyperCloud Infra #17,Supplier Payment,SaaS-GL,26044.74,0,EUR,SWIFT MT103,HyperCloud Infra #17,***8969,,PO-202409-SaaS-GL-0001,FALSE,FALSE,REF-124228,First Continental Bank,***3219,Globex EMEA Manufacturing Ltd.,IE,-879996.01
09/09/2024,09/09/2024,Client Receipt - CloudBridge Co. #17,Sales Receipt,SaaS-GL,0,394.62,EUR,SEPA SCT Inst,CloudBridge Co. #17,***8970,INV-202409-SaaS-GL-0006,,FALSE,FALSE,REF-404550,First Continental Bank,***8761,Globex EMEA Manufacturing Ltd.,IE,-879601.39
09/09/2024,09/09/2024,Client Receipt - Novatek Components Ltd #4,Sales Receipt,CEM-EMEA,0,107203.6,EUR,SEPA SCT Inst,Novatek Components Ltd #4,***4008,INV-202409-CEM-EMEA-0004,,FALSE,FALSE,REF-740034,First Continental Bank,***7110,Globex EMEA Manufacturing Ltd.,IE,-772397.79
10/09/2024,10/09/2024,Supplier Payment - CodeCraft Contractors #7,Supplier Payment,SaaS-GL,35425.17,0,EUR,SEPA Debit,CodeCraft Contractors #7,***7130,,PO-202409-SaaS-GL-0007,FALSE,FALSE,REF-169850,First Continental Bank,***8812,Globex EMEA Manufacturing Ltd.,IE,-807822.96
10/09/2024,10/09/2024,Client Receipt - Aurora Electronics GmbH #19,Sales Receipt,CEM-EMEA,0,303998.96,EUR,SEPA SCT Inst,Aurora Electronics GmbH #19,***9247,INV-202409-CEM-EMEA-0011,,FALSE,FALSE,REF-339783,First Continental Bank,***9681,Globex EMEA Manufacturing Ltd.,IE,-503824
11/09/2024,11/09/2024,Merchant Processing Fees,Bank/Merchant Fees,ALL,4681.42,0,EUR,SWIFT MT103,First Continental Bank,***2414,,,FALSE,FALSE,REF-614296,First Continental Bank,***5130,Globex EMEA Manufacturing Ltd.,IE,-508505.42
11/09/2024,11/09/2024,Supplier Payment - Stelliform Parts BV #5,Supplier Payment,CEM-EMEA,85939,0,EUR,SWIFT MT103,Stelliform Parts BV #5,***3663,,PO-202409-CEM-EMEA-0007,FALSE,FALSE,REF-147954,First Continental Bank,***2054,Globex EMEA Manufacturing Ltd.,IE,-594444.42
12/09/2024,12/09/2024,Merchant Processing Fees,Bank/Merchant Fees,ALL,1507.49,0,EUR,SWIFT MT103,First Continental Bank,***6187,,,FALSE,FALSE,REF-153019,First Continental Bank,***8514,Globex EMEA Manufacturing Ltd.,IE,-595951.91
12/09/2024,12/09/2024,Supplier Payment - EuroFab Assembly #18,Supplier Payment,CEM-EMEA,34166.44,0,EUR,SEPA Credit Transfer,EuroFab Assembly #18,***7999,,PO-202409-CEM-EMEA-0006,FALSE,FALSE,REF-869480,First Continental Bank,***8996,Globex EMEA Manufacturing Ltd.,IE,-630118.35
12/09/2024,12/09/2024,Intercompany Settlement - Globex APAC Logistics Pte. Ltd.,Intercompany Transfer,ALL,278845,0,EUR,Internal Transfer,Globex APAC Logistics Pte. Ltd.,***1686,,,TRUE,TRUE,REF-639837,First Continental Bank,***3308,Globex EMEA Manufacturing Ltd.,IE,-908963.35
12/09/2024,12/09/2024,Client Receipt - Novatek Components Ltd #6,Sales Receipt,CEM-EMEA,0,12667.28,EUR,Card Settlement,Novatek Components Ltd #6,***6850,INV-202409-CEM-EMEA-0009,,FALSE,FALSE,REF-406252,First Continental Bank,***5076,Globex EMEA Manufacturing Ltd.,IE,-896296.07
14/09/2024,14/09/2024,Client Receipt - Vertex Advisory Client #16,Sales Receipt,PS-GL,0,12237.38,EUR,Card Settlement,Vertex Advisory Client #16,***5575,INV-202409-PS-GL-0004,,FALSE,FALSE,REF-441795,First Continental Bank,***3925,Globex EMEA Manufacturing Ltd.,IE,-884058.69
15/09/2024,15/09/2024,Supplier Payment - ExpertNet Subcontractors #13,Supplier Payment,PS-GL,9140.96,0,EUR,SWIFT MT103,ExpertNet Subcontractors #13,***1930,,PO-202409-PS-GL-0004,FALSE,FALSE,REF-926312,First Continental Bank,***8013,Globex EMEA Manufacturing Ltd.,IE,-893199.65
15/09/2024,15/09/2024,Loan Interest Payment,Loan Interest,ALL,85000,0,EUR,SEPA Credit Transfer,First Continental Bank - Corporate Lending,***9879,,,FALSE,FALSE,REF-656293,First Continental Bank,***8434,Globex EMEA Manufacturing Ltd.,IE,-978199.65
15/09/2024,15/09/2024,Loan Principal Repayment,Loan Principal,ALL,500000,0,EUR,SEPA Debit,First Continental Bank - Corporate Lending,***5440,,,FALSE,FALSE,REF-658422,First Continental Bank,***6895,Globex EMEA Manufacturing Ltd.,IE,-1478199.65
15/09/2024,15/09/2024,Client Receipt - Vertex Advisory Client #24,Sales Receipt,PS-GL,0,68301.16,EUR,SEPA SCT Inst,Vertex Advisory Client #24,***2962,INV-202409-PS-GL-0009,,FALSE,FALSE,REF-245590,First Continental Bank,***7548,Globex EMEA Manufacturing Ltd.,IE,-1409898.49
16/09/2024,16/09/2024,Client Receipt - CloudBridge Co. #50,Sales Receipt,SaaS-GL,0,2465.24,EUR,SEPA SCT Inst,CloudBridge Co. #50,***9104,INV-202409-SaaS-GL-0010,,FALSE,FALSE,REF-987445,First Continental Bank,***5348,Globex EMEA Manufacturing Ltd.,IE,-1407433.25
16/09/2024,16/09/2024,Client Receipt - Vertex Advisory Client #8,Sales Receipt,PS-GL,0,34868.3,EUR,SEPA SCT,Vertex Advisory Client #8,***2749,INV-202409-PS-GL-0001,,FALSE,FALSE,REF-924032,First Continental Bank,***6099,Globex EMEA Manufacturing Ltd.,IE,-1372564.95
16/09/2024,16/09/2024,Client Receipt - Vertex Advisory Client #44,Sales Receipt,PS-GL,0,78533.39,EUR,SEPA SCT Inst,Vertex Advisory Client #44,***4699,INV-202409-PS-GL-0008,,FALSE,FALSE,REF-289966,First Continental Bank,***5436,Globex EMEA Manufacturing Ltd.,IE,-1294031.56
18/09/2024,18/09/2024,BluePeak Property Mgmt,Rent & Utilities,ALL,8780.49,0,EUR,SEPA Credit Transfer,BluePeak Property Mgmt,***2539,,,FALSE,FALSE,REF-220916,First Continental Bank,***2841,Globex EMEA Manufacturing Ltd.,IE,-1302812.05
18/09/2024,18/09/2024,Supplier Payment - ExpertNet Subcontractors #7,Supplier Payment,PS-GL,36878.88,0,EUR,SEPA Debit,ExpertNet Subcontractors #7,***9251,,PO-202409-PS-GL-0007,FALSE,FALSE,REF-521064,First Continental Bank,***1018,Globex EMEA Manufacturing Ltd.,IE,-1339690.93
18/09/2024,18/09/2024,Supplier Payment - Stelliform Parts BV #13,Supplier Payment,CEM-EMEA,60456.38,0,EUR,SEPA Debit,Stelliform Parts BV #13,***2891,,PO-202409-CEM-EMEA-0009,FALSE,FALSE,REF-921561,First Continental Bank,***3567,Globex EMEA Manufacturing Ltd.,IE,-1400147.31
18/09/2024,18/09/2024,Client Receipt - CloudBridge Co. #13,Sales Receipt,SaaS-GL,0,53118.4,EUR,SEPA SCT,CloudBridge Co. #13,***1725,INV-202409-SaaS-GL-0016,,FALSE,FALSE,REF-902155,First Continental Bank,***9805,Globex EMEA Manufacturing Ltd.,IE,-1347028.91
18/09/2024,18/09/2024,Client Receipt - Novatek Components Ltd #1,Sales Receipt,CEM-EMEA,0,99653.95,EUR,Card Settlement,Novatek Components Ltd #1,***1459,INV-202409-CEM-EMEA-0001,,FALSE,FALSE,REF-340427,First Continental Bank,***3293,Globex EMEA Manufacturing Ltd.,IE,-1247374.96
18/09/2024,18/09/2024,Client Receipt - CloudBridge Co. #68,Sales Receipt,SaaS-GL,0,106592.8,EUR,Card Settlement,CloudBridge Co. #68,***8380,INV-202409-SaaS-GL-0009,,FALSE,FALSE,REF-578042,First Continental Bank,***4677,Globex EMEA Manufacturing Ltd.,IE,-1140782.16
19/09/2024,19/09/2024,Supplier Payment - CodeCraft Contractors #3,Supplier Payment,SaaS-GL,6379.78,0,EUR,SEPA Credit Transfer,CodeCraft Contractors #3,***5094,,PO-202409-SaaS-GL-0004,FALSE,FALSE,REF-191100,First Continental Bank,***3647,Globex EMEA Manufacturing Ltd.,IE,-1147161.94
19/09/2024,19/09/2024,VAT/GST Remittance - Revenue Ireland,Tax Payment,ALL,126618.01,0,EUR,SWIFT MT103,Revenue Ireland,***1997,,,FALSE,FALSE,REF-360431,First Continental Bank,***2213,Globex EMEA Manufacturing Ltd.,IE,-1273779.95
19/09/2024,19/09/2024,Client Receipt - CloudBridge Co. #71,Sales Receipt,SaaS-GL,0,11979.29,EUR,SEPA SCT,CloudBridge Co. #71,***5978,INV-202409-SaaS-GL-0001,,FALSE,FALSE,REF-218916,First Continental Bank,***3089,Globex EMEA Manufacturing Ltd.,IE,-1261800.66
19/09/2024,19/09/2024,Client Receipt - CloudBridge Co. #25,Sales Receipt,SaaS-GL,0,40342.85,EUR,Card Settlement,CloudBridge Co. #25,***7873,INV-202409-SaaS-GL-0004,,FALSE,FALSE,REF-968870,First Continental Bank,***9753,Globex EMEA Manufacturing Ltd.,IE,-1221457.81
19/09/2024,19/09/2024,Client Receipt - Aurora Electronics GmbH #9,Sales Receipt,CEM-EMEA,0,59465.15,EUR,SEPA SCT Inst,Aurora Electronics GmbH #9,***2372,INV-202409-CEM-EMEA-0008,,FALSE,FALSE,REF-857941,First Continental Bank,***4290,Globex EMEA Manufacturing Ltd.,IE,-1161992.66
20/09/2024,20/09/2024,Supplier Payment - ExpertNet Subcontractors #1,Supplier Payment,PS-GL,5199.68,0,EUR,SWIFT MT103,ExpertNet Subcontractors #1,***1726,,PO-202409-PS-GL-0002,FALSE,FALSE,REF-588587,First Continental Bank,***3289,Globex EMEA Manufacturing Ltd.,IE,-1167192.34
20/09/2024,20/09/2024,Supplier Payment - ExpertNet Subcontractors #11,Supplier Payment,PS-GL,10861.43,0,EUR,SEPA Debit,ExpertNet Subcontractors #11,***6176,,PO-202409-PS-GL-0003,FALSE,FALSE,REF-234714,First Continental Bank,***5147,Globex EMEA Manufacturing Ltd.,IE,-1178053.77
20/09/2024,20/09/2024,Client Receipt - CloudBridge Co. #48,Sales Receipt,SaaS-GL,0,9090.68,EUR,Card Settlement,CloudBridge Co. #48,***8893,INV-202409-SaaS-GL-0002,,FALSE,FALSE,REF-360390,First Continental Bank,***1957,Globex EMEA Manufacturing Ltd.,IE,-1168963.09
20/09/2024,20/09/2024,Client Receipt - Aurora Electronics GmbH #18,Sales Receipt,CEM-EMEA,0,12036.36,EUR,SEPA SCT Inst,Aurora Electronics GmbH #18,***9598,INV-202409-CEM-EMEA-0003,,FALSE,FALSE,REF-630645,First Continental Bank,***4844,Globex EMEA Manufacturing Ltd.,IE,-1156926.73
20/09/2024,20/09/2024,Client Receipt - Vertex Advisory Client #49,Sales Receipt,PS-GL,0,53052.18,EUR,SEPA SCT Inst,Vertex Advisory Client #49,***3175,INV-202409-PS-GL-0007,,FALSE,FALSE,REF-639149,First Continental Bank,***1323,Globex EMEA Manufacturing Ltd.,IE,-1103874.55
20/09/2024,20/09/2024,Client Receipt - Novatek Components Ltd #2,Sales Receipt,CEM-EMEA,0,55520.76,EUR,SEPA SCT,Novatek Components Ltd #2,***7198,INV-202409-CEM-EMEA-0010,,FALSE,FALSE,REF-946506,First Continental Bank,***8622,Globex EMEA Manufacturing Ltd.,IE,-1048353.79
21/09/2024,21/09/2024,Supplier Payment - HyperCloud Infra #14,Supplier Payment,SaaS-GL,36280.36,0,EUR,SEPA Credit Transfer,HyperCloud Infra #14,***4351,,PO-202409-SaaS-GL-0005,FALSE,FALSE,REF-839366,First Continental Bank,***9382,Globex EMEA Manufacturing Ltd.,IE,-1084634.15
21/09/2024,21/09/2024,Client Receipt - Vertex Advisory Client #36,Sales Receipt,PS-GL,0,27863.96,EUR,SEPA SCT Inst,Vertex Advisory Client #36,***3833,INV-202409-PS-GL-0005,,FALSE,FALSE,REF-703180,First Continental Bank,***5377,Globex EMEA Manufacturing Ltd.,IE,-1056770.19
22/09/2024,22/09/2024,Supplier Payment - HyperCloud Infra #12,Supplier Payment,SaaS-GL,11115.41,0,EUR,SEPA Debit,HyperCloud Infra #12,***7561,,PO-202409-SaaS-GL-0006,FALSE,FALSE,REF-202949,First Continental Bank,***2680,Globex EMEA Manufacturing Ltd.,IE,-1067885.6
22/09/2024,22/09/2024,Marketing - Aurelia Media #1,Marketing,ALL,41228.85,0,EUR,SWIFT MT103,Aurelia Media #1,***7203,,,FALSE,FALSE,REF-118565,First Continental Bank,***6101,Globex EMEA Manufacturing Ltd.,IE,-1109114.45
22/09/2024,22/09/2024,Client Receipt - Vertex Advisory Client #10,Sales Receipt,PS-GL,0,52374.36,EUR,SEPA SCT Inst,Vertex Advisory Client #10,***1850,INV-202409-PS-GL-0006,,FALSE,FALSE,REF-633963,First Continental Bank,***6057,Globex EMEA Manufacturing Ltd.,IE,-1056740.09
23/09/2024,23/09/2024,Supplier Payment - ExpertNet Subcontractors #16,Supplier Payment,PS-GL,28947.65,0,EUR,SEPA Debit,ExpertNet Subcontractors #16,***7386,,PO-202409-PS-GL-0010,FALSE,FALSE,REF-888034,First Continental Bank,***6917,Globex EMEA Manufacturing Ltd.,IE,-1085687.74
23/09/2024,23/09/2024,Client Receipt - CloudBridge Co. #26,Sales Receipt,SaaS-GL,0,3226.06,EUR,SEPA SCT Inst,CloudBridge Co. #26,***7091,INV-202409-SaaS-GL-0007,,FALSE,FALSE,REF-205157,First Continental Bank,***9321,Globex EMEA Manufacturing Ltd.,IE,-1082461.68
24/09/2024,24/09/2024,Supplier Payment - HyperCloud Infra #3,Supplier Payment,SaaS-GL,3052.05,0,EUR,SEPA Debit,HyperCloud Infra #3,***8844,,PO-202409-SaaS-GL-0008,FALSE,FALSE,REF-138460,First Continental Bank,***8408,Globex EMEA Manufacturing Ltd.,IE,-1085513.73
24/09/2024,24/09/2024,Client Receipt - CloudBridge Co. #14,Sales Receipt,SaaS-GL,0,95543.42,EUR,Card Settlement,CloudBridge Co. #14,***9175,INV-202409-SaaS-GL-0012,,FALSE,FALSE,REF-179987,First Continental Bank,***1952,Globex EMEA Manufacturing Ltd.,IE,-989970.31
25/09/2024,25/09/2024,Payroll - GlobalPay Services Ltd,Payroll,ALL,160382.43,0,EUR,SWIFT MT103,GlobalPay Services Ltd,***6324,,,FALSE,FALSE,REF-330090,First Continental Bank,***4764,Globex EMEA Manufacturing Ltd.,IE,-1150352.74
25/09/2024,25/09/2024,Client Receipt - CloudBridge Co. #27,Sales Receipt,SaaS-GL,0,2121.04,EUR,SEPA SCT Inst,CloudBridge Co. #27,***2322,INV-202409-SaaS-GL-0003,,FALSE,FALSE,REF-459174,First Continental Bank,***8033,Globex EMEA Manufacturing Ltd.,IE,-1148231.7
26/09/2024,26/09/2024,Intercompany Settlement - Globex APAC Logistics Pte. Ltd.,Intercompany Transfer,ALL,408840,0,EUR,Internal Transfer,Globex APAC Logistics Pte. Ltd.,***3581,,,TRUE,TRUE,REF-716868,First Continental Bank,***3322,Globex EMEA Manufacturing Ltd.,IE,-1557071.7
26/09/2024,26/09/2024,Client Receipt - CloudBridge Co. #28,Sales Receipt,SaaS-GL,0,1718.7,EUR,Card Settlement,CloudBridge Co. #28,***6469,INV-202409-SaaS-GL-0011,,FALSE,FALSE,REF-646753,First Continental Bank,***9094,Globex EMEA Manufacturing Ltd.,IE,-1555353
26/09/2024,26/09/2024,Client Receipt - Novatek Components Ltd #11,Sales Receipt,CEM-EMEA,0,89129.82,EUR,SEPA SCT,Novatek Components Ltd #11,***3362,INV-202409-CEM-EMEA-0006,,FALSE,FALSE,REF-857875,First Continental Bank,***9568,Globex EMEA Manufacturing Ltd.,IE,-1466223.18
27/09/2024,27/09/2024,Supplier Payment - ExpertNet Subcontractors #7,Supplier Payment,PS-GL,5398,0,EUR,SEPA Debit,ExpertNet Subcontractors #7,***4889,,PO-202409-PS-GL-0005,FALSE,FALSE,REF-135711,First Continental Bank,***5792,Globex EMEA Manufacturing Ltd.,IE,-1471621.18
27/09/2024,27/09/2024,Supplier Payment - EuroFab Assembly #4,Supplier Payment,CEM-EMEA,33601.88,0,EUR,SWIFT MT103,EuroFab Assembly #4,***6311,,PO-202409-CEM-EMEA-0004,FALSE,FALSE,REF-246187,First Continental Bank,***4736,Globex EMEA Manufacturing Ltd.,IE,-1505223.06
27/09/2024,27/09/2024,Client Receipt - CloudBridge Co. #49,Sales Receipt,SaaS-GL,0,4981.57,EUR,SEPA SCT,CloudBridge Co. #49,***7366,INV-202409-SaaS-GL-0005,,FALSE,FALSE,REF-100658,First Continental Bank,***2820,Globex EMEA Manufacturing Ltd.,IE,-1500241.49
30/09/2024,30/09/2024,Supplier Payment - ExpertNet Subcontractors #17,Supplier Payment,PS-GL,150.65,0,EUR,SEPA Debit,ExpertNet Subcontractors #17,***7611,,PO-202409-PS-GL-0001,FALSE,FALSE,REF-520940,First Continental Bank,***4789,Globex EMEA Manufacturing Ltd.,IE,-1500392.14
30/09/2024,30/09/2024,Supplier Payment - ExpertNet Subcontractors #1,Supplier Payment,PS-GL,11484.94,0,EUR,SEPA Debit,ExpertNet Subcontractors #1,***8019,,PO-202409-PS-GL-0006,FALSE,FALSE,REF-870737,First Continental Bank,***9577,Globex EMEA Manufacturing Ltd.,IE,-1511877.08
30/09/2024,30/09/2024,Payroll - GlobalPay Services Ltd,Payroll,ALL,160382.43,0,EUR,SEPA Debit,GlobalPay Services Ltd,***9230,,,FALSE,FALSE,REF-243599,First Continental Bank,***6469,Globex EMEA Manufacturing Ltd.,IE,-1672259.51
30/09/2024,30/09/2024,Interest Earned,Interest Income,ALL,0,11726.46,EUR,Card Settlement,First Continental Bank,***9290,,,FALSE,FALSE,REF-308471,First Continental Bank,***8611,Globex EMEA Manufacturing Ltd.,IE,-1660533.05
01/10/2024,01/10/2024,Account Maintenance Fee,Bank/Merchant Fees,ALL,2500,0,EUR,SEPA Credit Transfer,First Continental Bank,***6629,,,FALSE,FALSE,REF-813216,First Continental Bank,***1453,Globex EMEA Manufacturing Ltd.,IE,-1663033.05
01/10/2024,01/10/2024,Supplier Payment - EuroFab Assembly #17,Supplier Payment,CEM-EMEA,95559.15,0,EUR,SEPA Credit Transfer,EuroFab Assembly #17,***6207,,PO-202410-CEM-EMEA-0006,FALSE,FALSE,REF-863910,First Continental Bank,***7049,Globex EMEA Manufacturing Ltd.,IE,-1758592.2
01/10/2024,01/10/2024,Client Receipt - CloudBridge Co. #40,Sales Receipt,SaaS-GL,0,37736.38,EUR,Card Settlement,CloudBridge Co. #40,***8523,INV-202410-SaaS-GL-0001,,FALSE,FALSE,REF-518353,First Continental Bank,***9260,Globex EMEA Manufacturing Ltd.,IE,-1720855.82
02/10/2024,02/10/2024,Supplier Payment - Stelliform Parts BV #11,Supplier Payment,CEM-EMEA,26347.58,0,EUR,SEPA Credit Transfer,Stelliform Parts BV #11,***4716,,PO-202410-CEM-EMEA-0009,FALSE,FALSE,REF-704849,First Continental Bank,***2072,Globex EMEA Manufacturing Ltd.,IE,-1747203.4
02/10/2024,02/10/2024,Client Receipt - CloudBridge Co. #26,Sales Receipt,SaaS-GL,0,3594.98,EUR,Card Settlement,CloudBridge Co. #26,***6955,INV-202410-SaaS-GL-0021,,FALSE,FALSE,REF-745294,First Continental Bank,***5394,Globex EMEA Manufacturing Ltd.,IE,-1743608.42
02/10/2024,02/10/2024,Client Receipt - CloudBridge Co. #36,Sales Receipt,SaaS-GL,0,31829.98,EUR,SEPA SCT Inst,CloudBridge Co. #36,***3804,INV-202410-SaaS-GL-0002,,FALSE,FALSE,REF-462805,First Continental Bank,***6275,Globex EMEA Manufacturing Ltd.,IE,-1711778.44
02/10/2024,02/10/2024,Client Receipt - Novatek Components Ltd #5,Sales Receipt,CEM-EMEA,0,43576.88,EUR,SEPA SCT,Novatek Components Ltd #5,***4411,INV-202410-CEM-EMEA-0016,,FALSE,FALSE,REF-179609,First Continental Bank,***4885,Globex EMEA Manufacturing Ltd.,IE,-1668201.56
02/10/2024,02/10/2024,Client Receipt - Novatek Components Ltd #13,Sales Receipt,CEM-EMEA,0,45625.5,EUR,SEPA SCT Inst,Novatek Components Ltd #13,***3504,INV-202410-CEM-EMEA-0004,,FALSE,FALSE,REF-712191,First Continental Bank,***2997,Globex EMEA Manufacturing Ltd.,IE,-1622576.06
03/10/2024,03/10/2024,Merchant Processing Fees,Bank/Merchant Fees,ALL,2555.34,0,EUR,SEPA Credit Transfer,First Continental Bank,***9327,,,FALSE,FALSE,REF-364093,First Continental Bank,***7232,Globex EMEA Manufacturing Ltd.,IE,-1625131.4
03/10/2024,03/10/2024,Client Receipt - CloudBridge Co. #26,Sales Receipt,SaaS-GL,0,659.06,EUR,SEPA SCT,CloudBridge Co. #26,***2946,INV-202410-SaaS-GL-0012,,FALSE,FALSE,REF-452434,First Continental Bank,***6550,Globex EMEA Manufacturing Ltd.,IE,-1624472.34
03/10/2024,03/10/2024,Client Receipt - CloudBridge Co. #53,Sales Receipt,SaaS-GL,0,6931.22,EUR,Card Settlement,CloudBridge Co. #53,***9335,INV-202410-SaaS-GL-0007,,FALSE,FALSE,REF-986985,First Continental Bank,***3662,Globex EMEA Manufacturing Ltd.,IE,-1617541.12
03/10/2024,03/10/2024,Client Receipt - CloudBridge Co. #50,Sales Receipt,SaaS-GL,0,14434.13,EUR,Card Settlement,CloudBridge Co. #50,***6630,INV-202410-SaaS-GL-0011,,FALSE,FALSE,REF-898931,First Continental Bank,***7620,Globex EMEA Manufacturing Ltd.,IE,-1603106.99
03/10/2024,03/10/2024,Client Receipt - Novatek Components Ltd #10,Sales Receipt,CEM-EMEA,0,26332.7,EUR,SEPA SCT,Novatek Components Ltd #10,***2182,INV-202410-CEM-EMEA-0012,,FALSE,FALSE,REF-314690,First Continental Bank,***5800,Globex EMEA Manufacturing Ltd.,IE,-1576774.29
03/10/2024,03/10/2024,Client Receipt - Vertex Advisory Client #25,Sales Receipt,PS-GL,0,116242.72,EUR,Card Settlement,Vertex Advisory Client #25,***8375,INV-202410-PS-GL-0008,,FALSE,FALSE,REF-414870,First Continental Bank,***9164,Globex EMEA Manufacturing Ltd.,IE,-1460531.57
04/10/2024,04/10/2024,Supplier Payment - CodeCraft Contractors #11,Supplier Payment,SaaS-GL,47331.78,0,EUR,SWIFT MT103,CodeCraft Contractors #11,***4201,,PO-202410-SaaS-GL-0006,FALSE,FALSE,REF-786964,First Continental Bank,***6815,Globex EMEA Manufacturing Ltd.,IE,-1507863.35
05/10/2024,05/10/2024,Supplier Payment - EuroFab Assembly #5,Supplier Payment,CEM-EMEA,6566.95,0,EUR,SEPA Debit,EuroFab Assembly #5,***7911,,PO-202410-CEM-EMEA-0004,FALSE,FALSE,REF-500327,First Continental Bank,***9391,Globex EMEA Manufacturing Ltd.,IE,-1514430.3
06/10/2024,06/10/2024,Supplier Payment - Stelliform Parts BV #13,Supplier Payment,CEM-EMEA,106250.7,0,EUR,SWIFT MT103,Stelliform Parts BV #13,***2743,,PO-202410-CEM-EMEA-0003,FALSE,FALSE,REF-575980,First Continental Bank,***9832,Globex EMEA Manufacturing Ltd.,IE,-1620681
07/10/2024,07/10/2024,Supplier Payment - ExpertNet Subcontractors #8,Supplier Payment,PS-GL,2247.51,0,EUR,SWIFT MT103,ExpertNet Subcontractors #8,***7063,,PO-202410-PS-GL-0006,FALSE,FALSE,REF-599204,First Continental Bank,***4742,Globex EMEA Manufacturing Ltd.,IE,-1622928.51
07/10/2024,07/10/2024,Supplier Payment - HyperCloud Infra #6,Supplier Payment,SaaS-GL,3372.67,0,EUR,SEPA Debit,HyperCloud Infra #6,***7885,,PO-202410-SaaS-GL-0008,FALSE,FALSE,REF-248106,First Continental Bank,***2194,Globex EMEA Manufacturing Ltd.,IE,-1626301.18
07/10/2024,07/10/2024,Supplier Payment - ExpertNet Subcontractors #12,Supplier Payment,PS-GL,7557.02,0,EUR,SEPA Debit,ExpertNet Subcontractors #12,***5376,,PO-202410-PS-GL-0005,FALSE,FALSE,REF-644813,First Continental Bank,***7340,Globex EMEA Manufacturing Ltd.,IE,-1633858.2
07/10/2024,07/10/2024,Supplier Payment - CodeCraft Contractors #7,Supplier Payment,SaaS-GL,23357.62,0,EUR,SWIFT MT103,CodeCraft Contractors #7,***5068,,PO-202410-SaaS-GL-0003,FALSE,FALSE,REF-916330,First Continental Bank,***8163,Globex EMEA Manufacturing Ltd.,IE,-1657215.82
07/10/2024,07/10/2024,Client Receipt - Novatek Components Ltd #3,Sales Receipt,CEM-EMEA,0,21568.42,EUR,SEPA SCT Inst,Novatek Components Ltd #3,***7951,INV-202410-CEM-EMEA-0018,,FALSE,FALSE,REF-246642,First Continental Bank,***8385,Globex EMEA Manufacturing Ltd.,IE,-1635647.4
07/10/2024,07/10/2024,Client Receipt - Novatek Components Ltd #3,Sales Receipt,CEM-EMEA,0,75551.41,EUR,Card Settlement,Novatek Components Ltd #3,***3882,INV-202410-CEM-EMEA-0009,,FALSE,FALSE,REF-754847,First Continental Bank,***3728,Globex EMEA Manufacturing Ltd.,IE,-1560095.99
07/10/2024,07/10/2024,Client Receipt - CloudBridge Co. #23,Sales Receipt,SaaS-GL,0,88875.38,EUR,Card Settlement,CloudBridge Co. #23,***8854,INV-202410-SaaS-GL-0008,,FALSE,FALSE,REF-523083,First Continental Bank,***1735,Globex EMEA Manufacturing Ltd.,IE,-1471220.61
08/10/2024,08/10/2024,Metro Water & Waste,Rent & Utilities,ALL,3474.67,0,EUR,SWIFT MT103,Metro Water & Waste,***3199,,,FALSE,FALSE,REF-913710,First Continental Bank,***5534,Globex EMEA Manufacturing Ltd.,IE,-1474695.28
08/10/2024,08/10/2024,Supplier Payment - HyperCloud Infra #15,Supplier Payment,SaaS-GL,8634.81,0,EUR,SEPA Credit Transfer,HyperCloud Infra #15,***8555,,PO-202410-SaaS-GL-0004,FALSE,FALSE,REF-705335,First Continental Bank,***3222,Globex EMEA Manufacturing Ltd.,IE,-1483330.09
08/10/2024,08/10/2024,Client Receipt - Novatek Components Ltd #6,Sales Receipt,CEM-EMEA,0,72621.06,EUR,SEPA SCT,Novatek Components Ltd #6,***2926,INV-202410-CEM-EMEA-0008,,FALSE,FALSE,REF-355180,First Continental Bank,***2684,Globex EMEA Manufacturing Ltd.,IE,-1410709.03
08/10/2024,08/10/2024,Client Receipt - Aurora Electronics GmbH #2,Sales Receipt,CEM-EMEA,0,74489.5,EUR,SEPA SCT Inst,Aurora Electronics GmbH #2,***3163,INV-202410-CEM-EMEA-0002,,FALSE,FALSE,REF-163541,First Continental Bank,***9778,Globex EMEA Manufacturing Ltd.,IE,-1336219.53
09/10/2024,09/10/2024,Client Receipt - Novatek Components Ltd #10,Sales Receipt,CEM-EMEA,0,68587.7,EUR,SEPA SCT,Novatek Components Ltd #10,***6039,INV-202410-CEM-EMEA-0007,,FALSE,FALSE,REF-817324,First Continental Bank,***6380,Globex EMEA Manufacturing Ltd.,IE,-1267631.83
10/10/2024,10/10/2024,Supplier Payment - ExpertNet Subcontractors #3,Supplier Payment,PS-GL,33500.44,0,EUR,SEPA Debit,ExpertNet Subcontractors #3,***9683,,PO-202410-PS-GL-0001,FALSE,FALSE,REF-286126,First Continental Bank,***1305,Globex EMEA Manufacturing Ltd.,IE,-1301132.27
10/10/2024,10/10/2024,Client Receipt - CloudBridge Co. #50,Sales Receipt,SaaS-GL,0,18028.4,EUR,Card Settlement,CloudBridge Co. #50,***3876,INV-202410-SaaS-GL-0024,,FALSE,FALSE,REF-905092,First Continental Bank,***9398,Globex EMEA Manufacturing Ltd.,IE,-1283103.87
11/10/2024,11/10/2024,Supplier Payment - ExpertNet Subcontractors #3,Supplier Payment,PS-GL,9750.5,0,EUR,SEPA Debit,ExpertNet Subcontractors #3,***2617,,PO-202410-PS-GL-0007,FALSE,FALSE,REF-566203,First Continental Bank,***3022,Globex EMEA Manufacturing Ltd.,IE,-1292854.37
11/10/2024,11/10/2024,Client Receipt - CloudBridge Co. #64,Sales Receipt,SaaS-GL,0,7048.31,EUR,SEPA SCT,CloudBridge Co. #64,***3257,INV-202410-SaaS-GL-0013,,FALSE,FALSE,REF-407822,First Continental Bank,***1792,Globex EMEA Manufacturing Ltd.,IE,-1285806.06
11/10/2024,11/10/2024,Client Receipt - CloudBridge Co. #6,Sales Receipt,SaaS-GL,0,25994.55,EUR,Card Settlement,CloudBridge Co. #6,***6224,INV-202410-SaaS-GL-0014,,FALSE,FALSE,REF-192779,First Continental Bank,***3693,Globex EMEA Manufacturing Ltd.,IE,-1259811.51
11/10/2024,11/10/2024,Client Receipt - Aurora Electronics GmbH #6,Sales Receipt,CEM-EMEA,0,148358.53,EUR,SEPA SCT,Aurora Electronics GmbH #6,***6292,INV-202410-CEM-EMEA-0015,,FALSE,FALSE,REF-944633,First Continental Bank,***9840,Globex EMEA Manufacturing Ltd.,IE,-1111452.98
12/10/2024,12/10/2024,Intercompany Settlement - Globex APAC Logistics Pte. Ltd.,Intercompany Transfer,ALL,372593,0,EUR,Internal Transfer,Globex APAC Logistics Pte. Ltd.,***8832,,,TRUE,TRUE,REF-951123,First Continental Bank,***6504,Globex EMEA Manufacturing Ltd.,IE,-1484045.98
13/10/2024,13/10/2024,Client Receipt - CloudBridge Co. #9,Sales Receipt,SaaS-GL,0,38113,EUR,SEPA SCT,CloudBridge Co. #9,***3456,INV-202410-SaaS-GL-0022,,FALSE,FALSE,REF-991775,First Continental Bank,***5196,Globex EMEA Manufacturing Ltd.,IE,-1445932.98
14/10/2024,14/10/2024,Supplier Payment - ExpertNet Subcontractors #4,Supplier Payment,PS-GL,19800.01,0,EUR,SEPA Credit Transfer,ExpertNet Subcontractors #4,***9934,,PO-202410-PS-GL-0009,FALSE,FALSE,REF-763981,First Continental Bank,***2997,Globex EMEA Manufacturing Ltd.,IE,-1465732.99
14/10/2024,14/10/2024,Client Receipt - CloudBridge Co. #44,Sales Receipt,SaaS-GL,0,24646.09,EUR,SEPA SCT,CloudBridge Co. #44,***8828,INV-202410-SaaS-GL-0018,,FALSE,FALSE,REF-502162,First Continental Bank,***5142,Globex EMEA Manufacturing Ltd.,IE,-1441086.9
15/10/2024,15/10/2024,Supplier Payment - HyperCloud Infra #18,Supplier Payment,SaaS-GL,1735.13,0,EUR,SEPA Debit,HyperCloud Infra #18,***8587,,PO-202410-SaaS-GL-0005,FALSE,FALSE,REF-849934,First Continental Bank,***4666,Globex EMEA Manufacturing Ltd.,IE,-1442822.03
15/10/2024,15/10/2024,Supplier Payment - ExpertNet Subcontractors #2,Supplier Payment,PS-GL,10066.52,0,EUR,SEPA Debit,ExpertNet Subcontractors #2,***8498,,PO-202410-PS-GL-0004,FALSE,FALSE,REF-604954,First Continental Bank,***6155,Globex EMEA Manufacturing Ltd.,IE,-1452888.55
15/10/2024,15/10/2024,Loan Interest Payment,Loan Interest,ALL,85000,0,EUR,SEPA Debit,First Continental Bank - Corporate Lending,***1377,,,FALSE,FALSE,REF-542497,First Continental Bank,***7975,Globex EMEA Manufacturing Ltd.,IE,-1537888.55
15/10/2024,15/10/2024,Loan Principal Repayment,Loan Principal,ALL,500000,0,EUR,SWIFT MT103,First Continental Bank - Corporate Lending,***1770,,,FALSE,FALSE,REF-647536,First Continental Bank,***8401,Globex EMEA Manufacturing Ltd.,IE,-2037888.55
15/10/2024,15/10/2024,Client Receipt - Vertex Advisory Client #5,Sales Receipt,PS-GL,0,22920.56,EUR,SEPA SCT,Vertex Advisory Client #5,***9256,INV-202410-PS-GL-0005,,FALSE,FALSE,REF-738731,First Continental Bank,***4866,Globex EMEA Manufacturing Ltd.,IE,-2014967.99
15/10/2024,15/10/2024,Client Receipt - Vertex Advisory Client #55,Sales Receipt,PS-GL,0,111382.85,EUR,SEPA SCT,Vertex Advisory Client #55,***2173,INV-202410-PS-GL-0006,,FALSE,FALSE,REF-519903,First Continental Bank,***6032,Globex EMEA Manufacturing Ltd.,IE,-1903585.14
15/10/2024,15/10/2024,Client Receipt - Aurora Electronics GmbH #11,Sales Receipt,CEM-EMEA,0,145629.5,EUR,Card Settlement,Aurora Electronics GmbH #11,***7891,INV-202410-CEM-EMEA-0003,,FALSE,FALSE,REF-144606,First Continental Bank,***1329,Globex EMEA Manufacturing Ltd.,IE,-1757955.64
16/10/2024,16/10/2024,Supplier Payment - Stelliform Parts BV #28,Supplier Payment,CEM-EMEA,40170.73,0,EUR,SWIFT MT103,Stelliform Parts BV #28,***6728,,PO-202410-CEM-EMEA-0001,FALSE,FALSE,REF-717684,First Continental Bank,***1743,Globex EMEA Manufacturing Ltd.,IE,-1798126.37
16/10/2024,16/10/2024,Supplier Payment - EuroFab Assembly #7,Supplier Payment,CEM-EMEA,65280.17,0,EUR,SEPA Debit,EuroFab Assembly #7,***8191,,PO-202410-CEM-EMEA-0005,FALSE,FALSE,REF-826568,First Continental Bank,***9041,Globex EMEA Manufacturing Ltd.,IE,-1863406.54
16/10/2024,16/10/2024,Supplier Payment - Stelliform Parts BV #31,Supplier Payment,CEM-EMEA,202479.56,0,EUR,SEPA Debit,Stelliform Parts BV #31,***1231,,PO-202410-CEM-EMEA-0007,FALSE,FALSE,REF-656314,First Continental Bank,***9200,Globex EMEA Manufacturing Ltd.,IE,-2065886.1
16/10/2024,16/10/2024,Client Receipt - CloudBridge Co. #33,Sales Receipt,SaaS-GL,0,47157.73,EUR,SEPA SCT,CloudBridge Co. #33,***3505,INV-202410-SaaS-GL-0004,,FALSE,FALSE,REF-869447,First Continental Bank,***2741,Globex EMEA Manufacturing Ltd.,IE,-2018728.37
16/10/2024,16/10/2024,Client Receipt - Aurora Electronics GmbH #17,Sales Receipt,CEM-EMEA,0,52007.55,EUR,Card Settlement,Aurora Electronics GmbH #17,***5316,INV-202410-CEM-EMEA-0006,,FALSE,FALSE,REF-975749,First Continental Bank,***7457,Globex EMEA Manufacturing Ltd.,IE,-1966720.82
17/10/2024,17/10/2024,Skyline Internet Services,Rent & Utilities,ALL,14304.35,0,EUR,SEPA Credit Transfer,Skyline Internet Services,***4001,,,FALSE,FALSE,REF-716296,First Continental Bank,***4278,Globex EMEA Manufacturing Ltd.,IE,-1981025.17
17/10/2024,17/10/2024,Client Receipt - Novatek Components Ltd #12,Sales Receipt,CEM-EMEA,0,13290.09,EUR,SEPA SCT,Novatek Components Ltd #12,***5452,INV-202410-CEM-EMEA-0010,,FALSE,FALSE,REF-308831,First Continental Bank,***4572,Globex EMEA Manufacturing Ltd.,IE,-1967735.08
17/10/2024,17/10/2024,Client Receipt - Vertex Advisory Client #48,Sales Receipt,PS-GL,0,34190.36,EUR,SEPA SCT Inst,Vertex Advisory Client #48,***3764,INV-202410-PS-GL-0007,,FALSE,FALSE,REF-744810,First Continental Bank,***8821,Globex EMEA Manufacturing Ltd.,IE,-1933544.72
17/10/2024,17/10/2024,Client Receipt - Aurora Electronics GmbH #12,Sales Receipt,CEM-EMEA,0,78496.97,EUR,SEPA SCT,Aurora Electronics GmbH #12,***2076,INV-202410-CEM-EMEA-0011,,FALSE,FALSE,REF-781591,First Continental Bank,***1889,Globex EMEA Manufacturing Ltd.,IE,-1855047.75
18/10/2024,18/10/2024,Supplier Payment - ExpertNet Subcontractors #12,Supplier Payment,PS-GL,35163.3,0,EUR,SEPA Debit,ExpertNet Subcontractors #12,***4443,,PO-202410-PS-GL-0003,FALSE,FALSE,REF-305822,First Continental Bank,***6954,Globex EMEA Manufacturing Ltd.,IE,-1890211.05
18/10/2024,18/10/2024,Client Receipt - CloudBridge Co. #33,Sales Receipt,SaaS-GL,0,42800.01,EUR,SEPA SCT Inst,CloudBridge Co. #33,***7383,INV-202410-SaaS-GL-0017,,FALSE,FALSE,REF-782404,First Continental Bank,***8376,Globex EMEA Manufacturing Ltd.,IE,-1847411.04
21/10/2024,21/10/2024,VAT/GST Remittance - Revenue Ireland,Tax Payment,ALL,128039.18,0,EUR,SEPA Credit Transfer,Revenue Ireland,***8017,,,FALSE,FALSE,REF-909457,First Continental Bank,***5019,Globex EMEA Manufacturing Ltd.,IE,-1975450.22
21/10/2024,21/10/2024,Client Receipt - CloudBridge Co. #38,Sales Receipt,SaaS-GL,0,21508.51,EUR,SEPA SCT,CloudBridge Co. #38,***1020,INV-202410-SaaS-GL-0019,,FALSE,FALSE,REF-697077,First Continental Bank,***6920,Globex EMEA Manufacturing Ltd.,IE,-1953941.71
21/10/2024,21/10/2024,Client Receipt - Vertex Advisory Client #43,Sales Receipt,PS-GL,0,25589.82,EUR,SEPA SCT Inst,Vertex Advisory Client #43,***9620,INV-202410-PS-GL-0004,,FALSE,FALSE,REF-851340,First Continental Bank,***7561,Globex EMEA Manufacturing Ltd.,IE,-1928351.89
22/10/2024,22/10/2024,Supplier Payment - CodeCraft Contractors #9,Supplier Payment,SaaS-GL,5053.5,0,EUR,SWIFT MT103,CodeCraft Contractors #9,***3964,,PO-202410-SaaS-GL-0002,FALSE,FALSE,REF-118700,First Continental Bank,***2336,Globex EMEA Manufacturing Ltd.,IE,-1933405.39
22/10/2024,22/10/2024,Marketing - Aurelia Media #1,Marketing,ALL,27093.19,0,EUR,SEPA Credit Transfer,Aurelia Media #1,***9583,,,FALSE,FALSE,REF-314195,First Continental Bank,***8758,Globex EMEA Manufacturing Ltd.,IE,-1960498.58
22/10/2024,22/10/2024,Supplier Payment - Stelliform Parts BV #20,Supplier Payment,CEM-EMEA,92270.88,0,EUR,SWIFT MT103,Stelliform Parts BV #20,***6087,,PO-202410-CEM-EMEA-0008,FALSE,FALSE,REF-993351,First Continental Bank,***4822,Globex EMEA Manufacturing Ltd.,IE,-2052769.46
22/10/2024,22/10/2024,Client Receipt - Novatek Components Ltd #7,Sales Receipt,CEM-EMEA,0,6151.44,EUR,SEPA SCT,Novatek Components Ltd #7,***7657,INV-202410-CEM-EMEA-0013,,FALSE,FALSE,REF-941734,First Continental Bank,***7971,Globex EMEA Manufacturing Ltd.,IE,-2046618.02
23/10/2024,23/10/2024,Merchant Processing Fees,Bank/Merchant Fees,ALL,4162.69,0,EUR,SWIFT MT103,First Continental Bank,***2788,,,FALSE,FALSE,REF-730980,First Continental Bank,***2798,Globex EMEA Manufacturing Ltd.,IE,-2050780.71
23/10/2024,23/10/2024,Client Receipt - CloudBridge Co. #74,Sales Receipt,SaaS-GL,0,29542.95,EUR,SEPA SCT,CloudBridge Co. #74,***4418,INV-202410-SaaS-GL-0016,,FALSE,FALSE,REF-757699,First Continental Bank,***2797,Globex EMEA Manufacturing Ltd.,IE,-2021237.76
24/10/2024,24/10/2024,Supplier Payment - ExpertNet Subcontractors #10,Supplier Payment,PS-GL,580.86,0,EUR,SEPA Debit,ExpertNet Subcontractors #10,***3941,,PO-202410-PS-GL-0011,FALSE,FALSE,REF-575339,First Continental Bank,***3851,Globex EMEA Manufacturing Ltd.,IE,-2021818.62
24/10/2024,24/10/2024,Supplier Payment - EuroFab Assembly #15,Supplier Payment,CEM-EMEA,940.34,0,EUR,SEPA Debit,EuroFab Assembly #15,***9233,,PO-202410-CEM-EMEA-0002,FALSE,FALSE,REF-899648,First Continental Bank,***8589,Globex EMEA Manufacturing Ltd.,IE,-2022758.96
24/10/2024,24/10/2024,Marketing - Beacon Digital #9,Marketing,ALL,28036.59,0,EUR,SEPA Debit,Beacon Digital #9,***5259,,,FALSE,FALSE,REF-423985,First Continental Bank,***7185,Globex EMEA Manufacturing Ltd.,IE,-2050795.55
24/10/2024,24/10/2024,Client Receipt - CloudBridge Co. #38,Sales Receipt,SaaS-GL,0,9631.88,EUR,SEPA SCT,CloudBridge Co. #38,***7188,INV-202410-SaaS-GL-0015,,FALSE,FALSE,REF-596110,First Continental Bank,***5653,Globex EMEA Manufacturing Ltd.,IE,-2041163.67
25/10/2024,25/10/2024,Supplier Payment - HyperCloud Infra #11,Supplier Payment,SaaS-GL,57219.22,0,EUR,SEPA Debit,HyperCloud Infra #11,***3474,,PO-202410-SaaS-GL-0007,FALSE,FALSE,REF-374414,First Continental Bank,***5167,Globex EMEA Manufacturing Ltd.,IE,-2098382.89
25/10/2024,25/10/2024,Client Receipt - Novatek Components Ltd #7,Sales Receipt,CEM-EMEA,0,38608.38,EUR,Card Settlement,Novatek Components Ltd #7,***2475,INV-202410-CEM-EMEA-0017,,FALSE,FALSE,REF-199070,First Continental Bank,***8100,Globex EMEA Manufacturing Ltd.,IE,-2059774.51
25/10/2024,25/10/2024,Client Receipt - Vertex Advisory Client #12,Sales Receipt,PS-GL,0,66273.13,EUR,Card Settlement,Vertex Advisory Client #12,***6454,INV-202410-PS-GL-0001,,FALSE,FALSE,REF-947861,First Continental Bank,***8860,Globex EMEA Manufacturing Ltd.,IE,-1993501.38
26/10/2024,26/10/2024,"Intercompany Settlement - Globex International Holdings, Inc.",Intercompany Transfer,ALL,532187,0,EUR,Internal Transfer,"Globex International Holdings, Inc.",***7321,,,TRUE,TRUE,REF-824833,First Continental Bank,***2264,Globex EMEA Manufacturing Ltd.,IE,-2525688.38
26/10/2024,26/10/2024,Client Receipt - Vertex Advisory Client #23,Sales Receipt,PS-GL,0,28993.78,EUR,SEPA SCT,Vertex Advisory Client #23,***4567,INV-202410-PS-GL-0003,,FALSE,FALSE,REF-256425,First Continental Bank,***2824,Globex EMEA Manufacturing Ltd.,IE,-2496694.6
26/10/2024,26/10/2024,Client Receipt - CloudBridge Co. #14,Sales Receipt,SaaS-GL,0,56977.37,EUR,Card Settlement,CloudBridge Co. #14,***8326,INV-202410-SaaS-GL-0009,,FALSE,FALSE,REF-475996,First Continental Bank,***6480,Globex EMEA Manufacturing Ltd.,IE,-2439717.23
26/10/2024,26/10/2024,"Intercompany Reimbursement - Globex International Holdings, Inc.",Intercompany Transfer,ALL,0,212874.8,EUR,Internal Transfer,"Globex International Holdings, Inc.",***6142,,,TRUE,TRUE,REF-954421,First Continental Bank,***3161,Globex EMEA Manufacturing Ltd.,IE,-2226842.43
27/10/2024,27/10/2024,Payroll - GlobalPay Services Ltd,Payroll,ALL,359747.15,0,EUR,SEPA Credit Transfer,GlobalPay Services Ltd,***8656,,,FALSE,FALSE,REF-435407,First Continental Bank,***3721,Globex EMEA Manufacturing Ltd.,IE,-2586589.58
28/10/2024,28/10/2024,Corporate Tax Estimate,Tax Payment,ALL,98105.52,0,EUR,SEPA Debit,HMRC UK,***6009,,,FALSE,FALSE,REF-777523,First Continental Bank,***5445,Globex EMEA Manufacturing Ltd.,IE,-2684695.1
28/10/2024,28/10/2024,Client Receipt - CloudBridge Co. #33,Sales Receipt,SaaS-GL,0,27476.19,EUR,SEPA SCT,CloudBridge Co. #33,***9489,INV-202410-SaaS-GL-0005,,FALSE,FALSE,REF-947223,First Continental Bank,***2054,Globex EMEA Manufacturing Ltd.,IE,-2657218.91
28/10/2024,28/10/2024,Client Receipt - CloudBridge Co. #45,Sales Receipt,SaaS-GL,0,28002.85,EUR,SEPA SCT,CloudBridge Co. #45,***3925,INV-202410-SaaS-GL-0020,,FALSE,FALSE,REF-348722,First Continental Bank,***2200,Globex EMEA Manufacturing Ltd.,IE,-2629216.06
28/10/2024,28/10/2024,Client Receipt - CloudBridge Co. #49,Sales Receipt,SaaS-GL,0,56023,EUR,SEPA SCT Inst,CloudBridge Co. #49,***6989,INV-202410-SaaS-GL-0006,,FALSE,FALSE,REF-867969,First Continental Bank,***7401,Globex EMEA Manufacturing Ltd.,IE,-2573193.06
29/10/2024,29/10/2024,Supplier Payment - HyperCloud Infra #18,Supplier Payment,SaaS-GL,5944.56,0,EUR,SEPA Debit,HyperCloud Infra #18,***5997,,PO-202410-SaaS-GL-0001,FALSE,FALSE,REF-653966,First Continental Bank,***1717,Globex EMEA Manufacturing Ltd.,IE,-2579137.62
29/10/2024,29/10/2024,Supplier Payment - Stelliform Parts BV #9,Supplier Payment,CEM-EMEA,11736.97,0,EUR,SWIFT MT103,Stelliform Parts BV #9,***7989,,PO-202410-CEM-EMEA-0010,FALSE,FALSE,REF-610109,First Continental Bank,***6147,Globex EMEA Manufacturing Ltd.,IE,-2590874.59
29/10/2024,29/10/2024,Supplier Payment - ExpertNet Subcontractors #8,Supplier Payment,PS-GL,15144.98,0,EUR,SEPA Credit Transfer,ExpertNet Subcontractors #8,***9583,,PO-202410-PS-GL-0010,FALSE,FALSE,REF-585048,First Continental Bank,***4519,Globex EMEA Manufacturing Ltd.,IE,-2606019.57
29/10/2024,29/10/2024,Client Receipt - CloudBridge Co. #7,Sales Receipt,SaaS-GL,0,35549.35,EUR,SEPA SCT Inst,CloudBridge Co. #7,***4416,INV-202410-SaaS-GL-0010,,FALSE,FALSE,REF-237370,First Continental Bank,***3170,Globex EMEA Manufacturing Ltd.,IE,-2570470.22
29/10/2024,29/10/2024,Client Receipt - Novatek Components Ltd #8,Sales Receipt,CEM-EMEA,0,46613.12,EUR,Card Settlement,Novatek Components Ltd #8,***4781,INV-202410-CEM-EMEA-0005,,FALSE,FALSE,REF-472242,First Continental Bank,***6809,Globex EMEA Manufacturing Ltd.,IE,-2523857.1
29/10/2024,29/10/2024,Client Receipt - Aurora Electronics GmbH #1,Sales Receipt,CEM-EMEA,0,79418.09,EUR,Card Settlement,Aurora Electronics GmbH #1,***1579,INV-202410-CEM-EMEA-0014,,FALSE,FALSE,REF-715909,First Continental Bank,***6977,Globex EMEA Manufacturing Ltd.,IE,-2444439.01
30/10/2024,30/10/2024,Interest Earned,Interest Income,ALL,0,10577.33,EUR,Card Settlement,First Continental Bank,***1897,,,FALSE,FALSE,REF-697265,First Continental Bank,***3151,Globex EMEA Manufacturing Ltd.,IE,-2433861.68
30/10/2024,30/10/2024,Client Receipt - CloudBridge Co. #78,Sales Receipt,SaaS-GL,0,28062.81,EUR,SEPA SCT Inst,CloudBridge Co. #78,***5227,INV-202410-SaaS-GL-0003,,FALSE,FALSE,REF-785885,First Continental Bank,***1108,Globex EMEA Manufacturing Ltd.,IE,-2405798.87
30/10/2024,30/10/2024,Client Receipt - Vertex Advisory Client #5,Sales Receipt,PS-GL,0,56980.37,EUR,SEPA SCT Inst,Vertex Advisory Client #5,***4399,INV-202410-PS-GL-0002,,FALSE,FALSE,REF-797546,First Continental Bank,***3726,Globex EMEA Manufacturing Ltd.,IE,-2348818.5
31/10/2024,31/10/2024,Supplier Payment - ExpertNet Subcontractors #16,Supplier Payment,PS-GL,1111.15,0,EUR,SWIFT MT103,ExpertNet Subcontractors #16,***6700,,PO-202410-PS-GL-0002,FALSE,FALSE,REF-553538,First Continental Bank,***2049,Globex EMEA Manufacturing Ltd.,IE,-2349929.65
31/10/2024,31/10/2024,Supplier Payment - ExpertNet Subcontractors #8,Supplier Payment,PS-GL,3849.79,0,EUR,SEPA Debit,ExpertNet Subcontractors #8,***5198,,PO-202410-PS-GL-0008,FALSE,FALSE,REF-960111,First Continental Bank,***8605,Globex EMEA Manufacturing Ltd.,IE,-2353779.44
31/10/2024,31/10/2024,Client Receipt - CloudBridge Co. #61,Sales Receipt,SaaS-GL,0,13236.26,EUR,Card Settlement,CloudBridge Co. #61,***3851,INV-202410-SaaS-GL-0023,,FALSE,FALSE,REF-102800,First Continental Bank,***2851,Globex EMEA Manufacturing Ltd.,IE,-2340543.18
31/10/2024,31/10/2024,Client Receipt - Novatek Components Ltd #6,Sales Receipt,CEM-EMEA,0,42411.54,EUR,Card Settlement,Novatek Components Ltd #6,***6430,INV-202410-CEM-EMEA-0001,,FALSE,FALSE,REF-262871,First Continental Bank,***3160,Globex EMEA Manufacturing Ltd.,IE,-2298131.64
01/11/2024,01/11/2024,Account Maintenance Fee,Bank/Merchant Fees,ALL,2500,0,EUR,SEPA Debit,First Continental Bank,***6746,,,FALSE,FALSE,REF-372784,First Continental Bank,***2004,Globex EMEA Manufacturing Ltd.,IE,-2300631.64
01/11/2024,01/11/2024,Supplier Payment - ExpertNet Subcontractors #4,Supplier Payment,PS-GL,13351.32,0,EUR,SWIFT MT103,ExpertNet Subcontractors #4,***4410,,PO-202411-PS-GL-0002,FALSE,FALSE,REF-145444,First Continental Bank,***8351,Globex EMEA Manufacturing Ltd.,IE,-2313982.96
01/11/2024,01/11/2024,Supplier Payment - HyperCloud Infra #7,Supplier Payment,SaaS-GL,41615.69,0,EUR,SEPA Debit,HyperCloud Infra #7,***9801,,PO-202411-SaaS-GL-0003,FALSE,FALSE,REF-509043,First Continental Bank,***9502,Globex EMEA Manufacturing Ltd.,IE,-2355598.65
01/11/2024,01/11/2024,Supplier Payment - Stelliform Parts BV #10,Supplier Payment,CEM-EMEA,192112.18,0,EUR,SEPA Debit,Stelliform Parts BV #10,***8182,,PO-202411-CEM-EMEA-0009,FALSE,FALSE,REF-818671,First Continental Bank,***2920,Globex EMEA Manufacturing Ltd.,IE,-2547710.83
01/11/2024,01/11/2024,Client Receipt - CloudBridge Co. #5,Sales Receipt,SaaS-GL,0,24343.14,EUR,Card Settlement,CloudBridge Co. #5,***3922,INV-202411-SaaS-GL-0021,,FALSE,FALSE,REF-674687,First Continental Bank,***6898,Globex EMEA Manufacturing Ltd.,IE,-2523367.69
01/11/2024,01/11/2024,Client Receipt - Vertex Advisory Client #9,Sales Receipt,PS-GL,0,34080.16,EUR,SEPA SCT Inst,Vertex Advisory Client #9,***9111,INV-202411-PS-GL-0008,,FALSE,FALSE,REF-366548,First Continental Bank,***1870,Globex EMEA Manufacturing Ltd.,IE,-2489287.53
03/11/2024,03/11/2024,Client Receipt - CloudBridge Co. #65,Sales Receipt,SaaS-GL,0,9978.65,EUR,SEPA SCT Inst,CloudBridge Co. #65,***7367,INV-202411-SaaS-GL-0011,,FALSE,FALSE,REF-943655,First Continental Bank,***5176,Globex EMEA Manufacturing Ltd.,IE,-2479308.88
03/11/2024,03/11/2024,Client Receipt - Novatek Components Ltd #3,Sales Receipt,CEM-EMEA,0,82843.73,EUR,SEPA SCT,Novatek Components Ltd #3,***6788,INV-202411-CEM-EMEA-0004,,FALSE,FALSE,REF-155239,First Continental Bank,***3985,Globex EMEA Manufacturing Ltd.,IE,-2396465.15
04/11/2024,04/11/2024,Supplier Payment - HyperCloud Infra #15,Supplier Payment,SaaS-GL,44557.78,0,EUR,SWIFT MT103,HyperCloud Infra #15,***1923,,PO-202411-SaaS-GL-0006,FALSE,FALSE,REF-727110,First Continental Bank,***7762,Globex EMEA Manufacturing Ltd.,IE,-2441022.93
04/11/2024,04/11/2024,Client Receipt - Aurora Electronics GmbH #18,Sales Receipt,CEM-EMEA,0,6299.11,EUR,SEPA SCT Inst,Aurora Electronics GmbH #18,***4437,INV-202411-CEM-EMEA-0013,,FALSE,FALSE,REF-258871,First Continental Bank,***5199,Globex EMEA Manufacturing Ltd.,IE,-2434723.82
04/11/2024,04/11/2024,Client Receipt - CloudBridge Co. #29,Sales Receipt,SaaS-GL,0,19707.89,EUR,SEPA SCT,CloudBridge Co. #29,***8387,INV-202411-SaaS-GL-0015,,FALSE,FALSE,REF-607169,First Continental Bank,***8268,Globex EMEA Manufacturing Ltd.,IE,-2415015.93
04/11/2024,04/11/2024,Client Receipt - CloudBridge Co. #37,Sales Receipt,SaaS-GL,0,24295.44,EUR,SEPA SCT Inst,CloudBridge Co. #37,***3452,INV-202411-SaaS-GL-0014,,FALSE,FALSE,REF-663884,First Continental Bank,***3434,Globex EMEA Manufacturing Ltd.,IE,-2390720.49
05/11/2024,05/11/2024,Supplier Payment - ExpertNet Subcontractors #3,Supplier Payment,PS-GL,6415.83,0,EUR,SEPA Credit Transfer,ExpertNet Subcontractors #3,***4123,,PO-202411-PS-GL-0009,FALSE,FALSE,REF-865659,First Continental Bank,***3465,Globex EMEA Manufacturing Ltd.,IE,-2397136.32
05/11/2024,05/11/2024,Supplier Payment - ExpertNet Subcontractors #18,Supplier Payment,PS-GL,7796.33,0,EUR,SEPA Debit,ExpertNet Subcontractors #18,***4346,,PO-202411-PS-GL-0005,FALSE,FALSE,REF-606168,First Continental Bank,***9460,Globex EMEA Manufacturing Ltd.,IE,-2404932.65
05/11/2024,05/11/2024,Client Receipt - CloudBridge Co. #73,Sales Receipt,SaaS-GL,0,15013.21,EUR,Card Settlement,CloudBridge Co. #73,***3405,INV-202411-SaaS-GL-0005,,FALSE,FALSE,REF-542474,First Continental Bank,***6165,Globex EMEA Manufacturing Ltd.,IE,-2389919.44
06/11/2024,06/11/2024,Marketing - Aurelia Media #11,Marketing,ALL,41898.14,0,EUR,SWIFT MT103,Aurelia Media #11,***6097,,,FALSE,FALSE,REF-216451,First Continental Bank,***8379,Globex EMEA Manufacturing Ltd.,IE,-2431817.58
06/11/2024,06/11/2024,Client Receipt - CloudBridge Co. #78,Sales Receipt,SaaS-GL,0,24897.7,EUR,Card Settlement,CloudBridge Co. #78,***2714,INV-202411-SaaS-GL-0023,,FALSE,FALSE,REF-999995,First Continental Bank,***7450,Globex EMEA Manufacturing Ltd.,IE,-2406919.88
07/11/2024,07/11/2024,Client Receipt - Vertex Advisory Client #21,Sales Receipt,PS-GL,0,15413.46,EUR,SEPA SCT,Vertex Advisory Client #21,***8577,INV-202411-PS-GL-0002,,FALSE,FALSE,REF-603584,First Continental Bank,***2634,Globex EMEA Manufacturing Ltd.,IE,-2391506.42
08/11/2024,08/11/2024,Client Receipt - CloudBridge Co. #35,Sales Receipt,SaaS-GL,0,42313.04,EUR,Card Settlement,CloudBridge Co. #35,***6069,INV-202411-SaaS-GL-0004,,FALSE,FALSE,REF-452945,First Continental Bank,***6031,Globex EMEA Manufacturing Ltd.,IE,-2349193.38
08/11/2024,08/11/2024,Client Receipt - CloudBridge Co. #49,Sales Receipt,SaaS-GL,0,49746.61,EUR,Card Settlement,CloudBridge Co. #49,***2833,INV-202411-SaaS-GL-0002,,FALSE,FALSE,REF-774941,First Continental Bank,***4429,Globex EMEA Manufacturing Ltd.,IE,-2299446.77
09/11/2024,09/11/2024,Client Receipt - Novatek Components Ltd #10,Sales Receipt,CEM-EMEA,0,10487.99,EUR,SEPA SCT,Novatek Components Ltd #10,***3295,INV-202411-CEM-EMEA-0007,,FALSE,FALSE,REF-289056,First Continental Bank,***7554,Globex EMEA Manufacturing Ltd.,IE,-2288958.78
09/11/2024,09/11/2024,Client Receipt - CloudBridge Co. #70,Sales Receipt,SaaS-GL,0,20317.03,EUR,Card Settlement,CloudBridge Co. #70,***7252,INV-202411-SaaS-GL-0009,,FALSE,FALSE,REF-136337,First Continental Bank,***9223,Globex EMEA Manufacturing Ltd.,IE,-2268641.75
11/11/2024,11/11/2024,Supplier Payment - HyperCloud Infra #8,Supplier Payment,SaaS-GL,7176.08,0,EUR,SWIFT MT103,HyperCloud Infra #8,***1695,,PO-202411-SaaS-GL-0002,FALSE,FALSE,REF-174741,First Continental Bank,***7007,Globex EMEA Manufacturing Ltd.,IE,-2275817.83
12/11/2024,12/11/2024,Supplier Payment - ExpertNet Subcontractors #3,Supplier Payment,PS-GL,15946.78,0,EUR,SEPA Debit,ExpertNet Subcontractors #3,***5053,,PO-202411-PS-GL-0007,FALSE,FALSE,REF-626766,First Continental Bank,***4411,Globex EMEA Manufacturing Ltd.,IE,-2291764.61
12/11/2024,12/11/2024,Supplier Payment - EuroFab Assembly #18,Supplier Payment,CEM-EMEA,62829.29,0,EUR,SEPA Debit,EuroFab Assembly #18,***9552,,PO-202411-CEM-EMEA-0006,FALSE,FALSE,REF-667961,First Continental Bank,***3045,Globex EMEA Manufacturing Ltd.,IE,-2354593.9
12/11/2024,12/11/2024,Intercompany Settlement - Globex APAC Logistics Pte. Ltd.,Intercompany Transfer,ALL,649541,0,EUR,Internal Transfer,Globex APAC Logistics Pte. Ltd.,***2144,,,TRUE,TRUE,REF-747753,First Continental Bank,***9540,Globex EMEA Manufacturing Ltd.,IE,-3004134.9
12/11/2024,12/11/2024,Client Receipt - Vertex Advisory Client #40,Sales Receipt,PS-GL,0,94111.93,EUR,SEPA SCT Inst,Vertex Advisory Client #40,***5952,INV-202411-PS-GL-0006,,FALSE,FALSE,REF-265318,First Continental Bank,***4193,Globex EMEA Manufacturing Ltd.,IE,-2910022.97
13/11/2024,13/11/2024,Marketing - Aurelia Media #7,Marketing,ALL,3355.27,0,EUR,SWIFT MT103,Aurelia Media #7,***7336,,,FALSE,FALSE,REF-544870,First Continental Bank,***9326,Globex EMEA Manufacturing Ltd.,IE,-2913378.24
13/11/2024,13/11/2024,Supplier Payment - HyperCloud Infra #18,Supplier Payment,SaaS-GL,10319.4,0,EUR,SWIFT MT103,HyperCloud Infra #18,***6210,,PO-202411-SaaS-GL-0007,FALSE,FALSE,REF-758072,First Continental Bank,***4729,Globex EMEA Manufacturing Ltd.,IE,-2923697.64
13/11/2024,13/11/2024,Supplier Payment - Stelliform Parts BV #7,Supplier Payment,CEM-EMEA,33612.63,0,EUR,SWIFT MT103,Stelliform Parts BV #7,***4331,,PO-202411-CEM-EMEA-0004,FALSE,FALSE,REF-662899,First Continental Bank,***6019,Globex EMEA Manufacturing Ltd.,IE,-2957310.27
13/11/2024,13/11/2024,Supplier Payment - CodeCraft Contractors #14,Supplier Payment,SaaS-GL,37872,0,EUR,SWIFT MT103,CodeCraft Contractors #14,***3170,,PO-202411-SaaS-GL-0005,FALSE,FALSE,REF-130654,First Continental Bank,***3848,Globex EMEA Manufacturing Ltd.,IE,-2995182.27
13/11/2024,13/11/2024,Client Receipt - CloudBridge Co. #16,Sales Receipt,SaaS-GL,0,12787.33,EUR,Card Settlement,CloudBridge Co. #16,***2229,INV-202411-SaaS-GL-0006,,FALSE,FALSE,REF-471988,First Continental Bank,***9052,Globex EMEA Manufacturing Ltd.,IE,-2982394.94
13/11/2024,13/11/2024,Client Receipt - CloudBridge Co. #67,Sales Receipt,SaaS-GL,0,69451.16,EUR,Card Settlement,CloudBridge Co. #67,***9000,INV-202411-SaaS-GL-0018,,FALSE,FALSE,REF-431118,First Continental Bank,***9897,Globex EMEA Manufacturing Ltd.,IE,-2912943.78
14/11/2024,14/11/2024,Supplier Payment - Stelliform Parts BV #26,Supplier Payment,CEM-EMEA,15045.11,0,EUR,SWIFT MT103,Stelliform Parts BV #26,***1136,,PO-202411-CEM-EMEA-0002,FALSE,FALSE,REF-121911,First Continental Bank,***3822,Globex EMEA Manufacturing Ltd.,IE,-2927988.89
14/11/2024,14/11/2024,Client Receipt - CloudBridge Co. #37,Sales Receipt,SaaS-GL,0,23755.16,EUR,SEPA SCT Inst,CloudBridge Co. #37,***6261,INV-202411-SaaS-GL-0012,,FALSE,FALSE,REF-697961,First Continental Bank,***8982,Globex EMEA Manufacturing Ltd.,IE,-2904233.73
15/11/2024,15/11/2024,Supplier Payment - ExpertNet Subcontractors #12,Supplier Payment,PS-GL,6747.7,0,EUR,SEPA Debit,ExpertNet Subcontractors #12,***1921,,PO-202411-PS-GL-0001,FALSE,FALSE,REF-699332,First Continental Bank,***1295,Globex EMEA Manufacturing Ltd.,IE,-2910981.43
15/11/2024,15/11/2024,Loan Interest Payment,Loan Interest,ALL,85000,0,EUR,SWIFT MT103,First Continental Bank - Corporate Lending,***9167,,,FALSE,FALSE,REF-905757,First Continental Bank,***6185,Globex EMEA Manufacturing Ltd.,IE,-2995981.43
15/11/2024,15/11/2024,Loan Principal Repayment,Loan Principal,ALL,500000,0,EUR,SWIFT MT103,First Continental Bank - Corporate Lending,***8394,,,FALSE,FALSE,REF-494611,First Continental Bank,***1994,Globex EMEA Manufacturing Ltd.,IE,-3495981.43
15/11/2024,15/11/2024,Client Receipt - CloudBridge Co. #59,Sales Receipt,SaaS-GL,0,7039.1,EUR,Card Settlement,CloudBridge Co. #59,***8110,INV-202411-SaaS-GL-0019,,FALSE,FALSE,REF-607183,First Continental Bank,***3773,Globex EMEA Manufacturing Ltd.,IE,-3488942.33
15/11/2024,15/11/2024,Client Receipt - Aurora Electronics GmbH #2,Sales Receipt,CEM-EMEA,0,284495.62,EUR,Card Settlement,Aurora Electronics GmbH #2,***6777,INV-202411-CEM-EMEA-0012,,FALSE,FALSE,REF-731391,First Continental Bank,***4433,Globex EMEA Manufacturing Ltd.,IE,-3204446.71
16/11/2024,16/11/2024,Supplier Payment - ExpertNet Subcontractors #15,Supplier Payment,PS-GL,7633.98,0,EUR,SWIFT MT103,ExpertNet Subcontractors #15,***8197,,PO-202411-PS-GL-0008,FALSE,FALSE,REF-755526,First Continental Bank,***4409,Globex EMEA Manufacturing Ltd.,IE,-3212080.69
16/11/2024,16/11/2024,Supplier Payment - ExpertNet Subcontractors #10,Supplier Payment,PS-GL,16445.89,0,EUR,SEPA Credit Transfer,ExpertNet Subcontractors #10,***8427,,PO-202411-PS-GL-0011,FALSE,FALSE,REF-701191,First Continental Bank,***4893,Globex EMEA Manufacturing Ltd.,IE,-3228526.58
16/11/2024,16/11/2024,Client Receipt - Novatek Components Ltd #14,Sales Receipt,CEM-EMEA,0,34435.44,EUR,SEPA SCT,Novatek Components Ltd #14,***8833,INV-202411-CEM-EMEA-0011,,FALSE,FALSE,REF-289521,First Continental Bank,***3011,Globex EMEA Manufacturing Ltd.,IE,-3194091.14
17/11/2024,17/11/2024,Supplier Payment - HyperCloud Infra #11,Supplier Payment,SaaS-GL,16440.79,0,EUR,SWIFT MT103,HyperCloud Infra #11,***2956,,PO-202411-SaaS-GL-0008,FALSE,FALSE,REF-632496,First Continental Bank,***8428,Globex EMEA Manufacturing Ltd.,IE,-3210531.93
18/11/2024,18/11/2024,Marketing - Beacon Digital #5,Marketing,ALL,18810.52,0,EUR,SWIFT MT103,Beacon Digital #5,***7671,,,FALSE,FALSE,REF-797754,First Continental Bank,***3194,Globex EMEA Manufacturing Ltd.,IE,-3229342.45
18/11/2024,18/11/2024,Supplier Payment - EuroFab Assembly #4,Supplier Payment,CEM-EMEA,124900.74,0,EUR,SEPA Credit Transfer,EuroFab Assembly #4,***8870,,PO-202411-CEM-EMEA-0007,FALSE,FALSE,REF-680656,First Continental Bank,***8936,Globex EMEA Manufacturing Ltd.,IE,-3354243.19
18/11/2024,18/11/2024,Supplier Payment - EuroFab Assembly #9,Supplier Payment,CEM-EMEA,141963.6,0,EUR,SEPA Credit Transfer,EuroFab Assembly #9,***3416,,PO-202411-CEM-EMEA-0003,FALSE,FALSE,REF-639338,First Continental Bank,***8849,Globex EMEA Manufacturing Ltd.,IE,-3496206.79
19/11/2024,19/11/2024,Merchant Processing Fees,Bank/Merchant Fees,ALL,4195.86,0,EUR,SEPA Credit Transfer,First Continental Bank,***9539,,,FALSE,FALSE,REF-783898,First Continental Bank,***6809,Globex EMEA Manufacturing Ltd.,IE,-3500402.65
19/11/2024,19/11/2024,Client Receipt - CloudBridge Co. #32,Sales Receipt,SaaS-GL,0,36356.74,EUR,SEPA SCT Inst,CloudBridge Co. #32,***4513,INV-202411-SaaS-GL-0008,,FALSE,FALSE,REF-508722,First Continental Bank,***5388,Globex EMEA Manufacturing Ltd.,IE,-3464045.91
19/11/2024,19/11/2024,Client Receipt - CloudBridge Co. #28,Sales Receipt,SaaS-GL,0,37111,EUR,SEPA SCT,CloudBridge Co. #28,***4016,INV-202411-SaaS-GL-0027,,FALSE,FALSE,REF-903042,First Continental Bank,***5092,Globex EMEA Manufacturing Ltd.,IE,-3426934.91
19/11/2024,19/11/2024,Client Receipt - Aurora Electronics GmbH #10,Sales Receipt,CEM-EMEA,0,74963.45,EUR,SEPA SCT,Aurora Electronics GmbH #10,***8496,INV-202411-CEM-EMEA-0005,,FALSE,FALSE,REF-727080,First Continental Bank,***6798,Globex EMEA Manufacturing Ltd.,IE,-3351971.46
19/11/2024,19/11/2024,Client Receipt - Vertex Advisory Client #16,Sales Receipt,PS-GL,0,196079.66,EUR,Card Settlement,Vertex Advisory Client #16,***8077,INV-202411-PS-GL-0001,,FALSE,FALSE,REF-152638,First Continental Bank,***2964,Globex EMEA Manufacturing Ltd.,IE,-3155891.8
20/11/2024,20/11/2024,Merchant Processing Fees,Bank/Merchant Fees,ALL,3281.61,0,EUR,SEPA Credit Transfer,First Continental Bank,***8961,,,FALSE,FALSE,REF-789393,First Continental Bank,***9211,Globex EMEA Manufacturing Ltd.,IE,-3159173.41
20/11/2024,20/11/2024,Client Receipt - Vertex Advisory Client #40,Sales Receipt,PS-GL,0,3204.51,EUR,SEPA SCT Inst,Vertex Advisory Client #40,***2888,INV-202411-PS-GL-0004,,FALSE,FALSE,REF-345375,First Continental Bank,***4480,Globex EMEA Manufacturing Ltd.,IE,-3155968.9
21/11/2024,21/11/2024,Supplier Payment - HyperCloud Infra #16,Supplier Payment,SaaS-GL,1119.87,0,EUR,SEPA Debit,HyperCloud Infra #16,***5645,,PO-202411-SaaS-GL-0001,FALSE,FALSE,REF-920434,First Continental Bank,***1656,Globex EMEA Manufacturing Ltd.,IE,-3157088.77
21/11/2024,21/11/2024,Supplier Payment - HyperCloud Infra #4,Supplier Payment,SaaS-GL,14363.49,0,EUR,SEPA Credit Transfer,HyperCloud Infra #4,***8581,,PO-202411-SaaS-GL-0004,FALSE,FALSE,REF-371835,First Continental Bank,***7562,Globex EMEA Manufacturing Ltd.,IE,-3171452.26
21/11/2024,21/11/2024,Alphagrid Utilities,Rent & Utilities,ALL,20452.81,0,EUR,SWIFT MT103,Alphagrid Utilities,***5433,,,FALSE,FALSE,REF-228281,First Continental Bank,***7438,Globex EMEA Manufacturing Ltd.,IE,-3191905.07
21/11/2024,21/11/2024,Supplier Payment - ExpertNet Subcontractors #13,Supplier Payment,PS-GL,22532.28,0,EUR,SEPA Credit Transfer,ExpertNet Subcontractors #13,***6635,,PO-202411-PS-GL-0006,FALSE,FALSE,REF-499715,First Continental Bank,***7119,Globex EMEA Manufacturing Ltd.,IE,-3214437.35
21/11/2024,21/11/2024,Client Receipt - CloudBridge Co. #34,Sales Receipt,SaaS-GL,0,7469.93,EUR,SEPA SCT Inst,CloudBridge Co. #34,***6320,INV-202411-SaaS-GL-0028,,FALSE,FALSE,REF-273557,First Continental Bank,***7457,Globex EMEA Manufacturing Ltd.,IE,-3206967.42
21/11/2024,21/11/2024,Client Receipt - CloudBridge Co. #28,Sales Receipt,SaaS-GL,0,56842.25,EUR,SEPA SCT,CloudBridge Co. #28,***6636,INV-202411-SaaS-GL-0007,,FALSE,FALSE,REF-310450,First Continental Bank,***5270,Globex EMEA Manufacturing Ltd.,IE,-3150125.17
21/11/2024,21/11/2024,Client Receipt - Novatek Components Ltd #10,Sales Receipt,CEM-EMEA,0,274203.68,EUR,SEPA SCT,Novatek Components Ltd #10,***4818,INV-202411-CEM-EMEA-0009,,FALSE,FALSE,REF-214779,First Continental Bank,***4471,Globex EMEA Manufacturing Ltd.,IE,-2875921.49
22/11/2024,22/11/2024,VAT/GST Remittance - Revenue Ireland,Tax Payment,ALL,142434.13,0,EUR,SWIFT MT103,Revenue Ireland,***1897,,,FALSE,FALSE,REF-908978,First Continental Bank,***5433,Globex EMEA Manufacturing Ltd.,IE,-3018355.62
22/11/2024,22/11/2024,Client Receipt - CloudBridge Co. #71,Sales Receipt,SaaS-GL,0,1344.34,EUR,SEPA SCT,CloudBridge Co. #71,***6465,INV-202411-SaaS-GL-0022,,FALSE,FALSE,REF-880771,First Continental Bank,***7766,Globex EMEA Manufacturing Ltd.,IE,-3017011.28
22/11/2024,22/11/2024,Client Receipt - CloudBridge Co. #1,Sales Receipt,SaaS-GL,0,4900.81,EUR,Card Settlement,CloudBridge Co. #1,***9247,INV-202411-SaaS-GL-0030,,FALSE,FALSE,REF-263808,First Continental Bank,***8843,Globex EMEA Manufacturing Ltd.,IE,-3012110.47
22/11/2024,22/11/2024,Client Receipt - CloudBridge Co. #37,Sales Receipt,SaaS-GL,0,34636.28,EUR,SEPA SCT Inst,CloudBridge Co. #37,***7189,INV-202411-SaaS-GL-0017,,FALSE,FALSE,REF-579230,First Continental Bank,***1812,Globex EMEA Manufacturing Ltd.,IE,-2977474.19
22/11/2024,22/11/2024,Client Receipt - CloudBridge Co. #73,Sales Receipt,SaaS-GL,0,52243.24,EUR,SEPA SCT Inst,CloudBridge Co. #73,***5690,INV-202411-SaaS-GL-0003,,FALSE,FALSE,REF-527287,First Continental Bank,***8295,Globex EMEA Manufacturing Ltd.,IE,-2925230.95
22/11/2024,22/11/2024,Client Receipt - Aurora Electronics GmbH #10,Sales Receipt,CEM-EMEA,0,57804.42,EUR,Card Settlement,Aurora Electronics GmbH #10,***4775,INV-202411-CEM-EMEA-0006,,FALSE,FALSE,REF-552656,First Continental Bank,***3942,Globex EMEA Manufacturing Ltd.,IE,-2867426.53
23/11/2024,23/11/2024,Client Receipt - Novatek Components Ltd #5,Sales Receipt,CEM-EMEA,0,12936.09,EUR,Card Settlement,Novatek Components Ltd #5,***3350,INV-202411-CEM-EMEA-0002,,FALSE,FALSE,REF-381526,First Continental Bank,***2858,Globex EMEA Manufacturing Ltd.,IE,-2854490.44
23/11/2024,23/11/2024,Client Receipt - Vertex Advisory Client #43,Sales Receipt,PS-GL,0,77740.74,EUR,Card Settlement,Vertex Advisory Client #43,***7805,INV-202411-PS-GL-0005,,FALSE,FALSE,REF-180840,First Continental Bank,***5261,Globex EMEA Manufacturing Ltd.,IE,-2776749.7
23/11/2024,23/11/2024,Client Receipt - Vertex Advisory Client #6,Sales Receipt,PS-GL,0,102146.22,EUR,Card Settlement,Vertex Advisory Client #6,***1491,INV-202411-PS-GL-0007,,FALSE,FALSE,REF-709243,First Continental Bank,***7703,Globex EMEA Manufacturing Ltd.,IE,-2674603.48
24/11/2024,24/11/2024,Client Receipt - CloudBridge Co. #13,Sales Receipt,SaaS-GL,0,56663.92,EUR,SEPA SCT,CloudBridge Co. #13,***2126,INV-202411-SaaS-GL-0001,,FALSE,FALSE,REF-897175,First Continental Bank,***5688,Globex EMEA Manufacturing Ltd.,IE,-2617939.56
25/11/2024,25/11/2024,Supplier Payment - ExpertNet Subcontractors #6,Supplier Payment,PS-GL,4242.23,0,EUR,SWIFT MT103,ExpertNet Subcontractors #6,***3562,,PO-202411-PS-GL-0004,FALSE,FALSE,REF-541160,First Continental Bank,***5500,Globex EMEA Manufacturing Ltd.,IE,-2622181.79
25/11/2024,25/11/2024,Supplier Payment - Stelliform Parts BV #31,Supplier Payment,CEM-EMEA,65476.13,0,EUR,SEPA Debit,Stelliform Parts BV #31,***2323,,PO-202411-CEM-EMEA-0005,FALSE,FALSE,REF-320030,First Continental Bank,***6041,Globex EMEA Manufacturing Ltd.,IE,-2687657.92
25/11/2024,25/11/2024,Client Receipt - CloudBridge Co. #21,Sales Receipt,SaaS-GL,0,6811.33,EUR,SEPA SCT Inst,CloudBridge Co. #21,***4682,INV-202411-SaaS-GL-0029,,FALSE,FALSE,REF-731772,First Continental Bank,***5195,Globex EMEA Manufacturing Ltd.,IE,-2680846.59
25/11/2024,25/11/2024,Client Receipt - Novatek Components Ltd #5,Sales Receipt,CEM-EMEA,0,104982.24,EUR,SEPA SCT Inst,Novatek Components Ltd #5,***8063,INV-202411-CEM-EMEA-0010,,FALSE,FALSE,REF-494004,First Continental Bank,***3799,Globex EMEA Manufacturing Ltd.,IE,-2575864.35
26/11/2024,26/11/2024,Supplier Payment - ExpertNet Subcontractors #16,Supplier Payment,PS-GL,6341.09,0,EUR,SEPA Debit,ExpertNet Subcontractors #16,***4942,,PO-202411-PS-GL-0010,FALSE,FALSE,REF-137979,First Continental Bank,***5054,Globex EMEA Manufacturing Ltd.,IE,-2582205.44
26/11/2024,26/11/2024,Intercompany Settlement - Globex APAC Logistics Pte. Ltd.,Intercompany Transfer,ALL,158650,0,EUR,Internal Transfer,Globex APAC Logistics Pte. Ltd.,***7569,,,TRUE,TRUE,REF-199064,First Continental Bank,***2795,Globex EMEA Manufacturing Ltd.,IE,-2740855.44
26/11/2024,26/11/2024,Payroll - GlobalPay Services Ltd,Payroll,ALL,198673.78,0,EUR,SWIFT MT103,GlobalPay Services Ltd,***1912,,,FALSE,FALSE,REF-785565,First Continental Bank,***2372,Globex EMEA Manufacturing Ltd.,IE,-2939529.22
26/11/2024,26/11/2024,Client Receipt - Vertex Advisory Client #30,Sales Receipt,PS-GL,0,2875.13,EUR,Card Settlement,Vertex Advisory Client #30,***6332,INV-202411-PS-GL-0003,,FALSE,FALSE,REF-420129,First Continental Bank,***6412,Globex EMEA Manufacturing Ltd.,IE,-2936654.09
26/11/2024,26/11/2024,Client Receipt - CloudBridge Co. #57,Sales Receipt,SaaS-GL,0,5969.24,EUR,Card Settlement,CloudBridge Co. #57,***1233,INV-202411-SaaS-GL-0020,,FALSE,FALSE,REF-264008,First Continental Bank,***1449,Globex EMEA Manufacturing Ltd.,IE,-2930684.85
26/11/2024,26/11/2024,Intercompany Reimbursement - Globex APAC Logistics Pte. Ltd.,Intercompany Transfer,ALL,0,63460,EUR,Internal Transfer,Globex APAC Logistics Pte. Ltd.,***7877,,,TRUE,TRUE,REF-746112,First Continental Bank,***1548,Globex EMEA Manufacturing Ltd.,IE,-2867224.85
27/11/2024,27/11/2024,Client Receipt - CloudBridge Co. #28,Sales Receipt,SaaS-GL,0,15859.02,EUR,SEPA SCT,CloudBridge Co. #28,***8320,INV-202411-SaaS-GL-0016,,FALSE,FALSE,REF-537579,First Continental Bank,***6473,Globex EMEA Manufacturing Ltd.,IE,-2851365.83
27/11/2024,27/11/2024,Client Receipt - Novatek Components Ltd #4,Sales Receipt,CEM-EMEA,0,44516.59,EUR,Card Settlement,Novatek Components Ltd #4,***3842,INV-202411-CEM-EMEA-0008,,FALSE,FALSE,REF-618879,First Continental Bank,***2014,Globex EMEA Manufacturing Ltd.,IE,-2806849.24
27/11/2024,27/11/2024,Client Receipt - Aurora Electronics GmbH #15,Sales Receipt,CEM-EMEA,0,115536.86,EUR,SEPA SCT Inst,Aurora Electronics GmbH #15,***1679,INV-202411-CEM-EMEA-0003,,FALSE,FALSE,REF-309075,First Continental Bank,***7036,Globex EMEA Manufacturing Ltd.,IE,-2691312.38
27/11/2024,27/11/2024,Client Receipt - Aurora Electronics GmbH #5,Sales Receipt,CEM-EMEA,0,123015.67,EUR,SEPA SCT Inst,Aurora Electronics GmbH #5,***3356,INV-202411-CEM-EMEA-0001,,FALSE,FALSE,REF-221425,First Continental Bank,***4182,Globex EMEA Manufacturing Ltd.,IE,-2568296.71
28/11/2024,28/11/2024,Supplier Payment - EuroFab Assembly #22,Supplier Payment,CEM-EMEA,33529.77,0,EUR,SWIFT MT103,EuroFab Assembly #22,***9571,,PO-202411-CEM-EMEA-0001,FALSE,FALSE,REF-891869,First Continental Bank,***3700,Globex EMEA Manufacturing Ltd.,IE,-2601826.48
28/11/2024,28/11/2024,Client Receipt - CloudBridge Co. #19,Sales Receipt,SaaS-GL,0,23671.14,EUR,SEPA SCT Inst,CloudBridge Co. #19,***3064,INV-202411-SaaS-GL-0010,,FALSE,FALSE,REF-455103,First Continental Bank,***2476,Globex EMEA Manufacturing Ltd.,IE,-2578155.34
28/11/2024,28/11/2024,Client Receipt - CloudBridge Co. #7,Sales Receipt,SaaS-GL,0,26203.38,EUR,SEPA SCT Inst,CloudBridge Co. #7,***1833,INV-202411-SaaS-GL-0026,,FALSE,FALSE,REF-495948,First Continental Bank,***9245,Globex EMEA Manufacturing Ltd.,IE,-2551951.96
28/11/2024,28/11/2024,Client Receipt - CloudBridge Co. #25,Sales Receipt,SaaS-GL,0,39395.13,EUR,Card Settlement,CloudBridge Co. #25,***8041,INV-202411-SaaS-GL-0013,,FALSE,FALSE,REF-382226,First Continental Bank,***1672,Globex EMEA Manufacturing Ltd.,IE,-2512556.83
29/11/2024,29/11/2024,Supplier Payment - ExpertNet Subcontractors #8,Supplier Payment,PS-GL,50242.11,0,EUR,SEPA Credit Transfer,ExpertNet Subcontractors #8,***1943,,PO-202411-PS-GL-0003,FALSE,FALSE,REF-941047,First Continental Bank,***3909,Globex EMEA Manufacturing Ltd.,IE,-2562798.94
29/11/2024,29/11/2024,Supplier Payment - EuroFab Assembly #3,Supplier Payment,CEM-EMEA,66443.08,0,EUR,SEPA Debit,EuroFab Assembly #3,***6933,,PO-202411-CEM-EMEA-0008,FALSE,FALSE,REF-330201,First Continental Bank,***4269,Globex EMEA Manufacturing Ltd.,IE,-2629242.02
29/11/2024,29/11/2024,Payroll - GlobalPay Services Ltd,Payroll,ALL,198673.78,0,EUR,SEPA Debit,GlobalPay Services Ltd,***4592,,,FALSE,FALSE,REF-176160,First Continental Bank,***7749,Globex EMEA Manufacturing Ltd.,IE,-2827915.8
29/11/2024,29/11/2024,Client Receipt - CloudBridge Co. #61,Sales Receipt,SaaS-GL,0,5854.29,EUR,SEPA SCT,CloudBridge Co. #61,***3776,INV-202411-SaaS-GL-0031,,FALSE,FALSE,REF-797474,First Continental Bank,***2834,Globex EMEA Manufacturing Ltd.,IE,-2822061.51
29/11/2024,29/11/2024,Client Receipt - CloudBridge Co. #64,Sales Receipt,SaaS-GL,0,15214.98,EUR,SEPA SCT,CloudBridge Co. #64,***1118,INV-202411-SaaS-GL-0024,,FALSE,FALSE,REF-698781,First Continental Bank,***6683,Globex EMEA Manufacturing Ltd.,IE,-2806846.53
29/11/2024,29/11/2024,Client Receipt - CloudBridge Co. #13,Sales Receipt,SaaS-GL,0,18285.23,EUR,SEPA SCT,CloudBridge Co. #13,***3761,INV-202411-SaaS-GL-0025,,FALSE,FALSE,REF-437408,First Continental Bank,***6293,Globex EMEA Manufacturing Ltd.,IE,-2788561.3
30/11/2024,30/11/2024,Interest Earned,Interest Income,ALL,0,10752.02,EUR,Card Settlement,First Continental Bank,***3138,,,FALSE,FALSE,REF-313185,First Continental Bank,***2771,Globex EMEA Manufacturing Ltd.,IE,-2777809.28
01/12/2024,01/12/2024,Account Maintenance Fee,Bank/Merchant Fees,ALL,2500,0,EUR,SEPA Debit,First Continental Bank,***8574,,,FALSE,FALSE,REF-235394,First Continental Bank,***5310,Globex EMEA Manufacturing Ltd.,IE,-2780309.28
01/12/2024,01/12/2024,Supplier Payment - ExpertNet Subcontractors #11,Supplier Payment,PS-GL,15750.34,0,EUR,SWIFT MT103,ExpertNet Subcontractors #11,***3121,,PO-202412-PS-GL-0004,FALSE,FALSE,REF-335444,First Continental Bank,***1211,Globex EMEA Manufacturing Ltd.,IE,-2796059.62
01/12/2024,01/12/2024,Client Receipt - CloudBridge Co. #8,Sales Receipt,SaaS-GL,0,119978.88,EUR,SEPA SCT,CloudBridge Co. #8,***5807,INV-202412-SaaS-GL-0008,,FALSE,FALSE,REF-968037,First Continental Bank,***1692,Globex EMEA Manufacturing Ltd.,IE,-2676080.74
02/12/2024,02/12/2024,Northshore Power,Rent & Utilities,ALL,12331.02,0,EUR,SEPA Debit,Northshore Power,***2107,,,FALSE,FALSE,REF-956961,First Continental Bank,***7255,Globex EMEA Manufacturing Ltd.,IE,-2688411.76
02/12/2024,02/12/2024,Client Receipt - CloudBridge Co. #20,Sales Receipt,SaaS-GL,0,46658.83,EUR,Card Settlement,CloudBridge Co. #20,***3370,INV-202412-SaaS-GL-0006,,FALSE,FALSE,REF-645121,First Continental Bank,***3323,Globex EMEA Manufacturing Ltd.,IE,-2641752.93
02/12/2024,02/12/2024,Client Receipt - CloudBridge Co. #18,Sales Receipt,SaaS-GL,0,80485.98,EUR,SEPA SCT Inst,CloudBridge Co. #18,***1589,INV-202412-SaaS-GL-0004,,FALSE,FALSE,REF-949130,First Continental Bank,***9338,Globex EMEA Manufacturing Ltd.,IE,-2561266.95
03/12/2024,03/12/2024,Supplier Payment - CodeCraft Contractors #2,Supplier Payment,SaaS-GL,53228.21,0,EUR,SWIFT MT103,CodeCraft Contractors #2,***5595,,PO-202412-SaaS-GL-0011,FALSE,FALSE,REF-678739,First Continental Bank,***5949,Globex EMEA Manufacturing Ltd.,IE,-2614495.16
03/12/2024,03/12/2024,Supplier Payment - Stelliform Parts BV #20,Supplier Payment,CEM-EMEA,89240.92,0,EUR,SWIFT MT103,Stelliform Parts BV #20,***8912,,PO-202412-CEM-EMEA-0003,FALSE,FALSE,REF-416035,First Continental Bank,***8990,Globex EMEA Manufacturing Ltd.,IE,-2703736.08
03/12/2024,03/12/2024,Client Receipt - CloudBridge Co. #28,Sales Receipt,SaaS-GL,0,47689.2,EUR,Card Settlement,CloudBridge Co. #28,***7725,INV-202412-SaaS-GL-0012,,FALSE,FALSE,REF-314792,First Continental Bank,***2639,Globex EMEA Manufacturing Ltd.,IE,-2656046.88
04/12/2024,04/12/2024,Supplier Payment - Stelliform Parts BV #20,Supplier Payment,CEM-EMEA,57305.1,0,EUR,SEPA Debit,Stelliform Parts BV #20,***4254,,PO-202412-CEM-EMEA-0006,FALSE,FALSE,REF-764084,First Continental Bank,***9698,Globex EMEA Manufacturing Ltd.,IE,-2713351.98
04/12/2024,04/12/2024,Client Receipt - Aurora Electronics GmbH #7,Sales Receipt,CEM-EMEA,0,10922.8,EUR,SEPA SCT Inst,Aurora Electronics GmbH #7,***3624,INV-202412-CEM-EMEA-0008,,FALSE,FALSE,REF-836792,First Continental Bank,***2373,Globex EMEA Manufacturing Ltd.,IE,-2702429.18
04/12/2024,04/12/2024,Client Receipt - CloudBridge Co. #4,Sales Receipt,SaaS-GL,0,56317.33,EUR,SEPA SCT,CloudBridge Co. #4,***7563,INV-202412-SaaS-GL-0016,,FALSE,FALSE,REF-844596,First Continental Bank,***6395,Globex EMEA Manufacturing Ltd.,IE,-2646111.85
05/12/2024,05/12/2024,Merchant Processing Fees,Bank/Merchant Fees,ALL,634.44,0,EUR,SWIFT MT103,First Continental Bank,***9661,,,FALSE,FALSE,REF-458463,First Continental Bank,***6360,Globex EMEA Manufacturing Ltd.,IE,-2646746.29
05/12/2024,05/12/2024,Client Receipt - CloudBridge Co. #65,Sales Receipt,SaaS-GL,0,17854.41,EUR,Card Settlement,CloudBridge Co. #65,***3251,INV-202412-SaaS-GL-0001,,FALSE,FALSE,REF-701511,First Continental Bank,***7157,Globex EMEA Manufacturing Ltd.,IE,-2628891.88
06/12/2024,06/12/2024,Supplier Payment - HyperCloud Infra #12,Supplier Payment,SaaS-GL,1375.93,0,EUR,SEPA Credit Transfer,HyperCloud Infra #12,***4308,,PO-202412-SaaS-GL-0007,FALSE,FALSE,REF-297412,First Continental Bank,***4523,Globex EMEA Manufacturing Ltd.,IE,-2630267.81
08/12/2024,08/12/2024,Client Receipt - CloudBridge Co. #64,Sales Receipt,SaaS-GL,0,4744.26,EUR,SEPA SCT,CloudBridge Co. #64,***1558,INV-202412-SaaS-GL-0018,,FALSE,FALSE,REF-933787,First Continental Bank,***6867,Globex EMEA Manufacturing Ltd.,IE,-2625523.55
09/12/2024,09/12/2024,Supplier Payment - HyperCloud Infra #12,Supplier Payment,SaaS-GL,22947.63,0,EUR,SEPA Debit,HyperCloud Infra #12,***5052,,PO-202412-SaaS-GL-0008,FALSE,FALSE,REF-335005,First Continental Bank,***2772,Globex EMEA Manufacturing Ltd.,IE,-2648471.18
09/12/2024,09/12/2024,Supplier Payment - Stelliform Parts BV #8,Supplier Payment,CEM-EMEA,26722.01,0,EUR,SWIFT MT103,Stelliform Parts BV #8,***9413,,PO-202412-CEM-EMEA-0008,FALSE,FALSE,REF-159656,First Continental Bank,***7133,Globex EMEA Manufacturing Ltd.,IE,-2675193.19
09/12/2024,09/12/2024,Client Receipt - Aurora Electronics GmbH #7,Sales Receipt,CEM-EMEA,0,87100.88,EUR,SEPA SCT,Aurora Electronics GmbH #7,***6794,INV-202412-CEM-EMEA-0004,,FALSE,FALSE,REF-945825,First Continental Bank,***9911,Globex EMEA Manufacturing Ltd.,IE,-2588092.31
10/12/2024,10/12/2024,Supplier Payment - ExpertNet Subcontractors #12,Supplier Payment,PS-GL,769.02,0,EUR,SEPA Credit Transfer,ExpertNet Subcontractors #12,***1488,,PO-202412-PS-GL-0008,FALSE,FALSE,REF-370500,First Continental Bank,***9292,Globex EMEA Manufacturing Ltd.,IE,-2588861.33
10/12/2024,10/12/2024,Supplier Payment - ExpertNet Subcontractors #18,Supplier Payment,PS-GL,19857.27,0,EUR,SEPA Credit Transfer,ExpertNet Subcontractors #18,***5677,,PO-202412-PS-GL-0007,FALSE,FALSE,REF-729326,First Continental Bank,***3147,Globex EMEA Manufacturing Ltd.,IE,-2608718.6
10/12/2024,10/12/2024,Supplier Payment - ExpertNet Subcontractors #18,Supplier Payment,PS-GL,42278.46,0,EUR,SEPA Credit Transfer,ExpertNet Subcontractors #18,***9292,,PO-202412-PS-GL-0005,FALSE,FALSE,REF-309497,First Continental Bank,***9719,Globex EMEA Manufacturing Ltd.,IE,-2650997.06
10/12/2024,10/12/2024,Supplier Payment - ExpertNet Subcontractors #12,Supplier Payment,PS-GL,63130.74,0,EUR,SEPA Credit Transfer,ExpertNet Subcontractors #12,***4158,,PO-202412-PS-GL-0002,FALSE,FALSE,REF-165917,First Continental Bank,***2444,Globex EMEA Manufacturing Ltd.,IE,-2714127.8
10/12/2024,10/12/2024,Supplier Payment - EuroFab Assembly #16,Supplier Payment,CEM-EMEA,128946.82,0,EUR,SEPA Credit Transfer,EuroFab Assembly #16,***2499,,PO-202412-CEM-EMEA-0002,FALSE,FALSE,REF-636940,First Continental Bank,***7107,Globex EMEA Manufacturing Ltd.,IE,-2843074.62
11/12/2024,11/12/2024,Supplier Payment - HyperCloud Infra #18,Supplier Payment,SaaS-GL,15154.22,0,EUR,SEPA Debit,HyperCloud Infra #18,***6183,,PO-202412-SaaS-GL-0010,FALSE,FALSE,REF-122936,First Continental Bank,***1320,Globex EMEA Manufacturing Ltd.,IE,-2858228.84
11/12/2024,11/12/2024,Client Receipt - Vertex Advisory Client #57,Sales Receipt,PS-GL,0,14994.48,EUR,Card Settlement,Vertex Advisory Client #57,***2777,INV-202412-PS-GL-0008,,FALSE,FALSE,REF-738269,First Continental Bank,***1908,Globex EMEA Manufacturing Ltd.,IE,-2843234.36
11/12/2024,11/12/2024,Client Receipt - Vertex Advisory Client #42,Sales Receipt,PS-GL,0,58704.09,EUR,SEPA SCT,Vertex Advisory Client #42,***4310,INV-202412-PS-GL-0001,,FALSE,FALSE,REF-972203,First Continental Bank,***7692,Globex EMEA Manufacturing Ltd.,IE,-2784530.27
11/12/2024,11/12/2024,Client Receipt - Vertex Advisory Client #44,Sales Receipt,PS-GL,0,70491.29,EUR,Card Settlement,Vertex Advisory Client #44,***8113,INV-202412-PS-GL-0003,,FALSE,FALSE,REF-852841,First Continental Bank,***5176,Globex EMEA Manufacturing Ltd.,IE,-2714038.98
12/12/2024,12/12/2024,Supplier Payment - HyperCloud Infra #13,Supplier Payment,SaaS-GL,5164.87,0,EUR,SEPA Credit Transfer,HyperCloud Infra #13,***7187,,PO-202412-SaaS-GL-0002,FALSE,FALSE,REF-317951,First Continental Bank,***4843,Globex EMEA Manufacturing Ltd.,IE,-2719203.85
12/12/2024,12/12/2024,Intercompany Settlement - Globex Consulting UK Ltd.,Intercompany Transfer,ALL,657270,0,EUR,Internal Transfer,Globex Consulting UK Ltd.,***7571,,,TRUE,TRUE,REF-378746,First Continental Bank,***4219,Globex EMEA Manufacturing Ltd.,IE,-3376473.85
12/12/2024,12/12/2024,Client Receipt - CloudBridge Co. #22,Sales Receipt,SaaS-GL,0,27314.41,EUR,SEPA SCT Inst,CloudBridge Co. #22,***5182,INV-202412-SaaS-GL-0009,,FALSE,FALSE,REF-763359,First Continental Bank,***8804,Globex EMEA Manufacturing Ltd.,IE,-3349159.44
12/12/2024,12/12/2024,Client Receipt - CloudBridge Co. #41,Sales Receipt,SaaS-GL,0,29095.95,EUR,SEPA SCT,CloudBridge Co. #41,***1091,INV-202412-SaaS-GL-0010,,FALSE,FALSE,REF-644081,First Continental Bank,***8449,Globex EMEA Manufacturing Ltd.,IE,-3320063.49
12/12/2024,12/12/2024,Client Receipt - Vertex Advisory Client #47,Sales Receipt,PS-GL,0,30876.39,EUR,SEPA SCT,Vertex Advisory Client #47,***4162,INV-202412-PS-GL-0006,,FALSE,FALSE,REF-764719,First Continental Bank,***4405,Globex EMEA Manufacturing Ltd.,IE,-3289187.1
12/12/2024,12/12/2024,Client Receipt - CloudBridge Co. #63,Sales Receipt,SaaS-GL,0,121389.94,EUR,SEPA SCT,CloudBridge Co. #63,***2356,INV-202412-SaaS-GL-0005,,FALSE,FALSE,REF-848403,First Continental Bank,***1020,Globex EMEA Manufacturing Ltd.,IE,-3167797.16
12/12/2024,12/12/2024,Client Receipt - Aurora Electronics GmbH #4,Sales Receipt,CEM-EMEA,0,143927.98,EUR,SEPA SCT Inst,Aurora Electronics GmbH #4,***9276,INV-202412-CEM-EMEA-0007,,FALSE,FALSE,REF-107874,First Continental Bank,***6884,Globex EMEA Manufacturing Ltd.,IE,-3023869.18
12/12/2024,12/12/2024,Client Receipt - Vertex Advisory Client #11,Sales Receipt,PS-GL,0,217054.64,EUR,SEPA SCT Inst,Vertex Advisory Client #11,***5135,INV-202412-PS-GL-0005,,FALSE,FALSE,REF-707458,First Continental Bank,***1681,Globex EMEA Manufacturing Ltd.,IE,-2806814.54
13/12/2024,13/12/2024,Supplier Payment - ExpertNet Subcontractors #6,Supplier Payment,PS-GL,15672.67,0,EUR,SEPA Debit,ExpertNet Subcontractors #6,***2292,,PO-202412-PS-GL-0001,FALSE,FALSE,REF-352708,First Continental Bank,***1612,Globex EMEA Manufacturing Ltd.,IE,-2822487.21
13/12/2024,13/12/2024,Supplier Payment - Stelliform Parts BV #20,Supplier Payment,CEM-EMEA,27262.73,0,EUR,SEPA Credit Transfer,Stelliform Parts BV #20,***2105,,PO-202412-CEM-EMEA-0005,FALSE,FALSE,REF-827637,First Continental Bank,***5937,Globex EMEA Manufacturing Ltd.,IE,-2849749.94
13/12/2024,13/12/2024,Client Receipt - Novatek Components Ltd #10,Sales Receipt,CEM-EMEA,0,62823.37,EUR,SEPA SCT,Novatek Components Ltd #10,***3058,INV-202412-CEM-EMEA-0003,,FALSE,FALSE,REF-361894,First Continental Bank,***3101,Globex EMEA Manufacturing Ltd.,IE,-2786926.57
13/12/2024,13/12/2024,Client Receipt - Novatek Components Ltd #11,Sales Receipt,CEM-EMEA,0,67405.53,EUR,SEPA SCT Inst,Novatek Components Ltd #11,***5176,INV-202412-CEM-EMEA-0013,,FALSE,FALSE,REF-516353,First Continental Bank,***6612,Globex EMEA Manufacturing Ltd.,IE,-2719521.04
13/12/2024,13/12/2024,Client Receipt - CloudBridge Co. #37,Sales Receipt,SaaS-GL,0,113055.22,EUR,Card Settlement,CloudBridge Co. #37,***6965,INV-202412-SaaS-GL-0007,,FALSE,FALSE,REF-370418,First Continental Bank,***4171,Globex EMEA Manufacturing Ltd.,IE,-2606465.82
14/12/2024,14/12/2024,Supplier Payment - ExpertNet Subcontractors #3,Supplier Payment,PS-GL,5263.28,0,EUR,SEPA Debit,ExpertNet Subcontractors #3,***6647,,PO-202412-PS-GL-0009,FALSE,FALSE,REF-905445,First Continental Bank,***1688,Globex EMEA Manufacturing Ltd.,IE,-2611729.1
14/12/2024,14/12/2024,Client Receipt - CloudBridge Co. #66,Sales Receipt,SaaS-GL,0,6768.42,EUR,Card Settlement,CloudBridge Co. #66,***1440,INV-202412-SaaS-GL-0014,,FALSE,FALSE,REF-827961,First Continental Bank,***6537,Globex EMEA Manufacturing Ltd.,IE,-2604960.68
15/12/2024,15/12/2024,Loan Interest Payment,Loan Interest,ALL,85000,0,EUR,SEPA Credit Transfer,First Continental Bank - Corporate Lending,***2839,,,FALSE,FALSE,REF-578555,First Continental Bank,***6331,Globex EMEA Manufacturing Ltd.,IE,-2689960.68
15/12/2024,15/12/2024,Loan Principal Repayment,Loan Principal,ALL,500000,0,EUR,SEPA Credit Transfer,First Continental Bank - Corporate Lending,***2876,,,FALSE,FALSE,REF-696209,First Continental Bank,***3278,Globex EMEA Manufacturing Ltd.,IE,-3189960.68
16/12/2024,16/12/2024,BluePeak Property Mgmt,Rent & Utilities,ALL,10382.25,0,EUR,SWIFT MT103,BluePeak Property Mgmt,***9384,,,FALSE,FALSE,REF-411550,First Continental Bank,***2190,Globex EMEA Manufacturing Ltd.,IE,-3200342.93
16/12/2024,16/12/2024,Supplier Payment - EuroFab Assembly #24,Supplier Payment,CEM-EMEA,40714.57,0,EUR,SEPA Debit,EuroFab Assembly #24,***7079,,PO-202412-CEM-EMEA-0001,FALSE,FALSE,REF-615957,First Continental Bank,***4107,Globex EMEA Manufacturing Ltd.,IE,-3241057.5
16/12/2024,16/12/2024,Client Receipt - CloudBridge Co. #21,Sales Receipt,SaaS-GL,0,7456.06,EUR,Card Settlement,CloudBridge Co. #21,***8396,INV-202412-SaaS-GL-0002,,FALSE,FALSE,REF-608148,First Continental Bank,***4750,Globex EMEA Manufacturing Ltd.,IE,-3233601.44
16/12/2024,16/12/2024,Client Receipt - Vertex Advisory Client #3,Sales Receipt,PS-GL,0,33699.17,EUR,Card Settlement,Vertex Advisory Client #3,***6619,INV-202412-PS-GL-0002,,FALSE,FALSE,REF-931869,First Continental Bank,***4559,Globex EMEA Manufacturing Ltd.,IE,-3199902.27
16/12/2024,16/12/2024,Client Receipt - Aurora Electronics GmbH #8,Sales Receipt,CEM-EMEA,0,34639.47,EUR,Card Settlement,Aurora Electronics GmbH #8,***5285,INV-202412-CEM-EMEA-0012,,FALSE,FALSE,REF-557868,First Continental Bank,***9812,Globex EMEA Manufacturing Ltd.,IE,-3165262.8
16/12/2024,16/12/2024,Client Receipt - Aurora Electronics GmbH #3,Sales Receipt,CEM-EMEA,0,69155.61,EUR,SEPA SCT Inst,Aurora Electronics GmbH #3,***9999,INV-202412-CEM-EMEA-0001,,FALSE,FALSE,REF-834125,First Continental Bank,***3606,Globex EMEA Manufacturing Ltd.,IE,-3096107.19
16/12/2024,16/12/2024,Client Receipt - Novatek Components Ltd #7,Sales Receipt,CEM-EMEA,0,170346.62,EUR,SEPA SCT,Novatek Components Ltd #7,***4948,INV-202412-CEM-EMEA-0011,,FALSE,FALSE,REF-997044,First Continental Bank,***8887,Globex EMEA Manufacturing Ltd.,IE,-2925760.57
17/12/2024,17/12/2024,Supplier Payment - ExpertNet Subcontractors #14,Supplier Payment,PS-GL,1860.09,0,EUR,SWIFT MT103,ExpertNet Subcontractors #14,***5737,,PO-202412-PS-GL-0006,FALSE,FALSE,REF-701865,First Continental Bank,***5408,Globex EMEA Manufacturing Ltd.,IE,-2927620.66
18/12/2024,18/12/2024,Merchant Processing Fees,Bank/Merchant Fees,ALL,8042.75,0,EUR,SEPA Debit,First Continental Bank,***7850,,,FALSE,FALSE,REF-667675,First Continental Bank,***8338,Globex EMEA Manufacturing Ltd.,IE,-2935663.41
18/12/2024,18/12/2024,Supplier Payment - HyperCloud Infra #12,Supplier Payment,SaaS-GL,29037.79,0,EUR,SWIFT MT103,HyperCloud Infra #12,***8426,,PO-202412-SaaS-GL-0006,FALSE,FALSE,REF-325935,First Continental Bank,***7165,Globex EMEA Manufacturing Ltd.,IE,-2964701.2
18/12/2024,18/12/2024,Client Receipt - Aurora Electronics GmbH #16,Sales Receipt,CEM-EMEA,0,94191.22,EUR,SEPA SCT Inst,Aurora Electronics GmbH #16,***1289,INV-202412-CEM-EMEA-0005,,FALSE,FALSE,REF-416189,First Continental Bank,***2312,Globex EMEA Manufacturing Ltd.,IE,-2870509.98
18/12/2024,18/12/2024,Client Receipt - Aurora Electronics GmbH #5,Sales Receipt,CEM-EMEA,0,129038.57,EUR,Card Settlement,Aurora Electronics GmbH #5,***2418,INV-202412-CEM-EMEA-0014,,FALSE,FALSE,REF-904370,First Continental Bank,***6273,Globex EMEA Manufacturing Ltd.,IE,-2741471.41
19/12/2024,19/12/2024,Supplier Payment - HyperCloud Infra #14,Supplier Payment,SaaS-GL,13862.46,0,EUR,SEPA Credit Transfer,HyperCloud Infra #14,***7955,,PO-202412-SaaS-GL-0003,FALSE,FALSE,REF-731761,First Continental Bank,***4601,Globex EMEA Manufacturing Ltd.,IE,-2755333.87
19/12/2024,19/12/2024,VAT/GST Remittance - Revenue Ireland,Tax Payment,ALL,154067,0,EUR,SEPA Credit Transfer,Revenue Ireland,***2598,,,FALSE,FALSE,REF-807657,First Continental Bank,***5064,Globex EMEA Manufacturing Ltd.,IE,-2909400.87
19/12/2024,19/12/2024,Client Receipt - Novatek Components Ltd #7,Sales Receipt,CEM-EMEA,0,25672.44,EUR,SEPA SCT,Novatek Components Ltd #7,***7317,INV-202412-CEM-EMEA-0010,,FALSE,FALSE,REF-338876,First Continental Bank,***6913,Globex EMEA Manufacturing Ltd.,IE,-2883728.43
19/12/2024,19/12/2024,Client Receipt - Vertex Advisory Client #17,Sales Receipt,PS-GL,0,62777.1,EUR,Card Settlement,Vertex Advisory Client #17,***6799,INV-202412-PS-GL-0009,,FALSE,FALSE,REF-706439,First Continental Bank,***1298,Globex EMEA Manufacturing Ltd.,IE,-2820951.33
19/12/2024,19/12/2024,Client Receipt - Novatek Components Ltd #8,Sales Receipt,CEM-EMEA,0,99860.54,EUR,SEPA SCT Inst,Novatek Components Ltd #8,***8504,INV-202412-CEM-EMEA-0002,,FALSE,FALSE,REF-123504,First Continental Bank,***5995,Globex EMEA Manufacturing Ltd.,IE,-2721090.79
20/12/2024,20/12/2024,Client Receipt - CloudBridge Co. #49,Sales Receipt,SaaS-GL,0,8740.4,EUR,Card Settlement,CloudBridge Co. #49,***2432,INV-202412-SaaS-GL-0003,,FALSE,FALSE,REF-672876,First Continental Bank,***7314,Globex EMEA Manufacturing Ltd.,IE,-2712350.39
21/12/2024,21/12/2024,Supplier Payment - HyperCloud Infra #10,Supplier Payment,SaaS-GL,12631.56,0,EUR,SEPA Debit,HyperCloud Infra #10,***9146,,PO-202412-SaaS-GL-0001,FALSE,FALSE,REF-401772,First Continental Bank,***3707,Globex EMEA Manufacturing Ltd.,IE,-2724981.95
22/12/2024,22/12/2024,Supplier Payment - ExpertNet Subcontractors #1,Supplier Payment,PS-GL,5592.32,0,EUR,SWIFT MT103,ExpertNet Subcontractors #1,***8219,,PO-202412-PS-GL-0010,FALSE,FALSE,REF-600874,First Continental Bank,***5269,Globex EMEA Manufacturing Ltd.,IE,-2730574.27
22/12/2024,22/12/2024,Client Receipt - Vertex Advisory Client #50,Sales Receipt,PS-GL,0,33880.6,EUR,SEPA SCT,Vertex Advisory Client #50,***3883,INV-202412-PS-GL-0007,,FALSE,FALSE,REF-479443,First Continental Bank,***7063,Globex EMEA Manufacturing Ltd.,IE,-2696693.67
22/12/2024,22/12/2024,Client Receipt - Aurora Electronics GmbH #3,Sales Receipt,CEM-EMEA,0,266359.33,EUR,Card Settlement,Aurora Electronics GmbH #3,***8629,INV-202412-CEM-EMEA-0015,,FALSE,FALSE,REF-428588,First Continental Bank,***2417,Globex EMEA Manufacturing Ltd.,IE,-2430334.34
23/12/2024,23/12/2024,Supplier Payment - Stelliform Parts BV #28,Supplier Payment,CEM-EMEA,44878.36,0,EUR,SWIFT MT103,Stelliform Parts BV #28,***7565,,PO-202412-CEM-EMEA-0007,FALSE,FALSE,REF-949492,First Continental Bank,***7541,Globex EMEA Manufacturing Ltd.,IE,-2475212.7
23/12/2024,23/12/2024,Client Receipt - Vertex Advisory Client #17,Sales Receipt,PS-GL,0,46856.19,EUR,Card Settlement,Vertex Advisory Client #17,***4837,INV-202412-PS-GL-0010,,FALSE,FALSE,REF-162942,First Continental Bank,***2315,Globex EMEA Manufacturing Ltd.,IE,-2428356.51
24/12/2024,24/12/2024,Supplier Payment - HyperCloud Infra #16,Supplier Payment,SaaS-GL,2404.05,0,EUR,SEPA Credit Transfer,HyperCloud Infra #16,***4391,,PO-202412-SaaS-GL-0005,FALSE,FALSE,REF-803134,First Continental Bank,***9275,Globex EMEA Manufacturing Ltd.,IE,-2430760.56
24/12/2024,24/12/2024,Marketing - Beacon Digital #4,Marketing,ALL,35175.27,0,EUR,SWIFT MT103,Beacon Digital #4,***3139,,,FALSE,FALSE,REF-815640,First Continental Bank,***4628,Globex EMEA Manufacturing Ltd.,IE,-2465935.83
24/12/2024,24/12/2024,Client Receipt - Aurora Electronics GmbH #16,Sales Receipt,CEM-EMEA,0,75392.89,EUR,SEPA SCT Inst,Aurora Electronics GmbH #16,***3463,INV-202412-CEM-EMEA-0006,,FALSE,FALSE,REF-330402,First Continental Bank,***7495,Globex EMEA Manufacturing Ltd.,IE,-2390542.94
25/12/2024,25/12/2024,Marketing - Beacon Digital #9,Marketing,ALL,3364.52,0,EUR,SEPA Debit,Beacon Digital #9,***3507,,,FALSE,FALSE,REF-552250,First Continental Bank,***2362,Globex EMEA Manufacturing Ltd.,IE,-2393907.46
25/12/2024,25/12/2024,Supplier Payment - ExpertNet Subcontractors #17,Supplier Payment,PS-GL,6444.82,0,EUR,SEPA Credit Transfer,ExpertNet Subcontractors #17,***6264,,PO-202412-PS-GL-0003,FALSE,FALSE,REF-447108,First Continental Bank,***9780,Globex EMEA Manufacturing Ltd.,IE,-2400352.28
25/12/2024,25/12/2024,Payroll - GlobalPay Services Ltd,Payroll,ALL,224585.71,0,EUR,SEPA Debit,GlobalPay Services Ltd,***5032,,,FALSE,FALSE,REF-848302,First Continental Bank,***2464,Globex EMEA Manufacturing Ltd.,IE,-2624937.99
25/12/2024,25/12/2024,Client Receipt - CloudBridge Co. #39,Sales Receipt,SaaS-GL,0,6468.18,EUR,SEPA SCT Inst,CloudBridge Co. #39,***5908,INV-202412-SaaS-GL-0019,,FALSE,FALSE,REF-624524,First Continental Bank,***9528,Globex EMEA Manufacturing Ltd.,IE,-2618469.81
25/12/2024,25/12/2024,Client Receipt - CloudBridge Co. #13,Sales Receipt,SaaS-GL,0,30025.78,EUR,SEPA SCT Inst,CloudBridge Co. #13,***2213,INV-202412-SaaS-GL-0015,,FALSE,FALSE,REF-654980,First Continental Bank,***5175,Globex EMEA Manufacturing Ltd.,IE,-2588444.03
26/12/2024,26/12/2024,Intercompany Settlement - Globex Consulting UK Ltd.,Intercompany Transfer,ALL,245743,0,EUR,Internal Transfer,Globex Consulting UK Ltd.,***2693,,,TRUE,TRUE,REF-715908,First Continental Bank,***1189,Globex EMEA Manufacturing Ltd.,IE,-2834187.03
26/12/2024,26/12/2024,Client Receipt - CloudBridge Co. #10,Sales Receipt,SaaS-GL,0,19653.84,EUR,SEPA SCT Inst,CloudBridge Co. #10,***6098,INV-202412-SaaS-GL-0011,,FALSE,FALSE,REF-335612,First Continental Bank,***5411,Globex EMEA Manufacturing Ltd.,IE,-2814533.19
26/12/2024,26/12/2024,Intercompany Reimbursement - Globex Consulting UK Ltd.,Intercompany Transfer,ALL,0,98297.2,EUR,Internal Transfer,Globex Consulting UK Ltd.,***6896,,,TRUE,TRUE,REF-663528,First Continental Bank,***3925,Globex EMEA Manufacturing Ltd.,IE,-2716235.99
27/12/2024,27/12/2024,Supplier Payment - HyperCloud Infra #11,Supplier Payment,SaaS-GL,14737.01,0,EUR,SEPA Credit Transfer,HyperCloud Infra #11,***7996,,PO-202412-SaaS-GL-0004,FALSE,FALSE,REF-888208,First Continental Bank,***7764,Globex EMEA Manufacturing Ltd.,IE,-2730973
27/12/2024,27/12/2024,Supplier Payment - HyperCloud Infra #5,Supplier Payment,SaaS-GL,23737.18,0,EUR,SEPA Debit,HyperCloud Infra #5,***2325,,PO-202412-SaaS-GL-0009,FALSE,FALSE,REF-358519,First Continental Bank,***9568,Globex EMEA Manufacturing Ltd.,IE,-2754710.18
27/12/2024,27/12/2024,Client Receipt - CloudBridge Co. #77,Sales Receipt,SaaS-GL,0,17606.56,EUR,SEPA SCT,CloudBridge Co. #77,***1798,INV-202412-SaaS-GL-0017,,FALSE,FALSE,REF-665239,First Continental Bank,***8518,Globex EMEA Manufacturing Ltd.,IE,-2737103.62
27/12/2024,27/12/2024,Client Receipt - Vertex Advisory Client #9,Sales Receipt,PS-GL,0,19396.08,EUR,SEPA SCT Inst,Vertex Advisory Client #9,***6035,INV-202412-PS-GL-0004,,FALSE,FALSE,REF-351458,First Continental Bank,***1501,Globex EMEA Manufacturing Ltd.,IE,-2717707.54
28/12/2024,28/12/2024,Supplier Payment - Stelliform Parts BV #16,Supplier Payment,CEM-EMEA,409151.53,0,EUR,SEPA Credit Transfer,Stelliform Parts BV #16,***9798,,PO-202412-CEM-EMEA-0004,FALSE,FALSE,REF-559988,First Continental Bank,***3507,Globex EMEA Manufacturing Ltd.,IE,-3126859.07
29/12/2024,29/12/2024,Payroll - GlobalPay Services Ltd,Payroll,ALL,224585.71,0,EUR,SWIFT MT103,GlobalPay Services Ltd,***5247,,,FALSE,FALSE,REF-460413,First Continental Bank,***4766,Globex EMEA Manufacturing Ltd.,IE,-3351444.78
30/12/2024,30/12/2024,Marketing - Beacon Digital #1,Marketing,ALL,33007.5,0,EUR,SEPA Debit,Beacon Digital #1,***8010,,,FALSE,FALSE,REF-850225,First Continental Bank,***2889,Globex EMEA Manufacturing Ltd.,IE,-3384452.28
30/12/2024,30/12/2024,Interest Earned,Interest Income,ALL,0,10765.19,EUR,Card Settlement,First Continental Bank,***8084,,,FALSE,FALSE,REF-953140,First Continental Bank,***7721,Globex EMEA Manufacturing Ltd.,IE,-3373687.09
30/12/2024,30/12/2024,Client Receipt - Aurora Electronics GmbH #15,Sales Receipt,CEM-EMEA,0,36866.14,EUR,SEPA SCT Inst,Aurora Electronics GmbH #15,***9371,INV-202412-CEM-EMEA-0009,,FALSE,FALSE,REF-862215,First Continental Bank,***1479,Globex EMEA Manufacturing Ltd.,IE,-3336820.95
31/12/2024,31/12/2024,Client Receipt - CloudBridge Co. #24,Sales Receipt,SaaS-GL,0,41709.57,EUR,SEPA SCT,CloudBridge Co. #24,***6148,INV-202412-SaaS-GL-0020,,FALSE,FALSE,REF-871496,First Continental Bank,***1342,Globex EMEA Manufacturing Ltd.,IE,-3295111.38
31/12/2024,31/12/2024,Client Receipt - CloudBridge Co. #2,Sales Receipt,SaaS-GL,0,80081.82,EUR,Card Settlement,CloudBridge Co. #2,***1093,INV-202412-SaaS-GL-0013,,FALSE,FALSE,REF-632450,First Continental Bank,***7045,Globex EMEA Manufacturing Ltd.,IE,-3215029.56
01/01/2025,01/01/2025,Account Maintenance Fee,Bank/Merchant Fees,ALL,2500,0,EUR,SWIFT MT103,First Continental Bank,***1991,,,FALSE,FALSE,REF-286534,First Continental Bank,***1561,Globex EMEA Manufacturing Ltd.,IE,-3217529.56
01/01/2025,01/01/2025,Supplier Payment - ExpertNet Subcontractors #7,Supplier Payment,PS-GL,4427.09,0,EUR,SWIFT MT103,ExpertNet Subcontractors #7,***1180,,PO-202501-PS-GL-0009,FALSE,FALSE,REF-747049,First Continental Bank,***8250,Globex EMEA Manufacturing Ltd.,IE,-3221956.65
01/01/2025,01/01/2025,Client Receipt - CloudBridge Co. #14,Sales Receipt,SaaS-GL,0,13578.77,EUR,Card Settlement,CloudBridge Co. #14,***5051,INV-202501-SaaS-GL-0004,,FALSE,FALSE,REF-631741,First Continental Bank,***7463,Globex EMEA Manufacturing Ltd.,IE,-3208377.88
02/01/2025,02/01/2025,Merchant Processing Fees,Bank/Merchant Fees,ALL,3145.6,0,EUR,SEPA Debit,First Continental Bank,***7840,,,FALSE,FALSE,REF-215756,First Continental Bank,***4457,Globex EMEA Manufacturing Ltd.,IE,-3211523.48
02/01/2025,02/01/2025,Supplier Payment - HyperCloud Infra #15,Supplier Payment,SaaS-GL,13988.25,0,EUR,SEPA Debit,HyperCloud Infra #15,***8606,,PO-202501-SaaS-GL-0004,FALSE,FALSE,REF-453988,First Continental Bank,***8842,Globex EMEA Manufacturing Ltd.,IE,-3225511.73
03/01/2025,03/01/2025,Supplier Payment - Stelliform Parts BV #26,Supplier Payment,CEM-EMEA,70561.89,0,EUR,SWIFT MT103,Stelliform Parts BV #26,***5072,,PO-202501-CEM-EMEA-0005,FALSE,FALSE,REF-576780,First Continental Bank,***5397,Globex EMEA Manufacturing Ltd.,IE,-3296073.62
03/01/2025,03/01/2025,Client Receipt - Aurora Electronics GmbH #12,Sales Receipt,CEM-EMEA,0,30116.23,EUR,Card Settlement,Aurora Electronics GmbH #12,***9242,INV-202501-CEM-EMEA-0011,,FALSE,FALSE,REF-492969,First Continental Bank,***4754,Globex EMEA Manufacturing Ltd.,IE,-3265957.39
05/01/2025,05/01/2025,Supplier Payment - EuroFab Assembly #20,Supplier Payment,CEM-EMEA,102728.83,0,EUR,SWIFT MT103,EuroFab Assembly #20,***8123,,PO-202501-CEM-EMEA-0007,FALSE,FALSE,REF-257621,First Continental Bank,***5658,Globex EMEA Manufacturing Ltd.,IE,-3368686.22
06/01/2025,06/01/2025,Supplier Payment - EuroFab Assembly #15,Supplier Payment,CEM-EMEA,2126.15,0,EUR,SEPA Credit Transfer,EuroFab Assembly #15,***2664,,PO-202501-CEM-EMEA-0001,FALSE,FALSE,REF-741870,First Continental Bank,***6103,Globex EMEA Manufacturing Ltd.,IE,-3370812.37
06/01/2025,06/01/2025,Client Receipt - CloudBridge Co. #39,Sales Receipt,SaaS-GL,0,26463.92,EUR,Card Settlement,CloudBridge Co. #39,***6623,INV-202501-SaaS-GL-0010,,FALSE,FALSE,REF-178756,First Continental Bank,***6053,Globex EMEA Manufacturing Ltd.,IE,-3344348.45
07/01/2025,07/01/2025,Client Receipt - Novatek Components Ltd #14,Sales Receipt,CEM-EMEA,0,28403.18,EUR,SEPA SCT Inst,Novatek Components Ltd #14,***9809,INV-202501-CEM-EMEA-0010,,FALSE,FALSE,REF-545222,First Continental Bank,***1364,Globex EMEA Manufacturing Ltd.,IE,-3315945.27
07/01/2025,07/01/2025,Client Receipt - Vertex Advisory Client #21,Sales Receipt,PS-GL,0,84657.33,EUR,SEPA SCT Inst,Vertex Advisory Client #21,***1005,INV-202501-PS-GL-0004,,FALSE,FALSE,REF-391533,First Continental Bank,***1128,Globex EMEA Manufacturing Ltd.,IE,-3231287.94
08/01/2025,08/01/2025,Supplier Payment - HyperCloud Infra #4,Supplier Payment,SaaS-GL,15950.92,0,EUR,SWIFT MT103,HyperCloud Infra #4,***7335,,PO-202501-SaaS-GL-0003,FALSE,FALSE,REF-442472,First Continental Bank,***4949,Globex EMEA Manufacturing Ltd.,IE,-3247238.86
08/01/2025,08/01/2025,Marketing - Aurelia Media #6,Marketing,ALL,20950.14,0,EUR,SEPA Credit Transfer,Aurelia Media #6,***5256,,,FALSE,FALSE,REF-132279,First Continental Bank,***8253,Globex EMEA Manufacturing Ltd.,IE,-3268189
08/01/2025,08/01/2025,Client Receipt - Aurora Electronics GmbH #19,Sales Receipt,CEM-EMEA,0,6201.41,EUR,SEPA SCT Inst,Aurora Electronics GmbH #19,***6424,INV-202501-CEM-EMEA-0004,,FALSE,FALSE,REF-856377,First Continental Bank,***8990,Globex EMEA Manufacturing Ltd.,IE,-3261987.59
08/01/2025,08/01/2025,Client Receipt - Vertex Advisory Client #17,Sales Receipt,PS-GL,0,12971.9,EUR,SEPA SCT Inst,Vertex Advisory Client #17,***5776,INV-202501-PS-GL-0001,,FALSE,FALSE,REF-528617,First Continental Bank,***4057,Globex EMEA Manufacturing Ltd.,IE,-3249015.69
08/01/2025,08/01/2025,Client Receipt - Novatek Components Ltd #8,Sales Receipt,CEM-EMEA,0,14072.22,EUR,Card Settlement,Novatek Components Ltd #8,***4797,INV-202501-CEM-EMEA-0008,,FALSE,FALSE,REF-377763,First Continental Bank,***2749,Globex EMEA Manufacturing Ltd.,IE,-3234943.47
09/01/2025,09/01/2025,Supplier Payment - ExpertNet Subcontractors #19,Supplier Payment,PS-GL,8424.41,0,EUR,SEPA Debit,ExpertNet Subcontractors #19,***5087,,PO-202501-PS-GL-0004,FALSE,FALSE,REF-411613,First Continental Bank,***6002,Globex EMEA Manufacturing Ltd.,IE,-3243367.88
09/01/2025,09/01/2025,BluePeak Property Mgmt,Rent & Utilities,ALL,11377.87,0,EUR,SEPA Credit Transfer,BluePeak Property Mgmt,***2544,,,FALSE,FALSE,REF-842932,First Continental Bank,***1665,Globex EMEA Manufacturing Ltd.,IE,-3254745.75
09/01/2025,09/01/2025,Supplier Payment - ExpertNet Subcontractors #7,Supplier Payment,PS-GL,35128.63,0,EUR,SWIFT MT103,ExpertNet Subcontractors #7,***3490,,PO-202501-PS-GL-0002,FALSE,FALSE,REF-787941,First Continental Bank,***6455,Globex EMEA Manufacturing Ltd.,IE,-3289874.38
09/01/2025,09/01/2025,Client Receipt - CloudBridge Co. #13,Sales Receipt,SaaS-GL,0,8133.86,EUR,SEPA SCT Inst,CloudBridge Co. #13,***7868,INV-202501-SaaS-GL-0003,,FALSE,FALSE,REF-144194,First Continental Bank,***5331,Globex EMEA Manufacturing Ltd.,IE,-3281740.52
09/01/2025,09/01/2025,Client Receipt - CloudBridge Co. #28,Sales Receipt,SaaS-GL,0,26160.94,EUR,Card Settlement,CloudBridge Co. #28,***1328,INV-202501-SaaS-GL-0009,,FALSE,FALSE,REF-940000,First Continental Bank,***7044,Globex EMEA Manufacturing Ltd.,IE,-3255579.58
10/01/2025,10/01/2025,Supplier Payment - ExpertNet Subcontractors #12,Supplier Payment,PS-GL,3315.89,0,EUR,SEPA Credit Transfer,ExpertNet Subcontractors #12,***7504,,PO-202501-PS-GL-0005,FALSE,FALSE,REF-788721,First Continental Bank,***9885,Globex EMEA Manufacturing Ltd.,IE,-3258895.47
10/01/2025,10/01/2025,Client Receipt - CloudBridge Co. #5,Sales Receipt,SaaS-GL,0,2718.68,EUR,SEPA SCT,CloudBridge Co. #5,***1229,INV-202501-SaaS-GL-0013,,FALSE,FALSE,REF-406432,First Continental Bank,***8025,Globex EMEA Manufacturing Ltd.,IE,-3256176.79
10/01/2025,10/01/2025,Client Receipt - CloudBridge Co. #39,Sales Receipt,SaaS-GL,0,24158.66,EUR,SEPA SCT,CloudBridge Co. #39,***3563,INV-202501-SaaS-GL-0016,,FALSE,FALSE,REF-404448,First Continental Bank,***6457,Globex EMEA Manufacturing Ltd.,IE,-3232018.13
10/01/2025,10/01/2025,Client Receipt - Aurora Electronics GmbH #11,Sales Receipt,CEM-EMEA,0,30350.51,EUR,SEPA SCT Inst,Aurora Electronics GmbH #11,***8550,INV-202501-CEM-EMEA-0012,,FALSE,FALSE,REF-388953,First Continental Bank,***7980,Globex EMEA Manufacturing Ltd.,IE,-3201667.62
10/01/2025,10/01/2025,Client Receipt - Vertex Advisory Client #12,Sales Receipt,PS-GL,0,60468.51,EUR,Card Settlement,Vertex Advisory Client #12,***1132,INV-202501-PS-GL-0007,,FALSE,FALSE,REF-999782,First Continental Bank,***2133,Globex EMEA Manufacturing Ltd.,IE,-3141199.11
12/01/2025,12/01/2025,"Intercompany Settlement - Globex International Holdings, Inc.",Intercompany Transfer,ALL,505179,0,EUR,Internal Transfer,"Globex International Holdings, Inc.",***7381,,,TRUE,TRUE,REF-781234,First Continental Bank,***9532,Globex EMEA Manufacturing Ltd.,IE,-3646378.11
12/01/2025,12/01/2025,Client Receipt - CloudBridge Co. #26,Sales Receipt,SaaS-GL,0,11382.82,EUR,SEPA SCT Inst,CloudBridge Co. #26,***5195,INV-202501-SaaS-GL-0019,,FALSE,FALSE,REF-680303,First Continental Bank,***4964,Globex EMEA Manufacturing Ltd.,IE,-3634995.29
13/01/2025,13/01/2025,Merchant Processing Fees,Bank/Merchant Fees,ALL,1139.3,0,EUR,SEPA Debit,First Continental Bank,***1981,,,FALSE,FALSE,REF-356260,First Continental Bank,***2366,Globex EMEA Manufacturing Ltd.,IE,-3636134.59
13/01/2025,13/01/2025,Supplier Payment - ExpertNet Subcontractors #8,Supplier Payment,PS-GL,12571.07,0,EUR,SEPA Debit,ExpertNet Subcontractors #8,***6205,,PO-202501-PS-GL-0008,FALSE,FALSE,REF-768764,First Continental Bank,***9412,Globex EMEA Manufacturing Ltd.,IE,-3648705.66
13/01/2025,13/01/2025,Client Receipt - CloudBridge Co. #55,Sales Receipt,SaaS-GL,0,11993.86,EUR,Card Settlement,CloudBridge Co. #55,***6060,INV-202501-SaaS-GL-0018,,FALSE,FALSE,REF-685910,First Continental Bank,***4553,Globex EMEA Manufacturing Ltd.,IE,-3636711.8
13/01/2025,13/01/2025,Client Receipt - CloudBridge Co. #44,Sales Receipt,SaaS-GL,0,52845.79,EUR,SEPA SCT,CloudBridge Co. #44,***2268,INV-202501-SaaS-GL-0011,,FALSE,FALSE,REF-935608,First Continental Bank,***2360,Globex EMEA Manufacturing Ltd.,IE,-3583866.01
13/01/2025,13/01/2025,Client Receipt - Aurora Electronics GmbH #9,Sales Receipt,CEM-EMEA,0,94886.79,EUR,Card Settlement,Aurora Electronics GmbH #9,***1356,INV-202501-CEM-EMEA-0007,,FALSE,FALSE,REF-694064,First Continental Bank,***9892,Globex EMEA Manufacturing Ltd.,IE,-3488979.22
13/01/2025,13/01/2025,Client Receipt - Novatek Components Ltd #7,Sales Receipt,CEM-EMEA,0,121270.51,EUR,SEPA SCT,Novatek Components Ltd #7,***3655,INV-202501-CEM-EMEA-0001,,FALSE,FALSE,REF-304860,First Continental Bank,***3989,Globex EMEA Manufacturing Ltd.,IE,-3367708.71
13/01/2025,13/01/2025,Client Receipt - Aurora Electronics GmbH #18,Sales Receipt,CEM-EMEA,0,131367.64,EUR,SEPA SCT,Aurora Electronics GmbH #18,***1556,INV-202501-CEM-EMEA-0006,,FALSE,FALSE,REF-979703,First Continental Bank,***7419,Globex EMEA Manufacturing Ltd.,IE,-3236341.07
15/01/2025,15/01/2025,Supplier Payment - Stelliform Parts BV #30,Supplier Payment,CEM-EMEA,18307.93,0,EUR,SWIFT MT103,Stelliform Parts BV #30,***4253,,PO-202501-CEM-EMEA-0003,FALSE,FALSE,REF-738693,First Continental Bank,***1279,Globex EMEA Manufacturing Ltd.,IE,-3254649
15/01/2025,15/01/2025,Supplier Payment - EuroFab Assembly #8,Supplier Payment,CEM-EMEA,20857.54,0,EUR,SWIFT MT103,EuroFab Assembly #8,***4941,,PO-202501-CEM-EMEA-0010,FALSE,FALSE,REF-440934,First Continental Bank,***7811,Globex EMEA Manufacturing Ltd.,IE,-3275506.54
15/01/2025,15/01/2025,Loan Interest Payment,Loan Interest,ALL,85000,0,EUR,SEPA Credit Transfer,First Continental Bank - Corporate Lending,***5402,,,FALSE,FALSE,REF-219359,First Continental Bank,***8548,Globex EMEA Manufacturing Ltd.,IE,-3360506.54
15/01/2025,15/01/2025,Loan Principal Repayment,Loan Principal,ALL,500000,0,EUR,SWIFT MT103,First Continental Bank - Corporate Lending,***8841,,,FALSE,FALSE,REF-810765,First Continental Bank,***5188,Globex EMEA Manufacturing Ltd.,IE,-3860506.54
16/01/2025,16/01/2025,Marketing - Beacon Digital #9,Marketing,ALL,4331.66,0,EUR,SWIFT MT103,Beacon Digital #9,***4427,,,FALSE,FALSE,REF-437875,First Continental Bank,***9230,Globex EMEA Manufacturing Ltd.,IE,-3864838.2
16/01/2025,16/01/2025,Supplier Payment - Stelliform Parts BV #22,Supplier Payment,CEM-EMEA,11001.37,0,EUR,SWIFT MT103,Stelliform Parts BV #22,***4259,,PO-202501-CEM-EMEA-0006,FALSE,FALSE,REF-200799,First Continental Bank,***6174,Globex EMEA Manufacturing Ltd.,IE,-3875839.57
16/01/2025,16/01/2025,Supplier Payment - EuroFab Assembly #13,Supplier Payment,CEM-EMEA,17804.05,0,EUR,SEPA Debit,EuroFab Assembly #13,***9056,,PO-202501-CEM-EMEA-0002,FALSE,FALSE,REF-886017,First Continental Bank,***5621,Globex EMEA Manufacturing Ltd.,IE,-3893643.62
16/01/2025,16/01/2025,Client Receipt - CloudBridge Co. #72,Sales Receipt,SaaS-GL,0,11755.41,EUR,SEPA SCT Inst,CloudBridge Co. #72,***9659,INV-202501-SaaS-GL-0021,,FALSE,FALSE,REF-228565,First Continental Bank,***7079,Globex EMEA Manufacturing Ltd.,IE,-3881888.21
16/01/2025,16/01/2025,Client Receipt - Vertex Advisory Client #42,Sales Receipt,PS-GL,0,17305.44,EUR,SEPA SCT Inst,Vertex Advisory Client #42,***1195,INV-202501-PS-GL-0005,,FALSE,FALSE,REF-629643,First Continental Bank,***3604,Globex EMEA Manufacturing Ltd.,IE,-3864582.77
16/01/2025,16/01/2025,Client Receipt - CloudBridge Co. #71,Sales Receipt,SaaS-GL,0,21448.22,EUR,Card Settlement,CloudBridge Co. #71,***6150,INV-202501-SaaS-GL-0020,,FALSE,FALSE,REF-733160,First Continental Bank,***9413,Globex EMEA Manufacturing Ltd.,IE,-3843134.55
17/01/2025,17/01/2025,Supplier Payment - Stelliform Parts BV #18,Supplier Payment,CEM-EMEA,73661.44,0,EUR,SWIFT MT103,Stelliform Parts BV #18,***8803,,PO-202501-CEM-EMEA-0008,FALSE,FALSE,REF-864588,First Continental Bank,***3209,Globex EMEA Manufacturing Ltd.,IE,-3916795.99
19/01/2025,19/01/2025,VAT/GST Remittance - Revenue Ireland,Tax Payment,ALL,86485.05,0,EUR,SEPA Credit Transfer,Revenue Ireland,***2813,,,FALSE,FALSE,REF-507474,First Continental Bank,***9303,Globex EMEA Manufacturing Ltd.,IE,-4003281.04
19/01/2025,19/01/2025,Client Receipt - CloudBridge Co. #16,Sales Receipt,SaaS-GL,0,7350.64,EUR,Card Settlement,CloudBridge Co. #16,***7876,INV-202501-SaaS-GL-0005,,FALSE,FALSE,REF-233105,First Continental Bank,***4939,Globex EMEA Manufacturing Ltd.,IE,-3995930.4
20/01/2025,20/01/2025,Supplier Payment - ExpertNet Subcontractors #7,Supplier Payment,PS-GL,5336.04,0,EUR,SWIFT MT103,ExpertNet Subcontractors #7,***8317,,PO-202501-PS-GL-0001,FALSE,FALSE,REF-315119,First Continental Bank,***7370,Globex EMEA Manufacturing Ltd.,IE,-4001266.44
20/01/2025,20/01/2025,Client Receipt - CloudBridge Co. #29,Sales Receipt,SaaS-GL,0,723.75,EUR,Card Settlement,CloudBridge Co. #29,***8747,INV-202501-SaaS-GL-0023,,FALSE,FALSE,REF-183526,First Continental Bank,***1010,Globex EMEA Manufacturing Ltd.,IE,-4000542.69
20/01/2025,20/01/2025,Client Receipt - CloudBridge Co. #15,Sales Receipt,SaaS-GL,0,4311.65,EUR,SEPA SCT,CloudBridge Co. #15,***2806,INV-202501-SaaS-GL-0002,,FALSE,FALSE,REF-897017,First Continental Bank,***2602,Globex EMEA Manufacturing Ltd.,IE,-3996231.04
20/01/2025,20/01/2025,Client Receipt - CloudBridge Co. #41,Sales Receipt,SaaS-GL,0,7092.79,EUR,SEPA SCT Inst,CloudBridge Co. #41,***5347,INV-202501-SaaS-GL-0001,,FALSE,FALSE,REF-524304,First Continental Bank,***4231,Globex EMEA Manufacturing Ltd.,IE,-3989138.25
20/01/2025,20/01/2025,Client Receipt - CloudBridge Co. #4,Sales Receipt,SaaS-GL,0,16004.12,EUR,SEPA SCT,CloudBridge Co. #4,***3516,INV-202501-SaaS-GL-0014,,FALSE,FALSE,REF-498337,First Continental Bank,***6369,Globex EMEA Manufacturing Ltd.,IE,-3973134.13
21/01/2025,21/01/2025,Supplier Payment - HyperCloud Infra #15,Supplier Payment,SaaS-GL,1263.66,0,EUR,SWIFT MT103,HyperCloud Infra #15,***1042,,PO-202501-SaaS-GL-0007,FALSE,FALSE,REF-752401,First Continental Bank,***9589,Globex EMEA Manufacturing Ltd.,IE,-3974397.79
21/01/2025,21/01/2025,Supplier Payment - ExpertNet Subcontractors #4,Supplier Payment,PS-GL,8376.53,0,EUR,SEPA Debit,ExpertNet Subcontractors #4,***6865,,PO-202501-PS-GL-0010,FALSE,FALSE,REF-307780,First Continental Bank,***4009,Globex EMEA Manufacturing Ltd.,IE,-3982774.32
21/01/2025,21/01/2025,Client Receipt - CloudBridge Co. #26,Sales Receipt,SaaS-GL,0,7658.18,EUR,Card Settlement,CloudBridge Co. #26,***3875,INV-202501-SaaS-GL-0025,,FALSE,FALSE,REF-587053,First Continental Bank,***2414,Globex EMEA Manufacturing Ltd.,IE,-3975116.14
21/01/2025,21/01/2025,Client Receipt - CloudBridge Co. #32,Sales Receipt,SaaS-GL,0,21467.44,EUR,SEPA SCT,CloudBridge Co. #32,***4689,INV-202501-SaaS-GL-0024,,FALSE,FALSE,REF-657683,First Continental Bank,***4508,Globex EMEA Manufacturing Ltd.,IE,-3953648.7
21/01/2025,21/01/2025,Client Receipt - CloudBridge Co. #55,Sales Receipt,SaaS-GL,0,31444.15,EUR,SEPA SCT Inst,CloudBridge Co. #55,***5218,INV-202501-SaaS-GL-0022,,FALSE,FALSE,REF-367957,First Continental Bank,***5680,Globex EMEA Manufacturing Ltd.,IE,-3922204.55
21/01/2025,21/01/2025,Client Receipt - CloudBridge Co. #65,Sales Receipt,SaaS-GL,0,42269.03,EUR,SEPA SCT Inst,CloudBridge Co. #65,***2620,INV-202501-SaaS-GL-0006,,FALSE,FALSE,REF-563604,First Continental Bank,***2344,Globex EMEA Manufacturing Ltd.,IE,-3879935.52
21/01/2025,21/01/2025,Client Receipt - Vertex Advisory Client #46,Sales Receipt,PS-GL,0,46753.9,EUR,Card Settlement,Vertex Advisory Client #46,***4309,INV-202501-PS-GL-0008,,FALSE,FALSE,REF-114429,First Continental Bank,***9244,Globex EMEA Manufacturing Ltd.,IE,-3833181.62
21/01/2025,21/01/2025,Client Receipt - Novatek Components Ltd #13,Sales Receipt,CEM-EMEA,0,65566.82,EUR,Card Settlement,Novatek Components Ltd #13,***8604,INV-202501-CEM-EMEA-0003,,FALSE,FALSE,REF-680744,First Continental Bank,***6172,Globex EMEA Manufacturing Ltd.,IE,-3767614.8
22/01/2025,22/01/2025,Supplier Payment - CodeCraft Contractors #2,Supplier Payment,SaaS-GL,14537.53,0,EUR,SWIFT MT103,CodeCraft Contractors #2,***2007,,PO-202501-SaaS-GL-0008,FALSE,FALSE,REF-747905,First Continental Bank,***4248,Globex EMEA Manufacturing Ltd.,IE,-3782152.33
22/01/2025,22/01/2025,Supplier Payment - EuroFab Assembly #1,Supplier Payment,CEM-EMEA,89089.39,0,EUR,SEPA Credit Transfer,EuroFab Assembly #1,***1929,,PO-202501-CEM-EMEA-0004,FALSE,FALSE,REF-332060,First Continental Bank,***5250,Globex EMEA Manufacturing Ltd.,IE,-3871241.72
23/01/2025,23/01/2025,Supplier Payment - CodeCraft Contractors #13,Supplier Payment,SaaS-GL,10117.3,0,EUR,SEPA Debit,CodeCraft Contractors #13,***2696,,PO-202501-SaaS-GL-0006,FALSE,FALSE,REF-748345,First Continental Bank,***6164,Globex EMEA Manufacturing Ltd.,IE,-3881359.02
23/01/2025,23/01/2025,Client Receipt - CloudBridge Co. #6,Sales Receipt,SaaS-GL,0,8062.4,EUR,SEPA SCT,CloudBridge Co. #6,***5178,INV-202501-SaaS-GL-0007,,FALSE,FALSE,REF-182596,First Continental Bank,***4233,Globex EMEA Manufacturing Ltd.,IE,-3873296.62
24/01/2025,24/01/2025,Client Receipt - CloudBridge Co. #49,Sales Receipt,SaaS-GL,0,52135.39,EUR,Card Settlement,CloudBridge Co. #49,***4103,INV-202501-SaaS-GL-0012,,FALSE,FALSE,REF-168201,First Continental Bank,***5147,Globex EMEA Manufacturing Ltd.,IE,-3821161.23
26/01/2025,26/01/2025,"Intercompany Settlement - Globex International Holdings, Inc.",Intercompany Transfer,ALL,817115,0,EUR,Internal Transfer,"Globex International Holdings, Inc.",***7732,,,TRUE,TRUE,REF-900430,First Continental Bank,***2902,Globex EMEA Manufacturing Ltd.,IE,-4638276.23
26/01/2025,26/01/2025,"Intercompany Reimbursement - Globex International Holdings, Inc.",Intercompany Transfer,ALL,0,326846,EUR,Internal Transfer,"Globex International Holdings, Inc.",***3415,,,TRUE,TRUE,REF-903405,First Continental Bank,***3532,Globex EMEA Manufacturing Ltd.,IE,-4311430.23
27/01/2025,27/01/2025,Supplier Payment - ExpertNet Subcontractors #12,Supplier Payment,PS-GL,247.58,0,EUR,SEPA Credit Transfer,ExpertNet Subcontractors #12,***8694,,PO-202501-PS-GL-0003,FALSE,FALSE,REF-118785,First Continental Bank,***2989,Globex EMEA Manufacturing Ltd.,IE,-4311677.81
28/01/2025,28/01/2025,Supplier Payment - CodeCraft Contractors #5,Supplier Payment,SaaS-GL,2651.26,0,EUR,SEPA Debit,CodeCraft Contractors #5,***1581,,PO-202501-SaaS-GL-0005,FALSE,FALSE,REF-104442,First Continental Bank,***9435,Globex EMEA Manufacturing Ltd.,IE,-4314329.07
28/01/2025,28/01/2025,Corporate Tax Estimate,Tax Payment,ALL,65946.14,0,EUR,SWIFT MT103,Revenue Ireland,***3618,,,FALSE,FALSE,REF-496261,First Continental Bank,***5237,Globex EMEA Manufacturing Ltd.,IE,-4380275.21
28/01/2025,28/01/2025,Client Receipt - Vertex Advisory Client #11,Sales Receipt,PS-GL,0,33459.35,EUR,SEPA SCT,Vertex Advisory Client #11,***7842,INV-202501-PS-GL-0002,,FALSE,FALSE,REF-373740,First Continental Bank,***1482,Globex EMEA Manufacturing Ltd.,IE,-4346815.86
28/01/2025,28/01/2025,Client Receipt - Aurora Electronics GmbH #16,Sales Receipt,CEM-EMEA,0,47675.13,EUR,SEPA SCT Inst,Aurora Electronics GmbH #16,***2330,INV-202501-CEM-EMEA-0005,,FALSE,FALSE,REF-588642,First Continental Bank,***6295,Globex EMEA Manufacturing Ltd.,IE,-4299140.73
29/01/2025,29/01/2025,Supplier Payment - ExpertNet Subcontractors #5,Supplier Payment,PS-GL,1026.29,0,EUR,SWIFT MT103,ExpertNet Subcontractors #5,***5944,,PO-202501-PS-GL-0006,FALSE,FALSE,REF-841710,First Continental Bank,***5202,Globex EMEA Manufacturing Ltd.,IE,-4300167.02
29/01/2025,29/01/2025,Marketing - Aurelia Media #6,Marketing,ALL,9815.71,0,EUR,SEPA Credit Transfer,Aurelia Media #6,***7583,,,FALSE,FALSE,REF-326090,First Continental Bank,***3400,Globex EMEA Manufacturing Ltd.,IE,-4309982.73
29/01/2025,29/01/2025,Supplier Payment - HyperCloud Infra #14,Supplier Payment,SaaS-GL,17968.65,0,EUR,SWIFT MT103,HyperCloud Infra #14,***4580,,PO-202501-SaaS-GL-0002,FALSE,FALSE,REF-677439,First Continental Bank,***2411,Globex EMEA Manufacturing Ltd.,IE,-4327951.38
29/01/2025,29/01/2025,Payroll - GlobalPay Services Ltd,Payroll,ALL,229172.66,0,EUR,SWIFT MT103,GlobalPay Services Ltd,***7382,,,FALSE,FALSE,REF-272006,First Continental Bank,***1910,Globex EMEA Manufacturing Ltd.,IE,-4557124.04
29/01/2025,29/01/2025,Client Receipt - Aurora Electronics GmbH #4,Sales Receipt,CEM-EMEA,0,17797.34,EUR,SEPA SCT,Aurora Electronics GmbH #4,***9830,INV-202501-CEM-EMEA-0009,,FALSE,FALSE,REF-676033,First Continental Bank,***4584,Globex EMEA Manufacturing Ltd.,IE,-4539326.7
29/01/2025,29/01/2025,Client Receipt - Aurora Electronics GmbH #17,Sales Receipt,CEM-EMEA,0,99143.92,EUR,Card Settlement,Aurora Electronics GmbH #17,***8446,INV-202501-CEM-EMEA-0002,,FALSE,FALSE,REF-779859,First Continental Bank,***4872,Globex EMEA Manufacturing Ltd.,IE,-4440182.78
30/01/2025,30/01/2025,Supplier Payment - Stelliform Parts BV #33,Supplier Payment,CEM-EMEA,5972.43,0,EUR,SEPA Debit,Stelliform Parts BV #33,***7142,,PO-202501-CEM-EMEA-0009,FALSE,FALSE,REF-189618,First Continental Bank,***8381,Globex EMEA Manufacturing Ltd.,IE,-4446155.21
30/01/2025,30/01/2025,Supplier Payment - ExpertNet Subcontractors #11,Supplier Payment,PS-GL,9455.97,0,EUR,SEPA Credit Transfer,ExpertNet Subcontractors #11,***9507,,PO-202501-PS-GL-0007,FALSE,FALSE,REF-168072,First Continental Bank,***7901,Globex EMEA Manufacturing Ltd.,IE,-4455611.18
30/01/2025,30/01/2025,Client Receipt - CloudBridge Co. #12,Sales Receipt,SaaS-GL,0,2095.59,EUR,Card Settlement,CloudBridge Co. #12,***6509,INV-202501-SaaS-GL-0026,,FALSE,FALSE,REF-498797,First Continental Bank,***3771,Globex EMEA Manufacturing Ltd.,IE,-4453515.59
30/01/2025,30/01/2025,Client Receipt - Vertex Advisory Client #10,Sales Receipt,PS-GL,0,4812.31,EUR,SEPA SCT Inst,Vertex Advisory Client #10,***7896,INV-202501-PS-GL-0006,,FALSE,FALSE,REF-557272,First Continental Bank,***2997,Globex EMEA Manufacturing Ltd.,IE,-4448703.28
30/01/2025,30/01/2025,Client Receipt - CloudBridge Co. #43,Sales Receipt,SaaS-GL,0,4859.56,EUR,Card Settlement,CloudBridge Co. #43,***4263,INV-202501-SaaS-GL-0008,,FALSE,FALSE,REF-417950,First Continental Bank,***1913,Globex EMEA Manufacturing Ltd.,IE,-4443843.72
30/01/2025,30/01/2025,Interest Earned,Interest Income,ALL,0,11312.47,EUR,SEPA SCT Inst,First Continental Bank,***8003,,,FALSE,FALSE,REF-617509,First Continental Bank,***9438,Globex EMEA Manufacturing Ltd.,IE,-4432531.25
31/01/2025,31/01/2025,Supplier Payment - HyperCloud Infra #17,Supplier Payment,SaaS-GL,20662.88,0,EUR,SWIFT MT103,HyperCloud Infra #17,***1717,,PO-202501-SaaS-GL-0001,FALSE,FALSE,REF-464028,First Continental Bank,***2854,Globex EMEA Manufacturing Ltd.,IE,-4453194.13
31/01/2025,31/01/2025,Client Receipt - CloudBridge Co. #4,Sales Receipt,SaaS-GL,0,6098.65,EUR,Card Settlement,CloudBridge Co. #4,***1274,INV-202501-SaaS-GL-0015,,FALSE,FALSE,REF-623396,First Continental Bank,***6592,Globex EMEA Manufacturing Ltd.,IE,-4447095.48
31/01/2025,31/01/2025,Client Receipt - CloudBridge Co. #25,Sales Receipt,SaaS-GL,0,19333.25,EUR,SEPA SCT,CloudBridge Co. #25,***1651,INV-202501-SaaS-GL-0017,,FALSE,FALSE,REF-773196,First Continental Bank,***2896,Globex EMEA Manufacturing Ltd.,IE,-4427762.23
31/01/2025,31/01/2025,Client Receipt - Vertex Advisory Client #22,Sales Receipt,PS-GL,0,33936.27,EUR,SEPA SCT,Vertex Advisory Client #22,***2312,INV-202501-PS-GL-0003,,FALSE,FALSE,REF-937515,First Continental Bank,***9667,Globex EMEA Manufacturing Ltd.,IE,-4393825.96
01/02/2025,01/02/2025,Account Maintenance Fee,Bank/Merchant Fees,ALL,2500,0,EUR,SEPA Debit,First Continental Bank,***7665,,,FALSE,FALSE,REF-583539,First Continental Bank,***8343,Globex EMEA Manufacturing Ltd.,IE,-4396325.96
01/02/2025,01/02/2025,Supplier Payment - EuroFab Assembly #9,Supplier Payment,CEM-EMEA,46920.8,0,EUR,SEPA Credit Transfer,EuroFab Assembly #9,***8918,,PO-202502-CEM-EMEA-0005,FALSE,FALSE,REF-432429,First Continental Bank,***6149,Globex EMEA Manufacturing Ltd.,IE,-4443246.76
02/02/2025,02/02/2025,Client Receipt - Aurora Electronics GmbH #18,Sales Receipt,CEM-EMEA,0,52888.59,EUR,SEPA SCT Inst,Aurora Electronics GmbH #18,***7586,INV-202502-CEM-EMEA-0012,,FALSE,FALSE,REF-542299,First Continental Bank,***8136,Globex EMEA Manufacturing Ltd.,IE,-4390358.17
04/02/2025,04/02/2025,Supplier Payment - EuroFab Assembly #1,Supplier Payment,CEM-EMEA,89940.92,0,EUR,SWIFT MT103,EuroFab Assembly #1,***9043,,PO-202502-CEM-EMEA-0008,FALSE,FALSE,REF-472315,First Continental Bank,***3283,Globex EMEA Manufacturing Ltd.,IE,-4480299.09
04/02/2025,04/02/2025,Client Receipt - CloudBridge Co. #51,Sales Receipt,SaaS-GL,0,65340.12,EUR,SEPA SCT Inst,CloudBridge Co. #51,***1398,INV-202502-SaaS-GL-0016,,FALSE,FALSE,REF-157337,First Continental Bank,***2307,Globex EMEA Manufacturing Ltd.,IE,-4414958.97
05/02/2025,05/02/2025,Marketing - Aurelia Media #3,Marketing,ALL,1350.79,0,EUR,SEPA Credit Transfer,Aurelia Media #3,***8717,,,FALSE,FALSE,REF-480190,First Continental Bank,***8560,Globex EMEA Manufacturing Ltd.,IE,-4416309.76
05/02/2025,05/02/2025,Supplier Payment - Stelliform Parts BV #13,Supplier Payment,CEM-EMEA,45874.12,0,EUR,SEPA Credit Transfer,Stelliform Parts BV #13,***8492,,PO-202502-CEM-EMEA-0010,FALSE,FALSE,REF-500779,First Continental Bank,***1831,Globex EMEA Manufacturing Ltd.,IE,-4462183.88
05/02/2025,05/02/2025,Client Receipt - Vertex Advisory Client #8,Sales Receipt,PS-GL,0,5179.87,EUR,SEPA SCT,Vertex Advisory Client #8,***7317,INV-202502-PS-GL-0011,,FALSE,FALSE,REF-188958,First Continental Bank,***8709,Globex EMEA Manufacturing Ltd.,IE,-4457004.01
05/02/2025,05/02/2025,Client Receipt - Vertex Advisory Client #13,Sales Receipt,PS-GL,0,12895.01,EUR,SEPA SCT Inst,Vertex Advisory Client #13,***9577,INV-202502-PS-GL-0004,,FALSE,FALSE,REF-390799,First Continental Bank,***5419,Globex EMEA Manufacturing Ltd.,IE,-4444109
06/02/2025,06/02/2025,Supplier Payment - Stelliform Parts BV #29,Supplier Payment,CEM-EMEA,76031.65,0,EUR,SEPA Credit Transfer,Stelliform Parts BV #29,***1479,,PO-202502-CEM-EMEA-0004,FALSE,FALSE,REF-701150,First Continental Bank,***9841,Globex EMEA Manufacturing Ltd.,IE,-4520140.65
06/02/2025,06/02/2025,Supplier Payment - EuroFab Assembly #11,Supplier Payment,CEM-EMEA,82639.58,0,EUR,SWIFT MT103,EuroFab Assembly #11,***1350,,PO-202502-CEM-EMEA-0011,FALSE,FALSE,REF-631911,First Continental Bank,***9044,Globex EMEA Manufacturing Ltd.,IE,-4602780.23
06/02/2025,06/02/2025,Client Receipt - CloudBridge Co. #34,Sales Receipt,SaaS-GL,0,625.57,EUR,SEPA SCT Inst,CloudBridge Co. #34,***2707,INV-202502-SaaS-GL-0004,,FALSE,FALSE,REF-999320,First Continental Bank,***5224,Globex EMEA Manufacturing Ltd.,IE,-4602154.66
06/02/2025,06/02/2025,Client Receipt - Vertex Advisory Client #6,Sales Receipt,PS-GL,0,7001.44,EUR,Card Settlement,Vertex Advisory Client #6,***3217,INV-202502-PS-GL-0002,,FALSE,FALSE,REF-502222,First Continental Bank,***9600,Globex EMEA Manufacturing Ltd.,IE,-4595153.22
06/02/2025,06/02/2025,Client Receipt - Aurora Electronics GmbH #15,Sales Receipt,CEM-EMEA,0,177360.2,EUR,Card Settlement,Aurora Electronics GmbH #15,***7765,INV-202502-CEM-EMEA-0001,,FALSE,FALSE,REF-916595,First Continental Bank,***2856,Globex EMEA Manufacturing Ltd.,IE,-4417793.02
07/02/2025,07/02/2025,Supplier Payment - ExpertNet Subcontractors #13,Supplier Payment,PS-GL,3003.7,0,EUR,SEPA Debit,ExpertNet Subcontractors #13,***5340,,PO-202502-PS-GL-0008,FALSE,FALSE,REF-387301,First Continental Bank,***8303,Globex EMEA Manufacturing Ltd.,IE,-4420796.72
07/02/2025,07/02/2025,Client Receipt - Vertex Advisory Client #14,Sales Receipt,PS-GL,0,950.89,EUR,Card Settlement,Vertex Advisory Client #14,***8431,INV-202502-PS-GL-0012,,FALSE,FALSE,REF-199853,First Continental Bank,***6888,Globex EMEA Manufacturing Ltd.,IE,-4419845.83
07/02/2025,07/02/2025,Client Receipt - Vertex Advisory Client #49,Sales Receipt,PS-GL,0,1159.94,EUR,SEPA SCT,Vertex Advisory Client #49,***9300,INV-202502-PS-GL-0009,,FALSE,FALSE,REF-790397,First Continental Bank,***4790,Globex EMEA Manufacturing Ltd.,IE,-4418685.89
08/02/2025,08/02/2025,Metro Water & Waste,Rent & Utilities,ALL,13848.45,0,EUR,SEPA Credit Transfer,Metro Water & Waste,***2862,,,FALSE,FALSE,REF-645004,First Continental Bank,***3820,Globex EMEA Manufacturing Ltd.,IE,-4432534.34
08/02/2025,08/02/2025,Client Receipt - CloudBridge Co. #31,Sales Receipt,SaaS-GL,0,91199.02,EUR,Card Settlement,CloudBridge Co. #31,***2687,INV-202502-SaaS-GL-0018,,FALSE,FALSE,REF-742349,First Continental Bank,***6202,Globex EMEA Manufacturing Ltd.,IE,-4341335.32
09/02/2025,09/02/2025,Supplier Payment - HyperCloud Infra #19,Supplier Payment,SaaS-GL,349.42,0,EUR,SWIFT MT103,HyperCloud Infra #19,***3318,,PO-202502-SaaS-GL-0001,FALSE,FALSE,REF-449817,First Continental Bank,***5447,Globex EMEA Manufacturing Ltd.,IE,-4341684.74
09/02/2025,09/02/2025,Supplier Payment - ExpertNet Subcontractors #11,Supplier Payment,PS-GL,12426.55,0,EUR,SEPA Debit,ExpertNet Subcontractors #11,***9969,,PO-202502-PS-GL-0001,FALSE,FALSE,REF-650094,First Continental Bank,***7118,Globex EMEA Manufacturing Ltd.,IE,-4354111.29
10/02/2025,10/02/2025,Supplier Payment - HyperCloud Infra #15,Supplier Payment,SaaS-GL,14102.13,0,EUR,SEPA Credit Transfer,HyperCloud Infra #15,***8948,,PO-202502-SaaS-GL-0005,FALSE,FALSE,REF-679629,First Continental Bank,***1605,Globex EMEA Manufacturing Ltd.,IE,-4368213.42
10/02/2025,10/02/2025,Client Receipt - CloudBridge Co. #21,Sales Receipt,SaaS-GL,0,5742.93,EUR,Card Settlement,CloudBridge Co. #21,***5786,INV-202502-SaaS-GL-0019,,FALSE,FALSE,REF-499922,First Continental Bank,***1106,Globex EMEA Manufacturing Ltd.,IE,-4362470.49
10/02/2025,10/02/2025,Client Receipt - CloudBridge Co. #29,Sales Receipt,SaaS-GL,0,39774.07,EUR,SEPA SCT,CloudBridge Co. #29,***4133,INV-202502-SaaS-GL-0009,,FALSE,FALSE,REF-737142,First Continental Bank,***2991,Globex EMEA Manufacturing Ltd.,IE,-4322696.42
11/02/2025,11/02/2025,Client Receipt - CloudBridge Co. #22,Sales Receipt,SaaS-GL,0,3872.08,EUR,SEPA SCT,CloudBridge Co. #22,***8457,INV-202502-SaaS-GL-0006,,FALSE,FALSE,REF-693207,First Continental Bank,***4013,Globex EMEA Manufacturing Ltd.,IE,-4318824.34
11/02/2025,11/02/2025,Client Receipt - Aurora Electronics GmbH #13,Sales Receipt,CEM-EMEA,0,30711.72,EUR,Card Settlement,Aurora Electronics GmbH #13,***3148,INV-202502-CEM-EMEA-0003,,FALSE,FALSE,REF-250668,First Continental Bank,***5145,Globex EMEA Manufacturing Ltd.,IE,-4288112.62
11/02/2025,11/02/2025,Client Receipt - Vertex Advisory Client #54,Sales Receipt,PS-GL,0,58256.19,EUR,SEPA SCT,Vertex Advisory Client #54,***9660,INV-202502-PS-GL-0008,,FALSE,FALSE,REF-628771,First Continental Bank,***6961,Globex EMEA Manufacturing Ltd.,IE,-4229856.43
11/02/2025,11/02/2025,Client Receipt - Novatek Components Ltd #7,Sales Receipt,CEM-EMEA,0,131362.83,EUR,SEPA SCT Inst,Novatek Components Ltd #7,***1193,INV-202502-CEM-EMEA-0013,,FALSE,FALSE,REF-158068,First Continental Bank,***7171,Globex EMEA Manufacturing Ltd.,IE,-4098493.6
12/02/2025,12/02/2025,Supplier Payment - ExpertNet Subcontractors #15,Supplier Payment,PS-GL,6801.85,0,EUR,SWIFT MT103,ExpertNet Subcontractors #15,***7402,,PO-202502-PS-GL-0007,FALSE,FALSE,REF-263247,First Continental Bank,***5345,Globex EMEA Manufacturing Ltd.,IE,-4105295.45
12/02/2025,12/02/2025,Intercompany Settlement - Globex APAC Logistics Pte. Ltd.,Intercompany Transfer,ALL,882974,0,EUR,Internal Transfer,Globex APAC Logistics Pte. Ltd.,***6615,,,TRUE,TRUE,REF-172120,First Continental Bank,***2890,Globex EMEA Manufacturing Ltd.,IE,-4988269.45
12/02/2025,12/02/2025,Client Receipt - CloudBridge Co. #48,Sales Receipt,SaaS-GL,0,10473.54,EUR,SEPA SCT Inst,CloudBridge Co. #48,***1357,INV-202502-SaaS-GL-0013,,FALSE,FALSE,REF-366927,First Continental Bank,***8014,Globex EMEA Manufacturing Ltd.,IE,-4977795.91
12/02/2025,12/02/2025,Client Receipt - CloudBridge Co. #10,Sales Receipt,SaaS-GL,0,28998.4,EUR,Card Settlement,CloudBridge Co. #10,***6183,INV-202502-SaaS-GL-0012,,FALSE,FALSE,REF-346046,First Continental Bank,***6799,Globex EMEA Manufacturing Ltd.,IE,-4948797.51
12/02/2025,12/02/2025,Client Receipt - CloudBridge Co. #76,Sales Receipt,SaaS-GL,0,53283,EUR,Card Settlement,CloudBridge Co. #76,***8771,INV-202502-SaaS-GL-0007,,FALSE,FALSE,REF-587260,First Continental Bank,***7362,Globex EMEA Manufacturing Ltd.,IE,-4895514.51
12/02/2025,12/02/2025,Client Receipt - Vertex Advisory Client #19,Sales Receipt,PS-GL,0,57826.2,EUR,SEPA SCT Inst,Vertex Advisory Client #19,***5093,INV-202502-PS-GL-0007,,FALSE,FALSE,REF-992401,First Continental Bank,***1432,Globex EMEA Manufacturing Ltd.,IE,-4837688.31
13/02/2025,13/02/2025,Supplier Payment - HyperCloud Infra #8,Supplier Payment,SaaS-GL,21441.73,0,EUR,SWIFT MT103,HyperCloud Infra #8,***8202,,PO-202502-SaaS-GL-0006,FALSE,FALSE,REF-702532,First Continental Bank,***9246,Globex EMEA Manufacturing Ltd.,IE,-4859130.04
13/02/2025,13/02/2025,Supplier Payment - Stelliform Parts BV #20,Supplier Payment,CEM-EMEA,36633.19,0,EUR,SWIFT MT103,Stelliform Parts BV #20,***5256,,PO-202502-CEM-EMEA-0001,FALSE,FALSE,REF-758419,First Continental Bank,***5412,Globex EMEA Manufacturing Ltd.,IE,-4895763.23
13/02/2025,13/02/2025,Supplier Payment - Stelliform Parts BV #32,Supplier Payment,CEM-EMEA,66994.96,0,EUR,SWIFT MT103,Stelliform Parts BV #32,***7369,,PO-202502-CEM-EMEA-0002,FALSE,FALSE,REF-572496,First Continental Bank,***6999,Globex EMEA Manufacturing Ltd.,IE,-4962758.19
13/02/2025,13/02/2025,Client Receipt - CloudBridge Co. #57,Sales Receipt,SaaS-GL,0,638.93,EUR,SEPA SCT Inst,CloudBridge Co. #57,***6209,INV-202502-SaaS-GL-0014,,FALSE,FALSE,REF-772431,First Continental Bank,***6538,Globex EMEA Manufacturing Ltd.,IE,-4962119.26
13/02/2025,13/02/2025,Client Receipt - Novatek Components Ltd #4,Sales Receipt,CEM-EMEA,0,7344.48,EUR,Card Settlement,Novatek Components Ltd #4,***5013,INV-202502-CEM-EMEA-0011,,FALSE,FALSE,REF-417819,First Continental Bank,***1114,Globex EMEA Manufacturing Ltd.,IE,-4954774.78
13/02/2025,13/02/2025,Client Receipt - CloudBridge Co. #64,Sales Receipt,SaaS-GL,0,9336.17,EUR,SEPA SCT Inst,CloudBridge Co. #64,***5697,INV-202502-SaaS-GL-0017,,FALSE,FALSE,REF-160895,First Continental Bank,***6643,Globex EMEA Manufacturing Ltd.,IE,-4945438.61
13/02/2025,13/02/2025,Client Receipt - Vertex Advisory Client #8,Sales Receipt,PS-GL,0,43076.02,EUR,Card Settlement,Vertex Advisory Client #8,***3245,INV-202502-PS-GL-0010,,FALSE,FALSE,REF-687611,First Continental Bank,***3550,Globex EMEA Manufacturing Ltd.,IE,-4902362.59
13/02/2025,13/02/2025,Client Receipt - Vertex Advisory Client #46,Sales Receipt,PS-GL,0,67374.82,EUR,SEPA SCT,Vertex Advisory Client #46,***8365,INV-202502-PS-GL-0006,,FALSE,FALSE,REF-738271,First Continental Bank,***1067,Globex EMEA Manufacturing Ltd.,IE,-4834987.77
14/02/2025,14/02/2025,Supplier Payment - ExpertNet Subcontractors #17,Supplier Payment,PS-GL,16347.29,0,EUR,SEPA Credit Transfer,ExpertNet Subcontractors #17,***8399,,PO-202502-PS-GL-0009,FALSE,FALSE,REF-720070,First Continental Bank,***5188,Globex EMEA Manufacturing Ltd.,IE,-4851335.06
14/02/2025,14/02/2025,Client Receipt - CloudBridge Co. #45,Sales Receipt,SaaS-GL,0,16175.14,EUR,Card Settlement,CloudBridge Co. #45,***8960,INV-202502-SaaS-GL-0011,,FALSE,FALSE,REF-216671,First Continental Bank,***7185,Globex EMEA Manufacturing Ltd.,IE,-4835159.92
15/02/2025,15/02/2025,Supplier Payment - ExpertNet Subcontractors #3,Supplier Payment,PS-GL,5360.43,0,EUR,SEPA Debit,ExpertNet Subcontractors #3,***9880,,PO-202502-PS-GL-0002,FALSE,FALSE,REF-250671,First Continental Bank,***4520,Globex EMEA Manufacturing Ltd.,IE,-4840520.35
15/02/2025,15/02/2025,Loan Interest Payment,Loan Interest,ALL,85000,0,EUR,SWIFT MT103,First Continental Bank - Corporate Lending,***6598,,,FALSE,FALSE,REF-140697,First Continental Bank,***3621,Globex EMEA Manufacturing Ltd.,IE,-4925520.35
15/02/2025,15/02/2025,Loan Principal Repayment,Loan Principal,ALL,500000,0,EUR,SEPA Debit,First Continental Bank - Corporate Lending,***3000,,,FALSE,FALSE,REF-236839,First Continental Bank,***2898,Globex EMEA Manufacturing Ltd.,IE,-5425520.35
16/02/2025,16/02/2025,Client Receipt - CloudBridge Co. #17,Sales Receipt,SaaS-GL,0,5757.34,EUR,SEPA SCT,CloudBridge Co. #17,***8601,INV-202502-SaaS-GL-0002,,FALSE,FALSE,REF-867487,First Continental Bank,***9870,Globex EMEA Manufacturing Ltd.,IE,-5419763.01
17/02/2025,17/02/2025,Merchant Processing Fees,Bank/Merchant Fees,ALL,1359.89,0,EUR,SWIFT MT103,First Continental Bank,***5917,,,FALSE,FALSE,REF-569344,First Continental Bank,***9771,Globex EMEA Manufacturing Ltd.,IE,-5421122.9
17/02/2025,17/02/2025,Client Receipt - CloudBridge Co. #58,Sales Receipt,SaaS-GL,0,1885.21,EUR,Card Settlement,CloudBridge Co. #58,***4259,INV-202502-SaaS-GL-0005,,FALSE,FALSE,REF-768226,First Continental Bank,***2093,Globex EMEA Manufacturing Ltd.,IE,-5419237.69
17/02/2025,17/02/2025,Client Receipt - Aurora Electronics GmbH #9,Sales Receipt,CEM-EMEA,0,22324.29,EUR,SEPA SCT,Aurora Electronics GmbH #9,***1636,INV-202502-CEM-EMEA-0010,,FALSE,FALSE,REF-428343,First Continental Bank,***7561,Globex EMEA Manufacturing Ltd.,IE,-5396913.4
18/02/2025,18/02/2025,Supplier Payment - Stelliform Parts BV #19,Supplier Payment,CEM-EMEA,15526.36,0,EUR,SEPA Debit,Stelliform Parts BV #19,***4649,,PO-202502-CEM-EMEA-0006,FALSE,FALSE,REF-700449,First Continental Bank,***6160,Globex EMEA Manufacturing Ltd.,IE,-5412439.76
18/02/2025,18/02/2025,Client Receipt - CloudBridge Co. #75,Sales Receipt,SaaS-GL,0,9589.4,EUR,Card Settlement,CloudBridge Co. #75,***3937,INV-202502-SaaS-GL-0020,,FALSE,FALSE,REF-418702,First Continental Bank,***8925,Globex EMEA Manufacturing Ltd.,IE,-5402850.36
18/02/2025,18/02/2025,Client Receipt - CloudBridge Co. #36,Sales Receipt,SaaS-GL,0,14210.82,EUR,SEPA SCT,CloudBridge Co. #36,***6416,INV-202502-SaaS-GL-0015,,FALSE,FALSE,REF-643932,First Continental Bank,***8988,Globex EMEA Manufacturing Ltd.,IE,-5388639.54
18/02/2025,18/02/2025,Client Receipt - Aurora Electronics GmbH #4,Sales Receipt,CEM-EMEA,0,34174.68,EUR,SEPA SCT Inst,Aurora Electronics GmbH #4,***7067,INV-202502-CEM-EMEA-0008,,FALSE,FALSE,REF-481811,First Continental Bank,***4933,Globex EMEA Manufacturing Ltd.,IE,-5354464.86
18/02/2025,18/02/2025,Client Receipt - Aurora Electronics GmbH #11,Sales Receipt,CEM-EMEA,0,213790.68,EUR,SEPA SCT Inst,Aurora Electronics GmbH #11,***4279,INV-202502-CEM-EMEA-0006,,FALSE,FALSE,REF-135954,First Continental Bank,***1358,Globex EMEA Manufacturing Ltd.,IE,-5140674.18
19/02/2025,19/02/2025,Merchant Processing Fees,Bank/Merchant Fees,ALL,3818.49,0,EUR,SEPA Debit,First Continental Bank,***3554,,,FALSE,FALSE,REF-791657,First Continental Bank,***4971,Globex EMEA Manufacturing Ltd.,IE,-5144492.67
19/02/2025,19/02/2025,Supplier Payment - Stelliform Parts BV #20,Supplier Payment,CEM-EMEA,20830.01,0,EUR,SWIFT MT103,Stelliform Parts BV #20,***9330,,PO-202502-CEM-EMEA-0009,FALSE,FALSE,REF-684424,First Continental Bank,***4931,Globex EMEA Manufacturing Ltd.,IE,-5165322.68
19/02/2025,19/02/2025,Client Receipt - Aurora Electronics GmbH #11,Sales Receipt,CEM-EMEA,0,6813.37,EUR,SEPA SCT,Aurora Electronics GmbH #11,***9708,INV-202502-CEM-EMEA-0007,,FALSE,FALSE,REF-443017,First Continental Bank,***3695,Globex EMEA Manufacturing Ltd.,IE,-5158509.31
19/02/2025,19/02/2025,Client Receipt - Novatek Components Ltd #14,Sales Receipt,CEM-EMEA,0,36167.25,EUR,Card Settlement,Novatek Components Ltd #14,***3907,INV-202502-CEM-EMEA-0005,,FALSE,FALSE,REF-718935,First Continental Bank,***4802,Globex EMEA Manufacturing Ltd.,IE,-5122342.06
19/02/2025,19/02/2025,Client Receipt - CloudBridge Co. #42,Sales Receipt,SaaS-GL,0,48746.23,EUR,SEPA SCT,CloudBridge Co. #42,***2993,INV-202502-SaaS-GL-0023,,FALSE,FALSE,REF-970154,First Continental Bank,***9621,Globex EMEA Manufacturing Ltd.,IE,-5073595.83
20/02/2025,20/02/2025,Supplier Payment - HyperCloud Infra #19,Supplier Payment,SaaS-GL,19848.42,0,EUR,SEPA Debit,HyperCloud Infra #19,***8474,,PO-202502-SaaS-GL-0007,FALSE,FALSE,REF-223763,First Continental Bank,***1840,Globex EMEA Manufacturing Ltd.,IE,-5093444.25
20/02/2025,20/02/2025,Client Receipt - CloudBridge Co. #68,Sales Receipt,SaaS-GL,0,40197.12,EUR,Card Settlement,CloudBridge Co. #68,***8395,INV-202502-SaaS-GL-0010,,FALSE,FALSE,REF-355316,First Continental Bank,***3780,Globex EMEA Manufacturing Ltd.,IE,-5053247.13
21/02/2025,21/02/2025,Supplier Payment - CodeCraft Contractors #3,Supplier Payment,SaaS-GL,13655.32,0,EUR,SEPA Credit Transfer,CodeCraft Contractors #3,***8387,,PO-202502-SaaS-GL-0002,FALSE,FALSE,REF-806122,First Continental Bank,***8442,Globex EMEA Manufacturing Ltd.,IE,-5066902.45
21/02/2025,21/02/2025,Supplier Payment - ExpertNet Subcontractors #16,Supplier Payment,PS-GL,17339.99,0,EUR,SEPA Debit,ExpertNet Subcontractors #16,***2906,,PO-202502-PS-GL-0004,FALSE,FALSE,REF-315822,First Continental Bank,***6932,Globex EMEA Manufacturing Ltd.,IE,-5084242.44
21/02/2025,21/02/2025,Marketing - Beacon Digital #3,Marketing,ALL,41366.64,0,EUR,SEPA Debit,Beacon Digital #3,***2444,,,FALSE,FALSE,REF-943446,First Continental Bank,***4858,Globex EMEA Manufacturing Ltd.,IE,-5125609.08
21/02/2025,21/02/2025,VAT/GST Remittance - Revenue Ireland,Tax Payment,ALL,102917.98,0,EUR,SWIFT MT103,Revenue Ireland,***8835,,,FALSE,FALSE,REF-532482,First Continental Bank,***5100,Globex EMEA Manufacturing Ltd.,IE,-5228527.06
23/02/2025,23/02/2025,Supplier Payment - Stelliform Parts BV #25,Supplier Payment,CEM-EMEA,1406.77,0,EUR,SWIFT MT103,Stelliform Parts BV #25,***2890,,PO-202502-CEM-EMEA-0003,FALSE,FALSE,REF-438695,First Continental Bank,***8582,Globex EMEA Manufacturing Ltd.,IE,-5229933.83
23/02/2025,23/02/2025,Supplier Payment - ExpertNet Subcontractors #15,Supplier Payment,PS-GL,16039.89,0,EUR,SEPA Credit Transfer,ExpertNet Subcontractors #15,***1016,,PO-202502-PS-GL-0010,FALSE,FALSE,REF-324755,First Continental Bank,***7871,Globex EMEA Manufacturing Ltd.,IE,-5245973.72
23/02/2025,23/02/2025,Client Receipt - Aurora Electronics GmbH #9,Sales Receipt,CEM-EMEA,0,52411.42,EUR,Card Settlement,Aurora Electronics GmbH #9,***1650,INV-202502-CEM-EMEA-0009,,FALSE,FALSE,REF-955469,First Continental Bank,***7952,Globex EMEA Manufacturing Ltd.,IE,-5193562.3
23/02/2025,23/02/2025,Client Receipt - Vertex Advisory Client #48,Sales Receipt,PS-GL,0,75640.33,EUR,SEPA SCT Inst,Vertex Advisory Client #48,***8205,INV-202502-PS-GL-0001,,FALSE,FALSE,REF-690336,First Continental Bank,***5309,Globex EMEA Manufacturing Ltd.,IE,-5117921.97
24/02/2025,24/02/2025,Supplier Payment - HyperCloud Infra #10,Supplier Payment,SaaS-GL,20628.61,0,EUR,SEPA Debit,HyperCloud Infra #10,***2833,,PO-202502-SaaS-GL-0003,FALSE,FALSE,REF-383939,First Continental Bank,***6628,Globex EMEA Manufacturing Ltd.,IE,-5138550.58
24/02/2025,24/02/2025,Client Receipt - CloudBridge Co. #25,Sales Receipt,SaaS-GL,0,19008.62,EUR,SEPA SCT,CloudBridge Co. #25,***4434,INV-202502-SaaS-GL-0003,,FALSE,FALSE,REF-982410,First Continental Bank,***2716,Globex EMEA Manufacturing Ltd.,IE,-5119541.96
24/02/2025,24/02/2025,Client Receipt - Vertex Advisory Client #47,Sales Receipt,PS-GL,0,20043.59,EUR,SEPA SCT,Vertex Advisory Client #47,***5821,INV-202502-PS-GL-0005,,FALSE,FALSE,REF-250306,First Continental Bank,***6592,Globex EMEA Manufacturing Ltd.,IE,-5099498.37
24/02/2025,24/02/2025,Client Receipt - Novatek Components Ltd #13,Sales Receipt,CEM-EMEA,0,21822.11,EUR,SEPA SCT Inst,Novatek Components Ltd #13,***5751,INV-202502-CEM-EMEA-0004,,FALSE,FALSE,REF-698817,First Continental Bank,***6911,Globex EMEA Manufacturing Ltd.,IE,-5077676.26
25/02/2025,25/02/2025,Supplier Payment - HyperCloud Infra #12,Supplier Payment,SaaS-GL,1390.93,0,EUR,SWIFT MT103,HyperCloud Infra #12,***4777,,PO-202502-SaaS-GL-0004,FALSE,FALSE,REF-512917,First Continental Bank,***3422,Globex EMEA Manufacturing Ltd.,IE,-5079067.19
25/02/2025,25/02/2025,Supplier Payment - EuroFab Assembly #8,Supplier Payment,CEM-EMEA,17622.16,0,EUR,SWIFT MT103,EuroFab Assembly #8,***3015,,PO-202502-CEM-EMEA-0007,FALSE,FALSE,REF-355618,First Continental Bank,***3709,Globex EMEA Manufacturing Ltd.,IE,-5096689.35
25/02/2025,25/02/2025,Payroll - GlobalPay Services Ltd,Payroll,ALL,276482.8,0,EUR,SEPA Debit,GlobalPay Services Ltd,***9520,,,FALSE,FALSE,REF-308569,First Continental Bank,***2207,Globex EMEA Manufacturing Ltd.,IE,-5373172.15
25/02/2025,25/02/2025,Client Receipt - Novatek Components Ltd #9,Sales Receipt,CEM-EMEA,0,8063.56,EUR,SEPA SCT,Novatek Components Ltd #9,***5920,INV-202502-CEM-EMEA-0015,,FALSE,FALSE,REF-667675,First Continental Bank,***7563,Globex EMEA Manufacturing Ltd.,IE,-5365108.59
25/02/2025,25/02/2025,Client Receipt - CloudBridge Co. #56,Sales Receipt,SaaS-GL,0,14255.49,EUR,Card Settlement,CloudBridge Co. #56,***5696,INV-202502-SaaS-GL-0008,,FALSE,FALSE,REF-309421,First Continental Bank,***5930,Globex EMEA Manufacturing Ltd.,IE,-5350853.1
25/02/2025,25/02/2025,Client Receipt - Aurora Electronics GmbH #12,Sales Receipt,CEM-EMEA,0,30700.55,EUR,Card Settlement,Aurora Electronics GmbH #12,***4046,INV-202502-CEM-EMEA-0002,,FALSE,FALSE,REF-167187,First Continental Bank,***8913,Globex EMEA Manufacturing Ltd.,IE,-5320152.55
26/02/2025,26/02/2025,Supplier Payment - ExpertNet Subcontractors #2,Supplier Payment,PS-GL,19596.36,0,EUR,SWIFT MT103,ExpertNet Subcontractors #2,***8656,,PO-202502-PS-GL-0003,FALSE,FALSE,REF-245312,First Continental Bank,***3795,Globex EMEA Manufacturing Ltd.,IE,-5339748.91
26/02/2025,26/02/2025,Supplier Payment - HyperCloud Infra #4,Supplier Payment,SaaS-GL,22097.97,0,EUR,SEPA Debit,HyperCloud Infra #4,***3665,,PO-202502-SaaS-GL-0008,FALSE,FALSE,REF-489000,First Continental Bank,***3144,Globex EMEA Manufacturing Ltd.,IE,-5361846.88
26/02/2025,26/02/2025,Intercompany Settlement - Globex Consulting UK Ltd.,Intercompany Transfer,ALL,415572,0,EUR,Internal Transfer,Globex Consulting UK Ltd.,***7653,,,TRUE,TRUE,REF-610302,First Continental Bank,***6567,Globex EMEA Manufacturing Ltd.,IE,-5777418.88
26/02/2025,26/02/2025,Client Receipt - CloudBridge Co. #65,Sales Receipt,SaaS-GL,0,6909.49,EUR,SEPA SCT Inst,CloudBridge Co. #65,***9457,INV-202502-SaaS-GL-0022,,FALSE,FALSE,REF-853439,First Continental Bank,***5151,Globex EMEA Manufacturing Ltd.,IE,-5770509.39
26/02/2025,26/02/2025,Client Receipt - Aurora Electronics GmbH #11,Sales Receipt,CEM-EMEA,0,8098.47,EUR,SEPA SCT,Aurora Electronics GmbH #11,***5377,INV-202502-CEM-EMEA-0014,,FALSE,FALSE,REF-178361,First Continental Bank,***5521,Globex EMEA Manufacturing Ltd.,IE,-5762410.92
27/02/2025,27/02/2025,Supplier Payment - ExpertNet Subcontractors #12,Supplier Payment,PS-GL,395.25,0,EUR,SEPA Credit Transfer,ExpertNet Subcontractors #12,***7937,,PO-202502-PS-GL-0006,FALSE,FALSE,REF-862775,First Continental Bank,***8479,Globex EMEA Manufacturing Ltd.,IE,-5762806.17
27/02/2025,27/02/2025,Supplier Payment - HyperCloud Infra #8,Supplier Payment,SaaS-GL,4441.74,0,EUR,SEPA Credit Transfer,HyperCloud Infra #8,***4489,,PO-202502-SaaS-GL-0009,FALSE,FALSE,REF-271545,First Continental Bank,***4101,Globex EMEA Manufacturing Ltd.,IE,-5767247.91
27/02/2025,27/02/2025,Client Receipt - Vertex Advisory Client #36,Sales Receipt,PS-GL,0,8038.93,EUR,SEPA SCT,Vertex Advisory Client #36,***4266,INV-202502-PS-GL-0003,,FALSE,FALSE,REF-758988,First Continental Bank,***5833,Globex EMEA Manufacturing Ltd.,IE,-5759208.98
28/02/2025,28/02/2025,Supplier Payment - ExpertNet Subcontractors #17,Supplier Payment,PS-GL,9921.66,0,EUR,SEPA Debit,ExpertNet Subcontractors #17,***1461,,PO-202502-PS-GL-0005,FALSE,FALSE,REF-966974,First Continental Bank,***5531,Globex EMEA Manufacturing Ltd.,IE,-5769130.64
28/02/2025,28/02/2025,Client Receipt - CloudBridge Co. #57,Sales Receipt,SaaS-GL,0,7264.07,EUR,Card Settlement,CloudBridge Co. #57,***2868,INV-202502-SaaS-GL-0021,,FALSE,FALSE,REF-855588,First Continental Bank,***8549,Globex EMEA Manufacturing Ltd.,IE,-5761866.57
28/02/2025,28/02/2025,Interest Earned,Interest Income,ALL,0,9833.98,EUR,SEPA SCT Inst,First Continental Bank,***7292,,,FALSE,FALSE,REF-337986,First Continental Bank,***3533,Globex EMEA Manufacturing Ltd.,IE,-5752032.59
28/02/2025,28/02/2025,Client Receipt - CloudBridge Co. #8,Sales Receipt,SaaS-GL,0,42882.08,EUR,SEPA SCT Inst,CloudBridge Co. #8,***3026,INV-202502-SaaS-GL-0001,,FALSE,FALSE,REF-437364,First Continental Bank,***7059,Globex EMEA Manufacturing Ltd.,IE,-5709150.51
01/03/2025,01/03/2025,Account Maintenance Fee,Bank/Merchant Fees,ALL,2500,0,EUR,SEPA Debit,First Continental Bank,***2246,,,FALSE,FALSE,REF-640902,First Continental Bank,***3275,Globex EMEA Manufacturing Ltd.,IE,-5711650.51
01/03/2025,01/03/2025,Client Receipt - CloudBridge Co. #74,Sales Receipt,SaaS-GL,0,31757.17,EUR,SEPA SCT Inst,CloudBridge Co. #74,***1232,INV-202503-SaaS-GL-0009,,FALSE,FALSE,REF-288010,First Continental Bank,***9565,Globex EMEA Manufacturing Ltd.,IE,-5679893.34
02/03/2025,02/03/2025,Supplier Payment - EuroFab Assembly #15,Supplier Payment,CEM-EMEA,113801.11,0,EUR,SWIFT MT103,EuroFab Assembly #15,***7018,,PO-202503-CEM-EMEA-0010,FALSE,FALSE,REF-917965,First Continental Bank,***5349,Globex EMEA Manufacturing Ltd.,IE,-5793694.45
03/03/2025,03/03/2025,Supplier Payment - HyperCloud Infra #3,Supplier Payment,SaaS-GL,1324.12,0,EUR,SEPA Credit Transfer,HyperCloud Infra #3,***1483,,PO-202503-SaaS-GL-0005,FALSE,FALSE,REF-545432,First Continental Bank,***7167,Globex EMEA Manufacturing Ltd.,IE,-5795018.57
03/03/2025,03/03/2025,Northshore Power,Rent & Utilities,ALL,15270.61,0,EUR,SEPA Debit,Northshore Power,***4351,,,FALSE,FALSE,REF-231636,First Continental Bank,***8725,Globex EMEA Manufacturing Ltd.,IE,-5810289.18
03/03/2025,03/03/2025,Client Receipt - CloudBridge Co. #79,Sales Receipt,SaaS-GL,0,3941.86,EUR,SEPA SCT Inst,CloudBridge Co. #79,***6448,INV-202503-SaaS-GL-0004,,FALSE,FALSE,REF-275100,First Continental Bank,***7854,Globex EMEA Manufacturing Ltd.,IE,-5806347.32
03/03/2025,03/03/2025,Client Receipt - CloudBridge Co. #36,Sales Receipt,SaaS-GL,0,4316.68,EUR,Card Settlement,CloudBridge Co. #36,***2729,INV-202503-SaaS-GL-0021,,FALSE,FALSE,REF-931939,First Continental Bank,***2930,Globex EMEA Manufacturing Ltd.,IE,-5802030.64
03/03/2025,03/03/2025,Client Receipt - CloudBridge Co. #34,Sales Receipt,SaaS-GL,0,16313.04,EUR,SEPA SCT,CloudBridge Co. #34,***2205,INV-202503-SaaS-GL-0008,,FALSE,FALSE,REF-869030,First Continental Bank,***7646,Globex EMEA Manufacturing Ltd.,IE,-5785717.6
03/03/2025,03/03/2025,Client Receipt - CloudBridge Co. #61,Sales Receipt,SaaS-GL,0,45326.49,EUR,Card Settlement,CloudBridge Co. #61,***4693,INV-202503-SaaS-GL-0016,,FALSE,FALSE,REF-223973,First Continental Bank,***7009,Globex EMEA Manufacturing Ltd.,IE,-5740391.11
04/03/2025,04/03/2025,Supplier Payment - ExpertNet Subcontractors #5,Supplier Payment,PS-GL,1638.49,0,EUR,SEPA Debit,ExpertNet Subcontractors #5,***9192,,PO-202503-PS-GL-0001,FALSE,FALSE,REF-300293,First Continental Bank,***3281,Globex EMEA Manufacturing Ltd.,IE,-5742029.6
04/03/2025,04/03/2025,Supplier Payment - HyperCloud Infra #11,Supplier Payment,SaaS-GL,38813.66,0,EUR,SWIFT MT103,HyperCloud Infra #11,***2462,,PO-202503-SaaS-GL-0011,FALSE,FALSE,REF-978221,First Continental Bank,***2837,Globex EMEA Manufacturing Ltd.,IE,-5780843.26
04/03/2025,04/03/2025,Supplier Payment - Stelliform Parts BV #2,Supplier Payment,CEM-EMEA,102821.36,0,EUR,SWIFT MT103,Stelliform Parts BV #2,***5327,,PO-202503-CEM-EMEA-0012,FALSE,FALSE,REF-358987,First Continental Bank,***1335,Globex EMEA Manufacturing Ltd.,IE,-5883664.62
04/03/2025,04/03/2025,Supplier Payment - Stelliform Parts BV #24,Supplier Payment,CEM-EMEA,123432.19,0,EUR,SEPA Credit Transfer,Stelliform Parts BV #24,***2810,,PO-202503-CEM-EMEA-0011,FALSE,FALSE,REF-144576,First Continental Bank,***2851,Globex EMEA Manufacturing Ltd.,IE,-6007096.81
04/03/2025,04/03/2025,Client Receipt - Aurora Electronics GmbH #18,Sales Receipt,CEM-EMEA,0,37416.86,EUR,SEPA SCT Inst,Aurora Electronics GmbH #18,***2503,INV-202503-CEM-EMEA-0007,,FALSE,FALSE,REF-732920,First Continental Bank,***9796,Globex EMEA Manufacturing Ltd.,IE,-5969679.95
04/03/2025,04/03/2025,Client Receipt - Aurora Electronics GmbH #12,Sales Receipt,CEM-EMEA,0,220892.49,EUR,SEPA SCT,Aurora Electronics GmbH #12,***6198,INV-202503-CEM-EMEA-0005,,FALSE,FALSE,REF-740325,First Continental Bank,***5092,Globex EMEA Manufacturing Ltd.,IE,-5748787.46
05/03/2025,05/03/2025,Supplier Payment - ExpertNet Subcontractors #13,Supplier Payment,PS-GL,24913.02,0,EUR,SWIFT MT103,ExpertNet Subcontractors #13,***2454,,PO-202503-PS-GL-0006,FALSE,FALSE,REF-410769,First Continental Bank,***9281,Globex EMEA Manufacturing Ltd.,IE,-5773700.48
05/03/2025,05/03/2025,Client Receipt - Aurora Electronics GmbH #7,Sales Receipt,CEM-EMEA,0,10206.97,EUR,SEPA SCT,Aurora Electronics GmbH #7,***1534,INV-202503-CEM-EMEA-0013,,FALSE,FALSE,REF-122489,First Continental Bank,***9741,Globex EMEA Manufacturing Ltd.,IE,-5763493.51
05/03/2025,05/03/2025,Client Receipt - Vertex Advisory Client #48,Sales Receipt,PS-GL,0,33139.68,EUR,SEPA SCT Inst,Vertex Advisory Client #48,***4057,INV-202503-PS-GL-0007,,FALSE,FALSE,REF-242015,First Continental Bank,***4129,Globex EMEA Manufacturing Ltd.,IE,-5730353.83
06/03/2025,06/03/2025,Client Receipt - CloudBridge Co. #25,Sales Receipt,SaaS-GL,0,5428.35,EUR,SEPA SCT,CloudBridge Co. #25,***2359,INV-202503-SaaS-GL-0034,,FALSE,FALSE,REF-752906,First Continental Bank,***3982,Globex EMEA Manufacturing Ltd.,IE,-5724925.48
06/03/2025,06/03/2025,Client Receipt - Vertex Advisory Client #8,Sales Receipt,PS-GL,0,104816.99,EUR,SEPA SCT,Vertex Advisory Client #8,***2798,INV-202503-PS-GL-0006,,FALSE,FALSE,REF-531243,First Continental Bank,***6763,Globex EMEA Manufacturing Ltd.,IE,-5620108.49
07/03/2025,07/03/2025,Marketing - Beacon Digital #3,Marketing,ALL,8595.21,0,EUR,SWIFT MT103,Beacon Digital #3,***2342,,,FALSE,FALSE,REF-746912,First Continental Bank,***2834,Globex EMEA Manufacturing Ltd.,IE,-5628703.7
07/03/2025,07/03/2025,Client Receipt - CloudBridge Co. #11,Sales Receipt,SaaS-GL,0,1122.21,EUR,Card Settlement,CloudBridge Co. #11,***8517,INV-202503-SaaS-GL-0011,,FALSE,FALSE,REF-344226,First Continental Bank,***9927,Globex EMEA Manufacturing Ltd.,IE,-5627581.49
07/03/2025,07/03/2025,Client Receipt - CloudBridge Co. #47,Sales Receipt,SaaS-GL,0,2057.13,EUR,SEPA SCT Inst,CloudBridge Co. #47,***9055,INV-202503-SaaS-GL-0019,,FALSE,FALSE,REF-728742,First Continental Bank,***9558,Globex EMEA Manufacturing Ltd.,IE,-5625524.36
07/03/2025,07/03/2025,Client Receipt - CloudBridge Co. #56,Sales Receipt,SaaS-GL,0,5976.63,EUR,SEPA SCT Inst,CloudBridge Co. #56,***5599,INV-202503-SaaS-GL-0013,,FALSE,FALSE,REF-143351,First Continental Bank,***1635,Globex EMEA Manufacturing Ltd.,IE,-5619547.73
07/03/2025,07/03/2025,Client Receipt - CloudBridge Co. #41,Sales Receipt,SaaS-GL,0,6756.37,EUR,SEPA SCT,CloudBridge Co. #41,***3293,INV-202503-SaaS-GL-0033,,FALSE,FALSE,REF-138955,First Continental Bank,***7688,Globex EMEA Manufacturing Ltd.,IE,-5612791.36
07/03/2025,07/03/2025,Client Receipt - Vertex Advisory Client #31,Sales Receipt,PS-GL,0,8297.26,EUR,Card Settlement,Vertex Advisory Client #31,***5412,INV-202503-PS-GL-0004,,FALSE,FALSE,REF-692428,First Continental Bank,***3418,Globex EMEA Manufacturing Ltd.,IE,-5604494.1
07/03/2025,07/03/2025,Client Receipt - CloudBridge Co. #57,Sales Receipt,SaaS-GL,0,18282.06,EUR,SEPA SCT,CloudBridge Co. #57,***4748,INV-202503-SaaS-GL-0006,,FALSE,FALSE,REF-405484,First Continental Bank,***4050,Globex EMEA Manufacturing Ltd.,IE,-5586212.04
07/03/2025,07/03/2025,Client Receipt - CloudBridge Co. #74,Sales Receipt,SaaS-GL,0,19111.27,EUR,Card Settlement,CloudBridge Co. #74,***7927,INV-202503-SaaS-GL-0001,,FALSE,FALSE,REF-520532,First Continental Bank,***1338,Globex EMEA Manufacturing Ltd.,IE,-5567100.77
07/03/2025,07/03/2025,Client Receipt - Aurora Electronics GmbH #3,Sales Receipt,CEM-EMEA,0,43461.88,EUR,SEPA SCT,Aurora Electronics GmbH #3,***9731,INV-202503-CEM-EMEA-0004,,FALSE,FALSE,REF-731243,First Continental Bank,***5384,Globex EMEA Manufacturing Ltd.,IE,-5523638.89
08/03/2025,08/03/2025,Supplier Payment - ExpertNet Subcontractors #10,Supplier Payment,PS-GL,653.77,0,EUR,SWIFT MT103,ExpertNet Subcontractors #10,***2200,,PO-202503-PS-GL-0007,FALSE,FALSE,REF-789965,First Continental Bank,***3433,Globex EMEA Manufacturing Ltd.,IE,-5524292.66
08/03/2025,08/03/2025,Supplier Payment - EuroFab Assembly #21,Supplier Payment,CEM-EMEA,23553.22,0,EUR,SWIFT MT103,EuroFab Assembly #21,***8306,,PO-202503-CEM-EMEA-0002,FALSE,FALSE,REF-418020,First Continental Bank,***5221,Globex EMEA Manufacturing Ltd.,IE,-5547845.88
09/03/2025,09/03/2025,Client Receipt - CloudBridge Co. #20,Sales Receipt,SaaS-GL,0,19795.12,EUR,Card Settlement,CloudBridge Co. #20,***4666,INV-202503-SaaS-GL-0022,,FALSE,FALSE,REF-855218,First Continental Bank,***7510,Globex EMEA Manufacturing Ltd.,IE,-5528050.76
10/03/2025,10/03/2025,Marketing - Aurelia Media #4,Marketing,ALL,39609.05,0,EUR,SWIFT MT103,Aurelia Media #4,***5302,,,FALSE,FALSE,REF-747512,First Continental Bank,***5090,Globex EMEA Manufacturing Ltd.,IE,-5567659.81
10/03/2025,10/03/2025,Client Receipt - Vertex Advisory Client #9,Sales Receipt,PS-GL,0,41215.4,EUR,SEPA SCT,Vertex Advisory Client #9,***6579,INV-202503-PS-GL-0002,,FALSE,FALSE,REF-741951,First Continental Bank,***7806,Globex EMEA Manufacturing Ltd.,IE,-5526444.41
10/03/2025,10/03/2025,Client Receipt - Novatek Components Ltd #13,Sales Receipt,CEM-EMEA,0,162476.05,EUR,SEPA SCT,Novatek Components Ltd #13,***7670,INV-202503-CEM-EMEA-0003,,FALSE,FALSE,REF-206198,First Continental Bank,***8080,Globex EMEA Manufacturing Ltd.,IE,-5363968.36
11/03/2025,11/03/2025,Supplier Payment - HyperCloud Infra #6,Supplier Payment,SaaS-GL,2057.41,0,EUR,SWIFT MT103,HyperCloud Infra #6,***2205,,PO-202503-SaaS-GL-0007,FALSE,FALSE,REF-814725,First Continental Bank,***7285,Globex EMEA Manufacturing Ltd.,IE,-5366025.77
11/03/2025,11/03/2025,Supplier Payment - ExpertNet Subcontractors #12,Supplier Payment,PS-GL,10360.87,0,EUR,SWIFT MT103,ExpertNet Subcontractors #12,***1964,,PO-202503-PS-GL-0002,FALSE,FALSE,REF-585044,First Continental Bank,***8256,Globex EMEA Manufacturing Ltd.,IE,-5376386.64
11/03/2025,11/03/2025,Client Receipt - CloudBridge Co. #42,Sales Receipt,SaaS-GL,0,14151.61,EUR,SEPA SCT Inst,CloudBridge Co. #42,***1102,INV-202503-SaaS-GL-0030,,FALSE,FALSE,REF-268536,First Continental Bank,***5443,Globex EMEA Manufacturing Ltd.,IE,-5362235.03
11/03/2025,11/03/2025,Client Receipt - CloudBridge Co. #60,Sales Receipt,SaaS-GL,0,18454.25,EUR,Card Settlement,CloudBridge Co. #60,***9581,INV-202503-SaaS-GL-0027,,FALSE,FALSE,REF-182472,First Continental Bank,***1834,Globex EMEA Manufacturing Ltd.,IE,-5343780.78
11/03/2025,11/03/2025,Client Receipt - CloudBridge Co. #38,Sales Receipt,SaaS-GL,0,39777.56,EUR,SEPA SCT,CloudBridge Co. #38,***4866,INV-202503-SaaS-GL-0026,,FALSE,FALSE,REF-547080,First Continental Bank,***4775,Globex EMEA Manufacturing Ltd.,IE,-5304003.22
11/03/2025,11/03/2025,Client Receipt - Aurora Electronics GmbH #2,Sales Receipt,CEM-EMEA,0,132428.58,EUR,SEPA SCT,Aurora Electronics GmbH #2,***9790,INV-202503-CEM-EMEA-0001,,FALSE,FALSE,REF-419095,First Continental Bank,***1253,Globex EMEA Manufacturing Ltd.,IE,-5171574.64
12/03/2025,12/03/2025,Supplier Payment - ExpertNet Subcontractors #6,Supplier Payment,PS-GL,4722.46,0,EUR,SWIFT MT103,ExpertNet Subcontractors #6,***6240,,PO-202503-PS-GL-0005,FALSE,FALSE,REF-840912,First Continental Bank,***2031,Globex EMEA Manufacturing Ltd.,IE,-5176297.1
12/03/2025,12/03/2025,"Intercompany Settlement - Globex International Holdings, Inc.",Intercompany Transfer,ALL,221423,0,EUR,Internal Transfer,"Globex International Holdings, Inc.",***9582,,,TRUE,TRUE,REF-660072,First Continental Bank,***7388,Globex EMEA Manufacturing Ltd.,IE,-5397720.1
12/03/2025,12/03/2025,"Intercompany Reimbursement - Globex International Holdings, Inc.",Intercompany Transfer,ALL,0,88569.2,EUR,Internal Transfer,"Globex International Holdings, Inc.",***6963,,,TRUE,TRUE,REF-590769,First Continental Bank,***1831,Globex EMEA Manufacturing Ltd.,IE,-5309150.9
13/03/2025,13/03/2025,Supplier Payment - ExpertNet Subcontractors #14,Supplier Payment,PS-GL,12839.83,0,EUR,SEPA Credit Transfer,ExpertNet Subcontractors #14,***3891,,PO-202503-PS-GL-0003,FALSE,FALSE,REF-799109,First Continental Bank,***2279,Globex EMEA Manufacturing Ltd.,IE,-5321990.73
13/03/2025,13/03/2025,Supplier Payment - EuroFab Assembly #19,Supplier Payment,CEM-EMEA,13145.38,0,EUR,SEPA Credit Transfer,EuroFab Assembly #19,***6513,,PO-202503-CEM-EMEA-0004,FALSE,FALSE,REF-308556,First Continental Bank,***4906,Globex EMEA Manufacturing Ltd.,IE,-5335136.11
13/03/2025,13/03/2025,Client Receipt - CloudBridge Co. #26,Sales Receipt,SaaS-GL,0,7112.16,EUR,SEPA SCT,CloudBridge Co. #26,***8459,INV-202503-SaaS-GL-0018,,FALSE,FALSE,REF-650131,First Continental Bank,***5788,Globex EMEA Manufacturing Ltd.,IE,-5328023.95
13/03/2025,13/03/2025,Client Receipt - CloudBridge Co. #24,Sales Receipt,SaaS-GL,0,16701.77,EUR,SEPA SCT,CloudBridge Co. #24,***3111,INV-202503-SaaS-GL-0028,,FALSE,FALSE,REF-659493,First Continental Bank,***8333,Globex EMEA Manufacturing Ltd.,IE,-5311322.18
13/03/2025,13/03/2025,Client Receipt - Novatek Components Ltd #2,Sales Receipt,CEM-EMEA,0,149672.43,EUR,SEPA SCT,Novatek Components Ltd #2,***5629,INV-202503-CEM-EMEA-0006,,FALSE,FALSE,REF-189770,First Continental Bank,***6176,Globex EMEA Manufacturing Ltd.,IE,-5161649.75
14/03/2025,14/03/2025,Supplier Payment - Stelliform Parts BV #9,Supplier Payment,CEM-EMEA,19358.2,0,EUR,SEPA Credit Transfer,Stelliform Parts BV #9,***6739,,PO-202503-CEM-EMEA-0008,FALSE,FALSE,REF-336926,First Continental Bank,***4163,Globex EMEA Manufacturing Ltd.,IE,-5181007.95
14/03/2025,14/03/2025,Client Receipt - CloudBridge Co. #2,Sales Receipt,SaaS-GL,0,8732.67,EUR,SEPA SCT,CloudBridge Co. #2,***7460,INV-202503-SaaS-GL-0024,,FALSE,FALSE,REF-675549,First Continental Bank,***2863,Globex EMEA Manufacturing Ltd.,IE,-5172275.28
14/03/2025,14/03/2025,Client Receipt - CloudBridge Co. #54,Sales Receipt,SaaS-GL,0,34217.79,EUR,SEPA SCT Inst,CloudBridge Co. #54,***9513,INV-202503-SaaS-GL-0025,,FALSE,FALSE,REF-984977,First Continental Bank,***6338,Globex EMEA Manufacturing Ltd.,IE,-5138057.49
14/03/2025,14/03/2025,Client Receipt - CloudBridge Co. #73,Sales Receipt,SaaS-GL,0,48944.58,EUR,SEPA SCT,CloudBridge Co. #73,***8899,INV-202503-SaaS-GL-0005,,FALSE,FALSE,REF-287731,First Continental Bank,***2805,Globex EMEA Manufacturing Ltd.,IE,-5089112.91
15/03/2025,15/03/2025,Loan Interest Payment,Loan Interest,ALL,85000,0,EUR,SEPA Debit,First Continental Bank - Corporate Lending,***9989,,,FALSE,FALSE,REF-500469,First Continental Bank,***3215,Globex EMEA Manufacturing Ltd.,IE,-5174112.91
15/03/2025,15/03/2025,Loan Principal Repayment,Loan Principal,ALL,500000,0,EUR,SWIFT MT103,First Continental Bank - Corporate Lending,***2730,,,FALSE,FALSE,REF-442508,First Continental Bank,***6245,Globex EMEA Manufacturing Ltd.,IE,-5674112.91
16/03/2025,16/03/2025,Merchant Processing Fees,Bank/Merchant Fees,ALL,4281.5,0,EUR,SWIFT MT103,First Continental Bank,***7683,,,FALSE,FALSE,REF-297491,First Continental Bank,***4492,Globex EMEA Manufacturing Ltd.,IE,-5678394.41
17/03/2025,17/03/2025,Merchant Processing Fees,Bank/Merchant Fees,ALL,1606.06,0,EUR,SEPA Credit Transfer,First Continental Bank,***2970,,,FALSE,FALSE,REF-463908,First Continental Bank,***1367,Globex EMEA Manufacturing Ltd.,IE,-5680000.47
17/03/2025,17/03/2025,Supplier Payment - EuroFab Assembly #11,Supplier Payment,CEM-EMEA,3093.91,0,EUR,SEPA Debit,EuroFab Assembly #11,***8310,,PO-202503-CEM-EMEA-0007,FALSE,FALSE,REF-694784,First Continental Bank,***3652,Globex EMEA Manufacturing Ltd.,IE,-5683094.38
17/03/2025,17/03/2025,Client Receipt - CloudBridge Co. #5,Sales Receipt,SaaS-GL,0,241.92,EUR,SEPA SCT,CloudBridge Co. #5,***6882,INV-202503-SaaS-GL-0023,,FALSE,FALSE,REF-341566,First Continental Bank,***1052,Globex EMEA Manufacturing Ltd.,IE,-5682852.46
17/03/2025,17/03/2025,Client Receipt - Aurora Electronics GmbH #9,Sales Receipt,CEM-EMEA,0,6823.82,EUR,Card Settlement,Aurora Electronics GmbH #9,***4723,INV-202503-CEM-EMEA-0008,,FALSE,FALSE,REF-741664,First Continental Bank,***2135,Globex EMEA Manufacturing Ltd.,IE,-5676028.64
17/03/2025,17/03/2025,Client Receipt - CloudBridge Co. #38,Sales Receipt,SaaS-GL,0,7089.28,EUR,SEPA SCT,CloudBridge Co. #38,***8282,INV-202503-SaaS-GL-0003,,FALSE,FALSE,REF-532307,First Continental Bank,***6571,Globex EMEA Manufacturing Ltd.,IE,-5668939.36
17/03/2025,17/03/2025,Client Receipt - CloudBridge Co. #26,Sales Receipt,SaaS-GL,0,19188.4,EUR,Card Settlement,CloudBridge Co. #26,***9621,INV-202503-SaaS-GL-0002,,FALSE,FALSE,REF-876786,First Continental Bank,***4525,Globex EMEA Manufacturing Ltd.,IE,-5649750.96
17/03/2025,17/03/2025,Client Receipt - Aurora Electronics GmbH #15,Sales Receipt,CEM-EMEA,0,47922.16,EUR,SEPA SCT Inst,Aurora Electronics GmbH #15,***6270,INV-202503-CEM-EMEA-0012,,FALSE,FALSE,REF-173134,First Continental Bank,***9177,Globex EMEA Manufacturing Ltd.,IE,-5601828.8
18/03/2025,18/03/2025,Supplier Payment - Stelliform Parts BV #28,Supplier Payment,CEM-EMEA,49506.62,0,EUR,SEPA Debit,Stelliform Parts BV #28,***4876,,PO-202503-CEM-EMEA-0001,FALSE,FALSE,REF-209552,First Continental Bank,***7183,Globex EMEA Manufacturing Ltd.,IE,-5651335.42
18/03/2025,18/03/2025,VAT/GST Remittance - Revenue Ireland,Tax Payment,ALL,112750.69,0,EUR,SWIFT MT103,Revenue Ireland,***3407,,,FALSE,FALSE,REF-436871,First Continental Bank,***4990,Globex EMEA Manufacturing Ltd.,IE,-5764086.11
18/03/2025,18/03/2025,Client Receipt - CloudBridge Co. #18,Sales Receipt,SaaS-GL,0,7729.71,EUR,Card Settlement,CloudBridge Co. #18,***9426,INV-202503-SaaS-GL-0010,,FALSE,FALSE,REF-972567,First Continental Bank,***5964,Globex EMEA Manufacturing Ltd.,IE,-5756356.4
19/03/2025,19/03/2025,Client Receipt - Aurora Electronics GmbH #12,Sales Receipt,CEM-EMEA,0,5522.42,EUR,SEPA SCT Inst,Aurora Electronics GmbH #12,***7695,INV-202503-CEM-EMEA-0002,,FALSE,FALSE,REF-377738,First Continental Bank,***2343,Globex EMEA Manufacturing Ltd.,IE,-5750833.98
19/03/2025,19/03/2025,Client Receipt - CloudBridge Co. #22,Sales Receipt,SaaS-GL,0,12554.79,EUR,Card Settlement,CloudBridge Co. #22,***6982,INV-202503-SaaS-GL-0032,,FALSE,FALSE,REF-605729,First Continental Bank,***8313,Globex EMEA Manufacturing Ltd.,IE,-5738279.19
19/03/2025,19/03/2025,Client Receipt - CloudBridge Co. #43,Sales Receipt,SaaS-GL,0,29351.36,EUR,SEPA SCT Inst,CloudBridge Co. #43,***1305,INV-202503-SaaS-GL-0017,,FALSE,FALSE,REF-475213,First Continental Bank,***5466,Globex EMEA Manufacturing Ltd.,IE,-5708927.83
20/03/2025,20/03/2025,Supplier Payment - HyperCloud Infra #18,Supplier Payment,SaaS-GL,85.52,0,EUR,SEPA Debit,HyperCloud Infra #18,***3782,,PO-202503-SaaS-GL-0004,FALSE,FALSE,REF-422378,First Continental Bank,***3869,Globex EMEA Manufacturing Ltd.,IE,-5709013.35
20/03/2025,20/03/2025,Supplier Payment - CodeCraft Contractors #1,Supplier Payment,SaaS-GL,5189.14,0,EUR,SEPA Debit,CodeCraft Contractors #1,***4101,,PO-202503-SaaS-GL-0006,FALSE,FALSE,REF-633563,First Continental Bank,***1122,Globex EMEA Manufacturing Ltd.,IE,-5714202.49
20/03/2025,20/03/2025,Supplier Payment - HyperCloud Infra #8,Supplier Payment,SaaS-GL,22922.08,0,EUR,SEPA Credit Transfer,HyperCloud Infra #8,***6436,,PO-202503-SaaS-GL-0008,FALSE,FALSE,REF-933854,First Continental Bank,***7276,Globex EMEA Manufacturing Ltd.,IE,-5737124.57
20/03/2025,20/03/2025,Client Receipt - CloudBridge Co. #28,Sales Receipt,SaaS-GL,0,19345.54,EUR,Card Settlement,CloudBridge Co. #28,***3899,INV-202503-SaaS-GL-0012,,FALSE,FALSE,REF-671467,First Continental Bank,***1387,Globex EMEA Manufacturing Ltd.,IE,-5717779.03
20/03/2025,20/03/2025,Client Receipt - Vertex Advisory Client #41,Sales Receipt,PS-GL,0,35856.15,EUR,SEPA SCT Inst,Vertex Advisory Client #41,***4335,INV-202503-PS-GL-0001,,FALSE,FALSE,REF-823767,First Continental Bank,***4848,Globex EMEA Manufacturing Ltd.,IE,-5681922.88
20/03/2025,20/03/2025,Client Receipt - Aurora Electronics GmbH #2,Sales Receipt,CEM-EMEA,0,42610.51,EUR,Card Settlement,Aurora Electronics GmbH #2,***4593,INV-202503-CEM-EMEA-0011,,FALSE,FALSE,REF-167728,First Continental Bank,***5279,Globex EMEA Manufacturing Ltd.,IE,-5639312.37
20/03/2025,20/03/2025,Client Receipt - Vertex Advisory Client #50,Sales Receipt,PS-GL,0,61148.22,EUR,SEPA SCT Inst,Vertex Advisory Client #50,***9325,INV-202503-PS-GL-0003,,FALSE,FALSE,REF-923026,First Continental Bank,***6085,Globex EMEA Manufacturing Ltd.,IE,-5578164.15
21/03/2025,21/03/2025,Client Receipt - CloudBridge Co. #61,Sales Receipt,SaaS-GL,0,8355.29,EUR,SEPA SCT,CloudBridge Co. #61,***5402,INV-202503-SaaS-GL-0007,,FALSE,FALSE,REF-203771,First Continental Bank,***8196,Globex EMEA Manufacturing Ltd.,IE,-5569808.86
21/03/2025,21/03/2025,Client Receipt - CloudBridge Co. #61,Sales Receipt,SaaS-GL,0,42159.02,EUR,SEPA SCT Inst,CloudBridge Co. #61,***2970,INV-202503-SaaS-GL-0014,,FALSE,FALSE,REF-355797,First Continental Bank,***4628,Globex EMEA Manufacturing Ltd.,IE,-5527649.84
21/03/2025,21/03/2025,Client Receipt - Aurora Electronics GmbH #11,Sales Receipt,CEM-EMEA,0,48736.67,EUR,SEPA SCT,Aurora Electronics GmbH #11,***8462,INV-202503-CEM-EMEA-0009,,FALSE,FALSE,REF-591705,First Continental Bank,***4550,Globex EMEA Manufacturing Ltd.,IE,-5478913.17
22/03/2025,22/03/2025,Client Receipt - Vertex Advisory Client #10,Sales Receipt,PS-GL,0,70593.98,EUR,Card Settlement,Vertex Advisory Client #10,***9667,INV-202503-PS-GL-0005,,FALSE,FALSE,REF-918742,First Continental Bank,***2871,Globex EMEA Manufacturing Ltd.,IE,-5408319.19
24/03/2025,24/03/2025,Supplier Payment - ExpertNet Subcontractors #18,Supplier Payment,PS-GL,6520.79,0,EUR,SWIFT MT103,ExpertNet Subcontractors #18,***6642,,PO-202503-PS-GL-0008,FALSE,FALSE,REF-139669,First Continental Bank,***6095,Globex EMEA Manufacturing Ltd.,IE,-5414839.98
24/03/2025,24/03/2025,Supplier Payment - HyperCloud Infra #19,Supplier Payment,SaaS-GL,28333.64,0,EUR,SEPA Credit Transfer,HyperCloud Infra #19,***3913,,PO-202503-SaaS-GL-0001,FALSE,FALSE,REF-108059,First Continental Bank,***5399,Globex EMEA Manufacturing Ltd.,IE,-5443173.62
24/03/2025,24/03/2025,Client Receipt - CloudBridge Co. #78,Sales Receipt,SaaS-GL,0,25538.93,EUR,SEPA SCT Inst,CloudBridge Co. #78,***9386,INV-202503-SaaS-GL-0031,,FALSE,FALSE,REF-783922,First Continental Bank,***1444,Globex EMEA Manufacturing Ltd.,IE,-5417634.69
26/03/2025,26/03/2025,Supplier Payment - HyperCloud Infra #14,Supplier Payment,SaaS-GL,1073.89,0,EUR,SEPA Credit Transfer,HyperCloud Infra #14,***4237,,PO-202503-SaaS-GL-0003,FALSE,FALSE,REF-223741,First Continental Bank,***8710,Globex EMEA Manufacturing Ltd.,IE,-5418708.58
26/03/2025,26/03/2025,Supplier Payment - ExpertNet Subcontractors #13,Supplier Payment,PS-GL,1460.81,0,EUR,SWIFT MT103,ExpertNet Subcontractors #13,***2541,,PO-202503-PS-GL-0011,FALSE,FALSE,REF-767359,First Continental Bank,***7467,Globex EMEA Manufacturing Ltd.,IE,-5420169.39
26/03/2025,26/03/2025,Supplier Payment - Stelliform Parts BV #27,Supplier Payment,CEM-EMEA,2435.9,0,EUR,SEPA Debit,Stelliform Parts BV #27,***4144,,PO-202503-CEM-EMEA-0005,FALSE,FALSE,REF-591270,First Continental Bank,***5433,Globex EMEA Manufacturing Ltd.,IE,-5422605.29
26/03/2025,26/03/2025,Supplier Payment - HyperCloud Infra #17,Supplier Payment,SaaS-GL,8862.21,0,EUR,SEPA Credit Transfer,HyperCloud Infra #17,***2525,,PO-202503-SaaS-GL-0009,FALSE,FALSE,REF-745041,First Continental Bank,***5894,Globex EMEA Manufacturing Ltd.,IE,-5431467.5
26/03/2025,26/03/2025,Payroll - GlobalPay Services Ltd,Payroll,ALL,156611.14,0,EUR,SEPA Debit,GlobalPay Services Ltd,***9801,,,FALSE,FALSE,REF-607953,First Continental Bank,***9751,Globex EMEA Manufacturing Ltd.,IE,-5588078.64
26/03/2025,26/03/2025,Intercompany Settlement - Globex Consulting UK Ltd.,Intercompany Transfer,ALL,821492,0,EUR,Internal Transfer,Globex Consulting UK Ltd.,***8638,,,TRUE,TRUE,REF-146415,First Continental Bank,***8172,Globex EMEA Manufacturing Ltd.,IE,-6409570.64
26/03/2025,26/03/2025,Intercompany Reimbursement - Globex Consulting UK Ltd.,Intercompany Transfer,ALL,0,328596.8,EUR,Internal Transfer,Globex Consulting UK Ltd.,***2648,,,TRUE,TRUE,REF-542177,First Continental Bank,***3390,Globex EMEA Manufacturing Ltd.,IE,-6080973.84
27/03/2025,27/03/2025,Supplier Payment - ExpertNet Subcontractors #9,Supplier Payment,PS-GL,11472.19,0,EUR,SEPA Credit Transfer,ExpertNet Subcontractors #9,***9505,,PO-202503-PS-GL-0009,FALSE,FALSE,REF-365249,First Continental Bank,***4065,Globex EMEA Manufacturing Ltd.,IE,-6092446.03
27/03/2025,27/03/2025,Supplier Payment - Stelliform Parts BV #22,Supplier Payment,CEM-EMEA,22769,0,EUR,SWIFT MT103,Stelliform Parts BV #22,***2712,,PO-202503-CEM-EMEA-0003,FALSE,FALSE,REF-508054,First Continental Bank,***2644,Globex EMEA Manufacturing Ltd.,IE,-6115215.03
27/03/2025,27/03/2025,Payroll - GlobalPay Services Ltd,Payroll,ALL,156611.14,0,EUR,SEPA Debit,GlobalPay Services Ltd,***6375,,,FALSE,FALSE,REF-618016,First Continental Bank,***2177,Globex EMEA Manufacturing Ltd.,IE,-6271826.17
27/03/2025,27/03/2025,Client Receipt - CloudBridge Co. #75,Sales Receipt,SaaS-GL,0,2204.55,EUR,SEPA SCT,CloudBridge Co. #75,***9265,INV-202503-SaaS-GL-0020,,FALSE,FALSE,REF-457003,First Continental Bank,***6759,Globex EMEA Manufacturing Ltd.,IE,-6269621.62
28/03/2025,28/03/2025,Supplier Payment - ExpertNet Subcontractors #17,Supplier Payment,PS-GL,23264.04,0,EUR,SWIFT MT103,ExpertNet Subcontractors #17,***4228,,PO-202503-PS-GL-0010,FALSE,FALSE,REF-727154,First Continental Bank,***5550,Globex EMEA Manufacturing Ltd.,IE,-6292885.66
28/03/2025,28/03/2025,Supplier Payment - Stelliform Parts BV #16,Supplier Payment,CEM-EMEA,28367.01,0,EUR,SWIFT MT103,Stelliform Parts BV #16,***7668,,PO-202503-CEM-EMEA-0006,FALSE,FALSE,REF-747739,First Continental Bank,***9150,Globex EMEA Manufacturing Ltd.,IE,-6321252.67
29/03/2025,29/03/2025,Supplier Payment - ExpertNet Subcontractors #15,Supplier Payment,PS-GL,22002.34,0,EUR,SWIFT MT103,ExpertNet Subcontractors #15,***6900,,PO-202503-PS-GL-0004,FALSE,FALSE,REF-268704,First Continental Bank,***7635,Globex EMEA Manufacturing Ltd.,IE,-6343255.01
30/03/2025,30/03/2025,Supplier Payment - CodeCraft Contractors #1,Supplier Payment,SaaS-GL,3770.17,0,EUR,SEPA Credit Transfer,CodeCraft Contractors #1,***3919,,PO-202503-SaaS-GL-0002,FALSE,FALSE,REF-802859,First Continental Bank,***1488,Globex EMEA Manufacturing Ltd.,IE,-6347025.18
30/03/2025,30/03/2025,Supplier Payment - HyperCloud Infra #5,Supplier Payment,SaaS-GL,14318.81,0,EUR,SEPA Debit,HyperCloud Infra #5,***4049,,PO-202503-SaaS-GL-0012,FALSE,FALSE,REF-260822,First Continental Bank,***3098,Globex EMEA Manufacturing Ltd.,IE,-6361343.99
30/03/2025,30/03/2025,Interest Earned,Interest Income,ALL,0,11726.71,EUR,Card Settlement,First Continental Bank,***4495,,,FALSE,FALSE,REF-498983,First Continental Bank,***3025,Globex EMEA Manufacturing Ltd.,IE,-6349617.28
30/03/2025,30/03/2025,Client Receipt - Vertex Advisory Client #30,Sales Receipt,PS-GL,0,44427.69,EUR,SEPA SCT Inst,Vertex Advisory Client #30,***8706,INV-202503-PS-GL-0008,,FALSE,FALSE,REF-994068,First Continental Bank,***4307,Globex EMEA Manufacturing Ltd.,IE,-6305189.59
31/03/2025,31/03/2025,Supplier Payment - CodeCraft Contractors #1,Supplier Payment,SaaS-GL,5082.82,0,EUR,SEPA Credit Transfer,CodeCraft Contractors #1,***7509,,PO-202503-SaaS-GL-0010,FALSE,FALSE,REF-455184,First Continental Bank,***5308,Globex EMEA Manufacturing Ltd.,IE,-6310272.41
31/03/2025,31/03/2025,Supplier Payment - Stelliform Parts BV #24,Supplier Payment,CEM-EMEA,57009.62,0,EUR,SEPA Credit Transfer,Stelliform Parts BV #24,***6310,,PO-202503-CEM-EMEA-0009,FALSE,FALSE,REF-719091,First Continental Bank,***9959,Globex EMEA Manufacturing Ltd.,IE,-6367282.03
31/03/2025,31/03/2025,Client Receipt - CloudBridge Co. #59,Sales Receipt,SaaS-GL,0,11790.21,EUR,SEPA SCT,CloudBridge Co. #59,***7893,INV-202503-SaaS-GL-0015,,FALSE,FALSE,REF-788288,First Continental Bank,***1533,Globex EMEA Manufacturing Ltd.,IE,-6355491.82
31/03/2025,31/03/2025,Client Receipt - Aurora Electronics GmbH #6,Sales Receipt,CEM-EMEA,0,23985.03,EUR,SEPA SCT,Aurora Electronics GmbH #6,***9675,INV-202503-CEM-EMEA-0010,,FALSE,FALSE,REF-974333,First Continental Bank,***8012,Globex EMEA Manufacturing Ltd.,IE,-6331506.79
31/03/2025,31/03/2025,Client Receipt - CloudBridge Co. #24,Sales Receipt,SaaS-GL,0,45417.29,EUR,Card Settlement,CloudBridge Co. #24,***7403,INV-202503-SaaS-GL-0029,,FALSE,FALSE,REF-277205,First Continental Bank,***8759,Globex EMEA Manufacturing Ltd.,IE,-6286089.5
01/04/2025,01/04/2025,Account Maintenance Fee,Bank/Merchant Fees,ALL,2500,0,EUR,SWIFT MT103,First Continental Bank,***5789,,,FALSE,FALSE,REF-928517,First Continental Bank,***4225,Globex EMEA Manufacturing Ltd.,IE,-6288589.5
01/04/2025,01/04/2025,Client Receipt - Vertex Advisory Client #50,Sales Receipt,PS-GL,0,1775.46,EUR,SEPA SCT Inst,Vertex Advisory Client #50,***8166,INV-202504-PS-GL-0010,,FALSE,FALSE,REF-936402,First Continental Bank,***7048,Globex EMEA Manufacturing Ltd.,IE,-6286814.04
01/04/2025,01/04/2025,Client Receipt - CloudBridge Co. #73,Sales Receipt,SaaS-GL,0,5460.81,EUR,SEPA SCT Inst,CloudBridge Co. #73,***3410,INV-202504-SaaS-GL-0029,,FALSE,FALSE,REF-487835,First Continental Bank,***1511,Globex EMEA Manufacturing Ltd.,IE,-6281353.23
01/04/2025,01/04/2025,Client Receipt - Vertex Advisory Client #7,Sales Receipt,PS-GL,0,5638.55,EUR,SEPA SCT,Vertex Advisory Client #7,***4608,INV-202504-PS-GL-0006,,FALSE,FALSE,REF-130732,First Continental Bank,***2973,Globex EMEA Manufacturing Ltd.,IE,-6275714.68
01/04/2025,01/04/2025,Client Receipt - CloudBridge Co. #15,Sales Receipt,SaaS-GL,0,8723.59,EUR,SEPA SCT Inst,CloudBridge Co. #15,***2625,INV-202504-SaaS-GL-0030,,FALSE,FALSE,REF-682848,First Continental Bank,***9990,Globex EMEA Manufacturing Ltd.,IE,-6266991.09
01/04/2025,01/04/2025,Client Receipt - Aurora Electronics GmbH #13,Sales Receipt,CEM-EMEA,0,35425.2,EUR,Card Settlement,Aurora Electronics GmbH #13,***3492,INV-202504-CEM-EMEA-0001,,FALSE,FALSE,REF-223897,First Continental Bank,***9176,Globex EMEA Manufacturing Ltd.,IE,-6231565.89
01/04/2025,01/04/2025,Client Receipt - Vertex Advisory Client #31,Sales Receipt,PS-GL,0,54665.14,EUR,Card Settlement,Vertex Advisory Client #31,***2516,INV-202504-PS-GL-0011,,FALSE,FALSE,REF-615038,First Continental Bank,***6635,Globex EMEA Manufacturing Ltd.,IE,-6176900.75
02/04/2025,02/04/2025,Supplier Payment - EuroFab Assembly #13,Supplier Payment,CEM-EMEA,20394.64,0,EUR,SWIFT MT103,EuroFab Assembly #13,***9921,,PO-202504-CEM-EMEA-0009,FALSE,FALSE,REF-413726,First Continental Bank,***8988,Globex EMEA Manufacturing Ltd.,IE,-6197295.39
02/04/2025,02/04/2025,Supplier Payment - Stelliform Parts BV #12,Supplier Payment,CEM-EMEA,86660.56,0,EUR,SWIFT MT103,Stelliform Parts BV #12,***2787,,PO-202504-CEM-EMEA-0011,FALSE,FALSE,REF-294617,First Continental Bank,***9155,Globex EMEA Manufacturing Ltd.,IE,-6283955.95
02/04/2025,02/04/2025,Client Receipt - CloudBridge Co. #24,Sales Receipt,SaaS-GL,0,25467.55,EUR,Card Settlement,CloudBridge Co. #24,***7151,INV-202504-SaaS-GL-0032,,FALSE,FALSE,REF-913459,First Continental Bank,***2242,Globex EMEA Manufacturing Ltd.,IE,-6258488.4
02/04/2025,02/04/2025,Client Receipt - Novatek Components Ltd #2,Sales Receipt,CEM-EMEA,0,65950.4,EUR,Card Settlement,Novatek Components Ltd #2,***9209,INV-202504-CEM-EMEA-0006,,FALSE,FALSE,REF-929017,First Continental Bank,***5305,Globex EMEA Manufacturing Ltd.,IE,-6192538
03/04/2025,03/04/2025,Supplier Payment - HyperCloud Infra #10,Supplier Payment,SaaS-GL,4345.66,0,EUR,SEPA Debit,HyperCloud Infra #10,***1168,,PO-202504-SaaS-GL-0007,FALSE,FALSE,REF-568574,First Continental Bank,***2316,Globex EMEA Manufacturing Ltd.,IE,-6196883.66
03/04/2025,03/04/2025,Supplier Payment - CodeCraft Contractors #5,Supplier Payment,SaaS-GL,12627.51,0,EUR,SEPA Debit,CodeCraft Contractors #5,***5209,,PO-202504-SaaS-GL-0009,FALSE,FALSE,REF-818608,First Continental Bank,***3412,Globex EMEA Manufacturing Ltd.,IE,-6209511.17
03/04/2025,03/04/2025,Client Receipt - CloudBridge Co. #41,Sales Receipt,SaaS-GL,0,22509.53,EUR,Card Settlement,CloudBridge Co. #41,***4610,INV-202504-SaaS-GL-0019,,FALSE,FALSE,REF-784528,First Continental Bank,***3125,Globex EMEA Manufacturing Ltd.,IE,-6187001.64
03/04/2025,03/04/2025,Client Receipt - Novatek Components Ltd #1,Sales Receipt,CEM-EMEA,0,40675.4,EUR,Card Settlement,Novatek Components Ltd #1,***2950,INV-202504-CEM-EMEA-0015,,FALSE,FALSE,REF-893394,First Continental Bank,***5980,Globex EMEA Manufacturing Ltd.,IE,-6146326.24
04/04/2025,04/04/2025,Supplier Payment - HyperCloud Infra #16,Supplier Payment,SaaS-GL,2146.15,0,EUR,SWIFT MT103,HyperCloud Infra #16,***3921,,PO-202504-SaaS-GL-0001,FALSE,FALSE,REF-523295,First Continental Bank,***3280,Globex EMEA Manufacturing Ltd.,IE,-6148472.39
04/04/2025,04/04/2025,Supplier Payment - HyperCloud Infra #1,Supplier Payment,SaaS-GL,2511.6,0,EUR,SWIFT MT103,HyperCloud Infra #1,***6143,,PO-202504-SaaS-GL-0004,FALSE,FALSE,REF-759635,First Continental Bank,***9774,Globex EMEA Manufacturing Ltd.,IE,-6150983.99
04/04/2025,04/04/2025,Merchant Processing Fees,Bank/Merchant Fees,ALL,3878.27,0,EUR,SWIFT MT103,First Continental Bank,***6110,,,FALSE,FALSE,REF-351487,First Continental Bank,***4410,Globex EMEA Manufacturing Ltd.,IE,-6154862.26
04/04/2025,04/04/2025,Supplier Payment - CodeCraft Contractors #5,Supplier Payment,SaaS-GL,44626.6,0,EUR,SEPA Credit Transfer,CodeCraft Contractors #5,***4801,,PO-202504-SaaS-GL-0003,FALSE,FALSE,REF-564801,First Continental Bank,***7979,Globex EMEA Manufacturing Ltd.,IE,-6199488.86
04/04/2025,04/04/2025,Client Receipt - CloudBridge Co. #61,Sales Receipt,SaaS-GL,0,21998.4,EUR,SEPA SCT,CloudBridge Co. #61,***9033,INV-202504-SaaS-GL-0007,,FALSE,FALSE,REF-991760,First Continental Bank,***1222,Globex EMEA Manufacturing Ltd.,IE,-6177490.46
05/04/2025,05/04/2025,Metro Water & Waste,Rent & Utilities,ALL,16038.81,0,EUR,SEPA Credit Transfer,Metro Water & Waste,***5319,,,FALSE,FALSE,REF-779728,First Continental Bank,***1863,Globex EMEA Manufacturing Ltd.,IE,-6193529.27
05/04/2025,05/04/2025,Supplier Payment - EuroFab Assembly #17,Supplier Payment,CEM-EMEA,40289.24,0,EUR,SEPA Debit,EuroFab Assembly #17,***2379,,PO-202504-CEM-EMEA-0008,FALSE,FALSE,REF-880282,First Continental Bank,***8191,Globex EMEA Manufacturing Ltd.,IE,-6233818.51
06/04/2025,06/04/2025,Client Receipt - CloudBridge Co. #64,Sales Receipt,SaaS-GL,0,4455.02,EUR,SEPA SCT,CloudBridge Co. #64,***4187,INV-202504-SaaS-GL-0010,,FALSE,FALSE,REF-123232,First Continental Bank,***8324,Globex EMEA Manufacturing Ltd.,IE,-6229363.49
06/04/2025,06/04/2025,Client Receipt - CloudBridge Co. #50,Sales Receipt,SaaS-GL,0,7670.71,EUR,SEPA SCT Inst,CloudBridge Co. #50,***6545,INV-202504-SaaS-GL-0008,,FALSE,FALSE,REF-351415,First Continental Bank,***1041,Globex EMEA Manufacturing Ltd.,IE,-6221692.78
07/04/2025,07/04/2025,Supplier Payment - ExpertNet Subcontractors #13,Supplier Payment,PS-GL,17409.34,0,EUR,SWIFT MT103,ExpertNet Subcontractors #13,***8033,,PO-202504-PS-GL-0001,FALSE,FALSE,REF-949710,First Continental Bank,***2718,Globex EMEA Manufacturing Ltd.,IE,-6239102.12
07/04/2025,07/04/2025,Supplier Payment - ExpertNet Subcontractors #19,Supplier Payment,PS-GL,30762.18,0,EUR,SEPA Debit,ExpertNet Subcontractors #19,***2444,,PO-202504-PS-GL-0007,FALSE,FALSE,REF-400199,First Continental Bank,***9199,Globex EMEA Manufacturing Ltd.,IE,-6269864.3
07/04/2025,07/04/2025,Supplier Payment - HyperCloud Infra #12,Supplier Payment,SaaS-GL,30772.31,0,EUR,SEPA Debit,HyperCloud Infra #12,***7160,,PO-202504-SaaS-GL-0008,FALSE,FALSE,REF-996973,First Continental Bank,***1512,Globex EMEA Manufacturing Ltd.,IE,-6300636.61
07/04/2025,07/04/2025,Client Receipt - CloudBridge Co. #51,Sales Receipt,SaaS-GL,0,25070.13,EUR,Card Settlement,CloudBridge Co. #51,***5040,INV-202504-SaaS-GL-0017,,FALSE,FALSE,REF-906391,First Continental Bank,***7701,Globex EMEA Manufacturing Ltd.,IE,-6275566.48
07/04/2025,07/04/2025,Client Receipt - Novatek Components Ltd #8,Sales Receipt,CEM-EMEA,0,67857.32,EUR,SEPA SCT Inst,Novatek Components Ltd #8,***3257,INV-202504-CEM-EMEA-0016,,FALSE,FALSE,REF-138036,First Continental Bank,***8992,Globex EMEA Manufacturing Ltd.,IE,-6207709.16
07/04/2025,07/04/2025,Client Receipt - Aurora Electronics GmbH #12,Sales Receipt,CEM-EMEA,0,83041.03,EUR,SEPA SCT Inst,Aurora Electronics GmbH #12,***8035,INV-202504-CEM-EMEA-0003,,FALSE,FALSE,REF-355593,First Continental Bank,***2314,Globex EMEA Manufacturing Ltd.,IE,-6124668.13
08/04/2025,08/04/2025,Supplier Payment - ExpertNet Subcontractors #12,Supplier Payment,PS-GL,2423.85,0,EUR,SWIFT MT103,ExpertNet Subcontractors #12,***4400,,PO-202504-PS-GL-0010,FALSE,FALSE,REF-376155,First Continental Bank,***8131,Globex EMEA Manufacturing Ltd.,IE,-6127091.98
08/04/2025,08/04/2025,Supplier Payment - EuroFab Assembly #19,Supplier Payment,CEM-EMEA,15912.13,0,EUR,SWIFT MT103,EuroFab Assembly #19,***6699,,PO-202504-CEM-EMEA-0007,FALSE,FALSE,REF-651656,First Continental Bank,***1145,Globex EMEA Manufacturing Ltd.,IE,-6143004.11
08/04/2025,08/04/2025,Client Receipt - CloudBridge Co. #13,Sales Receipt,SaaS-GL,0,15760.13,EUR,SEPA SCT Inst,CloudBridge Co. #13,***3765,INV-202504-SaaS-GL-0031,,FALSE,FALSE,REF-752256,First Continental Bank,***8577,Globex EMEA Manufacturing Ltd.,IE,-6127243.98
08/04/2025,08/04/2025,Client Receipt - Vertex Advisory Client #40,Sales Receipt,PS-GL,0,15820.95,EUR,SEPA SCT,Vertex Advisory Client #40,***5012,INV-202504-PS-GL-0003,,FALSE,FALSE,REF-441164,First Continental Bank,***8202,Globex EMEA Manufacturing Ltd.,IE,-6111423.03
09/04/2025,09/04/2025,Supplier Payment - EuroFab Assembly #19,Supplier Payment,CEM-EMEA,20308.04,0,EUR,SWIFT MT103,EuroFab Assembly #19,***5816,,PO-202504-CEM-EMEA-0001,FALSE,FALSE,REF-836754,First Continental Bank,***9190,Globex EMEA Manufacturing Ltd.,IE,-6131731.07
09/04/2025,09/04/2025,Client Receipt - CloudBridge Co. #37,Sales Receipt,SaaS-GL,0,9917.3,EUR,SEPA SCT Inst,CloudBridge Co. #37,***3510,INV-202504-SaaS-GL-0023,,FALSE,FALSE,REF-546148,First Continental Bank,***3754,Globex EMEA Manufacturing Ltd.,IE,-6121813.77
09/04/2025,09/04/2025,Client Receipt - CloudBridge Co. #61,Sales Receipt,SaaS-GL,0,29094.87,EUR,Card Settlement,CloudBridge Co. #61,***8463,INV-202504-SaaS-GL-0013,,FALSE,FALSE,REF-795231,First Continental Bank,***4678,Globex EMEA Manufacturing Ltd.,IE,-6092718.9
09/04/2025,09/04/2025,Client Receipt - CloudBridge Co. #64,Sales Receipt,SaaS-GL,0,66455.08,EUR,Card Settlement,CloudBridge Co. #64,***2316,INV-202504-SaaS-GL-0025,,FALSE,FALSE,REF-173860,First Continental Bank,***4720,Globex EMEA Manufacturing Ltd.,IE,-6026263.82
10/04/2025,10/04/2025,Supplier Payment - ExpertNet Subcontractors #9,Supplier Payment,PS-GL,1172.71,0,EUR,SEPA Debit,ExpertNet Subcontractors #9,***6166,,PO-202504-PS-GL-0003,FALSE,FALSE,REF-392541,First Continental Bank,***2423,Globex EMEA Manufacturing Ltd.,IE,-6027436.53
10/04/2025,10/04/2025,Supplier Payment - EuroFab Assembly #10,Supplier Payment,CEM-EMEA,9238.23,0,EUR,SEPA Debit,EuroFab Assembly #10,***6895,,PO-202504-CEM-EMEA-0003,FALSE,FALSE,REF-393690,First Continental Bank,***3316,Globex EMEA Manufacturing Ltd.,IE,-6036674.76
10/04/2025,10/04/2025,Client Receipt - CloudBridge Co. #60,Sales Receipt,SaaS-GL,0,5199.25,EUR,SEPA SCT Inst,CloudBridge Co. #60,***9695,INV-202504-SaaS-GL-0011,,FALSE,FALSE,REF-822618,First Continental Bank,***8445,Globex EMEA Manufacturing Ltd.,IE,-6031475.51
10/04/2025,10/04/2025,Client Receipt - Vertex Advisory Client #32,Sales Receipt,PS-GL,0,27905.33,EUR,SEPA SCT,Vertex Advisory Client #32,***6665,INV-202504-PS-GL-0007,,FALSE,FALSE,REF-659289,First Continental Bank,***8832,Globex EMEA Manufacturing Ltd.,IE,-6003570.18
11/04/2025,11/04/2025,Supplier Payment - ExpertNet Subcontractors #11,Supplier Payment,PS-GL,7485.42,0,EUR,SEPA Debit,ExpertNet Subcontractors #11,***2871,,PO-202504-PS-GL-0009,FALSE,FALSE,REF-219592,First Continental Bank,***3884,Globex EMEA Manufacturing Ltd.,IE,-6011055.6
11/04/2025,11/04/2025,Client Receipt - Aurora Electronics GmbH #5,Sales Receipt,CEM-EMEA,0,26611.81,EUR,SEPA SCT,Aurora Electronics GmbH #5,***2466,INV-202504-CEM-EMEA-0013,,FALSE,FALSE,REF-111404,First Continental Bank,***5389,Globex EMEA Manufacturing Ltd.,IE,-5984443.79
12/04/2025,12/04/2025,"Intercompany Settlement - Globex International Holdings, Inc.",Intercompany Transfer,ALL,696734,0,EUR,Internal Transfer,"Globex International Holdings, Inc.",***9086,,,TRUE,TRUE,REF-308886,First Continental Bank,***1835,Globex EMEA Manufacturing Ltd.,IE,-6681177.79
12/04/2025,12/04/2025,Client Receipt - CloudBridge Co. #2,Sales Receipt,SaaS-GL,0,22676.13,EUR,Card Settlement,CloudBridge Co. #2,***3584,INV-202504-SaaS-GL-0022,,FALSE,FALSE,REF-172320,First Continental Bank,***1928,Globex EMEA Manufacturing Ltd.,IE,-6658501.66
14/04/2025,14/04/2025,Supplier Payment - ExpertNet Subcontractors #2,Supplier Payment,PS-GL,5784.38,0,EUR,SEPA Credit Transfer,ExpertNet Subcontractors #2,***4363,,PO-202504-PS-GL-0008,FALSE,FALSE,REF-819707,First Continental Bank,***5872,Globex EMEA Manufacturing Ltd.,IE,-6664286.04
14/04/2025,14/04/2025,Client Receipt - CloudBridge Co. #7,Sales Receipt,SaaS-GL,0,1539.1,EUR,SEPA SCT Inst,CloudBridge Co. #7,***3515,INV-202504-SaaS-GL-0028,,FALSE,FALSE,REF-538024,First Continental Bank,***4687,Globex EMEA Manufacturing Ltd.,IE,-6662746.94
14/04/2025,14/04/2025,Client Receipt - Aurora Electronics GmbH #3,Sales Receipt,CEM-EMEA,0,82141.79,EUR,SEPA SCT Inst,Aurora Electronics GmbH #3,***7012,INV-202504-CEM-EMEA-0007,,FALSE,FALSE,REF-580820,First Continental Bank,***4475,Globex EMEA Manufacturing Ltd.,IE,-6580605.15
15/04/2025,15/04/2025,Supplier Payment - ExpertNet Subcontractors #9,Supplier Payment,PS-GL,7750.28,0,EUR,SWIFT MT103,ExpertNet Subcontractors #9,***4743,,PO-202504-PS-GL-0005,FALSE,FALSE,REF-835897,First Continental Bank,***6809,Globex EMEA Manufacturing Ltd.,IE,-6588355.43
15/04/2025,15/04/2025,Loan Interest Payment,Loan Interest,ALL,85000,0,EUR,SEPA Credit Transfer,First Continental Bank - Corporate Lending,***2765,,,FALSE,FALSE,REF-582264,First Continental Bank,***9478,Globex EMEA Manufacturing Ltd.,IE,-6673355.43
15/04/2025,15/04/2025,Loan Principal Repayment,Loan Principal,ALL,500000,0,EUR,SEPA Credit Transfer,First Continental Bank - Corporate Lending,***8260,,,FALSE,FALSE,REF-690805,First Continental Bank,***3272,Globex EMEA Manufacturing Ltd.,IE,-7173355.43
15/04/2025,15/04/2025,Client Receipt - CloudBridge Co. #39,Sales Receipt,SaaS-GL,0,3221.93,EUR,SEPA SCT Inst,CloudBridge Co. #39,***5932,INV-202504-SaaS-GL-0016,,FALSE,FALSE,REF-729413,First Continental Bank,***6499,Globex EMEA Manufacturing Ltd.,IE,-7170133.5
15/04/2025,15/04/2025,Client Receipt - CloudBridge Co. #32,Sales Receipt,SaaS-GL,0,19372.05,EUR,Card Settlement,CloudBridge Co. #32,***2969,INV-202504-SaaS-GL-0026,,FALSE,FALSE,REF-703510,First Continental Bank,***2183,Globex EMEA Manufacturing Ltd.,IE,-7150761.45
15/04/2025,15/04/2025,Client Receipt - CloudBridge Co. #23,Sales Receipt,SaaS-GL,0,28228.61,EUR,Card Settlement,CloudBridge Co. #23,***7903,INV-202504-SaaS-GL-0006,,FALSE,FALSE,REF-747400,First Continental Bank,***6684,Globex EMEA Manufacturing Ltd.,IE,-7122532.84
16/04/2025,16/04/2025,Supplier Payment - HyperCloud Infra #5,Supplier Payment,SaaS-GL,35423.44,0,EUR,SWIFT MT103,HyperCloud Infra #5,***8247,,PO-202504-SaaS-GL-0002,FALSE,FALSE,REF-660900,First Continental Bank,***4798,Globex EMEA Manufacturing Ltd.,IE,-7157956.28
16/04/2025,16/04/2025,Supplier Payment - Stelliform Parts BV #31,Supplier Payment,CEM-EMEA,143968.04,0,EUR,SEPA Debit,Stelliform Parts BV #31,***3658,,PO-202504-CEM-EMEA-0004,FALSE,FALSE,REF-449162,First Continental Bank,***2007,Globex EMEA Manufacturing Ltd.,IE,-7301924.32
16/04/2025,16/04/2025,Client Receipt - CloudBridge Co. #40,Sales Receipt,SaaS-GL,0,4135.37,EUR,SEPA SCT Inst,CloudBridge Co. #40,***6396,INV-202504-SaaS-GL-0024,,FALSE,FALSE,REF-246297,First Continental Bank,***5296,Globex EMEA Manufacturing Ltd.,IE,-7297788.95
16/04/2025,16/04/2025,Client Receipt - CloudBridge Co. #50,Sales Receipt,SaaS-GL,0,8097.45,EUR,Card Settlement,CloudBridge Co. #50,***6345,INV-202504-SaaS-GL-0002,,FALSE,FALSE,REF-249270,First Continental Bank,***2089,Globex EMEA Manufacturing Ltd.,IE,-7289691.5
16/04/2025,16/04/2025,Client Receipt - Vertex Advisory Client #55,Sales Receipt,PS-GL,0,63640.67,EUR,SEPA SCT,Vertex Advisory Client #55,***3585,INV-202504-PS-GL-0001,,FALSE,FALSE,REF-607734,First Continental Bank,***3042,Globex EMEA Manufacturing Ltd.,IE,-7226050.83
16/04/2025,16/04/2025,Client Receipt - Vertex Advisory Client #37,Sales Receipt,PS-GL,0,76035.93,EUR,SEPA SCT Inst,Vertex Advisory Client #37,***8586,INV-202504-PS-GL-0005,,FALSE,FALSE,REF-578968,First Continental Bank,***7599,Globex EMEA Manufacturing Ltd.,IE,-7150014.9
16/04/2025,16/04/2025,Client Receipt - Aurora Electronics GmbH #18,Sales Receipt,CEM-EMEA,0,113552.41,EUR,Card Settlement,Aurora Electronics GmbH #18,***6851,INV-202504-CEM-EMEA-0005,,FALSE,FALSE,REF-845590,First Continental Bank,***1698,Globex EMEA Manufacturing Ltd.,IE,-7036462.49
17/04/2025,17/04/2025,Merchant Processing Fees,Bank/Merchant Fees,ALL,2398.99,0,EUR,SEPA Debit,First Continental Bank,***2798,,,FALSE,FALSE,REF-821746,First Continental Bank,***1018,Globex EMEA Manufacturing Ltd.,IE,-7038861.48
17/04/2025,17/04/2025,Marketing - Aurelia Media #4,Marketing,ALL,43096.59,0,EUR,SEPA Credit Transfer,Aurelia Media #4,***2694,,,FALSE,FALSE,REF-258607,First Continental Bank,***1942,Globex EMEA Manufacturing Ltd.,IE,-7081958.07
17/04/2025,17/04/2025,Client Receipt - CloudBridge Co. #19,Sales Receipt,SaaS-GL,0,12652.93,EUR,SEPA SCT,CloudBridge Co. #19,***4082,INV-202504-SaaS-GL-0009,,FALSE,FALSE,REF-810423,First Continental Bank,***9307,Globex EMEA Manufacturing Ltd.,IE,-7069305.14
17/04/2025,17/04/2025,Client Receipt - CloudBridge Co. #32,Sales Receipt,SaaS-GL,0,15076.67,EUR,SEPA SCT Inst,CloudBridge Co. #32,***6602,INV-202504-SaaS-GL-0018,,FALSE,FALSE,REF-534032,First Continental Bank,***5669,Globex EMEA Manufacturing Ltd.,IE,-7054228.47
17/04/2025,17/04/2025,Client Receipt - CloudBridge Co. #41,Sales Receipt,SaaS-GL,0,16180.51,EUR,SEPA SCT Inst,CloudBridge Co. #41,***6823,INV-202504-SaaS-GL-0015,,FALSE,FALSE,REF-957104,First Continental Bank,***9170,Globex EMEA Manufacturing Ltd.,IE,-7038047.96
17/04/2025,17/04/2025,Client Receipt - CloudBridge Co. #42,Sales Receipt,SaaS-GL,0,22298.03,EUR,Card Settlement,CloudBridge Co. #42,***1371,INV-202504-SaaS-GL-0033,,FALSE,FALSE,REF-910935,First Continental Bank,***7844,Globex EMEA Manufacturing Ltd.,IE,-7015749.93
17/04/2025,17/04/2025,Client Receipt - Novatek Components Ltd #10,Sales Receipt,CEM-EMEA,0,47832.42,EUR,SEPA SCT Inst,Novatek Components Ltd #10,***1257,INV-202504-CEM-EMEA-0008,,FALSE,FALSE,REF-923078,First Continental Bank,***5619,Globex EMEA Manufacturing Ltd.,IE,-6967917.51
17/04/2025,17/04/2025,Client Receipt - CloudBridge Co. #67,Sales Receipt,SaaS-GL,0,58885.05,EUR,SEPA SCT,CloudBridge Co. #67,***1763,INV-202504-SaaS-GL-0020,,FALSE,FALSE,REF-757516,First Continental Bank,***2263,Globex EMEA Manufacturing Ltd.,IE,-6909032.46
17/04/2025,17/04/2025,Client Receipt - Novatek Components Ltd #10,Sales Receipt,CEM-EMEA,0,77970.28,EUR,Card Settlement,Novatek Components Ltd #10,***9441,INV-202504-CEM-EMEA-0011,,FALSE,FALSE,REF-963808,First Continental Bank,***9718,Globex EMEA Manufacturing Ltd.,IE,-6831062.18
17/04/2025,17/04/2025,Client Receipt - Novatek Components Ltd #5,Sales Receipt,CEM-EMEA,0,138109.19,EUR,SEPA SCT Inst,Novatek Components Ltd #5,***8464,INV-202504-CEM-EMEA-0004,,FALSE,FALSE,REF-209940,First Continental Bank,***7606,Globex EMEA Manufacturing Ltd.,IE,-6692952.99
18/04/2025,18/04/2025,Supplier Payment - EuroFab Assembly #11,Supplier Payment,CEM-EMEA,54422.1,0,EUR,SEPA Debit,EuroFab Assembly #11,***6568,,PO-202504-CEM-EMEA-0002,FALSE,FALSE,REF-620841,First Continental Bank,***9496,Globex EMEA Manufacturing Ltd.,IE,-6747375.09
18/04/2025,18/04/2025,Client Receipt - Novatek Components Ltd #5,Sales Receipt,CEM-EMEA,0,13591.12,EUR,SEPA SCT Inst,Novatek Components Ltd #5,***6756,INV-202504-CEM-EMEA-0010,,FALSE,FALSE,REF-241832,First Continental Bank,***4981,Globex EMEA Manufacturing Ltd.,IE,-6733783.97
18/04/2025,18/04/2025,Client Receipt - CloudBridge Co. #18,Sales Receipt,SaaS-GL,0,16823.79,EUR,Card Settlement,CloudBridge Co. #18,***8316,INV-202504-SaaS-GL-0014,,FALSE,FALSE,REF-153195,First Continental Bank,***8204,Globex EMEA Manufacturing Ltd.,IE,-6716960.18
18/04/2025,18/04/2025,Client Receipt - Novatek Components Ltd #6,Sales Receipt,CEM-EMEA,0,33746.68,EUR,Card Settlement,Novatek Components Ltd #6,***7246,INV-202504-CEM-EMEA-0012,,FALSE,FALSE,REF-935087,First Continental Bank,***9568,Globex EMEA Manufacturing Ltd.,IE,-6683213.5
19/04/2025,19/04/2025,Supplier Payment - CodeCraft Contractors #14,Supplier Payment,SaaS-GL,3492.65,0,EUR,SEPA Credit Transfer,CodeCraft Contractors #14,***5397,,PO-202504-SaaS-GL-0006,FALSE,FALSE,REF-877574,First Continental Bank,***1411,Globex EMEA Manufacturing Ltd.,IE,-6686706.15
20/04/2025,20/04/2025,Supplier Payment - ExpertNet Subcontractors #13,Supplier Payment,PS-GL,6896.89,0,EUR,SWIFT MT103,ExpertNet Subcontractors #13,***5280,,PO-202504-PS-GL-0002,FALSE,FALSE,REF-397502,First Continental Bank,***6947,Globex EMEA Manufacturing Ltd.,IE,-6693603.04
21/04/2025,21/04/2025,VAT/GST Remittance - Revenue Ireland,Tax Payment,ALL,125360.15,0,EUR,SEPA Debit,Revenue Ireland,***9830,,,FALSE,FALSE,REF-484137,First Continental Bank,***9454,Globex EMEA Manufacturing Ltd.,IE,-6818963.19
21/04/2025,21/04/2025,Client Receipt - CloudBridge Co. #14,Sales Receipt,SaaS-GL,0,5361.1,EUR,SEPA SCT Inst,CloudBridge Co. #14,***3166,INV-202504-SaaS-GL-0012,,FALSE,FALSE,REF-621338,First Continental Bank,***6783,Globex EMEA Manufacturing Ltd.,IE,-6813602.09
21/04/2025,21/04/2025,Client Receipt - Novatek Components Ltd #7,Sales Receipt,CEM-EMEA,0,74240.45,EUR,SEPA SCT,Novatek Components Ltd #7,***3665,INV-202504-CEM-EMEA-0002,,FALSE,FALSE,REF-716883,First Continental Bank,***8248,Globex EMEA Manufacturing Ltd.,IE,-6739361.64
22/04/2025,22/04/2025,Supplier Payment - Stelliform Parts BV #13,Supplier Payment,CEM-EMEA,20979.61,0,EUR,SEPA Credit Transfer,Stelliform Parts BV #13,***8579,,PO-202504-CEM-EMEA-0005,FALSE,FALSE,REF-407489,First Continental Bank,***4285,Globex EMEA Manufacturing Ltd.,IE,-6760341.25
22/04/2025,22/04/2025,Supplier Payment - ExpertNet Subcontractors #8,Supplier Payment,PS-GL,25603.92,0,EUR,SEPA Credit Transfer,ExpertNet Subcontractors #8,***2484,,PO-202504-PS-GL-0011,FALSE,FALSE,REF-410057,First Continental Bank,***5904,Globex EMEA Manufacturing Ltd.,IE,-6785945.17
22/04/2025,22/04/2025,Client Receipt - Vertex Advisory Client #17,Sales Receipt,PS-GL,0,24210.06,EUR,SEPA SCT Inst,Vertex Advisory Client #17,***5368,INV-202504-PS-GL-0009,,FALSE,FALSE,REF-339042,First Continental Bank,***9485,Globex EMEA Manufacturing Ltd.,IE,-6761735.11
22/04/2025,22/04/2025,Client Receipt - Vertex Advisory Client #26,Sales Receipt,PS-GL,0,33321.25,EUR,Card Settlement,Vertex Advisory Client #26,***4048,INV-202504-PS-GL-0008,,FALSE,FALSE,REF-216987,First Continental Bank,***3928,Globex EMEA Manufacturing Ltd.,IE,-6728413.86
22/04/2025,22/04/2025,Client Receipt - Novatek Components Ltd #2,Sales Receipt,CEM-EMEA,0,64638.43,EUR,SEPA SCT Inst,Novatek Components Ltd #2,***3074,INV-202504-CEM-EMEA-0009,,FALSE,FALSE,REF-818100,First Continental Bank,***2767,Globex EMEA Manufacturing Ltd.,IE,-6663775.43
23/04/2025,23/04/2025,Supplier Payment - Stelliform Parts BV #29,Supplier Payment,CEM-EMEA,86867.81,0,EUR,SEPA Credit Transfer,Stelliform Parts BV #29,***6589,,PO-202504-CEM-EMEA-0006,FALSE,FALSE,REF-525786,First Continental Bank,***2600,Globex EMEA Manufacturing Ltd.,IE,-6750643.24
23/04/2025,23/04/2025,Supplier Payment - EuroFab Assembly #22,Supplier Payment,CEM-EMEA,89689.63,0,EUR,SWIFT MT103,EuroFab Assembly #22,***2560,,PO-202504-CEM-EMEA-0010,FALSE,FALSE,REF-663179,First Continental Bank,***6155,Globex EMEA Manufacturing Ltd.,IE,-6840332.87
23/04/2025,23/04/2025,Client Receipt - CloudBridge Co. #58,Sales Receipt,SaaS-GL,0,54331.31,EUR,SEPA SCT Inst,CloudBridge Co. #58,***2114,INV-202504-SaaS-GL-0001,,FALSE,FALSE,REF-613806,First Continental Bank,***6055,Globex EMEA Manufacturing Ltd.,IE,-6786001.56
24/04/2025,24/04/2025,Supplier Payment - ExpertNet Subcontractors #3,Supplier Payment,PS-GL,16977.39,0,EUR,SEPA Credit Transfer,ExpertNet Subcontractors #3,***6911,,PO-202504-PS-GL-0004,FALSE,FALSE,REF-269654,First Continental Bank,***8290,Globex EMEA Manufacturing Ltd.,IE,-6802978.95
24/04/2025,24/04/2025,Client Receipt - CloudBridge Co. #3,Sales Receipt,SaaS-GL,0,13369.02,EUR,SEPA SCT,CloudBridge Co. #3,***8561,INV-202504-SaaS-GL-0027,,FALSE,FALSE,REF-173730,First Continental Bank,***9041,Globex EMEA Manufacturing Ltd.,IE,-6789609.93
24/04/2025,24/04/2025,Client Receipt - CloudBridge Co. #10,Sales Receipt,SaaS-GL,0,29274.59,EUR,SEPA SCT,CloudBridge Co. #10,***2367,INV-202504-SaaS-GL-0005,,FALSE,FALSE,REF-311413,First Continental Bank,***5391,Globex EMEA Manufacturing Ltd.,IE,-6760335.34
25/04/2025,25/04/2025,Marketing - Beacon Digital #1,Marketing,ALL,8446.68,0,EUR,SWIFT MT103,Beacon Digital #1,***6510,,,FALSE,FALSE,REF-872024,First Continental Bank,***4910,Globex EMEA Manufacturing Ltd.,IE,-6768782.02
25/04/2025,25/04/2025,Client Receipt - Vertex Advisory Client #21,Sales Receipt,PS-GL,0,278.65,EUR,SEPA SCT,Vertex Advisory Client #21,***6624,INV-202504-PS-GL-0004,,FALSE,FALSE,REF-559604,First Continental Bank,***1858,Globex EMEA Manufacturing Ltd.,IE,-6768503.37
25/04/2025,25/04/2025,Client Receipt - CloudBridge Co. #65,Sales Receipt,SaaS-GL,0,25065.06,EUR,SEPA SCT Inst,CloudBridge Co. #65,***9409,INV-202504-SaaS-GL-0021,,FALSE,FALSE,REF-527832,First Continental Bank,***2443,Globex EMEA Manufacturing Ltd.,IE,-6743438.31
26/04/2025,26/04/2025,Intercompany Settlement - Globex Retail NA LLC,Intercompany Transfer,ALL,798040,0,EUR,Internal Transfer,Globex Retail NA LLC,***4486,,,TRUE,TRUE,REF-489643,First Continental Bank,***3048,Globex EMEA Manufacturing Ltd.,IE,-7541478.31
26/04/2025,26/04/2025,Intercompany Reimbursement - Globex Retail NA LLC,Intercompany Transfer,ALL,0,319216,EUR,Internal Transfer,Globex Retail NA LLC,***7883,,,TRUE,TRUE,REF-193265,First Continental Bank,***8439,Globex EMEA Manufacturing Ltd.,IE,-7222262.31
27/04/2025,27/04/2025,Payroll - GlobalPay Services Ltd,Payroll,ALL,163968.88,0,EUR,SEPA Debit,GlobalPay Services Ltd,***8438,,,FALSE,FALSE,REF-247309,First Continental Bank,***7050,Globex EMEA Manufacturing Ltd.,IE,-7386231.19
27/04/2025,27/04/2025,Client Receipt - CloudBridge Co. #54,Sales Receipt,SaaS-GL,0,13526.92,EUR,SEPA SCT Inst,CloudBridge Co. #54,***7670,INV-202504-SaaS-GL-0004,,FALSE,FALSE,REF-810214,First Continental Bank,***9949,Globex EMEA Manufacturing Ltd.,IE,-7372704.27
28/04/2025,28/04/2025,Corporate Tax Estimate,Tax Payment,ALL,90054.11,0,EUR,SEPA Credit Transfer,HMRC UK,***9392,,,FALSE,FALSE,REF-261036,First Continental Bank,***5935,Globex EMEA Manufacturing Ltd.,IE,-7462758.38
28/04/2025,28/04/2025,Payroll - GlobalPay Services Ltd,Payroll,ALL,163968.88,0,EUR,SEPA Credit Transfer,GlobalPay Services Ltd,***1931,,,FALSE,FALSE,REF-502968,First Continental Bank,***2542,Globex EMEA Manufacturing Ltd.,IE,-7626727.26
29/04/2025,29/04/2025,Supplier Payment - HyperCloud Infra #11,Supplier Payment,SaaS-GL,2826.16,0,EUR,SWIFT MT103,HyperCloud Infra #11,***7952,,PO-202504-SaaS-GL-0005,FALSE,FALSE,REF-131887,First Continental Bank,***9591,Globex EMEA Manufacturing Ltd.,IE,-7629553.42
29/04/2025,29/04/2025,Supplier Payment - ExpertNet Subcontractors #6,Supplier Payment,PS-GL,3890.07,0,EUR,SEPA Debit,ExpertNet Subcontractors #6,***2883,,PO-202504-PS-GL-0006,FALSE,FALSE,REF-687145,First Continental Bank,***3551,Globex EMEA Manufacturing Ltd.,IE,-7633443.49
29/04/2025,29/04/2025,Client Receipt - CloudBridge Co. #6,Sales Receipt,SaaS-GL,0,12884.18,EUR,SEPA SCT,CloudBridge Co. #6,***2936,INV-202504-SaaS-GL-0003,,FALSE,FALSE,REF-152168,First Continental Bank,***2195,Globex EMEA Manufacturing Ltd.,IE,-7620559.31
29/04/2025,29/04/2025,Client Receipt - Aurora Electronics GmbH #3,Sales Receipt,CEM-EMEA,0,15832.78,EUR,Card Settlement,Aurora Electronics GmbH #3,***1369,INV-202504-CEM-EMEA-0014,,FALSE,FALSE,REF-540814,First Continental Bank,***4653,Globex EMEA Manufacturing Ltd.,IE,-7604726.53
29/04/2025,29/04/2025,Client Receipt - Vertex Advisory Client #57,Sales Receipt,PS-GL,0,117229.46,EUR,SEPA SCT,Vertex Advisory Client #57,***7969,INV-202504-PS-GL-0002,,FALSE,FALSE,REF-812276,First Continental Bank,***2305,Globex EMEA Manufacturing Ltd.,IE,-7487497.07
30/04/2025,30/04/2025,Interest Earned,Interest Income,ALL,0,8422.5,EUR,Card Settlement,First Continental Bank,***4977,,,FALSE,FALSE,REF-802361,First Continental Bank,***1021,Globex EMEA Manufacturing Ltd.,IE,-7479074.57
01/05/2025,01/05/2025,Account Maintenance Fee,Bank/Merchant Fees,ALL,2500,0,EUR,SEPA Credit Transfer,First Continental Bank,***1717,,,FALSE,FALSE,REF-301922,First Continental Bank,***5098,Globex EMEA Manufacturing Ltd.,IE,-7481574.57
01/05/2025,01/05/2025,Client Receipt - CloudBridge Co. #73,Sales Receipt,SaaS-GL,0,8259.36,EUR,SEPA SCT Inst,CloudBridge Co. #73,***2362,INV-202505-SaaS-GL-0003,,FALSE,FALSE,REF-534430,First Continental Bank,***9387,Globex EMEA Manufacturing Ltd.,IE,-7473315.21
01/05/2025,01/05/2025,Client Receipt - Novatek Components Ltd #10,Sales Receipt,CEM-EMEA,0,21224.24,EUR,SEPA SCT Inst,Novatek Components Ltd #10,***6994,INV-202505-CEM-EMEA-0009,,FALSE,FALSE,REF-757933,First Continental Bank,***3501,Globex EMEA Manufacturing Ltd.,IE,-7452090.97
01/05/2025,01/05/2025,Client Receipt - Novatek Components Ltd #7,Sales Receipt,CEM-EMEA,0,54788.02,EUR,SEPA SCT,Novatek Components Ltd #7,***9583,INV-202505-CEM-EMEA-0005,,FALSE,FALSE,REF-667248,First Continental Bank,***1459,Globex EMEA Manufacturing Ltd.,IE,-7397302.95
02/05/2025,02/05/2025,Client Receipt - CloudBridge Co. #40,Sales Receipt,SaaS-GL,0,59041.77,EUR,SEPA SCT,CloudBridge Co. #40,***9760,INV-202505-SaaS-GL-0010,,FALSE,FALSE,REF-313641,First Continental Bank,***2437,Globex EMEA Manufacturing Ltd.,IE,-7338261.18
04/05/2025,04/05/2025,Merchant Processing Fees,Bank/Merchant Fees,ALL,5117.43,0,EUR,SWIFT MT103,First Continental Bank,***4284,,,FALSE,FALSE,REF-893725,First Continental Bank,***9733,Globex EMEA Manufacturing Ltd.,IE,-7343378.61
04/05/2025,04/05/2025,Client Receipt - CloudBridge Co. #30,Sales Receipt,SaaS-GL,0,36775.9,EUR,SEPA SCT,CloudBridge Co. #30,***9027,INV-202505-SaaS-GL-0032,,FALSE,FALSE,REF-797969,First Continental Bank,***5092,Globex EMEA Manufacturing Ltd.,IE,-7306602.71
05/05/2025,05/05/2025,Supplier Payment - ExpertNet Subcontractors #19,Supplier Payment,PS-GL,2387.28,0,EUR,SEPA Credit Transfer,ExpertNet Subcontractors #19,***5283,,PO-202505-PS-GL-0008,FALSE,FALSE,REF-160259,First Continental Bank,***4776,Globex EMEA Manufacturing Ltd.,IE,-7308989.99
05/05/2025,05/05/2025,Supplier Payment - ExpertNet Subcontractors #14,Supplier Payment,PS-GL,16060.12,0,EUR,SWIFT MT103,ExpertNet Subcontractors #14,***9306,,PO-202505-PS-GL-0005,FALSE,FALSE,REF-467419,First Continental Bank,***7531,Globex EMEA Manufacturing Ltd.,IE,-7325050.11
05/05/2025,05/05/2025,Client Receipt - CloudBridge Co. #68,Sales Receipt,SaaS-GL,0,4020.62,EUR,SEPA SCT Inst,CloudBridge Co. #68,***7418,INV-202505-SaaS-GL-0025,,FALSE,FALSE,REF-244924,First Continental Bank,***1633,Globex EMEA Manufacturing Ltd.,IE,-7321029.49
05/05/2025,05/05/2025,Client Receipt - CloudBridge Co. #17,Sales Receipt,SaaS-GL,0,12713.93,EUR,SEPA SCT,CloudBridge Co. #17,***9674,INV-202505-SaaS-GL-0019,,FALSE,FALSE,REF-241858,First Continental Bank,***8500,Globex EMEA Manufacturing Ltd.,IE,-7308315.56
05/05/2025,05/05/2025,Client Receipt - Vertex Advisory Client #29,Sales Receipt,PS-GL,0,42556.37,EUR,Card Settlement,Vertex Advisory Client #29,***6719,INV-202505-PS-GL-0004,,FALSE,FALSE,REF-225407,First Continental Bank,***7259,Globex EMEA Manufacturing Ltd.,IE,-7265759.19
05/05/2025,05/05/2025,Client Receipt - Novatek Components Ltd #2,Sales Receipt,CEM-EMEA,0,241066.32,EUR,SEPA SCT,Novatek Components Ltd #2,***5703,INV-202505-CEM-EMEA-0006,,FALSE,FALSE,REF-176533,First Continental Bank,***7396,Globex EMEA Manufacturing Ltd.,IE,-7024692.87
06/05/2025,06/05/2025,Supplier Payment - CodeCraft Contractors #12,Supplier Payment,SaaS-GL,1358.52,0,EUR,SEPA Credit Transfer,CodeCraft Contractors #12,***3237,,PO-202505-SaaS-GL-0007,FALSE,FALSE,REF-512032,First Continental Bank,***9906,Globex EMEA Manufacturing Ltd.,IE,-7026051.39
06/05/2025,06/05/2025,Supplier Payment - CodeCraft Contractors #8,Supplier Payment,SaaS-GL,26406.32,0,EUR,SEPA Debit,CodeCraft Contractors #8,***7668,,PO-202505-SaaS-GL-0003,FALSE,FALSE,REF-958570,First Continental Bank,***6433,Globex EMEA Manufacturing Ltd.,IE,-7052457.71
06/05/2025,06/05/2025,Client Receipt - CloudBridge Co. #23,Sales Receipt,SaaS-GL,0,2492.86,EUR,SEPA SCT Inst,CloudBridge Co. #23,***9015,INV-202505-SaaS-GL-0024,,FALSE,FALSE,REF-113638,First Continental Bank,***7349,Globex EMEA Manufacturing Ltd.,IE,-7049964.85
07/05/2025,07/05/2025,Supplier Payment - HyperCloud Infra #16,Supplier Payment,SaaS-GL,1849.43,0,EUR,SEPA Debit,HyperCloud Infra #16,***4582,,PO-202505-SaaS-GL-0002,FALSE,FALSE,REF-601099,First Continental Bank,***6230,Globex EMEA Manufacturing Ltd.,IE,-7051814.28
07/05/2025,07/05/2025,Supplier Payment - ExpertNet Subcontractors #10,Supplier Payment,PS-GL,16482.29,0,EUR,SWIFT MT103,ExpertNet Subcontractors #10,***6382,,PO-202505-PS-GL-0006,FALSE,FALSE,REF-331999,First Continental Bank,***7689,Globex EMEA Manufacturing Ltd.,IE,-7068296.57
07/05/2025,07/05/2025,Client Receipt - CloudBridge Co. #30,Sales Receipt,SaaS-GL,0,3847.11,EUR,SEPA SCT,CloudBridge Co. #30,***4891,INV-202505-SaaS-GL-0018,,FALSE,FALSE,REF-192728,First Continental Bank,***3677,Globex EMEA Manufacturing Ltd.,IE,-7064449.46
07/05/2025,07/05/2025,Client Receipt - CloudBridge Co. #40,Sales Receipt,SaaS-GL,0,22383.55,EUR,SEPA SCT Inst,CloudBridge Co. #40,***8326,INV-202505-SaaS-GL-0006,,FALSE,FALSE,REF-635739,First Continental Bank,***8826,Globex EMEA Manufacturing Ltd.,IE,-7042065.91
08/05/2025,08/05/2025,Client Receipt - CloudBridge Co. #70,Sales Receipt,SaaS-GL,0,8149.87,EUR,SEPA SCT,CloudBridge Co. #70,***7521,INV-202505-SaaS-GL-0011,,FALSE,FALSE,REF-670566,First Continental Bank,***5857,Globex EMEA Manufacturing Ltd.,IE,-7033916.04
08/05/2025,08/05/2025,Client Receipt - Vertex Advisory Client #6,Sales Receipt,PS-GL,0,25933.64,EUR,SEPA SCT Inst,Vertex Advisory Client #6,***3357,INV-202505-PS-GL-0007,,FALSE,FALSE,REF-133569,First Continental Bank,***6558,Globex EMEA Manufacturing Ltd.,IE,-7007982.4
08/05/2025,08/05/2025,Client Receipt - Aurora Electronics GmbH #9,Sales Receipt,CEM-EMEA,0,160042.86,EUR,SEPA SCT Inst,Aurora Electronics GmbH #9,***8388,INV-202505-CEM-EMEA-0004,,FALSE,FALSE,REF-803526,First Continental Bank,***7378,Globex EMEA Manufacturing Ltd.,IE,-6847939.54
09/05/2025,09/05/2025,Supplier Payment - Stelliform Parts BV #25,Supplier Payment,CEM-EMEA,40201.68,0,EUR,SEPA Credit Transfer,Stelliform Parts BV #25,***2801,,PO-202505-CEM-EMEA-0001,FALSE,FALSE,REF-785300,First Continental Bank,***8735,Globex EMEA Manufacturing Ltd.,IE,-6888141.22
09/05/2025,09/05/2025,Client Receipt - CloudBridge Co. #23,Sales Receipt,SaaS-GL,0,15781.67,EUR,SEPA SCT,CloudBridge Co. #23,***3341,INV-202505-SaaS-GL-0002,,FALSE,FALSE,REF-369123,First Continental Bank,***7135,Globex EMEA Manufacturing Ltd.,IE,-6872359.55
11/05/2025,11/05/2025,Marketing - Beacon Digital #6,Marketing,ALL,748.02,0,EUR,SEPA Credit Transfer,Beacon Digital #6,***3469,,,FALSE,FALSE,REF-117361,First Continental Bank,***9722,Globex EMEA Manufacturing Ltd.,IE,-6873107.57
11/05/2025,11/05/2025,Supplier Payment - EuroFab Assembly #9,Supplier Payment,CEM-EMEA,44049,0,EUR,SEPA Credit Transfer,EuroFab Assembly #9,***1860,,PO-202505-CEM-EMEA-0009,FALSE,FALSE,REF-890528,First Continental Bank,***1773,Globex EMEA Manufacturing Ltd.,IE,-6917156.57
11/05/2025,11/05/2025,Client Receipt - CloudBridge Co. #61,Sales Receipt,SaaS-GL,0,17165.92,EUR,SEPA SCT Inst,CloudBridge Co. #61,***5186,INV-202505-SaaS-GL-0020,,FALSE,FALSE,REF-380454,First Continental Bank,***1580,Globex EMEA Manufacturing Ltd.,IE,-6899990.65
12/05/2025,12/05/2025,Intercompany Settlement - Globex Retail NA LLC,Intercompany Transfer,ALL,471348,0,EUR,Internal Transfer,Globex Retail NA LLC,***5033,,,TRUE,TRUE,REF-802929,First Continental Bank,***1244,Globex EMEA Manufacturing Ltd.,IE,-7371338.65
12/05/2025,12/05/2025,Client Receipt - CloudBridge Co. #4,Sales Receipt,SaaS-GL,0,10001.22,EUR,SEPA SCT,CloudBridge Co. #4,***6805,INV-202505-SaaS-GL-0012,,FALSE,FALSE,REF-109040,First Continental Bank,***1926,Globex EMEA Manufacturing Ltd.,IE,-7361337.43
12/05/2025,12/05/2025,Client Receipt - CloudBridge Co. #9,Sales Receipt,SaaS-GL,0,24152.09,EUR,SEPA SCT,CloudBridge Co. #9,***1981,INV-202505-SaaS-GL-0028,,FALSE,FALSE,REF-231207,First Continental Bank,***5607,Globex EMEA Manufacturing Ltd.,IE,-7337185.34
13/05/2025,13/05/2025,Supplier Payment - ExpertNet Subcontractors #18,Supplier Payment,PS-GL,4457.73,0,EUR,SWIFT MT103,ExpertNet Subcontractors #18,***9136,,PO-202505-PS-GL-0003,FALSE,FALSE,REF-736032,First Continental Bank,***3327,Globex EMEA Manufacturing Ltd.,IE,-7341643.07
13/05/2025,13/05/2025,BluePeak Property Mgmt,Rent & Utilities,ALL,10415.87,0,EUR,SEPA Credit Transfer,BluePeak Property Mgmt,***6852,,,FALSE,FALSE,REF-825720,First Continental Bank,***4914,Globex EMEA Manufacturing Ltd.,IE,-7352058.94
13/05/2025,13/05/2025,Marketing - Beacon Digital #1,Marketing,ALL,44506.21,0,EUR,SWIFT MT103,Beacon Digital #1,***9988,,,FALSE,FALSE,REF-974295,First Continental Bank,***7101,Globex EMEA Manufacturing Ltd.,IE,-7396565.15
13/05/2025,13/05/2025,Client Receipt - CloudBridge Co. #10,Sales Receipt,SaaS-GL,0,1577.69,EUR,SEPA SCT Inst,CloudBridge Co. #10,***5442,INV-202505-SaaS-GL-0031,,FALSE,FALSE,REF-446287,First Continental Bank,***2712,Globex EMEA Manufacturing Ltd.,IE,-7394987.46
13/05/2025,13/05/2025,Client Receipt - CloudBridge Co. #47,Sales Receipt,SaaS-GL,0,17724.41,EUR,SEPA SCT Inst,CloudBridge Co. #47,***6316,INV-202505-SaaS-GL-0013,,FALSE,FALSE,REF-321171,First Continental Bank,***4176,Globex EMEA Manufacturing Ltd.,IE,-7377263.05
13/05/2025,13/05/2025,Client Receipt - CloudBridge Co. #22,Sales Receipt,SaaS-GL,0,20811.24,EUR,SEPA SCT,CloudBridge Co. #22,***1116,INV-202505-SaaS-GL-0030,,FALSE,FALSE,REF-403488,First Continental Bank,***5192,Globex EMEA Manufacturing Ltd.,IE,-7356451.81
13/05/2025,13/05/2025,Client Receipt - Vertex Advisory Client #12,Sales Receipt,PS-GL,0,24247.42,EUR,SEPA SCT,Vertex Advisory Client #12,***9215,INV-202505-PS-GL-0005,,FALSE,FALSE,REF-632371,First Continental Bank,***6915,Globex EMEA Manufacturing Ltd.,IE,-7332204.39
13/05/2025,13/05/2025,Client Receipt - CloudBridge Co. #57,Sales Receipt,SaaS-GL,0,46472.83,EUR,SEPA SCT,CloudBridge Co. #57,***6808,INV-202505-SaaS-GL-0007,,FALSE,FALSE,REF-459135,First Continental Bank,***4094,Globex EMEA Manufacturing Ltd.,IE,-7285731.56
14/05/2025,14/05/2025,Supplier Payment - ExpertNet Subcontractors #8,Supplier Payment,PS-GL,3505.9,0,EUR,SWIFT MT103,ExpertNet Subcontractors #8,***7581,,PO-202505-PS-GL-0004,FALSE,FALSE,REF-346510,First Continental Bank,***7637,Globex EMEA Manufacturing Ltd.,IE,-7289237.46
14/05/2025,14/05/2025,Supplier Payment - HyperCloud Infra #4,Supplier Payment,SaaS-GL,9181.81,0,EUR,SWIFT MT103,HyperCloud Infra #4,***4859,,PO-202505-SaaS-GL-0005,FALSE,FALSE,REF-728443,First Continental Bank,***2339,Globex EMEA Manufacturing Ltd.,IE,-7298419.27
14/05/2025,14/05/2025,Supplier Payment - Stelliform Parts BV #10,Supplier Payment,CEM-EMEA,88520.46,0,EUR,SEPA Debit,Stelliform Parts BV #10,***7170,,PO-202505-CEM-EMEA-0004,FALSE,FALSE,REF-859047,First Continental Bank,***8470,Globex EMEA Manufacturing Ltd.,IE,-7386939.73
15/05/2025,15/05/2025,Supplier Payment - ExpertNet Subcontractors #17,Supplier Payment,PS-GL,8054.99,0,EUR,SWIFT MT103,ExpertNet Subcontractors #17,***7756,,PO-202505-PS-GL-0007,FALSE,FALSE,REF-487635,First Continental Bank,***7990,Globex EMEA Manufacturing Ltd.,IE,-7394994.72
15/05/2025,15/05/2025,Supplier Payment - ExpertNet Subcontractors #16,Supplier Payment,PS-GL,19707.89,0,EUR,SEPA Debit,ExpertNet Subcontractors #16,***9127,,PO-202505-PS-GL-0009,FALSE,FALSE,REF-999703,First Continental Bank,***9262,Globex EMEA Manufacturing Ltd.,IE,-7414702.61
15/05/2025,15/05/2025,Supplier Payment - EuroFab Assembly #10,Supplier Payment,CEM-EMEA,75107.26,0,EUR,SEPA Credit Transfer,EuroFab Assembly #10,***1624,,PO-202505-CEM-EMEA-0005,FALSE,FALSE,REF-322838,First Continental Bank,***1108,Globex EMEA Manufacturing Ltd.,IE,-7489809.87
15/05/2025,15/05/2025,Loan Interest Payment,Loan Interest,ALL,85000,0,EUR,SEPA Debit,First Continental Bank - Corporate Lending,***8278,,,FALSE,FALSE,REF-549583,First Continental Bank,***8460,Globex EMEA Manufacturing Ltd.,IE,-7574809.87
15/05/2025,15/05/2025,Loan Principal Repayment,Loan Principal,ALL,500000,0,EUR,SWIFT MT103,First Continental Bank - Corporate Lending,***2219,,,FALSE,FALSE,REF-652687,First Continental Bank,***4151,Globex EMEA Manufacturing Ltd.,IE,-8074809.87
15/05/2025,15/05/2025,Client Receipt - Vertex Advisory Client #51,Sales Receipt,PS-GL,0,3935.49,EUR,Card Settlement,Vertex Advisory Client #51,***9732,INV-202505-PS-GL-0001,,FALSE,FALSE,REF-101262,First Continental Bank,***3146,Globex EMEA Manufacturing Ltd.,IE,-8070874.38
15/05/2025,15/05/2025,Client Receipt - Aurora Electronics GmbH #11,Sales Receipt,CEM-EMEA,0,65418.34,EUR,SEPA SCT Inst,Aurora Electronics GmbH #11,***2430,INV-202505-CEM-EMEA-0001,,FALSE,FALSE,REF-578329,First Continental Bank,***3862,Globex EMEA Manufacturing Ltd.,IE,-8005456.04
15/05/2025,15/05/2025,Client Receipt - Aurora Electronics GmbH #16,Sales Receipt,CEM-EMEA,0,253467.22,EUR,SEPA SCT,Aurora Electronics GmbH #16,***9892,INV-202505-CEM-EMEA-0002,,FALSE,FALSE,REF-629420,First Continental Bank,***6354,Globex EMEA Manufacturing Ltd.,IE,-7751988.82
16/05/2025,16/05/2025,Supplier Payment - CodeCraft Contractors #1,Supplier Payment,SaaS-GL,7279.32,0,EUR,SEPA Credit Transfer,CodeCraft Contractors #1,***1804,,PO-202505-SaaS-GL-0001,FALSE,FALSE,REF-516343,First Continental Bank,***1954,Globex EMEA Manufacturing Ltd.,IE,-7759268.14
16/05/2025,16/05/2025,Client Receipt - Vertex Advisory Client #23,Sales Receipt,PS-GL,0,7217.48,EUR,SEPA SCT,Vertex Advisory Client #23,***2762,INV-202505-PS-GL-0009,,FALSE,FALSE,REF-742615,First Continental Bank,***4547,Globex EMEA Manufacturing Ltd.,IE,-7752050.66
16/05/2025,16/05/2025,Client Receipt - CloudBridge Co. #50,Sales Receipt,SaaS-GL,0,14803.76,EUR,Card Settlement,CloudBridge Co. #50,***3061,INV-202505-SaaS-GL-0026,,FALSE,FALSE,REF-150732,First Continental Bank,***9698,Globex EMEA Manufacturing Ltd.,IE,-7737246.9
16/05/2025,16/05/2025,Client Receipt - CloudBridge Co. #45,Sales Receipt,SaaS-GL,0,33427.98,EUR,SEPA SCT,CloudBridge Co. #45,***8987,INV-202505-SaaS-GL-0015,,FALSE,FALSE,REF-687543,First Continental Bank,***2953,Globex EMEA Manufacturing Ltd.,IE,-7703818.92
17/05/2025,17/05/2025,Supplier Payment - ExpertNet Subcontractors #16,Supplier Payment,PS-GL,646.08,0,EUR,SWIFT MT103,ExpertNet Subcontractors #16,***1630,,PO-202505-PS-GL-0011,FALSE,FALSE,REF-867133,First Continental Bank,***7381,Globex EMEA Manufacturing Ltd.,IE,-7704465
17/05/2025,17/05/2025,Supplier Payment - ExpertNet Subcontractors #15,Supplier Payment,PS-GL,1929.52,0,EUR,SEPA Credit Transfer,ExpertNet Subcontractors #15,***4232,,PO-202505-PS-GL-0001,FALSE,FALSE,REF-395219,First Continental Bank,***1423,Globex EMEA Manufacturing Ltd.,IE,-7706394.52
17/05/2025,17/05/2025,Client Receipt - CloudBridge Co. #50,Sales Receipt,SaaS-GL,0,26358.69,EUR,Card Settlement,CloudBridge Co. #50,***3125,INV-202505-SaaS-GL-0033,,FALSE,FALSE,REF-487741,First Continental Bank,***2184,Globex EMEA Manufacturing Ltd.,IE,-7680035.83
17/05/2025,17/05/2025,Client Receipt - CloudBridge Co. #70,Sales Receipt,SaaS-GL,0,26476.17,EUR,SEPA SCT,CloudBridge Co. #70,***7415,INV-202505-SaaS-GL-0017,,FALSE,FALSE,REF-380970,First Continental Bank,***5182,Globex EMEA Manufacturing Ltd.,IE,-7653559.66
18/05/2025,18/05/2025,Client Receipt - CloudBridge Co. #30,Sales Receipt,SaaS-GL,0,2862.64,EUR,SEPA SCT Inst,CloudBridge Co. #30,***7421,INV-202505-SaaS-GL-0027,,FALSE,FALSE,REF-383575,First Continental Bank,***9999,Globex EMEA Manufacturing Ltd.,IE,-7650697.02
18/05/2025,18/05/2025,Client Receipt - CloudBridge Co. #48,Sales Receipt,SaaS-GL,0,3369.03,EUR,SEPA SCT Inst,CloudBridge Co. #48,***6720,INV-202505-SaaS-GL-0014,,FALSE,FALSE,REF-942370,First Continental Bank,***7914,Globex EMEA Manufacturing Ltd.,IE,-7647327.99
18/05/2025,18/05/2025,Client Receipt - CloudBridge Co. #49,Sales Receipt,SaaS-GL,0,19829.11,EUR,SEPA SCT Inst,CloudBridge Co. #49,***3675,INV-202505-SaaS-GL-0005,,FALSE,FALSE,REF-587707,First Continental Bank,***2384,Globex EMEA Manufacturing Ltd.,IE,-7627498.88
18/05/2025,18/05/2025,Client Receipt - Aurora Electronics GmbH #1,Sales Receipt,CEM-EMEA,0,29800.61,EUR,Card Settlement,Aurora Electronics GmbH #1,***1610,INV-202505-CEM-EMEA-0008,,FALSE,FALSE,REF-659818,First Continental Bank,***2769,Globex EMEA Manufacturing Ltd.,IE,-7597698.27
19/05/2025,19/05/2025,Supplier Payment - HyperCloud Infra #6,Supplier Payment,SaaS-GL,20744.17,0,EUR,SEPA Debit,HyperCloud Infra #6,***2396,,PO-202505-SaaS-GL-0006,FALSE,FALSE,REF-608252,First Continental Bank,***2579,Globex EMEA Manufacturing Ltd.,IE,-7618442.44
19/05/2025,19/05/2025,Supplier Payment - Stelliform Parts BV #9,Supplier Payment,CEM-EMEA,30360.22,0,EUR,SEPA Debit,Stelliform Parts BV #9,***9562,,PO-202505-CEM-EMEA-0007,FALSE,FALSE,REF-509474,First Continental Bank,***8764,Globex EMEA Manufacturing Ltd.,IE,-7648802.66
19/05/2025,19/05/2025,Supplier Payment - ExpertNet Subcontractors #11,Supplier Payment,PS-GL,37463.01,0,EUR,SEPA Debit,ExpertNet Subcontractors #11,***4430,,PO-202505-PS-GL-0010,FALSE,FALSE,REF-547665,First Continental Bank,***6286,Globex EMEA Manufacturing Ltd.,IE,-7686265.67
19/05/2025,19/05/2025,Supplier Payment - Stelliform Parts BV #29,Supplier Payment,CEM-EMEA,69872.32,0,EUR,SWIFT MT103,Stelliform Parts BV #29,***4098,,PO-202505-CEM-EMEA-0003,FALSE,FALSE,REF-953480,First Continental Bank,***9501,Globex EMEA Manufacturing Ltd.,IE,-7756137.99
19/05/2025,19/05/2025,VAT/GST Remittance - Revenue Ireland,Tax Payment,ALL,124354.07,0,EUR,SEPA Credit Transfer,Revenue Ireland,***4229,,,FALSE,FALSE,REF-756278,First Continental Bank,***9431,Globex EMEA Manufacturing Ltd.,IE,-7880492.06
19/05/2025,19/05/2025,Client Receipt - CloudBridge Co. #37,Sales Receipt,SaaS-GL,0,22531.72,EUR,Card Settlement,CloudBridge Co. #37,***9987,INV-202505-SaaS-GL-0021,,FALSE,FALSE,REF-438103,First Continental Bank,***2670,Globex EMEA Manufacturing Ltd.,IE,-7857960.34
19/05/2025,19/05/2025,Client Receipt - Aurora Electronics GmbH #5,Sales Receipt,CEM-EMEA,0,34736.5,EUR,SEPA SCT,Aurora Electronics GmbH #5,***2275,INV-202505-CEM-EMEA-0010,,FALSE,FALSE,REF-258260,First Continental Bank,***9777,Globex EMEA Manufacturing Ltd.,IE,-7823223.84
20/05/2025,20/05/2025,Supplier Payment - Stelliform Parts BV #16,Supplier Payment,CEM-EMEA,45403.02,0,EUR,SEPA Debit,Stelliform Parts BV #16,***8678,,PO-202505-CEM-EMEA-0002,FALSE,FALSE,REF-558853,First Continental Bank,***6233,Globex EMEA Manufacturing Ltd.,IE,-7868626.86
20/05/2025,20/05/2025,Client Receipt - CloudBridge Co. #14,Sales Receipt,SaaS-GL,0,10746.45,EUR,Card Settlement,CloudBridge Co. #14,***2359,INV-202505-SaaS-GL-0008,,FALSE,FALSE,REF-319924,First Continental Bank,***4788,Globex EMEA Manufacturing Ltd.,IE,-7857880.41
20/05/2025,20/05/2025,Client Receipt - CloudBridge Co. #45,Sales Receipt,SaaS-GL,0,32167.67,EUR,SEPA SCT,CloudBridge Co. #45,***9344,INV-202505-SaaS-GL-0023,,FALSE,FALSE,REF-881193,First Continental Bank,***7179,Globex EMEA Manufacturing Ltd.,IE,-7825712.74
20/05/2025,20/05/2025,Client Receipt - Vertex Advisory Client #43,Sales Receipt,PS-GL,0,109464.88,EUR,SEPA SCT Inst,Vertex Advisory Client #43,***8772,INV-202505-PS-GL-0003,,FALSE,FALSE,REF-926613,First Continental Bank,***1105,Globex EMEA Manufacturing Ltd.,IE,-7716247.86
21/05/2025,21/05/2025,Merchant Processing Fees,Bank/Merchant Fees,ALL,1246.07,0,EUR,SEPA Credit Transfer,First Continental Bank,***5078,,,FALSE,FALSE,REF-896695,First Continental Bank,***5971,Globex EMEA Manufacturing Ltd.,IE,-7717493.93
21/05/2025,21/05/2025,Northshore Power,Rent & Utilities,ALL,6597.41,0,EUR,SEPA Credit Transfer,Northshore Power,***7086,,,FALSE,FALSE,REF-589625,First Continental Bank,***3248,Globex EMEA Manufacturing Ltd.,IE,-7724091.34
21/05/2025,21/05/2025,Marketing - Beacon Digital #1,Marketing,ALL,7373.46,0,EUR,SEPA Credit Transfer,Beacon Digital #1,***1675,,,FALSE,FALSE,REF-743269,First Continental Bank,***6856,Globex EMEA Manufacturing Ltd.,IE,-7731464.8
21/05/2025,21/05/2025,Client Receipt - CloudBridge Co. #63,Sales Receipt,SaaS-GL,0,37832.59,EUR,SEPA SCT,CloudBridge Co. #63,***5756,INV-202505-SaaS-GL-0004,,FALSE,FALSE,REF-804534,First Continental Bank,***4765,Globex EMEA Manufacturing Ltd.,IE,-7693632.21
22/05/2025,22/05/2025,Supplier Payment - Stelliform Parts BV #9,Supplier Payment,CEM-EMEA,42902.5,0,EUR,SEPA Debit,Stelliform Parts BV #9,***9048,,PO-202505-CEM-EMEA-0010,FALSE,FALSE,REF-873959,First Continental Bank,***7363,Globex EMEA Manufacturing Ltd.,IE,-7736534.71
22/05/2025,22/05/2025,Client Receipt - CloudBridge Co. #31,Sales Receipt,SaaS-GL,0,8292.72,EUR,SEPA SCT,CloudBridge Co. #31,***3228,INV-202505-SaaS-GL-0009,,FALSE,FALSE,REF-827118,First Continental Bank,***6690,Globex EMEA Manufacturing Ltd.,IE,-7728241.99
22/05/2025,22/05/2025,Client Receipt - CloudBridge Co. #2,Sales Receipt,SaaS-GL,0,31521.88,EUR,SEPA SCT Inst,CloudBridge Co. #2,***4856,INV-202505-SaaS-GL-0029,,FALSE,FALSE,REF-137814,First Continental Bank,***3246,Globex EMEA Manufacturing Ltd.,IE,-7696720.11
23/05/2025,23/05/2025,Supplier Payment - CodeCraft Contractors #4,Supplier Payment,SaaS-GL,8913.3,0,EUR,SEPA Credit Transfer,CodeCraft Contractors #4,***2166,,PO-202505-SaaS-GL-0004,FALSE,FALSE,REF-643627,First Continental Bank,***1292,Globex EMEA Manufacturing Ltd.,IE,-7705633.41
24/05/2025,24/05/2025,Supplier Payment - ExpertNet Subcontractors #4,Supplier Payment,PS-GL,21769.45,0,EUR,SWIFT MT103,ExpertNet Subcontractors #4,***2517,,PO-202505-PS-GL-0002,FALSE,FALSE,REF-351344,First Continental Bank,***6857,Globex EMEA Manufacturing Ltd.,IE,-7727402.86
24/05/2025,24/05/2025,Client Receipt - Novatek Components Ltd #11,Sales Receipt,CEM-EMEA,0,108034.15,EUR,SEPA SCT Inst,Novatek Components Ltd #11,***3441,INV-202505-CEM-EMEA-0003,,FALSE,FALSE,REF-195828,First Continental Bank,***3140,Globex EMEA Manufacturing Ltd.,IE,-7619368.71
25/05/2025,25/05/2025,Client Receipt - CloudBridge Co. #56,Sales Receipt,SaaS-GL,0,26328.3,EUR,SEPA SCT,CloudBridge Co. #56,***4261,INV-202505-SaaS-GL-0016,,FALSE,FALSE,REF-899995,First Continental Bank,***8920,Globex EMEA Manufacturing Ltd.,IE,-7593040.41
26/05/2025,26/05/2025,Supplier Payment - CodeCraft Contractors #6,Supplier Payment,SaaS-GL,47612.02,0,EUR,SWIFT MT103,CodeCraft Contractors #6,***5992,,PO-202505-SaaS-GL-0009,FALSE,FALSE,REF-642784,First Continental Bank,***2137,Globex EMEA Manufacturing Ltd.,IE,-7640652.43
26/05/2025,26/05/2025,Intercompany Settlement - Globex APAC Logistics Pte. Ltd.,Intercompany Transfer,ALL,856907,0,EUR,Internal Transfer,Globex APAC Logistics Pte. Ltd.,***5036,,,TRUE,TRUE,REF-528624,First Continental Bank,***8378,Globex EMEA Manufacturing Ltd.,IE,-8497559.43
27/05/2025,27/05/2025,Supplier Payment - Stelliform Parts BV #22,Supplier Payment,CEM-EMEA,152122.12,0,EUR,SEPA Credit Transfer,Stelliform Parts BV #22,***9641,,PO-202505-CEM-EMEA-0006,FALSE,FALSE,REF-323710,First Continental Bank,***6865,Globex EMEA Manufacturing Ltd.,IE,-8649681.55
27/05/2025,27/05/2025,Payroll - GlobalPay Services Ltd,Payroll,ALL,171019.14,0,EUR,SWIFT MT103,GlobalPay Services Ltd,***7161,,,FALSE,FALSE,REF-820172,First Continental Bank,***6719,Globex EMEA Manufacturing Ltd.,IE,-8820700.69
27/05/2025,27/05/2025,Client Receipt - Vertex Advisory Client #51,Sales Receipt,PS-GL,0,89862.73,EUR,SEPA SCT,Vertex Advisory Client #51,***9954,INV-202505-PS-GL-0006,,FALSE,FALSE,REF-221360,First Continental Bank,***3858,Globex EMEA Manufacturing Ltd.,IE,-8730837.96
28/05/2025,28/05/2025,Payroll - GlobalPay Services Ltd,Payroll,ALL,171019.14,0,EUR,SEPA Debit,GlobalPay Services Ltd,***7607,,,FALSE,FALSE,REF-441577,First Continental Bank,***4649,Globex EMEA Manufacturing Ltd.,IE,-8901857.1
28/05/2025,28/05/2025,Client Receipt - Vertex Advisory Client #6,Sales Receipt,PS-GL,0,87064.98,EUR,SEPA SCT Inst,Vertex Advisory Client #6,***1350,INV-202505-PS-GL-0008,,FALSE,FALSE,REF-178924,First Continental Bank,***8769,Globex EMEA Manufacturing Ltd.,IE,-8814792.12
29/05/2025,29/05/2025,Supplier Payment - HyperCloud Infra #19,Supplier Payment,SaaS-GL,22365.79,0,EUR,SWIFT MT103,HyperCloud Infra #19,***1221,,PO-202505-SaaS-GL-0008,FALSE,FALSE,REF-905307,First Continental Bank,***9226,Globex EMEA Manufacturing Ltd.,IE,-8837157.91
29/05/2025,29/05/2025,Client Receipt - Vertex Advisory Client #57,Sales Receipt,PS-GL,0,23981.09,EUR,SEPA SCT,Vertex Advisory Client #57,***2173,INV-202505-PS-GL-0010,,FALSE,FALSE,REF-742449,First Continental Bank,***9496,Globex EMEA Manufacturing Ltd.,IE,-8813176.82
29/05/2025,29/05/2025,Client Receipt - Vertex Advisory Client #48,Sales Receipt,PS-GL,0,27283.44,EUR,SEPA SCT,Vertex Advisory Client #48,***7102,INV-202505-PS-GL-0002,,FALSE,FALSE,REF-902673,First Continental Bank,***7742,Globex EMEA Manufacturing Ltd.,IE,-8785893.38
29/05/2025,29/05/2025,Client Receipt - Aurora Electronics GmbH #17,Sales Receipt,CEM-EMEA,0,61699.28,EUR,Card Settlement,Aurora Electronics GmbH #17,***7182,INV-202505-CEM-EMEA-0007,,FALSE,FALSE,REF-820519,First Continental Bank,***8500,Globex EMEA Manufacturing Ltd.,IE,-8724194.1
30/05/2025,30/05/2025,Supplier Payment - EuroFab Assembly #12,Supplier Payment,CEM-EMEA,29627.95,0,EUR,SEPA Debit,EuroFab Assembly #12,***6761,,PO-202505-CEM-EMEA-0008,FALSE,FALSE,REF-746183,First Continental Bank,***4102,Globex EMEA Manufacturing Ltd.,IE,-8753822.05
30/05/2025,30/05/2025,Interest Earned,Interest Income,ALL,0,11079.46,EUR,SEPA SCT Inst,First Continental Bank,***5855,,,FALSE,FALSE,REF-432086,First Continental Bank,***9950,Globex EMEA Manufacturing Ltd.,IE,-8742742.59
30/05/2025,30/05/2025,Client Receipt - CloudBridge Co. #56,Sales Receipt,SaaS-GL,0,14719.87,EUR,Card Settlement,CloudBridge Co. #56,***8156,INV-202505-SaaS-GL-0022,,FALSE,FALSE,REF-437739,First Continental Bank,***4996,Globex EMEA Manufacturing Ltd.,IE,-8728022.72
30/05/2025,30/05/2025,Client Receipt - CloudBridge Co. #50,Sales Receipt,SaaS-GL,0,39680.66,EUR,SEPA SCT,CloudBridge Co. #50,***6428,INV-202505-SaaS-GL-0001,,FALSE,FALSE,REF-712019,First Continental Bank,***9571,Globex EMEA Manufacturing Ltd.,IE,-8688342.06
01/06/2025,01/06/2025,Account Maintenance Fee,Bank/Merchant Fees,ALL,2500,0,EUR,SEPA Credit Transfer,First Continental Bank,***3562,,,FALSE,FALSE,REF-316487,First Continental Bank,***9273,Globex EMEA Manufacturing Ltd.,IE,-8690842.06
02/06/2025,02/06/2025,Supplier Payment - CodeCraft Contractors #10,Supplier Payment,SaaS-GL,9731.25,0,EUR,SEPA Debit,CodeCraft Contractors #10,***2958,,PO-202506-SaaS-GL-0007,FALSE,FALSE,REF-981719,First Continental Bank,***6136,Globex EMEA Manufacturing Ltd.,IE,-8700573.31
02/06/2025,02/06/2025,Supplier Payment - Stelliform Parts BV #16,Supplier Payment,CEM-EMEA,17856.68,0,EUR,SEPA Credit Transfer,Stelliform Parts BV #16,***7781,,PO-202506-CEM-EMEA-0001,FALSE,FALSE,REF-995783,First Continental Bank,***8676,Globex EMEA Manufacturing Ltd.,IE,-8718429.99
02/06/2025,02/06/2025,Client Receipt - CloudBridge Co. #8,Sales Receipt,SaaS-GL,0,6737.37,EUR,Card Settlement,CloudBridge Co. #8,***6578,INV-202506-SaaS-GL-0016,,FALSE,FALSE,REF-125711,First Continental Bank,***9128,Globex EMEA Manufacturing Ltd.,IE,-8711692.62
02/06/2025,02/06/2025,Client Receipt - Aurora Electronics GmbH #2,Sales Receipt,CEM-EMEA,0,28409.54,EUR,SEPA SCT,Aurora Electronics GmbH #2,***1028,INV-202506-CEM-EMEA-0005,,FALSE,FALSE,REF-496143,First Continental Bank,***1869,Globex EMEA Manufacturing Ltd.,IE,-8683283.08
03/06/2025,03/06/2025,Supplier Payment - ExpertNet Subcontractors #17,Supplier Payment,PS-GL,4909.04,0,EUR,SEPA Debit,ExpertNet Subcontractors #17,***8899,,PO-202506-PS-GL-0005,FALSE,FALSE,REF-620521,First Continental Bank,***6523,Globex EMEA Manufacturing Ltd.,IE,-8688192.12
03/06/2025,03/06/2025,Supplier Payment - ExpertNet Subcontractors #18,Supplier Payment,PS-GL,7608.01,0,EUR,SEPA Credit Transfer,ExpertNet Subcontractors #18,***4902,,PO-202506-PS-GL-0011,FALSE,FALSE,REF-898392,First Continental Bank,***9802,Globex EMEA Manufacturing Ltd.,IE,-8695800.13
03/06/2025,03/06/2025,Supplier Payment - EuroFab Assembly #2,Supplier Payment,CEM-EMEA,105912.01,0,EUR,SEPA Debit,EuroFab Assembly #2,***9111,,PO-202506-CEM-EMEA-0007,FALSE,FALSE,REF-787998,First Continental Bank,***4236,Globex EMEA Manufacturing Ltd.,IE,-8801712.14
03/06/2025,03/06/2025,Client Receipt - CloudBridge Co. #79,Sales Receipt,SaaS-GL,0,10038.39,EUR,SEPA SCT Inst,CloudBridge Co. #79,***8229,INV-202506-SaaS-GL-0007,,FALSE,FALSE,REF-868114,First Continental Bank,***5665,Globex EMEA Manufacturing Ltd.,IE,-8791673.75
03/06/2025,03/06/2025,Client Receipt - Vertex Advisory Client #17,Sales Receipt,PS-GL,0,118647.53,EUR,SEPA SCT,Vertex Advisory Client #17,***3029,INV-202506-PS-GL-0004,,FALSE,FALSE,REF-256507,First Continental Bank,***7781,Globex EMEA Manufacturing Ltd.,IE,-8673026.22
04/06/2025,04/06/2025,Client Receipt - CloudBridge Co. #39,Sales Receipt,SaaS-GL,0,4344.7,EUR,SEPA SCT,CloudBridge Co. #39,***5327,INV-202506-SaaS-GL-0011,,FALSE,FALSE,REF-968049,First Continental Bank,***1532,Globex EMEA Manufacturing Ltd.,IE,-8668681.52
04/06/2025,04/06/2025,Client Receipt - Aurora Electronics GmbH #3,Sales Receipt,CEM-EMEA,0,12347.02,EUR,SEPA SCT,Aurora Electronics GmbH #3,***5293,INV-202506-CEM-EMEA-0009,,FALSE,FALSE,REF-961112,First Continental Bank,***7019,Globex EMEA Manufacturing Ltd.,IE,-8656334.5
04/06/2025,04/06/2025,Client Receipt - CloudBridge Co. #65,Sales Receipt,SaaS-GL,0,17207.58,EUR,Card Settlement,CloudBridge Co. #65,***8757,INV-202506-SaaS-GL-0029,,FALSE,FALSE,REF-377607,First Continental Bank,***6549,Globex EMEA Manufacturing Ltd.,IE,-8639126.92
04/06/2025,04/06/2025,Client Receipt - CloudBridge Co. #62,Sales Receipt,SaaS-GL,0,52643.21,EUR,SEPA SCT,CloudBridge Co. #62,***4066,INV-202506-SaaS-GL-0013,,FALSE,FALSE,REF-614673,First Continental Bank,***2884,Globex EMEA Manufacturing Ltd.,IE,-8586483.71
04/06/2025,04/06/2025,Client Receipt - Novatek Components Ltd #10,Sales Receipt,CEM-EMEA,0,216589.11,EUR,SEPA SCT Inst,Novatek Components Ltd #10,***8526,INV-202506-CEM-EMEA-0017,,FALSE,FALSE,REF-558847,First Continental Bank,***4840,Globex EMEA Manufacturing Ltd.,IE,-8369894.6
05/06/2025,05/06/2025,Supplier Payment - ExpertNet Subcontractors #4,Supplier Payment,PS-GL,4256.26,0,EUR,SEPA Credit Transfer,ExpertNet Subcontractors #4,***8886,,PO-202506-PS-GL-0006,FALSE,FALSE,REF-261316,First Continental Bank,***4557,Globex EMEA Manufacturing Ltd.,IE,-8374150.86
05/06/2025,05/06/2025,Supplier Payment - ExpertNet Subcontractors #9,Supplier Payment,PS-GL,10476.31,0,EUR,SEPA Credit Transfer,ExpertNet Subcontractors #9,***6610,,PO-202506-PS-GL-0004,FALSE,FALSE,REF-782818,First Continental Bank,***4941,Globex EMEA Manufacturing Ltd.,IE,-8384627.17
05/06/2025,05/06/2025,Client Receipt - Novatek Components Ltd #1,Sales Receipt,CEM-EMEA,0,19316.71,EUR,Card Settlement,Novatek Components Ltd #1,***2020,INV-202506-CEM-EMEA-0002,,FALSE,FALSE,REF-491643,First Continental Bank,***4611,Globex EMEA Manufacturing Ltd.,IE,-8365310.46
05/06/2025,05/06/2025,Client Receipt - CloudBridge Co. #26,Sales Receipt,SaaS-GL,0,26845.37,EUR,SEPA SCT,CloudBridge Co. #26,***8503,INV-202506-SaaS-GL-0009,,FALSE,FALSE,REF-503660,First Continental Bank,***1868,Globex EMEA Manufacturing Ltd.,IE,-8338465.09
06/06/2025,06/06/2025,Supplier Payment - ExpertNet Subcontractors #5,Supplier Payment,PS-GL,11312.48,0,EUR,SEPA Debit,ExpertNet Subcontractors #5,***2878,,PO-202506-PS-GL-0001,FALSE,FALSE,REF-857465,First Continental Bank,***4915,Globex EMEA Manufacturing Ltd.,IE,-8349777.57
06/06/2025,06/06/2025,Marketing - Beacon Digital #5,Marketing,ALL,38716.72,0,EUR,SEPA Credit Transfer,Beacon Digital #5,***8018,,,FALSE,FALSE,REF-987004,First Continental Bank,***7034,Globex EMEA Manufacturing Ltd.,IE,-8388494.29
07/06/2025,07/06/2025,Supplier Payment - CodeCraft Contractors #11,Supplier Payment,SaaS-GL,49208.47,0,EUR,SWIFT MT103,CodeCraft Contractors #11,***9482,,PO-202506-SaaS-GL-0005,FALSE,FALSE,REF-836501,First Continental Bank,***2003,Globex EMEA Manufacturing Ltd.,IE,-8437702.76
08/06/2025,08/06/2025,Client Receipt - Novatek Components Ltd #10,Sales Receipt,CEM-EMEA,0,998.35,EUR,SEPA SCT Inst,Novatek Components Ltd #10,***9070,INV-202506-CEM-EMEA-0001,,FALSE,FALSE,REF-285590,First Continental Bank,***6764,Globex EMEA Manufacturing Ltd.,IE,-8436704.41
08/06/2025,08/06/2025,Client Receipt - CloudBridge Co. #58,Sales Receipt,SaaS-GL,0,14465.61,EUR,SEPA SCT Inst,CloudBridge Co. #58,***7544,INV-202506-SaaS-GL-0010,,FALSE,FALSE,REF-623544,First Continental Bank,***9780,Globex EMEA Manufacturing Ltd.,IE,-8422238.8
08/06/2025,08/06/2025,Client Receipt - Novatek Components Ltd #12,Sales Receipt,CEM-EMEA,0,120758.73,EUR,SEPA SCT,Novatek Components Ltd #12,***8763,INV-202506-CEM-EMEA-0011,,FALSE,FALSE,REF-824200,First Continental Bank,***4976,Globex EMEA Manufacturing Ltd.,IE,-8301480.07
09/06/2025,09/06/2025,Merchant Processing Fees,Bank/Merchant Fees,ALL,4198.59,0,EUR,SWIFT MT103,First Continental Bank,***3706,,,FALSE,FALSE,REF-831275,First Continental Bank,***6923,Globex EMEA Manufacturing Ltd.,IE,-8305678.66
09/06/2025,09/06/2025,Metro Water & Waste,Rent & Utilities,ALL,12339.26,0,EUR,SEPA Credit Transfer,Metro Water & Waste,***9161,,,FALSE,FALSE,REF-217300,First Continental Bank,***4741,Globex EMEA Manufacturing Ltd.,IE,-8318017.92
09/06/2025,09/06/2025,Supplier Payment - ExpertNet Subcontractors #15,Supplier Payment,PS-GL,28400.77,0,EUR,SWIFT MT103,ExpertNet Subcontractors #15,***2032,,PO-202506-PS-GL-0010,FALSE,FALSE,REF-888430,First Continental Bank,***5922,Globex EMEA Manufacturing Ltd.,IE,-8346418.69
09/06/2025,09/06/2025,Client Receipt - Aurora Electronics GmbH #18,Sales Receipt,CEM-EMEA,0,22561.46,EUR,SEPA SCT Inst,Aurora Electronics GmbH #18,***9449,INV-202506-CEM-EMEA-0004,,FALSE,FALSE,REF-119935,First Continental Bank,***5072,Globex EMEA Manufacturing Ltd.,IE,-8323857.23
09/06/2025,09/06/2025,Client Receipt - CloudBridge Co. #52,Sales Receipt,SaaS-GL,0,31185.74,EUR,Card Settlement,CloudBridge Co. #52,***5758,INV-202506-SaaS-GL-0026,,FALSE,FALSE,REF-589440,First Continental Bank,***9413,Globex EMEA Manufacturing Ltd.,IE,-8292671.49
09/06/2025,09/06/2025,Client Receipt - Aurora Electronics GmbH #8,Sales Receipt,CEM-EMEA,0,42934.33,EUR,SEPA SCT,Aurora Electronics GmbH #8,***4596,INV-202506-CEM-EMEA-0018,,FALSE,FALSE,REF-436135,First Continental Bank,***1174,Globex EMEA Manufacturing Ltd.,IE,-8249737.16
10/06/2025,10/06/2025,Supplier Payment - CodeCraft Contractors #13,Supplier Payment,SaaS-GL,7800.92,0,EUR,SEPA Debit,CodeCraft Contractors #13,***6249,,PO-202506-SaaS-GL-0009,FALSE,FALSE,REF-699866,First Continental Bank,***1486,Globex EMEA Manufacturing Ltd.,IE,-8257538.08
10/06/2025,10/06/2025,Client Receipt - CloudBridge Co. #17,Sales Receipt,SaaS-GL,0,30312.19,EUR,SEPA SCT Inst,CloudBridge Co. #17,***3876,INV-202506-SaaS-GL-0022,,FALSE,FALSE,REF-539315,First Continental Bank,***8979,Globex EMEA Manufacturing Ltd.,IE,-8227225.89
10/06/2025,10/06/2025,Client Receipt - CloudBridge Co. #70,Sales Receipt,SaaS-GL,0,33544.96,EUR,Card Settlement,CloudBridge Co. #70,***9016,INV-202506-SaaS-GL-0025,,FALSE,FALSE,REF-168303,First Continental Bank,***9251,Globex EMEA Manufacturing Ltd.,IE,-8193680.93
10/06/2025,10/06/2025,Client Receipt - CloudBridge Co. #59,Sales Receipt,SaaS-GL,0,33633.34,EUR,SEPA SCT,CloudBridge Co. #59,***2591,INV-202506-SaaS-GL-0005,,FALSE,FALSE,REF-765153,First Continental Bank,***5738,Globex EMEA Manufacturing Ltd.,IE,-8160047.59
10/06/2025,10/06/2025,Client Receipt - Aurora Electronics GmbH #19,Sales Receipt,CEM-EMEA,0,45468.97,EUR,Card Settlement,Aurora Electronics GmbH #19,***6836,INV-202506-CEM-EMEA-0003,,FALSE,FALSE,REF-101765,First Continental Bank,***7796,Globex EMEA Manufacturing Ltd.,IE,-8114578.62
11/06/2025,11/06/2025,Merchant Processing Fees,Bank/Merchant Fees,ALL,2251.75,0,EUR,SEPA Credit Transfer,First Continental Bank,***7555,,,FALSE,FALSE,REF-479477,First Continental Bank,***5624,Globex EMEA Manufacturing Ltd.,IE,-8116830.37
11/06/2025,11/06/2025,Client Receipt - CloudBridge Co. #76,Sales Receipt,SaaS-GL,0,48436.31,EUR,SEPA SCT Inst,CloudBridge Co. #76,***6958,INV-202506-SaaS-GL-0021,,FALSE,FALSE,REF-273056,First Continental Bank,***1624,Globex EMEA Manufacturing Ltd.,IE,-8068394.06
11/06/2025,11/06/2025,Client Receipt - CloudBridge Co. #15,Sales Receipt,SaaS-GL,0,59042.8,EUR,Card Settlement,CloudBridge Co. #15,***3051,INV-202506-SaaS-GL-0014,,FALSE,FALSE,REF-316166,First Continental Bank,***9724,Globex EMEA Manufacturing Ltd.,IE,-8009351.26
11/06/2025,11/06/2025,Client Receipt - Vertex Advisory Client #16,Sales Receipt,PS-GL,0,203341.4,EUR,SEPA SCT,Vertex Advisory Client #16,***2129,INV-202506-PS-GL-0002,,FALSE,FALSE,REF-152323,First Continental Bank,***6053,Globex EMEA Manufacturing Ltd.,IE,-7806009.86
12/06/2025,12/06/2025,Supplier Payment - ExpertNet Subcontractors #15,Supplier Payment,PS-GL,22750.99,0,EUR,SWIFT MT103,ExpertNet Subcontractors #15,***4476,,PO-202506-PS-GL-0009,FALSE,FALSE,REF-800262,First Continental Bank,***8123,Globex EMEA Manufacturing Ltd.,IE,-7828760.85
12/06/2025,12/06/2025,Intercompany Settlement - Globex Retail NA LLC,Intercompany Transfer,ALL,721848,0,EUR,Internal Transfer,Globex Retail NA LLC,***1030,,,TRUE,TRUE,REF-308645,First Continental Bank,***6982,Globex EMEA Manufacturing Ltd.,IE,-8550608.85
12/06/2025,12/06/2025,Client Receipt - CloudBridge Co. #16,Sales Receipt,SaaS-GL,0,32218.83,EUR,SEPA SCT Inst,CloudBridge Co. #16,***8566,INV-202506-SaaS-GL-0004,,FALSE,FALSE,REF-317561,First Continental Bank,***9452,Globex EMEA Manufacturing Ltd.,IE,-8518390.02
12/06/2025,12/06/2025,Intercompany Reimbursement - Globex Retail NA LLC,Intercompany Transfer,ALL,0,288739.2,EUR,Internal Transfer,Globex Retail NA LLC,***3777,,,TRUE,TRUE,REF-984757,First Continental Bank,***9652,Globex EMEA Manufacturing Ltd.,IE,-8229650.82
13/06/2025,13/06/2025,Supplier Payment - Stelliform Parts BV #18,Supplier Payment,CEM-EMEA,40372.17,0,EUR,SEPA Credit Transfer,Stelliform Parts BV #18,***2379,,PO-202506-CEM-EMEA-0009,FALSE,FALSE,REF-605866,First Continental Bank,***7959,Globex EMEA Manufacturing Ltd.,IE,-8270022.99
13/06/2025,13/06/2025,Client Receipt - CloudBridge Co. #61,Sales Receipt,SaaS-GL,0,25200.48,EUR,Card Settlement,CloudBridge Co. #61,***3729,INV-202506-SaaS-GL-0020,,FALSE,FALSE,REF-971975,First Continental Bank,***1103,Globex EMEA Manufacturing Ltd.,IE,-8244822.51
13/06/2025,13/06/2025,Client Receipt - Aurora Electronics GmbH #8,Sales Receipt,CEM-EMEA,0,45077.3,EUR,SEPA SCT Inst,Aurora Electronics GmbH #8,***1931,INV-202506-CEM-EMEA-0014,,FALSE,FALSE,REF-883137,First Continental Bank,***6430,Globex EMEA Manufacturing Ltd.,IE,-8199745.21
14/06/2025,14/06/2025,Client Receipt - CloudBridge Co. #73,Sales Receipt,SaaS-GL,0,10831.1,EUR,SEPA SCT,CloudBridge Co. #73,***3279,INV-202506-SaaS-GL-0012,,FALSE,FALSE,REF-959075,First Continental Bank,***1268,Globex EMEA Manufacturing Ltd.,IE,-8188914.11
14/06/2025,14/06/2025,Client Receipt - Novatek Components Ltd #9,Sales Receipt,CEM-EMEA,0,49150.29,EUR,Card Settlement,Novatek Components Ltd #9,***1512,INV-202506-CEM-EMEA-0010,,FALSE,FALSE,REF-843117,First Continental Bank,***7016,Globex EMEA Manufacturing Ltd.,IE,-8139763.82
15/06/2025,15/06/2025,Loan Interest Payment,Loan Interest,ALL,85000,0,EUR,SEPA Debit,First Continental Bank - Corporate Lending,***9336,,,FALSE,FALSE,REF-299706,First Continental Bank,***8797,Globex EMEA Manufacturing Ltd.,IE,-8224763.82
15/06/2025,15/06/2025,Loan Principal Repayment,Loan Principal,ALL,500000,0,EUR,SEPA Credit Transfer,First Continental Bank - Corporate Lending,***4669,,,FALSE,FALSE,REF-366742,First Continental Bank,***4339,Globex EMEA Manufacturing Ltd.,IE,-8724763.82
15/06/2025,15/06/2025,Client Receipt - CloudBridge Co. #18,Sales Receipt,SaaS-GL,0,271.07,EUR,Card Settlement,CloudBridge Co. #18,***4878,INV-202506-SaaS-GL-0008,,FALSE,FALSE,REF-176903,First Continental Bank,***2277,Globex EMEA Manufacturing Ltd.,IE,-8724492.75
16/06/2025,16/06/2025,Client Receipt - Novatek Components Ltd #4,Sales Receipt,CEM-EMEA,0,94641.89,EUR,SEPA SCT,Novatek Components Ltd #4,***9952,INV-202506-CEM-EMEA-0013,,FALSE,FALSE,REF-808459,First Continental Bank,***9858,Globex EMEA Manufacturing Ltd.,IE,-8629850.86
17/06/2025,17/06/2025,Supplier Payment - ExpertNet Subcontractors #13,Supplier Payment,PS-GL,14205.39,0,EUR,SEPA Debit,ExpertNet Subcontractors #13,***8647,,PO-202506-PS-GL-0002,FALSE,FALSE,REF-590447,First Continental Bank,***5432,Globex EMEA Manufacturing Ltd.,IE,-8644056.25
17/06/2025,17/06/2025,Supplier Payment - ExpertNet Subcontractors #9,Supplier Payment,PS-GL,16605.2,0,EUR,SWIFT MT103,ExpertNet Subcontractors #9,***8668,,PO-202506-PS-GL-0007,FALSE,FALSE,REF-864332,First Continental Bank,***5477,Globex EMEA Manufacturing Ltd.,IE,-8660661.45
17/06/2025,17/06/2025,Client Receipt - Vertex Advisory Client #42,Sales Receipt,PS-GL,0,9393.22,EUR,SEPA SCT,Vertex Advisory Client #42,***9414,INV-202506-PS-GL-0007,,FALSE,FALSE,REF-513616,First Continental Bank,***3549,Globex EMEA Manufacturing Ltd.,IE,-8651268.23
17/06/2025,17/06/2025,Client Receipt - Vertex Advisory Client #9,Sales Receipt,PS-GL,0,12535.55,EUR,SEPA SCT,Vertex Advisory Client #9,***1294,INV-202506-PS-GL-0008,,FALSE,FALSE,REF-698733,First Continental Bank,***8886,Globex EMEA Manufacturing Ltd.,IE,-8638732.68
17/06/2025,17/06/2025,Client Receipt - CloudBridge Co. #47,Sales Receipt,SaaS-GL,0,16987.46,EUR,Card Settlement,CloudBridge Co. #47,***9888,INV-202506-SaaS-GL-0024,,FALSE,FALSE,REF-502879,First Continental Bank,***2152,Globex EMEA Manufacturing Ltd.,IE,-8621745.22
17/06/2025,17/06/2025,Client Receipt - CloudBridge Co. #72,Sales Receipt,SaaS-GL,0,26847.46,EUR,SEPA SCT,CloudBridge Co. #72,***3504,INV-202506-SaaS-GL-0019,,FALSE,FALSE,REF-792488,First Continental Bank,***5768,Globex EMEA Manufacturing Ltd.,IE,-8594897.76
17/06/2025,17/06/2025,Client Receipt - Vertex Advisory Client #57,Sales Receipt,PS-GL,0,47970.19,EUR,SEPA SCT Inst,Vertex Advisory Client #57,***4187,INV-202506-PS-GL-0006,,FALSE,FALSE,REF-457995,First Continental Bank,***7901,Globex EMEA Manufacturing Ltd.,IE,-8546927.57
18/06/2025,18/06/2025,Supplier Payment - ExpertNet Subcontractors #10,Supplier Payment,PS-GL,3726.31,0,EUR,SWIFT MT103,ExpertNet Subcontractors #10,***6550,,PO-202506-PS-GL-0008,FALSE,FALSE,REF-777573,First Continental Bank,***3797,Globex EMEA Manufacturing Ltd.,IE,-8550653.88
18/06/2025,18/06/2025,Marketing - Aurelia Media #2,Marketing,ALL,16309.55,0,EUR,SEPA Credit Transfer,Aurelia Media #2,***7104,,,FALSE,FALSE,REF-490468,First Continental Bank,***4054,Globex EMEA Manufacturing Ltd.,IE,-8566963.43
18/06/2025,18/06/2025,Supplier Payment - EuroFab Assembly #22,Supplier Payment,CEM-EMEA,65609.75,0,EUR,SEPA Credit Transfer,EuroFab Assembly #22,***9573,,PO-202506-CEM-EMEA-0005,FALSE,FALSE,REF-124353,First Continental Bank,***7713,Globex EMEA Manufacturing Ltd.,IE,-8632573.18
18/06/2025,18/06/2025,Supplier Payment - EuroFab Assembly #1,Supplier Payment,CEM-EMEA,103126.18,0,EUR,SEPA Credit Transfer,EuroFab Assembly #1,***8675,,PO-202506-CEM-EMEA-0006,FALSE,FALSE,REF-743803,First Continental Bank,***3821,Globex EMEA Manufacturing Ltd.,IE,-8735699.36
18/06/2025,18/06/2025,Supplier Payment - Stelliform Parts BV #25,Supplier Payment,CEM-EMEA,168734.11,0,EUR,SEPA Debit,Stelliform Parts BV #25,***1444,,PO-202506-CEM-EMEA-0004,FALSE,FALSE,REF-753904,First Continental Bank,***4984,Globex EMEA Manufacturing Ltd.,IE,-8904433.47
19/06/2025,19/06/2025,Client Receipt - Vertex Advisory Client #23,Sales Receipt,PS-GL,0,4312.37,EUR,SEPA SCT Inst,Vertex Advisory Client #23,***8148,INV-202506-PS-GL-0009,,FALSE,FALSE,REF-664532,First Continental Bank,***1852,Globex EMEA Manufacturing Ltd.,IE,-8900121.1
19/06/2025,19/06/2025,Client Receipt - CloudBridge Co. #71,Sales Receipt,SaaS-GL,0,5216.25,EUR,Card Settlement,CloudBridge Co. #71,***5386,INV-202506-SaaS-GL-0023,,FALSE,FALSE,REF-229468,First Continental Bank,***8428,Globex EMEA Manufacturing Ltd.,IE,-8894904.85
19/06/2025,19/06/2025,Client Receipt - CloudBridge Co. #47,Sales Receipt,SaaS-GL,0,9434.4,EUR,SEPA SCT Inst,CloudBridge Co. #47,***4605,INV-202506-SaaS-GL-0002,,FALSE,FALSE,REF-208238,First Continental Bank,***2912,Globex EMEA Manufacturing Ltd.,IE,-8885470.45
19/06/2025,19/06/2025,Client Receipt - Vertex Advisory Client #33,Sales Receipt,PS-GL,0,20003.18,EUR,Card Settlement,Vertex Advisory Client #33,***5764,INV-202506-PS-GL-0003,,FALSE,FALSE,REF-687618,First Continental Bank,***5389,Globex EMEA Manufacturing Ltd.,IE,-8865467.27
20/06/2025,20/06/2025,Supplier Payment - ExpertNet Subcontractors #14,Supplier Payment,PS-GL,4780.47,0,EUR,SWIFT MT103,ExpertNet Subcontractors #14,***9350,,PO-202506-PS-GL-0003,FALSE,FALSE,REF-687295,First Continental Bank,***7581,Globex EMEA Manufacturing Ltd.,IE,-8870247.74
20/06/2025,20/06/2025,Client Receipt - CloudBridge Co. #45,Sales Receipt,SaaS-GL,0,9702.75,EUR,SEPA SCT,CloudBridge Co. #45,***8996,INV-202506-SaaS-GL-0001,,FALSE,FALSE,REF-944243,First Continental Bank,***5662,Globex EMEA Manufacturing Ltd.,IE,-8860544.99
20/06/2025,20/06/2025,Client Receipt - CloudBridge Co. #11,Sales Receipt,SaaS-GL,0,32528.08,EUR,Card Settlement,CloudBridge Co. #11,***3126,INV-202506-SaaS-GL-0003,,FALSE,FALSE,REF-961864,First Continental Bank,***5312,Globex EMEA Manufacturing Ltd.,IE,-8828016.91
21/06/2025,21/06/2025,Supplier Payment - CodeCraft Contractors #10,Supplier Payment,SaaS-GL,7410.93,0,EUR,SWIFT MT103,CodeCraft Contractors #10,***7230,,PO-202506-SaaS-GL-0008,FALSE,FALSE,REF-594291,First Continental Bank,***9759,Globex EMEA Manufacturing Ltd.,IE,-8835427.84
21/06/2025,21/06/2025,Client Receipt - CloudBridge Co. #24,Sales Receipt,SaaS-GL,0,13995.31,EUR,SEPA SCT,CloudBridge Co. #24,***7212,INV-202506-SaaS-GL-0006,,FALSE,FALSE,REF-685417,First Continental Bank,***9550,Globex EMEA Manufacturing Ltd.,IE,-8821432.53
22/06/2025,22/06/2025,VAT/GST Remittance - Revenue Ireland,Tax Payment,ALL,129936.86,0,EUR,SWIFT MT103,Revenue Ireland,***5768,,,FALSE,FALSE,REF-348929,First Continental Bank,***2310,Globex EMEA Manufacturing Ltd.,IE,-8951369.39
22/06/2025,22/06/2025,Client Receipt - Aurora Electronics GmbH #2,Sales Receipt,CEM-EMEA,0,61113.17,EUR,Card Settlement,Aurora Electronics GmbH #2,***5130,INV-202506-CEM-EMEA-0015,,FALSE,FALSE,REF-408456,First Continental Bank,***8247,Globex EMEA Manufacturing Ltd.,IE,-8890256.22
23/06/2025,23/06/2025,Client Receipt - CloudBridge Co. #4,Sales Receipt,SaaS-GL,0,2524.88,EUR,SEPA SCT Inst,CloudBridge Co. #4,***2995,INV-202506-SaaS-GL-0027,,FALSE,FALSE,REF-805464,First Continental Bank,***6012,Globex EMEA Manufacturing Ltd.,IE,-8887731.34
23/06/2025,23/06/2025,Client Receipt - Aurora Electronics GmbH #13,Sales Receipt,CEM-EMEA,0,15843.46,EUR,SEPA SCT Inst,Aurora Electronics GmbH #13,***7519,INV-202506-CEM-EMEA-0006,,FALSE,FALSE,REF-777316,First Continental Bank,***5774,Globex EMEA Manufacturing Ltd.,IE,-8871887.88
24/06/2025,24/06/2025,Supplier Payment - Stelliform Parts BV #26,Supplier Payment,CEM-EMEA,2828.54,0,EUR,SEPA Debit,Stelliform Parts BV #26,***4886,,PO-202506-CEM-EMEA-0003,FALSE,FALSE,REF-302264,First Continental Bank,***5453,Globex EMEA Manufacturing Ltd.,IE,-8874716.42
24/06/2025,24/06/2025,Supplier Payment - Stelliform Parts BV #25,Supplier Payment,CEM-EMEA,31987.28,0,EUR,SEPA Debit,Stelliform Parts BV #25,***9767,,PO-202506-CEM-EMEA-0002,FALSE,FALSE,REF-260556,First Continental Bank,***8714,Globex EMEA Manufacturing Ltd.,IE,-8906703.7
24/06/2025,24/06/2025,Client Receipt - Novatek Components Ltd #13,Sales Receipt,CEM-EMEA,0,299.02,EUR,Card Settlement,Novatek Components Ltd #13,***2652,INV-202506-CEM-EMEA-0007,,FALSE,FALSE,REF-199817,First Continental Bank,***4849,Globex EMEA Manufacturing Ltd.,IE,-8906404.68
24/06/2025,24/06/2025,Client Receipt - CloudBridge Co. #6,Sales Receipt,SaaS-GL,0,7660.38,EUR,Card Settlement,CloudBridge Co. #6,***2350,INV-202506-SaaS-GL-0028,,FALSE,FALSE,REF-714033,First Continental Bank,***5371,Globex EMEA Manufacturing Ltd.,IE,-8898744.3
24/06/2025,24/06/2025,Client Receipt - CloudBridge Co. #59,Sales Receipt,SaaS-GL,0,32756.82,EUR,SEPA SCT Inst,CloudBridge Co. #59,***8381,INV-202506-SaaS-GL-0017,,FALSE,FALSE,REF-995575,First Continental Bank,***6706,Globex EMEA Manufacturing Ltd.,IE,-8865987.48
24/06/2025,24/06/2025,Client Receipt - CloudBridge Co. #49,Sales Receipt,SaaS-GL,0,38489.52,EUR,SEPA SCT Inst,CloudBridge Co. #49,***8520,INV-202506-SaaS-GL-0015,,FALSE,FALSE,REF-190393,First Continental Bank,***6561,Globex EMEA Manufacturing Ltd.,IE,-8827497.96
25/06/2025,25/06/2025,Supplier Payment - HyperCloud Infra #14,Supplier Payment,SaaS-GL,7617.08,0,EUR,SEPA Credit Transfer,HyperCloud Infra #14,***4690,,PO-202506-SaaS-GL-0004,FALSE,FALSE,REF-130709,First Continental Bank,***8323,Globex EMEA Manufacturing Ltd.,IE,-8835115.04
25/06/2025,25/06/2025,Supplier Payment - HyperCloud Infra #15,Supplier Payment,SaaS-GL,24731.21,0,EUR,SEPA Debit,HyperCloud Infra #15,***5152,,PO-202506-SaaS-GL-0002,FALSE,FALSE,REF-918358,First Continental Bank,***6534,Globex EMEA Manufacturing Ltd.,IE,-8859846.25
25/06/2025,25/06/2025,Client Receipt - Aurora Electronics GmbH #4,Sales Receipt,CEM-EMEA,0,76712.94,EUR,SEPA SCT,Aurora Electronics GmbH #4,***9301,INV-202506-CEM-EMEA-0008,,FALSE,FALSE,REF-351198,First Continental Bank,***1538,Globex EMEA Manufacturing Ltd.,IE,-8783133.31
26/06/2025,26/06/2025,Alphagrid Utilities,Rent & Utilities,ALL,4879.09,0,EUR,SEPA Debit,Alphagrid Utilities,***7945,,,FALSE,FALSE,REF-379433,First Continental Bank,***9245,Globex EMEA Manufacturing Ltd.,IE,-8788012.4
26/06/2025,26/06/2025,Supplier Payment - HyperCloud Infra #5,Supplier Payment,SaaS-GL,19920.25,0,EUR,SEPA Credit Transfer,HyperCloud Infra #5,***7707,,PO-202506-SaaS-GL-0001,FALSE,FALSE,REF-459184,First Continental Bank,***2698,Globex EMEA Manufacturing Ltd.,IE,-8807932.65
26/06/2025,26/06/2025,"Intercompany Settlement - Globex International Holdings, Inc.",Intercompany Transfer,ALL,192414,0,EUR,Internal Transfer,"Globex International Holdings, Inc.",***8029,,,TRUE,TRUE,REF-167283,First Continental Bank,***6236,Globex EMEA Manufacturing Ltd.,IE,-9000346.65
26/06/2025,26/06/2025,Client Receipt - Vertex Advisory Client #2,Sales Receipt,PS-GL,0,10202.28,EUR,SEPA SCT Inst,Vertex Advisory Client #2,***2055,INV-202506-PS-GL-0001,,FALSE,FALSE,REF-387103,First Continental Bank,***9183,Globex EMEA Manufacturing Ltd.,IE,-8990144.37
26/06/2025,26/06/2025,Client Receipt - Aurora Electronics GmbH #14,Sales Receipt,CEM-EMEA,0,60570.74,EUR,SEPA SCT Inst,Aurora Electronics GmbH #14,***6202,INV-202506-CEM-EMEA-0016,,FALSE,FALSE,REF-796806,First Continental Bank,***6412,Globex EMEA Manufacturing Ltd.,IE,-8929573.63
26/06/2025,26/06/2025,Client Receipt - Aurora Electronics GmbH #16,Sales Receipt,CEM-EMEA,0,117484.51,EUR,Card Settlement,Aurora Electronics GmbH #16,***3880,INV-202506-CEM-EMEA-0012,,FALSE,FALSE,REF-733173,First Continental Bank,***2817,Globex EMEA Manufacturing Ltd.,IE,-8812089.12
27/06/2025,27/06/2025,Supplier Payment - ExpertNet Subcontractors #1,Supplier Payment,PS-GL,3433.03,0,EUR,SWIFT MT103,ExpertNet Subcontractors #1,***8540,,PO-202506-PS-GL-0012,FALSE,FALSE,REF-576262,First Continental Bank,***8473,Globex EMEA Manufacturing Ltd.,IE,-8815522.15
27/06/2025,27/06/2025,Supplier Payment - CodeCraft Contractors #6,Supplier Payment,SaaS-GL,7547.97,0,EUR,SWIFT MT103,CodeCraft Contractors #6,***5769,,PO-202506-SaaS-GL-0003,FALSE,FALSE,REF-596256,First Continental Bank,***8136,Globex EMEA Manufacturing Ltd.,IE,-8823070.12
27/06/2025,27/06/2025,Supplier Payment - CodeCraft Contractors #9,Supplier Payment,SaaS-GL,11742.6,0,EUR,SEPA Credit Transfer,CodeCraft Contractors #9,***4404,,PO-202506-SaaS-GL-0006,FALSE,FALSE,REF-260219,First Continental Bank,***4975,Globex EMEA Manufacturing Ltd.,IE,-8834812.72
27/06/2025,27/06/2025,Supplier Payment - Stelliform Parts BV #14,Supplier Payment,CEM-EMEA,81739.81,0,EUR,SEPA Debit,Stelliform Parts BV #14,***2800,,PO-202506-CEM-EMEA-0008,FALSE,FALSE,REF-810601,First Continental Bank,***2588,Globex EMEA Manufacturing Ltd.,IE,-8916552.53
28/06/2025,28/06/2025,Payroll - GlobalPay Services Ltd,Payroll,ALL,336565.25,0,EUR,SWIFT MT103,GlobalPay Services Ltd,***2741,,,FALSE,FALSE,REF-245249,First Continental Bank,***7679,Globex EMEA Manufacturing Ltd.,IE,-9253117.78
28/06/2025,28/06/2025,Client Receipt - Vertex Advisory Client #4,Sales Receipt,PS-GL,0,15141.8,EUR,SEPA SCT Inst,Vertex Advisory Client #4,***7830,INV-202506-PS-GL-0005,,FALSE,FALSE,REF-476032,First Continental Bank,***8908,Globex EMEA Manufacturing Ltd.,IE,-9237975.98
30/06/2025,30/06/2025,Interest Earned,Interest Income,ALL,0,10938.22,EUR,Card Settlement,First Continental Bank,***5237,,,FALSE,FALSE,REF-392111,First Continental Bank,***1913,Globex EMEA Manufacturing Ltd.,IE,-9227037.76
30/06/2025,30/06/2025,Client Receipt - CloudBridge Co. #31,Sales Receipt,SaaS-GL,0,29218.92,EUR,SEPA SCT Inst,CloudBridge Co. #31,***6896,INV-202506-SaaS-GL-0018,,FALSE,FALSE,REF-825409,First Continental Bank,***3560,Globex EMEA Manufacturing Ltd.,IE,-9197818.84
01/07/2025,01/07/2025,Account Maintenance Fee,Bank/Merchant Fees,ALL,2500,0,EUR,SWIFT MT103,First Continental Bank,***5181,,,FALSE,FALSE,REF-140346,First Continental Bank,***8947,Globex EMEA Manufacturing Ltd.,IE,-9200318.84
01/07/2025,01/07/2025,Client Receipt - CloudBridge Co. #20,Sales Receipt,SaaS-GL,0,6651.35,EUR,Card Settlement,CloudBridge Co. #20,***7884,INV-202507-SaaS-GL-0023,,FALSE,FALSE,REF-409693,First Continental Bank,***2898,Globex EMEA Manufacturing Ltd.,IE,-9193667.49
01/07/2025,01/07/2025,Client Receipt - Vertex Advisory Client #5,Sales Receipt,PS-GL,0,37446.39,EUR,Card Settlement,Vertex Advisory Client #5,***4454,INV-202507-PS-GL-0002,,FALSE,FALSE,REF-936449,First Continental Bank,***2544,Globex EMEA Manufacturing Ltd.,IE,-9156221.1
01/07/2025,01/07/2025,Client Receipt - Vertex Advisory Client #55,Sales Receipt,PS-GL,0,43325.09,EUR,Card Settlement,Vertex Advisory Client #55,***6012,INV-202507-PS-GL-0008,,FALSE,FALSE,REF-612713,First Continental Bank,***8243,Globex EMEA Manufacturing Ltd.,IE,-9112896.01
02/07/2025,02/07/2025,Supplier Payment - ExpertNet Subcontractors #18,Supplier Payment,PS-GL,4232.48,0,EUR,SWIFT MT103,ExpertNet Subcontractors #18,***1866,,PO-202507-PS-GL-0005,FALSE,FALSE,REF-947069,First Continental Bank,***5419,Globex EMEA Manufacturing Ltd.,IE,-9117128.49
02/07/2025,02/07/2025,Supplier Payment - ExpertNet Subcontractors #10,Supplier Payment,PS-GL,6642.24,0,EUR,SWIFT MT103,ExpertNet Subcontractors #10,***8458,,PO-202507-PS-GL-0004,FALSE,FALSE,REF-321434,First Continental Bank,***4890,Globex EMEA Manufacturing Ltd.,IE,-9123770.73
02/07/2025,02/07/2025,Supplier Payment - ExpertNet Subcontractors #19,Supplier Payment,PS-GL,9411.13,0,EUR,SEPA Credit Transfer,ExpertNet Subcontractors #19,***3181,,PO-202507-PS-GL-0008,FALSE,FALSE,REF-335925,First Continental Bank,***8039,Globex EMEA Manufacturing Ltd.,IE,-9133181.86
02/07/2025,02/07/2025,Supplier Payment - HyperCloud Infra #15,Supplier Payment,SaaS-GL,10769.04,0,EUR,SEPA Debit,HyperCloud Infra #15,***2866,,PO-202507-SaaS-GL-0008,FALSE,FALSE,REF-337105,First Continental Bank,***4123,Globex EMEA Manufacturing Ltd.,IE,-9143950.9
02/07/2025,02/07/2025,Supplier Payment - ExpertNet Subcontractors #14,Supplier Payment,PS-GL,62490.65,0,EUR,SWIFT MT103,ExpertNet Subcontractors #14,***2820,,PO-202507-PS-GL-0001,FALSE,FALSE,REF-837001,First Continental Bank,***2293,Globex EMEA Manufacturing Ltd.,IE,-9206441.55
02/07/2025,02/07/2025,Client Receipt - CloudBridge Co. #77,Sales Receipt,SaaS-GL,0,31592.75,EUR,SEPA SCT Inst,CloudBridge Co. #77,***7798,INV-202507-SaaS-GL-0018,,FALSE,FALSE,REF-321582,First Continental Bank,***8476,Globex EMEA Manufacturing Ltd.,IE,-9174848.8
02/07/2025,02/07/2025,Client Receipt - Novatek Components Ltd #13,Sales Receipt,CEM-EMEA,0,32190.48,EUR,SEPA SCT,Novatek Components Ltd #13,***7751,INV-202507-CEM-EMEA-0002,,FALSE,FALSE,REF-320888,First Continental Bank,***2416,Globex EMEA Manufacturing Ltd.,IE,-9142658.32
02/07/2025,02/07/2025,Client Receipt - Novatek Components Ltd #7,Sales Receipt,CEM-EMEA,0,46086.58,EUR,SEPA SCT,Novatek Components Ltd #7,***9149,INV-202507-CEM-EMEA-0013,,FALSE,FALSE,REF-383238,First Continental Bank,***6427,Globex EMEA Manufacturing Ltd.,IE,-9096571.74
03/07/2025,03/07/2025,Supplier Payment - ExpertNet Subcontractors #17,Supplier Payment,PS-GL,4393.93,0,EUR,SEPA Credit Transfer,ExpertNet Subcontractors #17,***9645,,PO-202507-PS-GL-0003,FALSE,FALSE,REF-550839,First Continental Bank,***7543,Globex EMEA Manufacturing Ltd.,IE,-9100965.67
03/07/2025,03/07/2025,Supplier Payment - HyperCloud Infra #11,Supplier Payment,SaaS-GL,5811.59,0,EUR,SEPA Credit Transfer,HyperCloud Infra #11,***4126,,PO-202507-SaaS-GL-0001,FALSE,FALSE,REF-877130,First Continental Bank,***4624,Globex EMEA Manufacturing Ltd.,IE,-9106777.26
03/07/2025,03/07/2025,Supplier Payment - EuroFab Assembly #22,Supplier Payment,CEM-EMEA,161541.64,0,EUR,SEPA Credit Transfer,EuroFab Assembly #22,***4169,,PO-202507-CEM-EMEA-0003,FALSE,FALSE,REF-503540,First Continental Bank,***2636,Globex EMEA Manufacturing Ltd.,IE,-9268318.9
04/07/2025,04/07/2025,Client Receipt - CloudBridge Co. #40,Sales Receipt,SaaS-GL,0,19582.75,EUR,SEPA SCT Inst,CloudBridge Co. #40,***4065,INV-202507-SaaS-GL-0019,,FALSE,FALSE,REF-154495,First Continental Bank,***2809,Globex EMEA Manufacturing Ltd.,IE,-9248736.15
04/07/2025,04/07/2025,Client Receipt - CloudBridge Co. #44,Sales Receipt,SaaS-GL,0,22723.65,EUR,SEPA SCT,CloudBridge Co. #44,***8408,INV-202507-SaaS-GL-0009,,FALSE,FALSE,REF-839070,First Continental Bank,***3162,Globex EMEA Manufacturing Ltd.,IE,-9226012.5
04/07/2025,04/07/2025,Client Receipt - CloudBridge Co. #7,Sales Receipt,SaaS-GL,0,132740.39,EUR,SEPA SCT Inst,CloudBridge Co. #7,***5397,INV-202507-SaaS-GL-0026,,FALSE,FALSE,REF-311433,First Continental Bank,***6588,Globex EMEA Manufacturing Ltd.,IE,-9093272.11
05/07/2025,05/07/2025,Supplier Payment - CodeCraft Contractors #8,Supplier Payment,SaaS-GL,179.44,0,EUR,SEPA Credit Transfer,CodeCraft Contractors #8,***9200,,PO-202507-SaaS-GL-0003,FALSE,FALSE,REF-731099,First Continental Bank,***1597,Globex EMEA Manufacturing Ltd.,IE,-9093451.55
05/07/2025,05/07/2025,Supplier Payment - EuroFab Assembly #20,Supplier Payment,CEM-EMEA,14406.57,0,EUR,SEPA Credit Transfer,EuroFab Assembly #20,***7277,,PO-202507-CEM-EMEA-0004,FALSE,FALSE,REF-719288,First Continental Bank,***8371,Globex EMEA Manufacturing Ltd.,IE,-9107858.12
05/07/2025,05/07/2025,Client Receipt - Aurora Electronics GmbH #3,Sales Receipt,CEM-EMEA,0,32091.09,EUR,SEPA SCT,Aurora Electronics GmbH #3,***8262,INV-202507-CEM-EMEA-0007,,FALSE,FALSE,REF-806089,First Continental Bank,***8807,Globex EMEA Manufacturing Ltd.,IE,-9075767.03
05/07/2025,05/07/2025,Client Receipt - Novatek Components Ltd #11,Sales Receipt,CEM-EMEA,0,34669.2,EUR,SEPA SCT Inst,Novatek Components Ltd #11,***6049,INV-202507-CEM-EMEA-0016,,FALSE,FALSE,REF-518596,First Continental Bank,***1401,Globex EMEA Manufacturing Ltd.,IE,-9041097.83
05/07/2025,05/07/2025,Client Receipt - CloudBridge Co. #51,Sales Receipt,SaaS-GL,0,45444.66,EUR,SEPA SCT,CloudBridge Co. #51,***4130,INV-202507-SaaS-GL-0012,,FALSE,FALSE,REF-772967,First Continental Bank,***5234,Globex EMEA Manufacturing Ltd.,IE,-8995653.17
06/07/2025,06/07/2025,Supplier Payment - HyperCloud Infra #1,Supplier Payment,SaaS-GL,18297.17,0,EUR,SWIFT MT103,HyperCloud Infra #1,***2314,,PO-202507-SaaS-GL-0010,FALSE,FALSE,REF-271260,First Continental Bank,***3794,Globex EMEA Manufacturing Ltd.,IE,-9013950.34
07/07/2025,07/07/2025,Client Receipt - Vertex Advisory Client #48,Sales Receipt,PS-GL,0,36574.39,EUR,Card Settlement,Vertex Advisory Client #48,***1123,INV-202507-PS-GL-0005,,FALSE,FALSE,REF-979663,First Continental Bank,***5348,Globex EMEA Manufacturing Ltd.,IE,-8977375.95
08/07/2025,08/07/2025,Client Receipt - Vertex Advisory Client #52,Sales Receipt,PS-GL,0,7625.68,EUR,SEPA SCT,Vertex Advisory Client #52,***3721,INV-202507-PS-GL-0006,,FALSE,FALSE,REF-387225,First Continental Bank,***6496,Globex EMEA Manufacturing Ltd.,IE,-8969750.27
08/07/2025,08/07/2025,Client Receipt - CloudBridge Co. #6,Sales Receipt,SaaS-GL,0,28306.25,EUR,SEPA SCT,CloudBridge Co. #6,***7567,INV-202507-SaaS-GL-0006,,FALSE,FALSE,REF-109963,First Continental Bank,***6429,Globex EMEA Manufacturing Ltd.,IE,-8941444.02
08/07/2025,08/07/2025,Client Receipt - Aurora Electronics GmbH #17,Sales Receipt,CEM-EMEA,0,47679.06,EUR,SEPA SCT,Aurora Electronics GmbH #17,***3198,INV-202507-CEM-EMEA-0009,,FALSE,FALSE,REF-439944,First Continental Bank,***7481,Globex EMEA Manufacturing Ltd.,IE,-8893764.96
08/07/2025,08/07/2025,Client Receipt - Vertex Advisory Client #46,Sales Receipt,PS-GL,0,87392.46,EUR,SEPA SCT Inst,Vertex Advisory Client #46,***6097,INV-202507-PS-GL-0007,,FALSE,FALSE,REF-234284,First Continental Bank,***6680,Globex EMEA Manufacturing Ltd.,IE,-8806372.5
08/07/2025,08/07/2025,Client Receipt - Novatek Components Ltd #12,Sales Receipt,CEM-EMEA,0,138889.83,EUR,SEPA SCT Inst,Novatek Components Ltd #12,***9062,INV-202507-CEM-EMEA-0003,,FALSE,FALSE,REF-238186,First Continental Bank,***3027,Globex EMEA Manufacturing Ltd.,IE,-8667482.67
09/07/2025,09/07/2025,Client Receipt - CloudBridge Co. #2,Sales Receipt,SaaS-GL,0,10900.97,EUR,SEPA SCT Inst,CloudBridge Co. #2,***5182,INV-202507-SaaS-GL-0010,,FALSE,FALSE,REF-670598,First Continental Bank,***2596,Globex EMEA Manufacturing Ltd.,IE,-8656581.7
10/07/2025,10/07/2025,Merchant Processing Fees,Bank/Merchant Fees,ALL,3280.13,0,EUR,SEPA Debit,First Continental Bank,***3436,,,FALSE,FALSE,REF-323269,First Continental Bank,***6184,Globex EMEA Manufacturing Ltd.,IE,-8659861.83
10/07/2025,10/07/2025,Supplier Payment - CodeCraft Contractors #4,Supplier Payment,SaaS-GL,3995.62,0,EUR,SEPA Credit Transfer,CodeCraft Contractors #4,***6599,,PO-202507-SaaS-GL-0002,FALSE,FALSE,REF-602773,First Continental Bank,***8212,Globex EMEA Manufacturing Ltd.,IE,-8663857.45
10/07/2025,10/07/2025,Supplier Payment - HyperCloud Infra #19,Supplier Payment,SaaS-GL,36474.14,0,EUR,SEPA Debit,HyperCloud Infra #19,***6113,,PO-202507-SaaS-GL-0007,FALSE,FALSE,REF-276498,First Continental Bank,***7018,Globex EMEA Manufacturing Ltd.,IE,-8700331.59
10/07/2025,10/07/2025,Supplier Payment - Stelliform Parts BV #33,Supplier Payment,CEM-EMEA,41947.01,0,EUR,SEPA Debit,Stelliform Parts BV #33,***4499,,PO-202507-CEM-EMEA-0002,FALSE,FALSE,REF-661398,First Continental Bank,***5746,Globex EMEA Manufacturing Ltd.,IE,-8742278.6
10/07/2025,10/07/2025,Supplier Payment - Stelliform Parts BV #33,Supplier Payment,CEM-EMEA,134449.92,0,EUR,SEPA Debit,Stelliform Parts BV #33,***8988,,PO-202507-CEM-EMEA-0007,FALSE,FALSE,REF-755848,First Continental Bank,***4760,Globex EMEA Manufacturing Ltd.,IE,-8876728.52
10/07/2025,10/07/2025,Client Receipt - CloudBridge Co. #23,Sales Receipt,SaaS-GL,0,34348.54,EUR,SEPA SCT,CloudBridge Co. #23,***5139,INV-202507-SaaS-GL-0004,,FALSE,FALSE,REF-999787,First Continental Bank,***6232,Globex EMEA Manufacturing Ltd.,IE,-8842379.98
11/07/2025,11/07/2025,Client Receipt - CloudBridge Co. #79,Sales Receipt,SaaS-GL,0,23936.3,EUR,Card Settlement,CloudBridge Co. #79,***9868,INV-202507-SaaS-GL-0021,,FALSE,FALSE,REF-371606,First Continental Bank,***4261,Globex EMEA Manufacturing Ltd.,IE,-8818443.68
11/07/2025,11/07/2025,Client Receipt - CloudBridge Co. #57,Sales Receipt,SaaS-GL,0,30506.84,EUR,Card Settlement,CloudBridge Co. #57,***2073,INV-202507-SaaS-GL-0005,,FALSE,FALSE,REF-839934,First Continental Bank,***8040,Globex EMEA Manufacturing Ltd.,IE,-8787936.84
11/07/2025,11/07/2025,Client Receipt - Vertex Advisory Client #40,Sales Receipt,PS-GL,0,117962.47,EUR,SEPA SCT,Vertex Advisory Client #40,***8725,INV-202507-PS-GL-0004,,FALSE,FALSE,REF-665670,First Continental Bank,***6985,Globex EMEA Manufacturing Ltd.,IE,-8669974.37
12/07/2025,12/07/2025,Intercompany Settlement - Globex APAC Logistics Pte. Ltd.,Intercompany Transfer,ALL,770776,0,EUR,Internal Transfer,Globex APAC Logistics Pte. Ltd.,***4420,,,TRUE,TRUE,REF-446004,First Continental Bank,***2132,Globex EMEA Manufacturing Ltd.,IE,-9440750.37
13/07/2025,13/07/2025,Client Receipt - Aurora Electronics GmbH #18,Sales Receipt,CEM-EMEA,0,96797.37,EUR,SEPA SCT Inst,Aurora Electronics GmbH #18,***7598,INV-202507-CEM-EMEA-0004,,FALSE,FALSE,REF-642537,First Continental Bank,***8769,Globex EMEA Manufacturing Ltd.,IE,-9343953
15/07/2025,15/07/2025,Marketing - Beacon Digital #3,Marketing,ALL,17896.1,0,EUR,SWIFT MT103,Beacon Digital #3,***4661,,,FALSE,FALSE,REF-512233,First Continental Bank,***2077,Globex EMEA Manufacturing Ltd.,IE,-9361849.1
15/07/2025,15/07/2025,Supplier Payment - Stelliform Parts BV #6,Supplier Payment,CEM-EMEA,30117.02,0,EUR,SWIFT MT103,Stelliform Parts BV #6,***7732,,PO-202507-CEM-EMEA-0006,FALSE,FALSE,REF-655195,First Continental Bank,***9477,Globex EMEA Manufacturing Ltd.,IE,-9391966.12
15/07/2025,15/07/2025,Loan Interest Payment,Loan Interest,ALL,85000,0,EUR,SWIFT MT103,First Continental Bank - Corporate Lending,***3384,,,FALSE,FALSE,REF-781488,First Continental Bank,***8889,Globex EMEA Manufacturing Ltd.,IE,-9476966.12
15/07/2025,15/07/2025,Loan Principal Repayment,Loan Principal,ALL,500000,0,EUR,SWIFT MT103,First Continental Bank - Corporate Lending,***2485,,,FALSE,FALSE,REF-187248,First Continental Bank,***8165,Globex EMEA Manufacturing Ltd.,IE,-9976966.12
15/07/2025,15/07/2025,Client Receipt - Vertex Advisory Client #7,Sales Receipt,PS-GL,0,5269.35,EUR,Card Settlement,Vertex Advisory Client #7,***6599,INV-202507-PS-GL-0001,,FALSE,FALSE,REF-692090,First Continental Bank,***9175,Globex EMEA Manufacturing Ltd.,IE,-9971696.77
15/07/2025,15/07/2025,Client Receipt - CloudBridge Co. #19,Sales Receipt,SaaS-GL,0,10598,EUR,SEPA SCT,CloudBridge Co. #19,***2663,INV-202507-SaaS-GL-0027,,FALSE,FALSE,REF-352444,First Continental Bank,***4367,Globex EMEA Manufacturing Ltd.,IE,-9961098.77
15/07/2025,15/07/2025,Client Receipt - CloudBridge Co. #32,Sales Receipt,SaaS-GL,0,30432.46,EUR,Card Settlement,CloudBridge Co. #32,***5237,INV-202507-SaaS-GL-0016,,FALSE,FALSE,REF-982156,First Continental Bank,***4733,Globex EMEA Manufacturing Ltd.,IE,-9930666.31
15/07/2025,15/07/2025,Client Receipt - Aurora Electronics GmbH #12,Sales Receipt,CEM-EMEA,0,67678.58,EUR,SEPA SCT Inst,Aurora Electronics GmbH #12,***5541,INV-202507-CEM-EMEA-0005,,FALSE,FALSE,REF-117006,First Continental Bank,***9514,Globex EMEA Manufacturing Ltd.,IE,-9862987.73
16/07/2025,16/07/2025,Client Receipt - CloudBridge Co. #66,Sales Receipt,SaaS-GL,0,3078.4,EUR,SEPA SCT,CloudBridge Co. #66,***2290,INV-202507-SaaS-GL-0020,,FALSE,FALSE,REF-546196,First Continental Bank,***6864,Globex EMEA Manufacturing Ltd.,IE,-9859909.33
16/07/2025,16/07/2025,Client Receipt - Novatek Components Ltd #5,Sales Receipt,CEM-EMEA,0,182775.85,EUR,SEPA SCT,Novatek Components Ltd #5,***3956,INV-202507-CEM-EMEA-0001,,FALSE,FALSE,REF-981594,First Continental Bank,***5419,Globex EMEA Manufacturing Ltd.,IE,-9677133.48
18/07/2025,18/07/2025,Supplier Payment - Stelliform Parts BV #29,Supplier Payment,CEM-EMEA,9792.74,0,EUR,SEPA Credit Transfer,Stelliform Parts BV #29,***4791,,PO-202507-CEM-EMEA-0008,FALSE,FALSE,REF-666199,First Continental Bank,***9191,Globex EMEA Manufacturing Ltd.,IE,-9686926.22
18/07/2025,18/07/2025,Supplier Payment - EuroFab Assembly #14,Supplier Payment,CEM-EMEA,26220.2,0,EUR,SEPA Debit,EuroFab Assembly #14,***7090,,PO-202507-CEM-EMEA-0009,FALSE,FALSE,REF-594258,First Continental Bank,***2518,Globex EMEA Manufacturing Ltd.,IE,-9713146.42
18/07/2025,18/07/2025,Client Receipt - CloudBridge Co. #79,Sales Receipt,SaaS-GL,0,4236.52,EUR,SEPA SCT Inst,CloudBridge Co. #79,***8165,INV-202507-SaaS-GL-0011,,FALSE,FALSE,REF-431896,First Continental Bank,***8250,Globex EMEA Manufacturing Ltd.,IE,-9708909.9
18/07/2025,18/07/2025,Client Receipt - CloudBridge Co. #28,Sales Receipt,SaaS-GL,0,23435.95,EUR,Card Settlement,CloudBridge Co. #28,***4047,INV-202507-SaaS-GL-0022,,FALSE,FALSE,REF-884618,First Continental Bank,***9115,Globex EMEA Manufacturing Ltd.,IE,-9685473.95
18/07/2025,18/07/2025,Client Receipt - CloudBridge Co. #40,Sales Receipt,SaaS-GL,0,32698.34,EUR,SEPA SCT Inst,CloudBridge Co. #40,***2501,INV-202507-SaaS-GL-0017,,FALSE,FALSE,REF-663988,First Continental Bank,***2123,Globex EMEA Manufacturing Ltd.,IE,-9652775.61
19/07/2025,19/07/2025,Client Receipt - Novatek Components Ltd #2,Sales Receipt,CEM-EMEA,0,5339.87,EUR,SEPA SCT Inst,Novatek Components Ltd #2,***8678,INV-202507-CEM-EMEA-0015,,FALSE,FALSE,REF-839206,First Continental Bank,***1656,Globex EMEA Manufacturing Ltd.,IE,-9647435.74
19/07/2025,19/07/2025,Client Receipt - Vertex Advisory Client #41,Sales Receipt,PS-GL,0,14874.76,EUR,Card Settlement,Vertex Advisory Client #41,***8616,INV-202507-PS-GL-0009,,FALSE,FALSE,REF-483680,First Continental Bank,***1349,Globex EMEA Manufacturing Ltd.,IE,-9632560.98
20/07/2025,20/07/2025,VAT/GST Remittance - Revenue Ireland,Tax Payment,ALL,125606.04,0,EUR,SWIFT MT103,Revenue Ireland,***5127,,,FALSE,FALSE,REF-491797,First Continental Bank,***2946,Globex EMEA Manufacturing Ltd.,IE,-9758167.02
21/07/2025,21/07/2025,Supplier Payment - HyperCloud Infra #8,Supplier Payment,SaaS-GL,2387.65,0,EUR,SWIFT MT103,HyperCloud Infra #8,***1125,,PO-202507-SaaS-GL-0011,FALSE,FALSE,REF-570577,First Continental Bank,***4219,Globex EMEA Manufacturing Ltd.,IE,-9760554.67
21/07/2025,21/07/2025,Client Receipt - CloudBridge Co. #71,Sales Receipt,SaaS-GL,0,8106.83,EUR,SEPA SCT Inst,CloudBridge Co. #71,***9099,INV-202507-SaaS-GL-0015,,FALSE,FALSE,REF-804903,First Continental Bank,***7087,Globex EMEA Manufacturing Ltd.,IE,-9752447.84
21/07/2025,21/07/2025,Client Receipt - Novatek Components Ltd #6,Sales Receipt,CEM-EMEA,0,9136.75,EUR,Card Settlement,Novatek Components Ltd #6,***7647,INV-202507-CEM-EMEA-0012,,FALSE,FALSE,REF-190391,First Continental Bank,***4232,Globex EMEA Manufacturing Ltd.,IE,-9743311.09
21/07/2025,21/07/2025,Client Receipt - Aurora Electronics GmbH #17,Sales Receipt,CEM-EMEA,0,86704.39,EUR,SEPA SCT Inst,Aurora Electronics GmbH #17,***2438,INV-202507-CEM-EMEA-0014,,FALSE,FALSE,REF-704144,First Continental Bank,***9578,Globex EMEA Manufacturing Ltd.,IE,-9656606.7
22/07/2025,22/07/2025,Supplier Payment - ExpertNet Subcontractors #3,Supplier Payment,PS-GL,11989.87,0,EUR,SEPA Debit,ExpertNet Subcontractors #3,***5529,,PO-202507-PS-GL-0007,FALSE,FALSE,REF-514497,First Continental Bank,***6671,Globex EMEA Manufacturing Ltd.,IE,-9668596.57
22/07/2025,22/07/2025,Skyline Internet Services,Rent & Utilities,ALL,16123.43,0,EUR,SWIFT MT103,Skyline Internet Services,***5021,,,FALSE,FALSE,REF-125874,First Continental Bank,***6680,Globex EMEA Manufacturing Ltd.,IE,-9684720
22/07/2025,22/07/2025,Marketing - Aurelia Media #2,Marketing,ALL,33895.77,0,EUR,SWIFT MT103,Aurelia Media #2,***2946,,,FALSE,FALSE,REF-477523,First Continental Bank,***2763,Globex EMEA Manufacturing Ltd.,IE,-9718615.77
22/07/2025,22/07/2025,Client Receipt - CloudBridge Co. #48,Sales Receipt,SaaS-GL,0,19702.56,EUR,Card Settlement,CloudBridge Co. #48,***6862,INV-202507-SaaS-GL-0025,,FALSE,FALSE,REF-551457,First Continental Bank,***7271,Globex EMEA Manufacturing Ltd.,IE,-9698913.21
23/07/2025,23/07/2025,Merchant Processing Fees,Bank/Merchant Fees,ALL,2782.04,0,EUR,SEPA Debit,First Continental Bank,***2418,,,FALSE,FALSE,REF-650682,First Continental Bank,***1425,Globex EMEA Manufacturing Ltd.,IE,-9701695.25
23/07/2025,23/07/2025,Supplier Payment - CodeCraft Contractors #5,Supplier Payment,SaaS-GL,6266.67,0,EUR,SEPA Credit Transfer,CodeCraft Contractors #5,***1259,,PO-202507-SaaS-GL-0009,FALSE,FALSE,REF-772947,First Continental Bank,***5181,Globex EMEA Manufacturing Ltd.,IE,-9707961.92
23/07/2025,23/07/2025,Supplier Payment - ExpertNet Subcontractors #10,Supplier Payment,PS-GL,13939.45,0,EUR,SWIFT MT103,ExpertNet Subcontractors #10,***5966,,PO-202507-PS-GL-0006,FALSE,FALSE,REF-880770,First Continental Bank,***3052,Globex EMEA Manufacturing Ltd.,IE,-9721901.37
23/07/2025,23/07/2025,Client Receipt - Novatek Components Ltd #4,Sales Receipt,CEM-EMEA,0,44513.08,EUR,SEPA SCT,Novatek Components Ltd #4,***5268,INV-202507-CEM-EMEA-0008,,FALSE,FALSE,REF-414975,First Continental Bank,***2622,Globex EMEA Manufacturing Ltd.,IE,-9677388.29
23/07/2025,23/07/2025,Client Receipt - Vertex Advisory Client #34,Sales Receipt,PS-GL,0,70050.86,EUR,SEPA SCT Inst,Vertex Advisory Client #34,***6334,INV-202507-PS-GL-0003,,FALSE,FALSE,REF-558251,First Continental Bank,***2341,Globex EMEA Manufacturing Ltd.,IE,-9607337.43
24/07/2025,24/07/2025,Supplier Payment - Stelliform Parts BV #32,Supplier Payment,CEM-EMEA,120160.01,0,EUR,SWIFT MT103,Stelliform Parts BV #32,***3756,,PO-202507-CEM-EMEA-0001,FALSE,FALSE,REF-940853,First Continental Bank,***7201,Globex EMEA Manufacturing Ltd.,IE,-9727497.44
25/07/2025,25/07/2025,Client Receipt - CloudBridge Co. #44,Sales Receipt,SaaS-GL,0,4.5,EUR,Card Settlement,CloudBridge Co. #44,***2004,INV-202507-SaaS-GL-0013,,FALSE,FALSE,REF-117623,First Continental Bank,***3932,Globex EMEA Manufacturing Ltd.,IE,-9727492.94
25/07/2025,25/07/2025,Client Receipt - CloudBridge Co. #51,Sales Receipt,SaaS-GL,0,6630.48,EUR,Card Settlement,CloudBridge Co. #51,***9828,INV-202507-SaaS-GL-0024,,FALSE,FALSE,REF-285012,First Continental Bank,***8424,Globex EMEA Manufacturing Ltd.,IE,-9720862.46
26/07/2025,26/07/2025,"Intercompany Settlement - Globex International Holdings, Inc.",Intercompany Transfer,ALL,727435,0,EUR,Internal Transfer,"Globex International Holdings, Inc.",***9876,,,TRUE,TRUE,REF-127688,First Continental Bank,***1534,Globex EMEA Manufacturing Ltd.,IE,-10448297.46
26/07/2025,26/07/2025,Client Receipt - CloudBridge Co. #64,Sales Receipt,SaaS-GL,0,12024.98,EUR,SEPA SCT,CloudBridge Co. #64,***1881,INV-202507-SaaS-GL-0014,,FALSE,FALSE,REF-536577,First Continental Bank,***8915,Globex EMEA Manufacturing Ltd.,IE,-10436272.48
27/07/2025,27/07/2025,Client Receipt - CloudBridge Co. #62,Sales Receipt,SaaS-GL,0,16509.63,EUR,Card Settlement,CloudBridge Co. #62,***5056,INV-202507-SaaS-GL-0002,,FALSE,FALSE,REF-920969,First Continental Bank,***2595,Globex EMEA Manufacturing Ltd.,IE,-10419762.85
27/07/2025,27/07/2025,Client Receipt - CloudBridge Co. #30,Sales Receipt,SaaS-GL,0,17183.14,EUR,SEPA SCT,CloudBridge Co. #30,***7897,INV-202507-SaaS-GL-0003,,FALSE,FALSE,REF-132554,First Continental Bank,***3117,Globex EMEA Manufacturing Ltd.,IE,-10402579.71
28/07/2025,28/07/2025,Supplier Payment - CodeCraft Contractors #9,Supplier Payment,SaaS-GL,12956.55,0,EUR,SEPA Debit,CodeCraft Contractors #9,***6905,,PO-202507-SaaS-GL-0006,FALSE,FALSE,REF-954087,First Continental Bank,***8446,Globex EMEA Manufacturing Ltd.,IE,-10415536.26
28/07/2025,28/07/2025,Supplier Payment - HyperCloud Infra #14,Supplier Payment,SaaS-GL,37730.83,0,EUR,SWIFT MT103,HyperCloud Infra #14,***1198,,PO-202507-SaaS-GL-0004,FALSE,FALSE,REF-836762,First Continental Bank,***5318,Globex EMEA Manufacturing Ltd.,IE,-10453267.09
28/07/2025,28/07/2025,Corporate Tax Estimate,Tax Payment,ALL,89637.3,0,EUR,SWIFT MT103,Revenue Ireland,***3595,,,FALSE,FALSE,REF-719863,First Continental Bank,***4927,Globex EMEA Manufacturing Ltd.,IE,-10542904.39
28/07/2025,28/07/2025,Client Receipt - CloudBridge Co. #70,Sales Receipt,SaaS-GL,0,25277.86,EUR,SEPA SCT Inst,CloudBridge Co. #70,***6461,INV-202507-SaaS-GL-0001,,FALSE,FALSE,REF-742812,First Continental Bank,***2058,Globex EMEA Manufacturing Ltd.,IE,-10517626.53
29/07/2025,29/07/2025,Supplier Payment - EuroFab Assembly #4,Supplier Payment,CEM-EMEA,50094.92,0,EUR,SWIFT MT103,EuroFab Assembly #4,***5406,,PO-202507-CEM-EMEA-0005,FALSE,FALSE,REF-624786,First Continental Bank,***3982,Globex EMEA Manufacturing Ltd.,IE,-10567721.45
30/07/2025,30/07/2025,Supplier Payment - HyperCloud Infra #4,Supplier Payment,SaaS-GL,3903.38,0,EUR,SEPA Debit,HyperCloud Infra #4,***2427,,PO-202507-SaaS-GL-0005,FALSE,FALSE,REF-726178,First Continental Bank,***4739,Globex EMEA Manufacturing Ltd.,IE,-10571624.83
30/07/2025,30/07/2025,Supplier Payment - ExpertNet Subcontractors #17,Supplier Payment,PS-GL,13056.68,0,EUR,SEPA Debit,ExpertNet Subcontractors #17,***1343,,PO-202507-PS-GL-0002,FALSE,FALSE,REF-451902,First Continental Bank,***7584,Globex EMEA Manufacturing Ltd.,IE,-10584681.51
30/07/2025,30/07/2025,Payroll - GlobalPay Services Ltd,Payroll,ALL,321521.54,0,EUR,SWIFT MT103,GlobalPay Services Ltd,***4238,,,FALSE,FALSE,REF-581220,First Continental Bank,***6344,Globex EMEA Manufacturing Ltd.,IE,-10906203.05
30/07/2025,30/07/2025,Client Receipt - Novatek Components Ltd #8,Sales Receipt,CEM-EMEA,0,2476.01,EUR,SEPA SCT,Novatek Components Ltd #8,***2200,INV-202507-CEM-EMEA-0011,,FALSE,FALSE,REF-766065,First Continental Bank,***5894,Globex EMEA Manufacturing Ltd.,IE,-10903727.04
30/07/2025,30/07/2025,Interest Earned,Interest Income,ALL,0,13263.21,EUR,Card Settlement,First Continental Bank,***3748,,,FALSE,FALSE,REF-505252,First Continental Bank,***4475,Globex EMEA Manufacturing Ltd.,IE,-10890463.83
30/07/2025,30/07/2025,Client Receipt - Aurora Electronics GmbH #14,Sales Receipt,CEM-EMEA,0,80515.64,EUR,SEPA SCT Inst,Aurora Electronics GmbH #14,***3891,INV-202507-CEM-EMEA-0010,,FALSE,FALSE,REF-701402,First Continental Bank,***3097,Globex EMEA Manufacturing Ltd.,IE,-10809948.19
31/07/2025,31/07/2025,Client Receipt - CloudBridge Co. #67,Sales Receipt,SaaS-GL,0,5705.53,EUR,SEPA SCT Inst,CloudBridge Co. #67,***8713,INV-202507-SaaS-GL-0008,,FALSE,FALSE,REF-167741,First Continental Bank,***7011,Globex EMEA Manufacturing Ltd.,IE,-10804242.66
31/07/2025,31/07/2025,Client Receipt - CloudBridge Co. #53,Sales Receipt,SaaS-GL,0,28422.54,EUR,SEPA SCT Inst,CloudBridge Co. #53,***1293,INV-202507-SaaS-GL-0007,,FALSE,FALSE,REF-571377,First Continental Bank,***3147,Globex EMEA Manufacturing Ltd.,IE,-10775820.12
31/07/2025,31/07/2025,Client Receipt - Aurora Electronics GmbH #12,Sales Receipt,CEM-EMEA,0,73672.93,EUR,Card Settlement,Aurora Electronics GmbH #12,***1221,INV-202507-CEM-EMEA-0006,,FALSE,FALSE,REF-183714,First Continental Bank,***8867,Globex EMEA Manufacturing Ltd.,IE,-10702147.19
01/08/2025,01/08/2025,Account Maintenance Fee,Bank/Merchant Fees,ALL,2500,0,EUR,SEPA Debit,First Continental Bank,***9767,,,FALSE,FALSE,REF-342895,First Continental Bank,***4099,Globex EMEA Manufacturing Ltd.,IE,-10704647.19
01/08/2025,01/08/2025,Supplier Payment - CodeCraft Contractors #14,Supplier Payment,SaaS-GL,8428.65,0,EUR,SEPA Credit Transfer,CodeCraft Contractors #14,***1995,,PO-202508-SaaS-GL-0007,FALSE,FALSE,REF-719728,First Continental Bank,***2612,Globex EMEA Manufacturing Ltd.,IE,-10713075.84
01/08/2025,01/08/2025,Supplier Payment - ExpertNet Subcontractors #17,Supplier Payment,PS-GL,12895.96,0,EUR,SEPA Debit,ExpertNet Subcontractors #17,***2686,,PO-202508-PS-GL-0005,FALSE,FALSE,REF-702056,First Continental Bank,***6670,Globex EMEA Manufacturing Ltd.,IE,-10725971.8
01/08/2025,01/08/2025,Client Receipt - Vertex Advisory Client #1,Sales Receipt,PS-GL,0,63511.51,EUR,SEPA SCT Inst,Vertex Advisory Client #1,***6432,INV-202508-PS-GL-0007,,FALSE,FALSE,REF-973670,First Continental Bank,***8331,Globex EMEA Manufacturing Ltd.,IE,-10662460.29
01/08/2025,01/08/2025,Client Receipt - Novatek Components Ltd #2,Sales Receipt,CEM-EMEA,0,240116.55,EUR,SEPA SCT Inst,Novatek Components Ltd #2,***5206,INV-202508-CEM-EMEA-0006,,FALSE,FALSE,REF-584868,First Continental Bank,***8654,Globex EMEA Manufacturing Ltd.,IE,-10422343.74
02/08/2025,02/08/2025,Supplier Payment - ExpertNet Subcontractors #13,Supplier Payment,PS-GL,5700.78,0,EUR,SWIFT MT103,ExpertNet Subcontractors #13,***8100,,PO-202508-PS-GL-0004,FALSE,FALSE,REF-467551,First Continental Bank,***2902,Globex EMEA Manufacturing Ltd.,IE,-10428044.52
03/08/2025,03/08/2025,Client Receipt - Vertex Advisory Client #18,Sales Receipt,PS-GL,0,89503.34,EUR,SEPA SCT Inst,Vertex Advisory Client #18,***3048,INV-202508-PS-GL-0006,,FALSE,FALSE,REF-642585,First Continental Bank,***9017,Globex EMEA Manufacturing Ltd.,IE,-10338541.18
04/08/2025,04/08/2025,Supplier Payment - ExpertNet Subcontractors #6,Supplier Payment,PS-GL,16982.85,0,EUR,SEPA Credit Transfer,ExpertNet Subcontractors #6,***4341,,PO-202508-PS-GL-0002,FALSE,FALSE,REF-745746,First Continental Bank,***2583,Globex EMEA Manufacturing Ltd.,IE,-10355524.03
04/08/2025,04/08/2025,Client Receipt - CloudBridge Co. #33,Sales Receipt,SaaS-GL,0,11608.56,EUR,Card Settlement,CloudBridge Co. #33,***4898,INV-202508-SaaS-GL-0001,,FALSE,FALSE,REF-450212,First Continental Bank,***1955,Globex EMEA Manufacturing Ltd.,IE,-10343915.47
04/08/2025,04/08/2025,Client Receipt - Aurora Electronics GmbH #2,Sales Receipt,CEM-EMEA,0,30411.36,EUR,SEPA SCT Inst,Aurora Electronics GmbH #2,***9963,INV-202508-CEM-EMEA-0013,,FALSE,FALSE,REF-609877,First Continental Bank,***7723,Globex EMEA Manufacturing Ltd.,IE,-10313504.11
05/08/2025,05/08/2025,Supplier Payment - HyperCloud Infra #19,Supplier Payment,SaaS-GL,1253.39,0,EUR,SEPA Debit,HyperCloud Infra #19,***3511,,PO-202508-SaaS-GL-0006,FALSE,FALSE,REF-234300,First Continental Bank,***8184,Globex EMEA Manufacturing Ltd.,IE,-10314757.5
05/08/2025,05/08/2025,Client Receipt - CloudBridge Co. #53,Sales Receipt,SaaS-GL,0,4787.47,EUR,Card Settlement,CloudBridge Co. #53,***8604,INV-202508-SaaS-GL-0008,,FALSE,FALSE,REF-929148,First Continental Bank,***1988,Globex EMEA Manufacturing Ltd.,IE,-10309970.03
05/08/2025,05/08/2025,Client Receipt - CloudBridge Co. #48,Sales Receipt,SaaS-GL,0,41471.12,EUR,Card Settlement,CloudBridge Co. #48,***9566,INV-202508-SaaS-GL-0015,,FALSE,FALSE,REF-311721,First Continental Bank,***1130,Globex EMEA Manufacturing Ltd.,IE,-10268498.91
06/08/2025,06/08/2025,Client Receipt - CloudBridge Co. #43,Sales Receipt,SaaS-GL,0,21449.22,EUR,SEPA SCT Inst,CloudBridge Co. #43,***2456,INV-202508-SaaS-GL-0006,,FALSE,FALSE,REF-648809,First Continental Bank,***8396,Globex EMEA Manufacturing Ltd.,IE,-10247049.69
07/08/2025,07/08/2025,Supplier Payment - HyperCloud Infra #12,Supplier Payment,SaaS-GL,15393.64,0,EUR,SEPA Credit Transfer,HyperCloud Infra #12,***6223,,PO-202508-SaaS-GL-0003,FALSE,FALSE,REF-107382,First Continental Bank,***9692,Globex EMEA Manufacturing Ltd.,IE,-10262443.33
07/08/2025,07/08/2025,Client Receipt - Vertex Advisory Client #55,Sales Receipt,PS-GL,0,7465.88,EUR,SEPA SCT,Vertex Advisory Client #55,***1454,INV-202508-PS-GL-0002,,FALSE,FALSE,REF-252744,First Continental Bank,***1500,Globex EMEA Manufacturing Ltd.,IE,-10254977.45
07/08/2025,07/08/2025,Client Receipt - Aurora Electronics GmbH #8,Sales Receipt,CEM-EMEA,0,39839.58,EUR,SEPA SCT Inst,Aurora Electronics GmbH #8,***1034,INV-202508-CEM-EMEA-0002,,FALSE,FALSE,REF-239200,First Continental Bank,***7499,Globex EMEA Manufacturing Ltd.,IE,-10215137.87
08/08/2025,08/08/2025,Supplier Payment - Stelliform Parts BV #12,Supplier Payment,CEM-EMEA,51248.2,0,EUR,SEPA Debit,Stelliform Parts BV #12,***1557,,PO-202508-CEM-EMEA-0004,FALSE,FALSE,REF-361757,First Continental Bank,***5672,Globex EMEA Manufacturing Ltd.,IE,-10266386.07
08/08/2025,08/08/2025,Client Receipt - CloudBridge Co. #36,Sales Receipt,SaaS-GL,0,10415.74,EUR,Card Settlement,CloudBridge Co. #36,***9312,INV-202508-SaaS-GL-0011,,FALSE,FALSE,REF-568823,First Continental Bank,***3005,Globex EMEA Manufacturing Ltd.,IE,-10255970.33
08/08/2025,08/08/2025,Client Receipt - Aurora Electronics GmbH #8,Sales Receipt,CEM-EMEA,0,39750.9,EUR,SEPA SCT,Aurora Electronics GmbH #8,***2933,INV-202508-CEM-EMEA-0008,,FALSE,FALSE,REF-252054,First Continental Bank,***6674,Globex EMEA Manufacturing Ltd.,IE,-10216219.43
08/08/2025,08/08/2025,Client Receipt - Aurora Electronics GmbH #13,Sales Receipt,CEM-EMEA,0,112430.64,EUR,Card Settlement,Aurora Electronics GmbH #13,***5776,INV-202508-CEM-EMEA-0010,,FALSE,FALSE,REF-894462,First Continental Bank,***9958,Globex EMEA Manufacturing Ltd.,IE,-10103788.79
09/08/2025,09/08/2025,Supplier Payment - CodeCraft Contractors #9,Supplier Payment,SaaS-GL,12826.01,0,EUR,SWIFT MT103,CodeCraft Contractors #9,***4368,,PO-202508-SaaS-GL-0012,FALSE,FALSE,REF-306752,First Continental Bank,***5136,Globex EMEA Manufacturing Ltd.,IE,-10116614.8
09/08/2025,09/08/2025,Supplier Payment - EuroFab Assembly #22,Supplier Payment,CEM-EMEA,27417.52,0,EUR,SEPA Debit,EuroFab Assembly #22,***7177,,PO-202508-CEM-EMEA-0007,FALSE,FALSE,REF-745422,First Continental Bank,***8272,Globex EMEA Manufacturing Ltd.,IE,-10144032.32
09/08/2025,09/08/2025,Client Receipt - CloudBridge Co. #66,Sales Receipt,SaaS-GL,0,1357.8,EUR,SEPA SCT Inst,CloudBridge Co. #66,***2619,INV-202508-SaaS-GL-0004,,FALSE,FALSE,REF-170041,First Continental Bank,***5614,Globex EMEA Manufacturing Ltd.,IE,-10142674.52
11/08/2025,11/08/2025,Supplier Payment - HyperCloud Infra #19,Supplier Payment,SaaS-GL,2218.3,0,EUR,SWIFT MT103,HyperCloud Infra #19,***6646,,PO-202508-SaaS-GL-0002,FALSE,FALSE,REF-759396,First Continental Bank,***3218,Globex EMEA Manufacturing Ltd.,IE,-10144892.82
11/08/2025,11/08/2025,Marketing - Aurelia Media #1,Marketing,ALL,29873.19,0,EUR,SWIFT MT103,Aurelia Media #1,***6741,,,FALSE,FALSE,REF-554862,First Continental Bank,***9221,Globex EMEA Manufacturing Ltd.,IE,-10174766.01
11/08/2025,11/08/2025,Supplier Payment - Stelliform Parts BV #12,Supplier Payment,CEM-EMEA,42372.06,0,EUR,SWIFT MT103,Stelliform Parts BV #12,***1420,,PO-202508-CEM-EMEA-0008,FALSE,FALSE,REF-251818,First Continental Bank,***3178,Globex EMEA Manufacturing Ltd.,IE,-10217138.07
11/08/2025,11/08/2025,Client Receipt - CloudBridge Co. #6,Sales Receipt,SaaS-GL,0,11186.38,EUR,Card Settlement,CloudBridge Co. #6,***8071,INV-202508-SaaS-GL-0016,,FALSE,FALSE,REF-196782,First Continental Bank,***5109,Globex EMEA Manufacturing Ltd.,IE,-10205951.69
11/08/2025,11/08/2025,Client Receipt - CloudBridge Co. #50,Sales Receipt,SaaS-GL,0,30888.73,EUR,SEPA SCT,CloudBridge Co. #50,***3557,INV-202508-SaaS-GL-0018,,FALSE,FALSE,REF-536792,First Continental Bank,***7669,Globex EMEA Manufacturing Ltd.,IE,-10175062.96
12/08/2025,12/08/2025,Intercompany Settlement - Globex Retail NA LLC,Intercompany Transfer,ALL,603638,0,EUR,Internal Transfer,Globex Retail NA LLC,***6721,,,TRUE,TRUE,REF-248435,First Continental Bank,***9943,Globex EMEA Manufacturing Ltd.,IE,-10778700.96
12/08/2025,12/08/2025,Client Receipt - CloudBridge Co. #14,Sales Receipt,SaaS-GL,0,39622.67,EUR,SEPA SCT Inst,CloudBridge Co. #14,***9145,INV-202508-SaaS-GL-0020,,FALSE,FALSE,REF-659284,First Continental Bank,***3044,Globex EMEA Manufacturing Ltd.,IE,-10739078.29
12/08/2025,12/08/2025,Client Receipt - CloudBridge Co. #19,Sales Receipt,SaaS-GL,0,46646.65,EUR,SEPA SCT,CloudBridge Co. #19,***1280,INV-202508-SaaS-GL-0013,,FALSE,FALSE,REF-732065,First Continental Bank,***7673,Globex EMEA Manufacturing Ltd.,IE,-10692431.64
13/08/2025,13/08/2025,Client Receipt - Novatek Components Ltd #5,Sales Receipt,CEM-EMEA,0,1189.07,EUR,Card Settlement,Novatek Components Ltd #5,***4699,INV-202508-CEM-EMEA-0009,,FALSE,FALSE,REF-401098,First Continental Bank,***3411,Globex EMEA Manufacturing Ltd.,IE,-10691242.57
13/08/2025,13/08/2025,Client Receipt - Vertex Advisory Client #36,Sales Receipt,PS-GL,0,3979.79,EUR,SEPA SCT,Vertex Advisory Client #36,***6732,INV-202508-PS-GL-0003,,FALSE,FALSE,REF-209864,First Continental Bank,***4497,Globex EMEA Manufacturing Ltd.,IE,-10687262.78
13/08/2025,13/08/2025,Client Receipt - Vertex Advisory Client #29,Sales Receipt,PS-GL,0,118967.48,EUR,Card Settlement,Vertex Advisory Client #29,***6446,INV-202508-PS-GL-0008,,FALSE,FALSE,REF-794776,First Continental Bank,***5820,Globex EMEA Manufacturing Ltd.,IE,-10568295.3
14/08/2025,14/08/2025,Merchant Processing Fees,Bank/Merchant Fees,ALL,2297.94,0,EUR,SEPA Credit Transfer,First Continental Bank,***8095,,,FALSE,FALSE,REF-533337,First Continental Bank,***8773,Globex EMEA Manufacturing Ltd.,IE,-10570593.24
14/08/2025,14/08/2025,Supplier Payment - HyperCloud Infra #9,Supplier Payment,SaaS-GL,13259.71,0,EUR,SEPA Credit Transfer,HyperCloud Infra #9,***4233,,PO-202508-SaaS-GL-0001,FALSE,FALSE,REF-702636,First Continental Bank,***1672,Globex EMEA Manufacturing Ltd.,IE,-10583852.95
14/08/2025,14/08/2025,Client Receipt - CloudBridge Co. #41,Sales Receipt,SaaS-GL,0,7706.57,EUR,Card Settlement,CloudBridge Co. #41,***8049,INV-202508-SaaS-GL-0021,,FALSE,FALSE,REF-139101,First Continental Bank,***7561,Globex EMEA Manufacturing Ltd.,IE,-10576146.38
14/08/2025,14/08/2025,Client Receipt - Aurora Electronics GmbH #12,Sales Receipt,CEM-EMEA,0,117681.73,EUR,Card Settlement,Aurora Electronics GmbH #12,***1596,INV-202508-CEM-EMEA-0012,,FALSE,FALSE,REF-342414,First Continental Bank,***6344,Globex EMEA Manufacturing Ltd.,IE,-10458464.65
15/08/2025,15/08/2025,Merchant Processing Fees,Bank/Merchant Fees,ALL,3651.93,0,EUR,SEPA Debit,First Continental Bank,***6240,,,FALSE,FALSE,REF-382231,First Continental Bank,***4072,Globex EMEA Manufacturing Ltd.,IE,-10462116.58
15/08/2025,15/08/2025,Supplier Payment - HyperCloud Infra #5,Supplier Payment,SaaS-GL,6581.12,0,EUR,SWIFT MT103,HyperCloud Infra #5,***3012,,PO-202508-SaaS-GL-0004,FALSE,FALSE,REF-970858,First Continental Bank,***2408,Globex EMEA Manufacturing Ltd.,IE,-10468697.7
15/08/2025,15/08/2025,Supplier Payment - ExpertNet Subcontractors #6,Supplier Payment,PS-GL,58439.73,0,EUR,SWIFT MT103,ExpertNet Subcontractors #6,***4750,,PO-202508-PS-GL-0008,FALSE,FALSE,REF-699159,First Continental Bank,***5372,Globex EMEA Manufacturing Ltd.,IE,-10527137.43
15/08/2025,15/08/2025,Loan Interest Payment,Loan Interest,ALL,85000,0,EUR,SWIFT MT103,First Continental Bank - Corporate Lending,***2439,,,FALSE,FALSE,REF-991777,First Continental Bank,***5851,Globex EMEA Manufacturing Ltd.,IE,-10612137.43
15/08/2025,15/08/2025,Loan Principal Repayment,Loan Principal,ALL,500000,0,EUR,SEPA Debit,First Continental Bank - Corporate Lending,***3989,,,FALSE,FALSE,REF-295029,First Continental Bank,***5102,Globex EMEA Manufacturing Ltd.,IE,-11112137.43
15/08/2025,15/08/2025,Client Receipt - Vertex Advisory Client #5,Sales Receipt,PS-GL,0,108663.63,EUR,SEPA SCT,Vertex Advisory Client #5,***7380,INV-202508-PS-GL-0004,,FALSE,FALSE,REF-964316,First Continental Bank,***1321,Globex EMEA Manufacturing Ltd.,IE,-11003473.8
17/08/2025,17/08/2025,Supplier Payment - EuroFab Assembly #18,Supplier Payment,CEM-EMEA,186074.83,0,EUR,SWIFT MT103,EuroFab Assembly #18,***4678,,PO-202508-CEM-EMEA-0001,FALSE,FALSE,REF-897151,First Continental Bank,***7583,Globex EMEA Manufacturing Ltd.,IE,-11189548.63
17/08/2025,17/08/2025,Client Receipt - Novatek Components Ltd #6,Sales Receipt,CEM-EMEA,0,59904.16,EUR,SEPA SCT,Novatek Components Ltd #6,***3725,INV-202508-CEM-EMEA-0005,,FALSE,FALSE,REF-867215,First Continental Bank,***4111,Globex EMEA Manufacturing Ltd.,IE,-11129644.47
18/08/2025,18/08/2025,Supplier Payment - HyperCloud Infra #2,Supplier Payment,SaaS-GL,35031.97,0,EUR,SEPA Debit,HyperCloud Infra #2,***2325,,PO-202508-SaaS-GL-0008,FALSE,FALSE,REF-360012,First Continental Bank,***2029,Globex EMEA Manufacturing Ltd.,IE,-11164676.44
18/08/2025,18/08/2025,VAT/GST Remittance - Revenue Ireland,Tax Payment,ALL,111566.36,0,EUR,SEPA Debit,Revenue Ireland,***9518,,,FALSE,FALSE,REF-698884,First Continental Bank,***6895,Globex EMEA Manufacturing Ltd.,IE,-11276242.8
18/08/2025,18/08/2025,Client Receipt - CloudBridge Co. #48,Sales Receipt,SaaS-GL,0,28434.27,EUR,Card Settlement,CloudBridge Co. #48,***6567,INV-202508-SaaS-GL-0017,,FALSE,FALSE,REF-231878,First Continental Bank,***1855,Globex EMEA Manufacturing Ltd.,IE,-11247808.53
18/08/2025,18/08/2025,Client Receipt - Aurora Electronics GmbH #15,Sales Receipt,CEM-EMEA,0,36508.51,EUR,Card Settlement,Aurora Electronics GmbH #15,***1274,INV-202508-CEM-EMEA-0001,,FALSE,FALSE,REF-534292,First Continental Bank,***8270,Globex EMEA Manufacturing Ltd.,IE,-11211300.02
19/08/2025,19/08/2025,Supplier Payment - ExpertNet Subcontractors #10,Supplier Payment,PS-GL,2267.05,0,EUR,SWIFT MT103,ExpertNet Subcontractors #10,***6790,,PO-202508-PS-GL-0006,FALSE,FALSE,REF-935891,First Continental Bank,***5801,Globex EMEA Manufacturing Ltd.,IE,-11213567.07
19/08/2025,19/08/2025,Supplier Payment - Stelliform Parts BV #15,Supplier Payment,CEM-EMEA,2727.35,0,EUR,SEPA Debit,Stelliform Parts BV #15,***9347,,PO-202508-CEM-EMEA-0006,FALSE,FALSE,REF-430028,First Continental Bank,***3111,Globex EMEA Manufacturing Ltd.,IE,-11216294.42
19/08/2025,19/08/2025,Supplier Payment - CodeCraft Contractors #10,Supplier Payment,SaaS-GL,6691.38,0,EUR,SEPA Credit Transfer,CodeCraft Contractors #10,***4971,,PO-202508-SaaS-GL-0005,FALSE,FALSE,REF-329559,First Continental Bank,***7526,Globex EMEA Manufacturing Ltd.,IE,-11222985.8
19/08/2025,19/08/2025,Client Receipt - CloudBridge Co. #4,Sales Receipt,SaaS-GL,0,39631.77,EUR,Card Settlement,CloudBridge Co. #4,***6782,INV-202508-SaaS-GL-0005,,FALSE,FALSE,REF-109256,First Continental Bank,***5455,Globex EMEA Manufacturing Ltd.,IE,-11183354.03
19/08/2025,19/08/2025,Client Receipt - Novatek Components Ltd #3,Sales Receipt,CEM-EMEA,0,145647.92,EUR,Card Settlement,Novatek Components Ltd #3,***3934,INV-202508-CEM-EMEA-0007,,FALSE,FALSE,REF-997370,First Continental Bank,***3902,Globex EMEA Manufacturing Ltd.,IE,-11037706.11
20/08/2025,20/08/2025,Metro Water & Waste,Rent & Utilities,ALL,15476.32,0,EUR,SEPA Debit,Metro Water & Waste,***8980,,,FALSE,FALSE,REF-959567,First Continental Bank,***4860,Globex EMEA Manufacturing Ltd.,IE,-11053182.43
20/08/2025,20/08/2025,Supplier Payment - Stelliform Parts BV #16,Supplier Payment,CEM-EMEA,115323.76,0,EUR,SWIFT MT103,Stelliform Parts BV #16,***2524,,PO-202508-CEM-EMEA-0003,FALSE,FALSE,REF-298173,First Continental Bank,***9323,Globex EMEA Manufacturing Ltd.,IE,-11168506.19
20/08/2025,20/08/2025,Client Receipt - CloudBridge Co. #14,Sales Receipt,SaaS-GL,0,11772.87,EUR,SEPA SCT Inst,CloudBridge Co. #14,***9991,INV-202508-SaaS-GL-0019,,FALSE,FALSE,REF-695166,First Continental Bank,***2207,Globex EMEA Manufacturing Ltd.,IE,-11156733.32
21/08/2025,21/08/2025,Supplier Payment - HyperCloud Infra #17,Supplier Payment,SaaS-GL,607.51,0,EUR,SEPA Debit,HyperCloud Infra #17,***9529,,PO-202508-SaaS-GL-0009,FALSE,FALSE,REF-644438,First Continental Bank,***6156,Globex EMEA Manufacturing Ltd.,IE,-11157340.83
21/08/2025,21/08/2025,Supplier Payment - HyperCloud Infra #10,Supplier Payment,SaaS-GL,18765.54,0,EUR,SEPA Debit,HyperCloud Infra #10,***5122,,PO-202508-SaaS-GL-0011,FALSE,FALSE,REF-521548,First Continental Bank,***8674,Globex EMEA Manufacturing Ltd.,IE,-11176106.37
22/08/2025,22/08/2025,Supplier Payment - ExpertNet Subcontractors #13,Supplier Payment,PS-GL,14465.2,0,EUR,SEPA Debit,ExpertNet Subcontractors #13,***9555,,PO-202508-PS-GL-0001,FALSE,FALSE,REF-553322,First Continental Bank,***3538,Globex EMEA Manufacturing Ltd.,IE,-11190571.57
22/08/2025,22/08/2025,Client Receipt - CloudBridge Co. #1,Sales Receipt,SaaS-GL,0,13520.92,EUR,SEPA SCT,CloudBridge Co. #1,***5541,INV-202508-SaaS-GL-0007,,FALSE,FALSE,REF-134913,First Continental Bank,***3642,Globex EMEA Manufacturing Ltd.,IE,-11177050.65
22/08/2025,22/08/2025,Client Receipt - CloudBridge Co. #10,Sales Receipt,SaaS-GL,0,19047.74,EUR,SEPA SCT,CloudBridge Co. #10,***7892,INV-202508-SaaS-GL-0014,,FALSE,FALSE,REF-141370,First Continental Bank,***6134,Globex EMEA Manufacturing Ltd.,IE,-11158002.91
24/08/2025,24/08/2025,Client Receipt - Novatek Components Ltd #13,Sales Receipt,CEM-EMEA,0,27816.55,EUR,SEPA SCT,Novatek Components Ltd #13,***7881,INV-202508-CEM-EMEA-0011,,FALSE,FALSE,REF-886097,First Continental Bank,***7293,Globex EMEA Manufacturing Ltd.,IE,-11130186.36
25/08/2025,25/08/2025,Client Receipt - Vertex Advisory Client #10,Sales Receipt,PS-GL,0,4627.56,EUR,SEPA SCT,Vertex Advisory Client #10,***6775,INV-202508-PS-GL-0001,,FALSE,FALSE,REF-406462,First Continental Bank,***6875,Globex EMEA Manufacturing Ltd.,IE,-11125558.8
25/08/2025,25/08/2025,Client Receipt - CloudBridge Co. #62,Sales Receipt,SaaS-GL,0,24381.69,EUR,SEPA SCT,CloudBridge Co. #62,***7726,INV-202508-SaaS-GL-0022,,FALSE,FALSE,REF-507352,First Continental Bank,***3071,Globex EMEA Manufacturing Ltd.,IE,-11101177.11
26/08/2025,26/08/2025,Payroll - GlobalPay Services Ltd,Payroll,ALL,307553.82,0,EUR,SEPA Debit,GlobalPay Services Ltd,***1028,,,FALSE,FALSE,REF-245037,First Continental Bank,***3017,Globex EMEA Manufacturing Ltd.,IE,-11408730.93
26/08/2025,26/08/2025,"Intercompany Settlement - Globex International Holdings, Inc.",Intercompany Transfer,ALL,431413,0,EUR,Internal Transfer,"Globex International Holdings, Inc.",***8874,,,TRUE,TRUE,REF-121204,First Continental Bank,***7626,Globex EMEA Manufacturing Ltd.,IE,-11840143.93
26/08/2025,26/08/2025,Client Receipt - Aurora Electronics GmbH #5,Sales Receipt,CEM-EMEA,0,8740.6,EUR,SEPA SCT Inst,Aurora Electronics GmbH #5,***2976,INV-202508-CEM-EMEA-0003,,FALSE,FALSE,REF-878046,First Continental Bank,***3084,Globex EMEA Manufacturing Ltd.,IE,-11831403.33
26/08/2025,26/08/2025,Client Receipt - CloudBridge Co. #46,Sales Receipt,SaaS-GL,0,11466.51,EUR,SEPA SCT Inst,CloudBridge Co. #46,***9536,INV-202508-SaaS-GL-0009,,FALSE,FALSE,REF-908897,First Continental Bank,***9989,Globex EMEA Manufacturing Ltd.,IE,-11819936.82
26/08/2025,26/08/2025,Client Receipt - Novatek Components Ltd #1,Sales Receipt,CEM-EMEA,0,72118.3,EUR,Card Settlement,Novatek Components Ltd #1,***8531,INV-202508-CEM-EMEA-0004,,FALSE,FALSE,REF-464771,First Continental Bank,***2749,Globex EMEA Manufacturing Ltd.,IE,-11747818.52
26/08/2025,26/08/2025,Client Receipt - CloudBridge Co. #8,Sales Receipt,SaaS-GL,0,177263.71,EUR,SEPA SCT Inst,CloudBridge Co. #8,***7440,INV-202508-SaaS-GL-0010,,FALSE,FALSE,REF-450217,First Continental Bank,***7009,Globex EMEA Manufacturing Ltd.,IE,-11570554.81
27/08/2025,27/08/2025,Supplier Payment - ExpertNet Subcontractors #1,Supplier Payment,PS-GL,2953.26,0,EUR,SEPA Credit Transfer,ExpertNet Subcontractors #1,***1154,,PO-202508-PS-GL-0003,FALSE,FALSE,REF-310819,First Continental Bank,***9558,Globex EMEA Manufacturing Ltd.,IE,-11573508.07
27/08/2025,27/08/2025,Supplier Payment - Stelliform Parts BV #15,Supplier Payment,CEM-EMEA,110444.93,0,EUR,SEPA Debit,Stelliform Parts BV #15,***6127,,PO-202508-CEM-EMEA-0002,FALSE,FALSE,REF-142497,First Continental Bank,***7327,Globex EMEA Manufacturing Ltd.,IE,-11683953
27/08/2025,27/08/2025,Client Receipt - Vertex Advisory Client #31,Sales Receipt,PS-GL,0,2776.18,EUR,Card Settlement,Vertex Advisory Client #31,***4370,INV-202508-PS-GL-0005,,FALSE,FALSE,REF-121685,First Continental Bank,***6507,Globex EMEA Manufacturing Ltd.,IE,-11681176.82
28/08/2025,28/08/2025,Supplier Payment - EuroFab Assembly #15,Supplier Payment,CEM-EMEA,23684.87,0,EUR,SEPA Credit Transfer,EuroFab Assembly #15,***7839,,PO-202508-CEM-EMEA-0005,FALSE,FALSE,REF-825347,First Continental Bank,***8622,Globex EMEA Manufacturing Ltd.,IE,-11704861.69
28/08/2025,28/08/2025,Client Receipt - CloudBridge Co. #19,Sales Receipt,SaaS-GL,0,8100.85,EUR,Card Settlement,CloudBridge Co. #19,***2899,INV-202508-SaaS-GL-0003,,FALSE,FALSE,REF-853275,First Continental Bank,***4485,Globex EMEA Manufacturing Ltd.,IE,-11696760.84
29/08/2025,29/08/2025,Supplier Payment - ExpertNet Subcontractors #1,Supplier Payment,PS-GL,6143.78,0,EUR,SWIFT MT103,ExpertNet Subcontractors #1,***6371,,PO-202508-PS-GL-0007,FALSE,FALSE,REF-845720,First Continental Bank,***2490,Globex EMEA Manufacturing Ltd.,IE,-11702904.62
29/08/2025,29/08/2025,Supplier Payment - HyperCloud Infra #7,Supplier Payment,SaaS-GL,10776.25,0,EUR,SEPA Debit,HyperCloud Infra #7,***5780,,PO-202508-SaaS-GL-0010,FALSE,FALSE,REF-446538,First Continental Bank,***5689,Globex EMEA Manufacturing Ltd.,IE,-11713680.87
29/08/2025,29/08/2025,Client Receipt - CloudBridge Co. #62,Sales Receipt,SaaS-GL,0,9628.68,EUR,SEPA SCT Inst,CloudBridge Co. #62,***4477,INV-202508-SaaS-GL-0002,,FALSE,FALSE,REF-956846,First Continental Bank,***7414,Globex EMEA Manufacturing Ltd.,IE,-11704052.19
30/08/2025,30/08/2025,Marketing - Aurelia Media #4,Marketing,ALL,18282.97,0,EUR,SWIFT MT103,Aurelia Media #4,***6791,,,FALSE,FALSE,REF-208357,First Continental Bank,***3885,Globex EMEA Manufacturing Ltd.,IE,-11722335.16
30/08/2025,30/08/2025,Interest Earned,Interest Income,ALL,0,11361.33,EUR,Card Settlement,First Continental Bank,***8736,,,FALSE,FALSE,REF-359322,First Continental Bank,***9581,Globex EMEA Manufacturing Ltd.,IE,-11710973.83
30/08/2025,30/08/2025,Client Receipt - CloudBridge Co. #33,Sales Receipt,SaaS-GL,0,28853.14,EUR,Card Settlement,CloudBridge Co. #33,***3340,INV-202508-SaaS-GL-0012,,FALSE,FALSE,REF-372040,First Continental Bank,***6584,Globex EMEA Manufacturing Ltd.,IE,-11682120.69
