Date,ValueDate,Description,Category,BusinessUnit,Debit,Credit,Currency,PaymentRail,Counterparty,CounterpartyAccount,InvoiceID,PONumber,Intercompany,EliminateInConsolidation,Reference,Bank,AccountNumberMasked,Company,Jurisdiction,Balance
2023-09-01,2023-09-01,Account Maintenance Fee,Bank/Merchant Fees,ALL,2500.0,0.0,GBP,CHAPS,First Continental Bank,***9078,,,False,False,REF-587817,First Continental Bank,***3176,Globex Consulting UK Ltd.,UK,9997500.0
2023-09-01,2023-09-01,Supplier Payment - Stelliform Parts BV #18,Supplier Payment,CEM-EMEA,7967.08,0.0,GBP,CHAPS,Stelliform Parts BV #18,***1508,,PO-202309-CEM-EMEA-0010,False,False,REF-859360,First Continental Bank,***8125,Globex Consulting UK Ltd.,UK,9989532.92
2023-09-01,2023-09-01,Client Receipt - Vertex Advisory Client #38,Sales Receipt,PS-GL,0.0,20918.68,GBP,Faster Payments Credit,Vertex Advisory Client #38,***6054,INV-202309-PS-GL-0004,,False,False,REF-928381,First Continental Bank,***3232,Globex Consulting UK Ltd.,UK,10010451.6
2023-09-04,2023-09-04,Supplier Payment - ExpertNet Subcontractors #12,Supplier Payment,PS-GL,2596.19,0.0,GBP,Faster Payments,ExpertNet Subcontractors #12,***5115,,PO-202309-PS-GL-0008,False,False,REF-781635,First Continental Bank,***5196,Globex Consulting UK Ltd.,UK,10007855.41
2023-09-04,2023-09-04,Supplier Payment - CodeCraft Contractors #14,Supplier Payment,SaaS-GL,6803.41,0.0,GBP,Faster Payments,CodeCraft Contractors #14,***1863,,PO-202309-SaaS-GL-0005,False,False,REF-732540,First Continental Bank,***6167,Globex Consulting UK Ltd.,UK,10001052.0
2023-09-04,2023-09-04,Client Receipt - CloudBridge Co. #12,Sales Receipt,SaaS-GL,0.0,5177.91,GBP,CHAPS Credit,CloudBridge Co. #12,***9547,INV-202309-SaaS-GL-0019,,False,False,REF-280437,First Continental Bank,***4690,Globex Consulting UK Ltd.,UK,10006229.91
2023-09-04,2023-09-04,Client Receipt - Novatek Components Ltd #14,Sales Receipt,CEM-EMEA,0.0,7805.94,GBP,Faster Payments Credit,Novatek Components Ltd #14,***3960,INV-202309-CEM-EMEA-0002,,False,False,REF-527453,First Continental Bank,***7024,Globex Consulting UK Ltd.,UK,10014035.85
2023-09-05,2023-09-05,Merchant Processing Fees,Bank/Merchant Fees,ALL,448.11,0.0,GBP,CHAPS,First Continental Bank,***9396,,,False,False,REF-257967,First Continental Bank,***5393,Globex Consulting UK Ltd.,UK,10013587.74
2023-09-05,2023-09-05,Supplier Payment - EuroFab Assembly #9,Supplier Payment,CEM-EMEA,20503.86,0.0,GBP,CHAPS,EuroFab Assembly #9,***4807,,PO-202309-CEM-EMEA-0002,False,False,REF-568199,First Continental Bank,***3199,Globex Consulting UK Ltd.,UK,9993083.88
2023-09-05,2023-09-05,Supplier Payment - Stelliform Parts BV #33,Supplier Payment,CEM-EMEA,62827.26,0.0,GBP,Faster Payments,Stelliform Parts BV #33,***4244,,PO-202309-CEM-EMEA-0006,False,False,REF-854076,First Continental Bank,***7897,Globex Consulting UK Ltd.,UK,9930256.62
2023-09-05,2023-09-05,Client Receipt - CloudBridge Co. #1,Sales Receipt,SaaS-GL,0.0,7305.34,GBP,Faster Payments Credit,CloudBridge Co. #1,***9092,INV-202309-SaaS-GL-0015,,False,False,REF-426833,First Continental Bank,***4062,Globex Consulting UK Ltd.,UK,9937561.96
2023-09-05,2023-09-05,Client Receipt - Novatek Components Ltd #9,Sales Receipt,CEM-EMEA,0.0,8240.44,GBP,Faster Payments Credit,Novatek Components Ltd #9,***6730,INV-202309-CEM-EMEA-0004,,False,False,REF-500848,First Continental Bank,***3314,Globex Consulting UK Ltd.,UK,9945802.4
2023-09-06,2023-09-06,Supplier Payment - HyperCloud Infra #3,Supplier Payment,SaaS-GL,7476.14,0.0,GBP,CHAPS,HyperCloud Infra #3,***4710,,PO-202309-SaaS-GL-0002,False,False,REF-986835,First Continental Bank,***5437,Globex Consulting UK Ltd.,UK,9938326.26
2023-09-06,2023-09-06,Supplier Payment - EuroFab Assembly #15,Supplier Payment,CEM-EMEA,15621.85,0.0,GBP,CHAPS,EuroFab Assembly #15,***7144,,PO-202309-CEM-EMEA-0011,False,False,REF-528958,First Continental Bank,***7151,Globex Consulting UK Ltd.,UK,9922704.41
2023-09-06,2023-09-06,Client Receipt - Vertex Advisory Client #30,Sales Receipt,PS-GL,0.0,624.01,GBP,Faster Payments Credit,Vertex Advisory Client #30,***5009,INV-202309-PS-GL-0001,,False,False,REF-784200,First Continental Bank,***6409,Globex Consulting UK Ltd.,UK,9923328.42
2023-09-06,2023-09-06,Client Receipt - CloudBridge Co. #46,Sales Receipt,SaaS-GL,0.0,675.57,GBP,Faster Payments Credit,CloudBridge Co. #46,***2479,INV-202309-SaaS-GL-0013,,False,False,REF-255875,First Continental Bank,***8092,Globex Consulting UK Ltd.,UK,9924003.99
2023-09-06,2023-09-06,Client Receipt - CloudBridge Co. #20,Sales Receipt,SaaS-GL,0.0,6651.42,GBP,Faster Payments Credit,CloudBridge Co. #20,***7094,INV-202309-SaaS-GL-0012,,False,False,REF-960217,First Continental Bank,***2220,Globex Consulting UK Ltd.,UK,9930655.41
2023-09-07,2023-09-07,Supplier Payment - EuroFab Assembly #11,Supplier Payment,CEM-EMEA,36990.6,0.0,GBP,CHAPS,EuroFab Assembly #11,***4367,,PO-202309-CEM-EMEA-0003,False,False,REF-750351,First Continental Bank,***4446,Globex Consulting UK Ltd.,UK,9893664.81
2023-09-07,2023-09-07,Client Receipt - CloudBridge Co. #18,Sales Receipt,SaaS-GL,0.0,12116.43,GBP,Faster Payments Credit,CloudBridge Co. #18,***8594,INV-202309-SaaS-GL-0005,,False,False,REF-263689,First Continental Bank,***5765,Globex Consulting UK Ltd.,UK,9905781.24
2023-09-07,2023-09-07,Client Receipt - Novatek Components Ltd #5,Sales Receipt,CEM-EMEA,0.0,20696.78,GBP,CHAPS Credit,Novatek Components Ltd #5,***9748,INV-202309-CEM-EMEA-0003,,False,False,REF-342172,First Continental Bank,***6513,Globex Consulting UK Ltd.,UK,9926478.02
2023-09-08,2023-09-08,Northshore Power,Rent & Utilities,ALL,3004.02,0.0,GBP,Faster Payments,Northshore Power,***5773,,,False,False,REF-455912,First Continental Bank,***3950,Globex Consulting UK Ltd.,UK,9923474.0
2023-09-09,2023-09-09,Northshore Power,Rent & Utilities,ALL,2188.76,0.0,GBP,CHAPS,Northshore Power,***3444,,,False,False,REF-768500,First Continental Bank,***7346,Globex Consulting UK Ltd.,UK,9921285.24
2023-09-09,2023-09-09,Client Receipt - Vertex Advisory Client #51,Sales Receipt,PS-GL,0.0,1847.99,GBP,Faster Payments Credit,Vertex Advisory Client #51,***3975,INV-202309-PS-GL-0006,,False,False,REF-268694,First Continental Bank,***3584,Globex Consulting UK Ltd.,UK,9923133.23
2023-09-10,2023-09-10,Client Receipt - Aurora Electronics GmbH #10,Sales Receipt,CEM-EMEA,0.0,35771.48,GBP,CHAPS Credit,Aurora Electronics GmbH #10,***3308,INV-202309-CEM-EMEA-0006,,False,False,REF-479619,First Continental Bank,***3307,Globex Consulting UK Ltd.,UK,9958904.71
2023-09-11,2023-09-11,Supplier Payment - ExpertNet Subcontractors #14,Supplier Payment,PS-GL,3286.32,0.0,GBP,Faster Payments,ExpertNet Subcontractors #14,***3032,,PO-202309-PS-GL-0007,False,False,REF-252412,First Continental Bank,***9011,Globex Consulting UK Ltd.,UK,9955618.39
2023-09-11,2023-09-11,Supplier Payment - ExpertNet Subcontractors #15,Supplier Payment,PS-GL,3611.28,0.0,GBP,Faster Payments,ExpertNet Subcontractors #15,***3653,,PO-202309-PS-GL-0009,False,False,REF-676867,First Continental Bank,***2025,Globex Consulting UK Ltd.,UK,9952007.11
2023-09-11,2023-09-11,Client Receipt - Aurora Electronics GmbH #5,Sales Receipt,CEM-EMEA,0.0,7466.39,GBP,CHAPS Credit,Aurora Electronics GmbH #5,***4325,INV-202309-CEM-EMEA-0010,,False,False,REF-484378,First Continental Bank,***7333,Globex Consulting UK Ltd.,UK,9959473.5
2023-09-11,2023-09-11,Client Receipt - Aurora Electronics GmbH #15,Sales Receipt,CEM-EMEA,0.0,12101.99,GBP,CHAPS Credit,Aurora Electronics GmbH #15,***1270,INV-202309-CEM-EMEA-0007,,False,False,REF-886037,First Continental Bank,***1813,Globex Consulting UK Ltd.,UK,9971575.49
2023-09-11,2023-09-11,Client Receipt - Novatek Components Ltd #8,Sales Receipt,CEM-EMEA,0.0,154535.87,GBP,CHAPS Credit,Novatek Components Ltd #8,***2538,INV-202309-CEM-EMEA-0008,,False,False,REF-859980,First Continental Bank,***7415,Globex Consulting UK Ltd.,UK,10126111.36
2023-09-12,2023-09-12,Supplier Payment - ExpertNet Subcontractors #5,Supplier Payment,PS-GL,1963.01,0.0,GBP,CHAPS,ExpertNet Subcontractors #5,***2400,,PO-202309-PS-GL-0001,False,False,REF-132160,First Continental Bank,***5670,Globex Consulting UK Ltd.,UK,10124148.35
2023-09-12,2023-09-12,Supplier Payment - CodeCraft Contractors #14,Supplier Payment,SaaS-GL,2606.28,0.0,GBP,CHAPS,CodeCraft Contractors #14,***4410,,PO-202309-SaaS-GL-0004,False,False,REF-654524,First Continental Bank,***3882,Globex Consulting UK Ltd.,UK,10121542.07
2023-09-12,2023-09-12,Intercompany Settlement - Globex APAC Logistics Pte. Ltd.,Intercompany Transfer,ALL,744553.0,0.0,GBP,Internal Transfer,Globex APAC Logistics Pte. Ltd.,***2598,,,True,True,REF-591974,First Continental Bank,***2023,Globex Consulting UK Ltd.,UK,9376989.07
2023-09-12,2023-09-12,Client Receipt - Aurora Electronics GmbH #18,Sales Receipt,CEM-EMEA,0.0,2402.54,GBP,CHAPS Credit,Aurora Electronics GmbH #18,***1696,INV-202309-CEM-EMEA-0009,,False,False,REF-511617,First Continental Bank,***7855,Globex Consulting UK Ltd.,UK,9379391.61
2023-09-13,2023-09-13,Supplier Payment - HyperCloud Infra #14,Supplier Payment,SaaS-GL,112.67,0.0,GBP,CHAPS,HyperCloud Infra #14,***1676,,PO-202309-SaaS-GL-0003,False,False,REF-884081,First Continental Bank,***9692,Globex Consulting UK Ltd.,UK,9379278.94
2023-09-13,2023-09-13,Merchant Processing Fees,Bank/Merchant Fees,ALL,1553.7,0.0,GBP,CHAPS,First Continental Bank,***5180,,,False,False,REF-114091,First Continental Bank,***4535,Globex Consulting UK Ltd.,UK,9377725.24
2023-09-13,2023-09-13,Supplier Payment - Stelliform Parts BV #12,Supplier Payment,CEM-EMEA,4783.37,0.0,GBP,CHAPS,Stelliform Parts BV #12,***4014,,PO-202309-CEM-EMEA-0001,False,False,REF-668944,First Continental Bank,***6666,Globex Consulting UK Ltd.,UK,9372941.87
2023-09-13,2023-09-13,Supplier Payment - Stelliform Parts BV #26,Supplier Payment,CEM-EMEA,9680.61,0.0,GBP,CHAPS,Stelliform Parts BV #26,***5990,,PO-202309-CEM-EMEA-0007,False,False,REF-440487,First Continental Bank,***7409,Globex Consulting UK Ltd.,UK,9363261.26
2023-09-13,2023-09-13,Client Receipt - CloudBridge Co. #34,Sales Receipt,SaaS-GL,0.0,15012.1,GBP,CHAPS Credit,CloudBridge Co. #34,***9164,INV-202309-SaaS-GL-0018,,False,False,REF-857912,First Continental Bank,***4954,Globex Consulting UK Ltd.,UK,9378273.36
2023-09-14,2023-09-14,Supplier Payment - ExpertNet Subcontractors #2,Supplier Payment,PS-GL,11546.71,0.0,GBP,Faster Payments,ExpertNet Subcontractors #2,***6159,,PO-202309-PS-GL-0002,False,False,REF-257641,First Continental Bank,***5671,Globex Consulting UK Ltd.,UK,9366726.65
2023-09-14,2023-09-14,Client Receipt - Vertex Advisory Client #39,Sales Receipt,PS-GL,0.0,6640.5,GBP,CHAPS Credit,Vertex Advisory Client #39,***4703,INV-202309-PS-GL-0007,,False,False,REF-428242,First Continental Bank,***7206,Globex Consulting UK Ltd.,UK,9373367.15
2023-09-14,2023-09-14,Client Receipt - CloudBridge Co. #40,Sales Receipt,SaaS-GL,0.0,9599.86,GBP,Faster Payments Credit,CloudBridge Co. #40,***9136,INV-202309-SaaS-GL-0011,,False,False,REF-154241,First Continental Bank,***5695,Globex Consulting UK Ltd.,UK,9382967.01
2023-09-14,2023-09-14,Client Receipt - Novatek Components Ltd #14,Sales Receipt,CEM-EMEA,0.0,16638.02,GBP,CHAPS Credit,Novatek Components Ltd #14,***9282,INV-202309-CEM-EMEA-0001,,False,False,REF-985989,First Continental Bank,***8137,Globex Consulting UK Ltd.,UK,9399605.03
2023-09-14,2023-09-14,Client Receipt - CloudBridge Co. #13,Sales Receipt,SaaS-GL,0.0,24663.06,GBP,CHAPS Credit,CloudBridge Co. #13,***5702,INV-202309-SaaS-GL-0020,,False,False,REF-465052,First Continental Bank,***2951,Globex Consulting UK Ltd.,UK,9424268.09
2023-09-14,2023-09-14,Client Receipt - Aurora Electronics GmbH #14,Sales Receipt,CEM-EMEA,0.0,48329.9,GBP,CHAPS Credit,Aurora Electronics GmbH #14,***8072,INV-202309-CEM-EMEA-0005,,False,False,REF-277245,First Continental Bank,***4162,Globex Consulting UK Ltd.,UK,9472597.99
2023-09-15,2023-09-15,Supplier Payment - EuroFab Assembly #21,Supplier Payment,CEM-EMEA,1360.71,0.0,GBP,CHAPS,EuroFab Assembly #21,***3879,,PO-202309-CEM-EMEA-0009,False,False,REF-752317,First Continental Bank,***3282,Globex Consulting UK Ltd.,UK,9471237.28
2023-09-15,2023-09-15,Client Receipt - CloudBridge Co. #28,Sales Receipt,SaaS-GL,0.0,328.22,GBP,CHAPS Credit,CloudBridge Co. #28,***4007,INV-202309-SaaS-GL-0001,,False,False,REF-699052,First Continental Bank,***1454,Globex Consulting UK Ltd.,UK,9471565.5
2023-09-15,2023-09-15,Client Receipt - Vertex Advisory Client #22,Sales Receipt,PS-GL,0.0,28328.68,GBP,CHAPS Credit,Vertex Advisory Client #22,***6152,INV-202309-PS-GL-0008,,False,False,REF-969002,First Continental Bank,***2906,Globex Consulting UK Ltd.,UK,9499894.18
2023-09-17,2023-09-17,Supplier Payment - ExpertNet Subcontractors #9,Supplier Payment,PS-GL,5129.0,0.0,GBP,Faster Payments,ExpertNet Subcontractors #9,***1106,,PO-202309-PS-GL-0005,False,False,REF-595465,First Continental Bank,***4600,Globex Consulting UK Ltd.,UK,9494765.18
2023-09-17,2023-09-17,Supplier Payment - Stelliform Parts BV #22,Supplier Payment,CEM-EMEA,8459.65,0.0,GBP,CHAPS,Stelliform Parts BV #22,***4466,,PO-202309-CEM-EMEA-0004,False,False,REF-357817,First Continental Bank,***7779,Globex Consulting UK Ltd.,UK,9486305.53
2023-09-17,2023-09-17,Client Receipt - CloudBridge Co. #53,Sales Receipt,SaaS-GL,0.0,2044.63,GBP,Faster Payments Credit,CloudBridge Co. #53,***4875,INV-202309-SaaS-GL-0009,,False,False,REF-790208,First Continental Bank,***5997,Globex Consulting UK Ltd.,UK,9488350.16
2023-09-17,2023-09-17,Client Receipt - CloudBridge Co. #78,Sales Receipt,SaaS-GL,0.0,6431.89,GBP,Faster Payments Credit,CloudBridge Co. #78,***1189,INV-202309-SaaS-GL-0014,,False,False,REF-255247,First Continental Bank,***1969,Globex Consulting UK Ltd.,UK,9494782.05
2023-09-17,2023-09-17,Client Receipt - CloudBridge Co. #10,Sales Receipt,SaaS-GL,0.0,8071.65,GBP,CHAPS Credit,CloudBridge Co. #10,***9271,INV-202309-SaaS-GL-0010,,False,False,REF-439240,First Continental Bank,***8248,Globex Consulting UK Ltd.,UK,9502853.7
2023-09-17,2023-09-17,Client Receipt - CloudBridge Co. #43,Sales Receipt,SaaS-GL,0.0,15754.21,GBP,Faster Payments Credit,CloudBridge Co. #43,***8444,INV-202309-SaaS-GL-0006,,False,False,REF-179477,First Continental Bank,***4427,Globex Consulting UK Ltd.,UK,9518607.91
2023-09-18,2023-09-18,VAT/GST Remittance - HMRC UK,Tax Payment,ALL,39083.16,0.0,GBP,CHAPS,HMRC UK,***4318,,,False,False,REF-722747,First Continental Bank,***4210,Globex Consulting UK Ltd.,UK,9479524.75
2023-09-18,2023-09-18,Client Receipt - CloudBridge Co. #2,Sales Receipt,SaaS-GL,0.0,6150.66,GBP,CHAPS Credit,CloudBridge Co. #2,***8512,INV-202309-SaaS-GL-0017,,False,False,REF-938197,First Continental Bank,***5804,Globex Consulting UK Ltd.,UK,9485675.41
2023-09-19,2023-09-19,Supplier Payment - ExpertNet Subcontractors #19,Supplier Payment,PS-GL,1167.36,0.0,GBP,CHAPS,ExpertNet Subcontractors #19,***5765,,PO-202309-PS-GL-0004,False,False,REF-107460,First Continental Bank,***9239,Globex Consulting UK Ltd.,UK,9484508.05
2023-09-19,2023-09-19,Client Receipt - CloudBridge Co. #20,Sales Receipt,SaaS-GL,0.0,5404.07,GBP,CHAPS Credit,CloudBridge Co. #20,***4833,INV-202309-SaaS-GL-0016,,False,False,REF-356365,First Continental Bank,***8369,Globex Consulting UK Ltd.,UK,9489912.12
2023-09-19,2023-09-19,Client Receipt - CloudBridge Co. #64,Sales Receipt,SaaS-GL,0.0,18288.83,GBP,Faster Payments Credit,CloudBridge Co. #64,***8225,INV-202309-SaaS-GL-0007,,False,False,REF-145208,First Continental Bank,***8316,Globex Consulting UK Ltd.,UK,9508200.95
2023-09-20,2023-09-20,Marketing - Aurelia Media #2,Marketing,ALL,3099.08,0.0,GBP,Faster Payments,Aurelia Media #2,***9966,,,False,False,REF-449525,First Continental Bank,***9972,Globex Consulting UK Ltd.,UK,9505101.87
2023-09-20,2023-09-20,Supplier Payment - HyperCloud Infra #7,Supplier Payment,SaaS-GL,21036.7,0.0,GBP,CHAPS,HyperCloud Infra #7,***8214,,PO-202309-SaaS-GL-0008,False,False,REF-133816,First Continental Bank,***8333,Globex Consulting UK Ltd.,UK,9484065.17
2023-09-20,2023-09-20,Client Receipt - Vertex Advisory Client #35,Sales Receipt,PS-GL,0.0,2924.57,GBP,CHAPS Credit,Vertex Advisory Client #35,***1536,INV-202309-PS-GL-0002,,False,False,REF-872547,First Continental Bank,***2608,Globex Consulting UK Ltd.,UK,9486989.74
2023-09-21,2023-09-21,Client Receipt - CloudBridge Co. #28,Sales Receipt,SaaS-GL,0.0,5135.0,GBP,Faster Payments Credit,CloudBridge Co. #28,***2447,INV-202309-SaaS-GL-0002,,False,False,REF-921107,First Continental Bank,***2036,Globex Consulting UK Ltd.,UK,9492124.74
2023-09-21,2023-09-21,Client Receipt - Vertex Advisory Client #58,Sales Receipt,PS-GL,0.0,7206.62,GBP,CHAPS Credit,Vertex Advisory Client #58,***3818,INV-202309-PS-GL-0010,,False,False,REF-468536,First Continental Bank,***4263,Globex Consulting UK Ltd.,UK,9499331.36
2023-09-21,2023-09-21,Client Receipt - CloudBridge Co. #16,Sales Receipt,SaaS-GL,0.0,24028.69,GBP,CHAPS Credit,CloudBridge Co. #16,***8319,INV-202309-SaaS-GL-0008,,False,False,REF-398680,First Continental Bank,***2772,Globex Consulting UK Ltd.,UK,9523360.05
2023-09-22,2023-09-22,Supplier Payment - ExpertNet Subcontractors #3,Supplier Payment,PS-GL,250.08,0.0,GBP,Faster Payments,ExpertNet Subcontractors #3,***5935,,PO-202309-PS-GL-0003,False,False,REF-685061,First Continental Bank,***4945,Globex Consulting UK Ltd.,UK,9523109.97
2023-09-22,2023-09-22,Marketing - Beacon Digital #1,Marketing,ALL,1693.34,0.0,GBP,Faster Payments,Beacon Digital #1,***4842,,,False,False,REF-351534,First Continental Bank,***7140,Globex Consulting UK Ltd.,UK,9521416.63
2023-09-22,2023-09-22,Client Receipt - CloudBridge Co. #70,Sales Receipt,SaaS-GL,0.0,1817.7,GBP,Faster Payments Credit,CloudBridge Co. #70,***8421,INV-202309-SaaS-GL-0004,,False,False,REF-123785,First Continental Bank,***3261,Globex Consulting UK Ltd.,UK,9523234.33
2023-09-24,2023-09-24,Supplier Payment - HyperCloud Infra #16,Supplier Payment,SaaS-GL,1456.43,0.0,GBP,CHAPS,HyperCloud Infra #16,***2534,,PO-202309-SaaS-GL-0001,False,False,REF-832876,First Continental Bank,***8433,Globex Consulting UK Ltd.,UK,9521777.9
2023-09-25,2023-09-25,Client Receipt - Vertex Advisory Client #16,Sales Receipt,PS-GL,0.0,49248.29,GBP,CHAPS Credit,Vertex Advisory Client #16,***2713,INV-202309-PS-GL-0003,,False,False,REF-707391,First Continental Bank,***6789,Globex Consulting UK Ltd.,UK,9571026.19
2023-09-26,2023-09-26,Supplier Payment - ExpertNet Subcontractors #3,Supplier Payment,PS-GL,10820.11,0.0,GBP,CHAPS,ExpertNet Subcontractors #3,***8522,,PO-202309-PS-GL-0006,False,False,REF-262401,First Continental Bank,***6084,Globex Consulting UK Ltd.,UK,9560206.08
2023-09-26,2023-09-26,Intercompany Settlement - Globex APAC Logistics Pte. Ltd.,Intercompany Transfer,ALL,537199.0,0.0,GBP,Internal Transfer,Globex APAC Logistics Pte. Ltd.,***8406,,,True,True,REF-379670,First Continental Bank,***8805,Globex Consulting UK Ltd.,UK,9023007.08
2023-09-26,2023-09-26,Client Receipt - Vertex Advisory Client #46,Sales Receipt,PS-GL,0.0,3723.23,GBP,Faster Payments Credit,Vertex Advisory Client #46,***8552,INV-202309-PS-GL-0005,,False,False,REF-715303,First Continental Bank,***9555,Globex Consulting UK Ltd.,UK,9026730.31
2023-09-26,2023-09-26,Client Receipt - Vertex Advisory Client #7,Sales Receipt,PS-GL,0.0,13104.29,GBP,CHAPS Credit,Vertex Advisory Client #7,***7149,INV-202309-PS-GL-0009,,False,False,REF-921680,First Continental Bank,***9071,Globex Consulting UK Ltd.,UK,9039834.6
2023-09-26,2023-09-26,Intercompany Reimbursement - Globex APAC Logistics Pte. Ltd.,Intercompany Transfer,ALL,0.0,214879.6,GBP,Internal Transfer,Globex APAC Logistics Pte. Ltd.,***6237,,,True,True,REF-527259,First Continental Bank,***3752,Globex Consulting UK Ltd.,UK,9254714.2
2023-09-27,2023-09-27,Supplier Payment - EuroFab Assembly #5,Supplier Payment,CEM-EMEA,9342.17,0.0,GBP,CHAPS,EuroFab Assembly #5,***9920,,PO-202309-CEM-EMEA-0005,False,False,REF-832351,First Continental Bank,***6138,Globex Consulting UK Ltd.,UK,9245372.03
2023-09-28,2023-09-28,Supplier Payment - HyperCloud Infra #19,Supplier Payment,SaaS-GL,1294.36,0.0,GBP,Faster Payments,HyperCloud Infra #19,***9058,,PO-202309-SaaS-GL-0006,False,False,REF-894404,First Continental Bank,***5761,Globex Consulting UK Ltd.,UK,9244077.67
2023-09-28,2023-09-28,Supplier Payment - HyperCloud Infra #19,Supplier Payment,SaaS-GL,3621.07,0.0,GBP,CHAPS,HyperCloud Infra #19,***6609,,PO-202309-SaaS-GL-0007,False,False,REF-268410,First Continental Bank,***7349,Globex Consulting UK Ltd.,UK,9240456.6
2023-09-28,2023-09-28,Supplier Payment - Stelliform Parts BV #2,Supplier Payment,CEM-EMEA,10856.45,0.0,GBP,Faster Payments,Stelliform Parts BV #2,***6592,,PO-202309-CEM-EMEA-0008,False,False,REF-672633,First Continental Bank,***1398,Globex Consulting UK Ltd.,UK,9229600.15
2023-09-28,2023-09-28,Payroll - GlobalPay Services Ltd,Payroll,ALL,52731.23,0.0,GBP,Faster Payments,GlobalPay Services Ltd,***6853,,,False,False,REF-789156,First Continental Bank,***6192,Globex Consulting UK Ltd.,UK,9176868.92
2023-09-29,2023-09-29,Payroll - GlobalPay Services Ltd,Payroll,ALL,52731.23,0.0,GBP,Faster Payments,GlobalPay Services Ltd,***4006,,,False,False,REF-541806,First Continental Bank,***3164,Globex Consulting UK Ltd.,UK,9124137.69
2023-09-29,2023-09-29,Client Receipt - CloudBridge Co. #54,Sales Receipt,SaaS-GL,0.0,27193.05,GBP,CHAPS Credit,CloudBridge Co. #54,***9681,INV-202309-SaaS-GL-0003,,False,False,REF-409545,First Continental Bank,***6131,Globex Consulting UK Ltd.,UK,9151330.74
2023-09-30,2023-09-30,Marketing - Aurelia Media #4,Marketing,ALL,11161.1,0.0,GBP,CHAPS,Aurelia Media #4,***3390,,,False,False,REF-671626,First Continental Bank,***5603,Globex Consulting UK Ltd.,UK,9140169.64
2023-09-30,2023-09-30,Interest Earned,Interest Income,ALL,0.0,11133.06,GBP,CHAPS Credit,First Continental Bank,***1253,,,False,False,REF-916666,First Continental Bank,***4996,Globex Consulting UK Ltd.,UK,9151302.7
2023-10-01,2023-10-01,Account Maintenance Fee,Bank/Merchant Fees,ALL,2500.0,0.0,GBP,Faster Payments,First Continental Bank,***9239,,,False,False,REF-605913,First Continental Bank,***1142,Globex Consulting UK Ltd.,UK,9148802.7
2023-10-02,2023-10-02,Supplier Payment - EuroFab Assembly #12,Supplier Payment,CEM-EMEA,16740.48,0.0,GBP,CHAPS,EuroFab Assembly #12,***3974,,PO-202310-CEM-EMEA-0008,False,False,REF-770971,First Continental Bank,***3015,Globex Consulting UK Ltd.,UK,9132062.22
2023-10-02,2023-10-02,Client Receipt - CloudBridge Co. #23,Sales Receipt,SaaS-GL,0.0,2051.27,GBP,CHAPS Credit,CloudBridge Co. #23,***9761,INV-202310-SaaS-GL-0007,,False,False,REF-331021,First Continental Bank,***4092,Globex Consulting UK Ltd.,UK,9134113.49
2023-10-03,2023-10-03,Supplier Payment - ExpertNet Subcontractors #2,Supplier Payment,PS-GL,36.56,0.0,GBP,CHAPS,ExpertNet Subcontractors #2,***3692,,PO-202310-PS-GL-0003,False,False,REF-577040,First Continental Bank,***8597,Globex Consulting UK Ltd.,UK,9134076.93
2023-10-03,2023-10-03,Supplier Payment - Stelliform Parts BV #5,Supplier Payment,CEM-EMEA,11361.74,0.0,GBP,Faster Payments,Stelliform Parts BV #5,***8067,,PO-202310-CEM-EMEA-0007,False,False,REF-196949,First Continental Bank,***8781,Globex Consulting UK Ltd.,UK,9122715.19
2023-10-03,2023-10-03,Client Receipt - CloudBridge Co. #58,Sales Receipt,SaaS-GL,0.0,8682.44,GBP,CHAPS Credit,CloudBridge Co. #58,***9589,INV-202310-SaaS-GL-0019,,False,False,REF-251531,First Continental Bank,***1882,Globex Consulting UK Ltd.,UK,9131397.63
2023-10-04,2023-10-04,Supplier Payment - Stelliform Parts BV #21,Supplier Payment,CEM-EMEA,2342.78,0.0,GBP,CHAPS,Stelliform Parts BV #21,***3926,,PO-202310-CEM-EMEA-0005,False,False,REF-132668,First Continental Bank,***5774,Globex Consulting UK Ltd.,UK,9129054.85
2023-10-04,2023-10-04,Supplier Payment - ExpertNet Subcontractors #9,Supplier Payment,PS-GL,7687.57,0.0,GBP,CHAPS,ExpertNet Subcontractors #9,***1446,,PO-202310-PS-GL-0010,False,False,REF-809290,First Continental Bank,***3223,Globex Consulting UK Ltd.,UK,9121367.28
2023-10-05,2023-10-05,Supplier Payment - CodeCraft Contractors #2,Supplier Payment,SaaS-GL,465.69,0.0,GBP,Faster Payments,CodeCraft Contractors #2,***4869,,PO-202310-SaaS-GL-0001,False,False,REF-286581,First Continental Bank,***9635,Globex Consulting UK Ltd.,UK,9120901.59
2023-10-05,2023-10-05,Client Receipt - CloudBridge Co. #33,Sales Receipt,SaaS-GL,0.0,30705.93,GBP,Faster Payments Credit,CloudBridge Co. #33,***9139,INV-202310-SaaS-GL-0018,,False,False,REF-445373,First Continental Bank,***2308,Globex Consulting UK Ltd.,UK,9151607.52
2023-10-06,2023-10-06,Supplier Payment - CodeCraft Contractors #2,Supplier Payment,SaaS-GL,1285.31,0.0,GBP,Faster Payments,CodeCraft Contractors #2,***1324,,PO-202310-SaaS-GL-0006,False,False,REF-216572,First Continental Bank,***1293,Globex Consulting UK Ltd.,UK,9150322.21
2023-10-06,2023-10-06,Marketing - Beacon Digital #1,Marketing,ALL,6346.06,0.0,GBP,Faster Payments,Beacon Digital #1,***3057,,,False,False,REF-528095,First Continental Bank,***9978,Globex Consulting UK Ltd.,UK,9143976.15
2023-10-06,2023-10-06,Client Receipt - Vertex Advisory Client #28,Sales Receipt,PS-GL,0.0,28575.21,GBP,CHAPS Credit,Vertex Advisory Client #28,***9054,INV-202310-PS-GL-0006,,False,False,REF-741546,First Continental Bank,***5724,Globex Consulting UK Ltd.,UK,9172551.36
2023-10-07,2023-10-07,BluePeak Property Mgmt,Rent & Utilities,ALL,5769.67,0.0,GBP,CHAPS,BluePeak Property Mgmt,***4714,,,False,False,REF-979786,First Continental Bank,***6522,Globex Consulting UK Ltd.,UK,9166781.69
2023-10-07,2023-10-07,Client Receipt - CloudBridge Co. #71,Sales Receipt,SaaS-GL,0.0,12398.05,GBP,CHAPS Credit,CloudBridge Co. #71,***2414,INV-202310-SaaS-GL-0009,,False,False,REF-372543,First Continental Bank,***4992,Globex Consulting UK Ltd.,UK,9179179.74
2023-10-09,2023-10-09,Supplier Payment - HyperCloud Infra #16,Supplier Payment,SaaS-GL,1051.9,0.0,GBP,CHAPS,HyperCloud Infra #16,***4997,,PO-202310-SaaS-GL-0005,False,False,REF-413269,First Continental Bank,***6326,Globex Consulting UK Ltd.,UK,9178127.84
2023-10-09,2023-10-09,Supplier Payment - EuroFab Assembly #9,Supplier Payment,CEM-EMEA,14963.24,0.0,GBP,CHAPS,EuroFab Assembly #9,***7703,,PO-202310-CEM-EMEA-0009,False,False,REF-717515,First Continental Bank,***9317,Globex Consulting UK Ltd.,UK,9163164.6
2023-10-09,2023-10-09,Client Receipt - CloudBridge Co. #5,Sales Receipt,SaaS-GL,0.0,512.15,GBP,CHAPS Credit,CloudBridge Co. #5,***1874,INV-202310-SaaS-GL-0013,,False,False,REF-569862,First Continental Bank,***2159,Globex Consulting UK Ltd.,UK,9163676.75
2023-10-09,2023-10-09,Client Receipt - CloudBridge Co. #67,Sales Receipt,SaaS-GL,0.0,4720.39,GBP,CHAPS Credit,CloudBridge Co. #67,***9527,INV-202310-SaaS-GL-0021,,False,False,REF-843974,First Continental Bank,***4023,Globex Consulting UK Ltd.,UK,9168397.14
2023-10-09,2023-10-09,Client Receipt - CloudBridge Co. #56,Sales Receipt,SaaS-GL,0.0,9238.67,GBP,Faster Payments Credit,CloudBridge Co. #56,***2517,INV-202310-SaaS-GL-0012,,False,False,REF-497654,First Continental Bank,***9772,Globex Consulting UK Ltd.,UK,9177635.81
2023-10-09,2023-10-09,Client Receipt - CloudBridge Co. #39,Sales Receipt,SaaS-GL,0.0,28826.07,GBP,Faster Payments Credit,CloudBridge Co. #39,***3818,INV-202310-SaaS-GL-0011,,False,False,REF-899739,First Continental Bank,***4827,Globex Consulting UK Ltd.,UK,9206461.88
2023-10-10,2023-10-10,Client Receipt - CloudBridge Co. #58,Sales Receipt,SaaS-GL,0.0,947.26,GBP,Faster Payments Credit,CloudBridge Co. #58,***4625,INV-202310-SaaS-GL-0006,,False,False,REF-236414,First Continental Bank,***7018,Globex Consulting UK Ltd.,UK,9207409.14
2023-10-10,2023-10-10,Client Receipt - Vertex Advisory Client #58,Sales Receipt,PS-GL,0.0,5828.92,GBP,Faster Payments Credit,Vertex Advisory Client #58,***6345,INV-202310-PS-GL-0008,,False,False,REF-765029,First Continental Bank,***8812,Globex Consulting UK Ltd.,UK,9213238.06
2023-10-10,2023-10-10,Client Receipt - CloudBridge Co. #38,Sales Receipt,SaaS-GL,0.0,37368.54,GBP,Faster Payments Credit,CloudBridge Co. #38,***7545,INV-202310-SaaS-GL-0005,,False,False,REF-657972,First Continental Bank,***5820,Globex Consulting UK Ltd.,UK,9250606.6
2023-10-11,2023-10-11,Client Receipt - CloudBridge Co. #77,Sales Receipt,SaaS-GL,0.0,1329.62,GBP,CHAPS Credit,CloudBridge Co. #77,***1486,INV-202310-SaaS-GL-0008,,False,False,REF-272038,First Continental Bank,***9553,Globex Consulting UK Ltd.,UK,9251936.22
2023-10-11,2023-10-11,Client Receipt - Vertex Advisory Client #15,Sales Receipt,PS-GL,0.0,4887.77,GBP,CHAPS Credit,Vertex Advisory Client #15,***3516,INV-202310-PS-GL-0002,,False,False,REF-442371,First Continental Bank,***8446,Globex Consulting UK Ltd.,UK,9256823.99
2023-10-11,2023-10-11,Client Receipt - Aurora Electronics GmbH #2,Sales Receipt,CEM-EMEA,0.0,25256.15,GBP,Faster Payments Credit,Aurora Electronics GmbH #2,***6478,INV-202310-CEM-EMEA-0015,,False,False,REF-307023,First Continental Bank,***7089,Globex Consulting UK Ltd.,UK,9282080.14
2023-10-11,2023-10-11,Client Receipt - Aurora Electronics GmbH #11,Sales Receipt,CEM-EMEA,0.0,27165.54,GBP,Faster Payments Credit,Aurora Electronics GmbH #11,***1736,INV-202310-CEM-EMEA-0001,,False,False,REF-378394,First Continental Bank,***8573,Globex Consulting UK Ltd.,UK,9309245.68
2023-10-12,2023-10-12,Supplier Payment - ExpertNet Subcontractors #10,Supplier Payment,PS-GL,1526.26,0.0,GBP,CHAPS,ExpertNet Subcontractors #10,***2402,,PO-202310-PS-GL-0011,False,False,REF-302721,First Continental Bank,***9794,Globex Consulting UK Ltd.,UK,9307719.42
2023-10-12,2023-10-12,"Intercompany Settlement - Globex International Holdings, Inc.",Intercompany Transfer,ALL,369578.0,0.0,GBP,Internal Transfer,"Globex International Holdings, Inc.",***2169,,,True,True,REF-456984,First Continental Bank,***1296,Globex Consulting UK Ltd.,UK,8938141.42
2023-10-12,2023-10-12,Client Receipt - CloudBridge Co. #66,Sales Receipt,SaaS-GL,0.0,30417.32,GBP,CHAPS Credit,CloudBridge Co. #66,***1554,INV-202310-SaaS-GL-0010,,False,False,REF-320215,First Continental Bank,***5974,Globex Consulting UK Ltd.,UK,8968558.74
2023-10-13,2023-10-13,Supplier Payment - ExpertNet Subcontractors #7,Supplier Payment,PS-GL,8623.65,0.0,GBP,CHAPS,ExpertNet Subcontractors #7,***5665,,PO-202310-PS-GL-0004,False,False,REF-251397,First Continental Bank,***7601,Globex Consulting UK Ltd.,UK,8959935.09
2023-10-13,2023-10-13,Client Receipt - Vertex Advisory Client #3,Sales Receipt,PS-GL,0.0,2030.58,GBP,Faster Payments Credit,Vertex Advisory Client #3,***8610,INV-202310-PS-GL-0005,,False,False,REF-973442,First Continental Bank,***7361,Globex Consulting UK Ltd.,UK,8961965.67
2023-10-13,2023-10-13,Client Receipt - CloudBridge Co. #13,Sales Receipt,SaaS-GL,0.0,2043.85,GBP,CHAPS Credit,CloudBridge Co. #13,***9509,INV-202310-SaaS-GL-0017,,False,False,REF-650230,First Continental Bank,***1396,Globex Consulting UK Ltd.,UK,8964009.52
2023-10-13,2023-10-13,Client Receipt - Aurora Electronics GmbH #15,Sales Receipt,CEM-EMEA,0.0,10519.89,GBP,Faster Payments Credit,Aurora Electronics GmbH #15,***4468,INV-202310-CEM-EMEA-0014,,False,False,REF-995908,First Continental Bank,***3500,Globex Consulting UK Ltd.,UK,8974529.41
2023-10-13,2023-10-13,Client Receipt - Novatek Components Ltd #3,Sales Receipt,CEM-EMEA,0.0,20785.48,GBP,Faster Payments Credit,Novatek Components Ltd #3,***6135,INV-202310-CEM-EMEA-0003,,False,False,REF-986101,First Continental Bank,***3681,Globex Consulting UK Ltd.,UK,8995314.89
2023-10-13,2023-10-13,Client Receipt - Aurora Electronics GmbH #13,Sales Receipt,CEM-EMEA,0.0,29196.06,GBP,CHAPS Credit,Aurora Electronics GmbH #13,***9133,INV-202310-CEM-EMEA-0013,,False,False,REF-849580,First Continental Bank,***6910,Globex Consulting UK Ltd.,UK,9024510.95
2023-10-14,2023-10-14,Client Receipt - Aurora Electronics GmbH #15,Sales Receipt,CEM-EMEA,0.0,2321.33,GBP,Faster Payments Credit,Aurora Electronics GmbH #15,***8211,INV-202310-CEM-EMEA-0012,,False,False,REF-185069,First Continental Bank,***5725,Globex Consulting UK Ltd.,UK,9026832.28
2023-10-15,2023-10-15,Client Receipt - Aurora Electronics GmbH #17,Sales Receipt,CEM-EMEA,0.0,7862.87,GBP,CHAPS Credit,Aurora Electronics GmbH #17,***1712,INV-202310-CEM-EMEA-0011,,False,False,REF-853071,First Continental Bank,***7934,Globex Consulting UK Ltd.,UK,9034695.15
2023-10-16,2023-10-16,Client Receipt - Vertex Advisory Client #3,Sales Receipt,PS-GL,0.0,1563.29,GBP,Faster Payments Credit,Vertex Advisory Client #3,***6500,INV-202310-PS-GL-0007,,False,False,REF-729629,First Continental Bank,***5640,Globex Consulting UK Ltd.,UK,9036258.44
2023-10-16,2023-10-16,Client Receipt - Novatek Components Ltd #8,Sales Receipt,CEM-EMEA,0.0,10398.19,GBP,CHAPS Credit,Novatek Components Ltd #8,***6356,INV-202310-CEM-EMEA-0010,,False,False,REF-147134,First Continental Bank,***1047,Globex Consulting UK Ltd.,UK,9046656.63
2023-10-16,2023-10-16,Client Receipt - Aurora Electronics GmbH #15,Sales Receipt,CEM-EMEA,0.0,84551.95,GBP,CHAPS Credit,Aurora Electronics GmbH #15,***1769,INV-202310-CEM-EMEA-0004,,False,False,REF-428261,First Continental Bank,***3734,Globex Consulting UK Ltd.,UK,9131208.58
2023-10-17,2023-10-17,Supplier Payment - HyperCloud Infra #7,Supplier Payment,SaaS-GL,1178.82,0.0,GBP,CHAPS,HyperCloud Infra #7,***4833,,PO-202310-SaaS-GL-0008,False,False,REF-315958,First Continental Bank,***4260,Globex Consulting UK Ltd.,UK,9130029.76
2023-10-17,2023-10-17,Client Receipt - CloudBridge Co. #48,Sales Receipt,SaaS-GL,0.0,1852.53,GBP,CHAPS Credit,CloudBridge Co. #48,***8992,INV-202310-SaaS-GL-0014,,False,False,REF-102045,First Continental Bank,***3725,Globex Consulting UK Ltd.,UK,9131882.29
2023-10-17,2023-10-17,Client Receipt - Novatek Components Ltd #11,Sales Receipt,CEM-EMEA,0.0,2145.02,GBP,Faster Payments Credit,Novatek Components Ltd #11,***5025,INV-202310-CEM-EMEA-0002,,False,False,REF-507332,First Continental Bank,***7386,Globex Consulting UK Ltd.,UK,9134027.31
2023-10-17,2023-10-17,Client Receipt - Novatek Components Ltd #11,Sales Receipt,CEM-EMEA,0.0,58402.18,GBP,CHAPS Credit,Novatek Components Ltd #11,***1298,INV-202310-CEM-EMEA-0005,,False,False,REF-822297,First Continental Bank,***8779,Globex Consulting UK Ltd.,UK,9192429.49
2023-10-18,2023-10-18,Supplier Payment - ExpertNet Subcontractors #7,Supplier Payment,PS-GL,1505.33,0.0,GBP,CHAPS,ExpertNet Subcontractors #7,***1880,,PO-202310-PS-GL-0008,False,False,REF-812087,First Continental Bank,***4928,Globex Consulting UK Ltd.,UK,9190924.16
2023-10-19,2023-10-19,Supplier Payment - ExpertNet Subcontractors #11,Supplier Payment,PS-GL,1318.0,0.0,GBP,CHAPS,ExpertNet Subcontractors #11,***2401,,PO-202310-PS-GL-0001,False,False,REF-476097,First Continental Bank,***3167,Globex Consulting UK Ltd.,UK,9189606.16
2023-10-19,2023-10-19,Supplier Payment - ExpertNet Subcontractors #3,Supplier Payment,PS-GL,1585.13,0.0,GBP,Faster Payments,ExpertNet Subcontractors #3,***5498,,PO-202310-PS-GL-0007,False,False,REF-573436,First Continental Bank,***1823,Globex Consulting UK Ltd.,UK,9188021.03
2023-10-19,2023-10-19,Supplier Payment - ExpertNet Subcontractors #15,Supplier Payment,PS-GL,3098.64,0.0,GBP,Faster Payments,ExpertNet Subcontractors #15,***2880,,PO-202310-PS-GL-0005,False,False,REF-143882,First Continental Bank,***6960,Globex Consulting UK Ltd.,UK,9184922.39
2023-10-19,2023-10-19,Supplier Payment - ExpertNet Subcontractors #6,Supplier Payment,PS-GL,4550.12,0.0,GBP,CHAPS,ExpertNet Subcontractors #6,***9746,,PO-202310-PS-GL-0006,False,False,REF-695492,First Continental Bank,***3312,Globex Consulting UK Ltd.,UK,9180372.27
2023-10-19,2023-10-19,Supplier Payment - HyperCloud Infra #12,Supplier Payment,SaaS-GL,4578.14,0.0,GBP,CHAPS,HyperCloud Infra #12,***6504,,PO-202310-SaaS-GL-0004,False,False,REF-701929,First Continental Bank,***3093,Globex Consulting UK Ltd.,UK,9175794.13
2023-10-19,2023-10-19,Supplier Payment - ExpertNet Subcontractors #1,Supplier Payment,PS-GL,5379.88,0.0,GBP,CHAPS,ExpertNet Subcontractors #1,***7063,,PO-202310-PS-GL-0002,False,False,REF-439486,First Continental Bank,***2209,Globex Consulting UK Ltd.,UK,9170414.25
2023-10-19,2023-10-19,Supplier Payment - Stelliform Parts BV #12,Supplier Payment,CEM-EMEA,83717.85,0.0,GBP,CHAPS,Stelliform Parts BV #12,***7472,,PO-202310-CEM-EMEA-0010,False,False,REF-320162,First Continental Bank,***8558,Globex Consulting UK Ltd.,UK,9086696.4
2023-10-19,2023-10-19,Client Receipt - Aurora Electronics GmbH #15,Sales Receipt,CEM-EMEA,0.0,1927.29,GBP,Faster Payments Credit,Aurora Electronics GmbH #15,***4097,INV-202310-CEM-EMEA-0007,,False,False,REF-309484,First Continental Bank,***5032,Globex Consulting UK Ltd.,UK,9088623.69
2023-10-19,2023-10-19,Client Receipt - Vertex Advisory Client #48,Sales Receipt,PS-GL,0.0,8161.72,GBP,CHAPS Credit,Vertex Advisory Client #48,***7805,INV-202310-PS-GL-0010,,False,False,REF-461082,First Continental Bank,***3082,Globex Consulting UK Ltd.,UK,9096785.41
2023-10-19,2023-10-19,Client Receipt - CloudBridge Co. #17,Sales Receipt,SaaS-GL,0.0,9695.35,GBP,CHAPS Credit,CloudBridge Co. #17,***5319,INV-202310-SaaS-GL-0001,,False,False,REF-298753,First Continental Bank,***2722,Globex Consulting UK Ltd.,UK,9106480.76
2023-10-19,2023-10-19,Client Receipt - Aurora Electronics GmbH #6,Sales Receipt,CEM-EMEA,0.0,37294.85,GBP,Faster Payments Credit,Aurora Electronics GmbH #6,***5032,INV-202310-CEM-EMEA-0008,,False,False,REF-695116,First Continental Bank,***3795,Globex Consulting UK Ltd.,UK,9143775.61
2023-10-20,2023-10-20,VAT/GST Remittance - HMRC UK,Tax Payment,ALL,44999.16,0.0,GBP,SWIFT MT103,HMRC UK,***3339,,,False,False,REF-147503,First Continental Bank,***4543,Globex Consulting UK Ltd.,UK,9098776.45
2023-10-20,2023-10-20,Supplier Payment - EuroFab Assembly #3,Supplier Payment,CEM-EMEA,50237.99,0.0,GBP,CHAPS,EuroFab Assembly #3,***8609,,PO-202310-CEM-EMEA-0006,False,False,REF-700218,First Continental Bank,***2205,Globex Consulting UK Ltd.,UK,9048538.46
2023-10-20,2023-10-20,Client Receipt - Vertex Advisory Client #48,Sales Receipt,PS-GL,0.0,25047.0,GBP,Faster Payments Credit,Vertex Advisory Client #48,***4513,INV-202310-PS-GL-0004,,False,False,REF-271081,First Continental Bank,***4537,Globex Consulting UK Ltd.,UK,9073585.46
2023-10-21,2023-10-21,Supplier Payment - ExpertNet Subcontractors #16,Supplier Payment,PS-GL,4585.38,0.0,GBP,Faster Payments,ExpertNet Subcontractors #16,***7319,,PO-202310-PS-GL-0009,False,False,REF-882825,First Continental Bank,***9133,Globex Consulting UK Ltd.,UK,9069000.08
2023-10-22,2023-10-22,Merchant Processing Fees,Bank/Merchant Fees,ALL,933.28,0.0,GBP,Faster Payments,First Continental Bank,***6210,,,False,False,REF-442180,First Continental Bank,***9770,Globex Consulting UK Ltd.,UK,9068066.8
2023-10-23,2023-10-23,Supplier Payment - HyperCloud Infra #12,Supplier Payment,SaaS-GL,4972.56,0.0,GBP,CHAPS,HyperCloud Infra #12,***4515,,PO-202310-SaaS-GL-0007,False,False,REF-251277,First Continental Bank,***4631,Globex Consulting UK Ltd.,UK,9063094.24
2023-10-23,2023-10-23,Marketing - Beacon Digital #9,Marketing,ALL,11386.88,0.0,GBP,CHAPS,Beacon Digital #9,***1495,,,False,False,REF-455546,First Continental Bank,***8014,Globex Consulting UK Ltd.,UK,9051707.36
2023-10-23,2023-10-23,Client Receipt - Vertex Advisory Client #7,Sales Receipt,PS-GL,0.0,17224.08,GBP,CHAPS Credit,Vertex Advisory Client #7,***1759,INV-202310-PS-GL-0011,,False,False,REF-574840,First Continental Bank,***8884,Globex Consulting UK Ltd.,UK,9068931.44
2023-10-24,2023-10-24,Supplier Payment - Stelliform Parts BV #7,Supplier Payment,CEM-EMEA,6202.37,0.0,GBP,CHAPS,Stelliform Parts BV #7,***9036,,PO-202310-CEM-EMEA-0001,False,False,REF-716855,First Continental Bank,***8646,Globex Consulting UK Ltd.,UK,9062729.07
2023-10-24,2023-10-24,Supplier Payment - HyperCloud Infra #15,Supplier Payment,SaaS-GL,6867.53,0.0,GBP,Faster Payments,HyperCloud Infra #15,***8373,,PO-202310-SaaS-GL-0003,False,False,REF-329605,First Continental Bank,***2525,Globex Consulting UK Ltd.,UK,9055861.54
2023-10-24,2023-10-24,Supplier Payment - EuroFab Assembly #8,Supplier Payment,CEM-EMEA,18634.06,0.0,GBP,CHAPS,EuroFab Assembly #8,***6621,,PO-202310-CEM-EMEA-0003,False,False,REF-386937,First Continental Bank,***4797,Globex Consulting UK Ltd.,UK,9037227.48
2023-10-24,2023-10-24,Client Receipt - CloudBridge Co. #5,Sales Receipt,SaaS-GL,0.0,7934.63,GBP,CHAPS Credit,CloudBridge Co. #5,***8000,INV-202310-SaaS-GL-0016,,False,False,REF-726438,First Continental Bank,***8755,Globex Consulting UK Ltd.,UK,9045162.11
2023-10-24,2023-10-24,Client Receipt - CloudBridge Co. #38,Sales Receipt,SaaS-GL,0.0,12541.34,GBP,CHAPS Credit,CloudBridge Co. #38,***2043,INV-202310-SaaS-GL-0015,,False,False,REF-385625,First Continental Bank,***5579,Globex Consulting UK Ltd.,UK,9057703.45
2023-10-24,2023-10-24,Client Receipt - Vertex Advisory Client #39,Sales Receipt,PS-GL,0.0,13081.16,GBP,Faster Payments Credit,Vertex Advisory Client #39,***5939,INV-202310-PS-GL-0001,,False,False,REF-437853,First Continental Bank,***2584,Globex Consulting UK Ltd.,UK,9070784.61
2023-10-25,2023-10-25,Supplier Payment - ExpertNet Subcontractors #17,Supplier Payment,PS-GL,4510.54,0.0,GBP,CHAPS,ExpertNet Subcontractors #17,***6614,,PO-202310-PS-GL-0012,False,False,REF-344372,First Continental Bank,***2802,Globex Consulting UK Ltd.,UK,9066274.07
2023-10-25,2023-10-25,Supplier Payment - HyperCloud Infra #17,Supplier Payment,SaaS-GL,15153.05,0.0,GBP,CHAPS,HyperCloud Infra #17,***3599,,PO-202310-SaaS-GL-0002,False,False,REF-972524,First Continental Bank,***3186,Globex Consulting UK Ltd.,UK,9051121.02
2023-10-25,2023-10-25,Payroll - GlobalPay Services Ltd,Payroll,ALL,57411.89,0.0,GBP,CHAPS,GlobalPay Services Ltd,***4107,,,False,False,REF-879114,First Continental Bank,***3313,Globex Consulting UK Ltd.,UK,8993709.13
2023-10-25,2023-10-25,Client Receipt - CloudBridge Co. #36,Sales Receipt,SaaS-GL,0.0,13165.0,GBP,Faster Payments Credit,CloudBridge Co. #36,***4235,INV-202310-SaaS-GL-0003,,False,False,REF-452930,First Continental Bank,***5610,Globex Consulting UK Ltd.,UK,9006874.13
2023-10-26,2023-10-26,Merchant Processing Fees,Bank/Merchant Fees,ALL,1215.6,0.0,GBP,Faster Payments,First Continental Bank,***1552,,,False,False,REF-279082,First Continental Bank,***2184,Globex Consulting UK Ltd.,UK,9005658.53
2023-10-26,2023-10-26,Intercompany Settlement - Globex APAC Logistics Pte. Ltd.,Intercompany Transfer,ALL,343275.0,0.0,GBP,Internal Transfer,Globex APAC Logistics Pte. Ltd.,***3070,,,True,True,REF-992375,First Continental Bank,***8757,Globex Consulting UK Ltd.,UK,8662383.53
2023-10-27,2023-10-27,Supplier Payment - Stelliform Parts BV #3,Supplier Payment,CEM-EMEA,1982.09,0.0,GBP,Faster Payments,Stelliform Parts BV #3,***7633,,PO-202310-CEM-EMEA-0004,False,False,REF-868653,First Continental Bank,***9716,Globex Consulting UK Ltd.,UK,8660401.44
2023-10-27,2023-10-27,Payroll - GlobalPay Services Ltd,Payroll,ALL,57411.89,0.0,GBP,CHAPS,GlobalPay Services Ltd,***4340,,,False,False,REF-819050,First Continental Bank,***9882,Globex Consulting UK Ltd.,UK,8602989.55
2023-10-27,2023-10-27,Client Receipt - Novatek Components Ltd #4,Sales Receipt,CEM-EMEA,0.0,16.58,GBP,CHAPS Credit,Novatek Components Ltd #4,***8471,INV-202310-CEM-EMEA-0006,,False,False,REF-857073,First Continental Bank,***3520,Globex Consulting UK Ltd.,UK,8603006.13
2023-10-27,2023-10-27,Client Receipt - CloudBridge Co. #67,Sales Receipt,SaaS-GL,0.0,5977.4,GBP,Faster Payments Credit,CloudBridge Co. #67,***5289,INV-202310-SaaS-GL-0002,,False,False,REF-747433,First Continental Bank,***2682,Globex Consulting UK Ltd.,UK,8608983.53
2023-10-28,2023-10-28,Corporate Tax Estimate,Tax Payment,ALL,31793.29,0.0,GBP,SWIFT MT103,HMRC UK,***3758,,,False,False,REF-401145,First Continental Bank,***1693,Globex Consulting UK Ltd.,UK,8577190.24
2023-10-30,2023-10-30,Client Receipt - Vertex Advisory Client #14,Sales Receipt,PS-GL,0.0,9261.29,GBP,CHAPS Credit,Vertex Advisory Client #14,***7547,INV-202310-PS-GL-0003,,False,False,REF-798719,First Continental Bank,***1275,Globex Consulting UK Ltd.,UK,8586451.53
2023-10-30,2023-10-30,Interest Earned,Interest Income,ALL,0.0,12374.95,GBP,Faster Payments Credit,First Continental Bank,***5976,,,False,False,REF-407967,First Continental Bank,***2321,Globex Consulting UK Ltd.,UK,8598826.48
2023-10-30,2023-10-30,Client Receipt - Aurora Electronics GmbH #10,Sales Receipt,CEM-EMEA,0.0,27544.9,GBP,CHAPS Credit,Aurora Electronics GmbH #10,***3303,INV-202310-CEM-EMEA-0009,,False,False,REF-472862,First Continental Bank,***5807,Globex Consulting UK Ltd.,UK,8626371.38
2023-10-31,2023-10-31,Supplier Payment - Stelliform Parts BV #2,Supplier Payment,CEM-EMEA,1050.37,0.0,GBP,CHAPS,Stelliform Parts BV #2,***3693,,PO-202310-CEM-EMEA-0002,False,False,REF-503758,First Continental Bank,***2062,Globex Consulting UK Ltd.,UK,8625321.01
2023-10-31,2023-10-31,Supplier Payment - CodeCraft Contractors #1,Supplier Payment,SaaS-GL,13294.77,0.0,GBP,Faster Payments,CodeCraft Contractors #1,***8480,,PO-202310-SaaS-GL-0009,False,False,REF-833357,First Continental Bank,***2424,Globex Consulting UK Ltd.,UK,8612026.24
2023-10-31,2023-10-31,Client Receipt - CloudBridge Co. #25,Sales Receipt,SaaS-GL,0.0,115.22,GBP,Faster Payments Credit,CloudBridge Co. #25,***6099,INV-202310-SaaS-GL-0004,,False,False,REF-234699,First Continental Bank,***1114,Globex Consulting UK Ltd.,UK,8612141.46
2023-10-31,2023-10-31,Client Receipt - CloudBridge Co. #63,Sales Receipt,SaaS-GL,0.0,1512.29,GBP,CHAPS Credit,CloudBridge Co. #63,***7839,INV-202310-SaaS-GL-0020,,False,False,REF-196878,First Continental Bank,***9381,Globex Consulting UK Ltd.,UK,8613653.75
2023-10-31,2023-10-31,Client Receipt - Vertex Advisory Client #48,Sales Receipt,PS-GL,0.0,32362.53,GBP,Faster Payments Credit,Vertex Advisory Client #48,***7690,INV-202310-PS-GL-0009,,False,False,REF-577141,First Continental Bank,***5519,Globex Consulting UK Ltd.,UK,8646016.28
2023-11-01,2023-11-01,Account Maintenance Fee,Bank/Merchant Fees,ALL,2500.0,0.0,GBP,CHAPS,First Continental Bank,***2173,,,False,False,REF-632931,First Continental Bank,***1402,Globex Consulting UK Ltd.,UK,8643516.28
2023-11-01,2023-11-01,Supplier Payment - HyperCloud Infra #12,Supplier Payment,SaaS-GL,4680.9,0.0,GBP,CHAPS,HyperCloud Infra #12,***4146,,PO-202311-SaaS-GL-0010,False,False,REF-740027,First Continental Bank,***6682,Globex Consulting UK Ltd.,UK,8638835.38
2023-11-01,2023-11-01,Client Receipt - Aurora Electronics GmbH #10,Sales Receipt,CEM-EMEA,0.0,2188.41,GBP,CHAPS Credit,Aurora Electronics GmbH #10,***4581,INV-202311-CEM-EMEA-0004,,False,False,REF-922570,First Continental Bank,***3787,Globex Consulting UK Ltd.,UK,8641023.79
2023-11-01,2023-11-01,Client Receipt - Vertex Advisory Client #14,Sales Receipt,PS-GL,0.0,7383.16,GBP,CHAPS Credit,Vertex Advisory Client #14,***6747,INV-202311-PS-GL-0008,,False,False,REF-505558,First Continental Bank,***4249,Globex Consulting UK Ltd.,UK,8648406.95
2023-11-01,2023-11-01,Client Receipt - Aurora Electronics GmbH #17,Sales Receipt,CEM-EMEA,0.0,12274.42,GBP,Faster Payments Credit,Aurora Electronics GmbH #17,***4990,INV-202311-CEM-EMEA-0012,,False,False,REF-976124,First Continental Bank,***2447,Globex Consulting UK Ltd.,UK,8660681.37
2023-11-02,2023-11-02,Supplier Payment - Stelliform Parts BV #25,Supplier Payment,CEM-EMEA,23240.93,0.0,GBP,Faster Payments,Stelliform Parts BV #25,***1938,,PO-202311-CEM-EMEA-0008,False,False,REF-499156,First Continental Bank,***2649,Globex Consulting UK Ltd.,UK,8637440.44
2023-11-02,2023-11-02,Client Receipt - CloudBridge Co. #66,Sales Receipt,SaaS-GL,0.0,14506.0,GBP,Faster Payments Credit,CloudBridge Co. #66,***7815,INV-202311-SaaS-GL-0014,,False,False,REF-324832,First Continental Bank,***7746,Globex Consulting UK Ltd.,UK,8651946.44
2023-11-02,2023-11-02,Client Receipt - Aurora Electronics GmbH #12,Sales Receipt,CEM-EMEA,0.0,30436.55,GBP,Faster Payments Credit,Aurora Electronics GmbH #12,***4174,INV-202311-CEM-EMEA-0013,,False,False,REF-350146,First Continental Bank,***2550,Globex Consulting UK Ltd.,UK,8682382.99
2023-11-03,2023-11-03,Supplier Payment - ExpertNet Subcontractors #10,Supplier Payment,PS-GL,1815.74,0.0,GBP,CHAPS,ExpertNet Subcontractors #10,***5931,,PO-202311-PS-GL-0005,False,False,REF-671899,First Continental Bank,***7867,Globex Consulting UK Ltd.,UK,8680567.25
2023-11-05,2023-11-05,Supplier Payment - Stelliform Parts BV #21,Supplier Payment,CEM-EMEA,32753.43,0.0,GBP,CHAPS,Stelliform Parts BV #21,***4226,,PO-202311-CEM-EMEA-0007,False,False,REF-897947,First Continental Bank,***6863,Globex Consulting UK Ltd.,UK,8647813.82
2023-11-06,2023-11-06,Alphagrid Utilities,Rent & Utilities,ALL,1888.96,0.0,GBP,CHAPS,Alphagrid Utilities,***3135,,,False,False,REF-519134,First Continental Bank,***2342,Globex Consulting UK Ltd.,UK,8645924.86
2023-11-06,2023-11-06,Supplier Payment - CodeCraft Contractors #2,Supplier Payment,SaaS-GL,15153.69,0.0,GBP,Faster Payments,CodeCraft Contractors #2,***3580,,PO-202311-SaaS-GL-0006,False,False,REF-497387,First Continental Bank,***5242,Globex Consulting UK Ltd.,UK,8630771.17
2023-11-06,2023-11-06,Client Receipt - CloudBridge Co. #69,Sales Receipt,SaaS-GL,0.0,1724.91,GBP,Faster Payments Credit,CloudBridge Co. #69,***4850,INV-202311-SaaS-GL-0025,,False,False,REF-402007,First Continental Bank,***9324,Globex Consulting UK Ltd.,UK,8632496.08
2023-11-06,2023-11-06,Client Receipt - Vertex Advisory Client #47,Sales Receipt,PS-GL,0.0,14882.37,GBP,CHAPS Credit,Vertex Advisory Client #47,***7389,INV-202311-PS-GL-0004,,False,False,REF-827752,First Continental Bank,***9407,Globex Consulting UK Ltd.,UK,8647378.45
2023-11-07,2023-11-07,Supplier Payment - ExpertNet Subcontractors #9,Supplier Payment,PS-GL,4139.81,0.0,GBP,CHAPS,ExpertNet Subcontractors #9,***1130,,PO-202311-PS-GL-0002,False,False,REF-186486,First Continental Bank,***3681,Globex Consulting UK Ltd.,UK,8643238.64
2023-11-07,2023-11-07,Client Receipt - CloudBridge Co. #52,Sales Receipt,SaaS-GL,0.0,1472.64,GBP,Faster Payments Credit,CloudBridge Co. #52,***7952,INV-202311-SaaS-GL-0007,,False,False,REF-357019,First Continental Bank,***6468,Globex Consulting UK Ltd.,UK,8644711.28
2023-11-07,2023-11-07,Client Receipt - CloudBridge Co. #36,Sales Receipt,SaaS-GL,0.0,6499.09,GBP,CHAPS Credit,CloudBridge Co. #36,***9857,INV-202311-SaaS-GL-0003,,False,False,REF-162817,First Continental Bank,***5452,Globex Consulting UK Ltd.,UK,8651210.37
2023-11-08,2023-11-08,Supplier Payment - ExpertNet Subcontractors #7,Supplier Payment,PS-GL,2431.37,0.0,GBP,CHAPS,ExpertNet Subcontractors #7,***8654,,PO-202311-PS-GL-0001,False,False,REF-686481,First Continental Bank,***9483,Globex Consulting UK Ltd.,UK,8648779.0
2023-11-08,2023-11-08,Supplier Payment - CodeCraft Contractors #5,Supplier Payment,SaaS-GL,2457.59,0.0,GBP,Faster Payments,CodeCraft Contractors #5,***3778,,PO-202311-SaaS-GL-0003,False,False,REF-818252,First Continental Bank,***4491,Globex Consulting UK Ltd.,UK,8646321.41
2023-11-08,2023-11-08,Supplier Payment - ExpertNet Subcontractors #3,Supplier Payment,PS-GL,4255.83,0.0,GBP,CHAPS,ExpertNet Subcontractors #3,***4096,,PO-202311-PS-GL-0003,False,False,REF-461343,First Continental Bank,***4278,Globex Consulting UK Ltd.,UK,8642065.58
2023-11-08,2023-11-08,Client Receipt - CloudBridge Co. #6,Sales Receipt,SaaS-GL,0.0,7060.25,GBP,Faster Payments Credit,CloudBridge Co. #6,***4777,INV-202311-SaaS-GL-0022,,False,False,REF-783489,First Continental Bank,***5013,Globex Consulting UK Ltd.,UK,8649125.83
2023-11-08,2023-11-08,Client Receipt - CloudBridge Co. #39,Sales Receipt,SaaS-GL,0.0,7333.71,GBP,Faster Payments Credit,CloudBridge Co. #39,***6810,INV-202311-SaaS-GL-0024,,False,False,REF-180342,First Continental Bank,***2761,Globex Consulting UK Ltd.,UK,8656459.54
2023-11-08,2023-11-08,Client Receipt - Vertex Advisory Client #41,Sales Receipt,PS-GL,0.0,13821.07,GBP,Faster Payments Credit,Vertex Advisory Client #41,***7476,INV-202311-PS-GL-0002,,False,False,REF-162627,First Continental Bank,***7419,Globex Consulting UK Ltd.,UK,8670280.61
2023-11-08,2023-11-08,Client Receipt - Vertex Advisory Client #30,Sales Receipt,PS-GL,0.0,55608.4,GBP,Faster Payments Credit,Vertex Advisory Client #30,***3605,INV-202311-PS-GL-0005,,False,False,REF-150902,First Continental Bank,***9706,Globex Consulting UK Ltd.,UK,8725889.01
2023-11-09,2023-11-09,Supplier Payment - HyperCloud Infra #4,Supplier Payment,SaaS-GL,2631.54,0.0,GBP,Faster Payments,HyperCloud Infra #4,***1752,,PO-202311-SaaS-GL-0008,False,False,REF-905583,First Continental Bank,***4679,Globex Consulting UK Ltd.,UK,8723257.47
2023-11-09,2023-11-09,Supplier Payment - ExpertNet Subcontractors #18,Supplier Payment,PS-GL,18401.9,0.0,GBP,CHAPS,ExpertNet Subcontractors #18,***6402,,PO-202311-PS-GL-0007,False,False,REF-778538,First Continental Bank,***3875,Globex Consulting UK Ltd.,UK,8704855.57
2023-11-09,2023-11-09,Client Receipt - Vertex Advisory Client #7,Sales Receipt,PS-GL,0.0,11727.65,GBP,CHAPS Credit,Vertex Advisory Client #7,***3566,INV-202311-PS-GL-0003,,False,False,REF-876773,First Continental Bank,***1044,Globex Consulting UK Ltd.,UK,8716583.22
2023-11-09,2023-11-09,Client Receipt - Vertex Advisory Client #52,Sales Receipt,PS-GL,0.0,17194.58,GBP,CHAPS Credit,Vertex Advisory Client #52,***1094,INV-202311-PS-GL-0011,,False,False,REF-385676,First Continental Bank,***4003,Globex Consulting UK Ltd.,UK,8733777.8
2023-11-10,2023-11-10,Supplier Payment - Stelliform Parts BV #24,Supplier Payment,CEM-EMEA,8608.9,0.0,GBP,Faster Payments,Stelliform Parts BV #24,***6321,,PO-202311-CEM-EMEA-0003,False,False,REF-900426,First Continental Bank,***1510,Globex Consulting UK Ltd.,UK,8725168.9
2023-11-10,2023-11-10,Supplier Payment - EuroFab Assembly #24,Supplier Payment,CEM-EMEA,18809.81,0.0,GBP,CHAPS,EuroFab Assembly #24,***5286,,PO-202311-CEM-EMEA-0001,False,False,REF-516732,First Continental Bank,***3331,Globex Consulting UK Ltd.,UK,8706359.09
2023-11-10,2023-11-10,Supplier Payment - EuroFab Assembly #23,Supplier Payment,CEM-EMEA,81512.25,0.0,GBP,Faster Payments,EuroFab Assembly #23,***1358,,PO-202311-CEM-EMEA-0005,False,False,REF-702849,First Continental Bank,***7033,Globex Consulting UK Ltd.,UK,8624846.84
2023-11-11,2023-11-11,Client Receipt - CloudBridge Co. #61,Sales Receipt,SaaS-GL,0.0,9466.82,GBP,CHAPS Credit,CloudBridge Co. #61,***9657,INV-202311-SaaS-GL-0008,,False,False,REF-225245,First Continental Bank,***4156,Globex Consulting UK Ltd.,UK,8634313.66
2023-11-11,2023-11-11,Client Receipt - Aurora Electronics GmbH #8,Sales Receipt,CEM-EMEA,0.0,17641.52,GBP,Faster Payments Credit,Aurora Electronics GmbH #8,***3624,INV-202311-CEM-EMEA-0001,,False,False,REF-136022,First Continental Bank,***3680,Globex Consulting UK Ltd.,UK,8651955.18
2023-11-12,2023-11-12,Intercompany Settlement - Globex Retail NA LLC,Intercompany Transfer,ALL,578936.0,0.0,GBP,Internal Transfer,Globex Retail NA LLC,***5471,,,True,True,REF-527148,First Continental Bank,***7071,Globex Consulting UK Ltd.,UK,8073019.18
2023-11-12,2023-11-12,Client Receipt - CloudBridge Co. #25,Sales Receipt,SaaS-GL,0.0,1372.29,GBP,CHAPS Credit,CloudBridge Co. #25,***1642,INV-202311-SaaS-GL-0006,,False,False,REF-674246,First Continental Bank,***2414,Globex Consulting UK Ltd.,UK,8074391.47
2023-11-12,2023-11-12,Client Receipt - CloudBridge Co. #51,Sales Receipt,SaaS-GL,0.0,20733.74,GBP,CHAPS Credit,CloudBridge Co. #51,***7507,INV-202311-SaaS-GL-0016,,False,False,REF-279219,First Continental Bank,***5475,Globex Consulting UK Ltd.,UK,8095125.21
2023-11-12,2023-11-12,Intercompany Reimbursement - Globex Retail NA LLC,Intercompany Transfer,ALL,0.0,231574.4,GBP,Internal Transfer,Globex Retail NA LLC,***4569,,,True,True,REF-839944,First Continental Bank,***2458,Globex Consulting UK Ltd.,UK,8326699.61
2023-11-13,2023-11-13,Client Receipt - CloudBridge Co. #19,Sales Receipt,SaaS-GL,0.0,6236.66,GBP,Faster Payments Credit,CloudBridge Co. #19,***8214,INV-202311-SaaS-GL-0002,,False,False,REF-214561,First Continental Bank,***3530,Globex Consulting UK Ltd.,UK,8332936.27
2023-11-13,2023-11-13,Client Receipt - CloudBridge Co. #51,Sales Receipt,SaaS-GL,0.0,7619.34,GBP,Faster Payments Credit,CloudBridge Co. #51,***1767,INV-202311-SaaS-GL-0004,,False,False,REF-509738,First Continental Bank,***5025,Globex Consulting UK Ltd.,UK,8340555.61
2023-11-14,2023-11-14,Supplier Payment - Stelliform Parts BV #17,Supplier Payment,CEM-EMEA,35181.23,0.0,GBP,Faster Payments,Stelliform Parts BV #17,***8311,,PO-202311-CEM-EMEA-0004,False,False,REF-627661,First Continental Bank,***8406,Globex Consulting UK Ltd.,UK,8305374.38
2023-11-14,2023-11-14,Client Receipt - CloudBridge Co. #53,Sales Receipt,SaaS-GL,0.0,6138.8,GBP,Faster Payments Credit,CloudBridge Co. #53,***8497,INV-202311-SaaS-GL-0013,,False,False,REF-342877,First Continental Bank,***9198,Globex Consulting UK Ltd.,UK,8311513.18
2023-11-14,2023-11-14,Client Receipt - CloudBridge Co. #8,Sales Receipt,SaaS-GL,0.0,19050.7,GBP,CHAPS Credit,CloudBridge Co. #8,***5932,INV-202311-SaaS-GL-0012,,False,False,REF-932817,First Continental Bank,***8219,Globex Consulting UK Ltd.,UK,8330563.88
2023-11-15,2023-11-15,Supplier Payment - ExpertNet Subcontractors #13,Supplier Payment,PS-GL,1493.96,0.0,GBP,Faster Payments,ExpertNet Subcontractors #13,***2403,,PO-202311-PS-GL-0008,False,False,REF-140293,First Continental Bank,***5993,Globex Consulting UK Ltd.,UK,8329069.92
2023-11-15,2023-11-15,Client Receipt - CloudBridge Co. #75,Sales Receipt,SaaS-GL,0.0,14082.78,GBP,Faster Payments Credit,CloudBridge Co. #75,***6673,INV-202311-SaaS-GL-0010,,False,False,REF-412858,First Continental Bank,***8297,Globex Consulting UK Ltd.,UK,8343152.7
2023-11-15,2023-11-15,Client Receipt - Aurora Electronics GmbH #1,Sales Receipt,CEM-EMEA,0.0,34018.37,GBP,CHAPS Credit,Aurora Electronics GmbH #1,***3411,INV-202311-CEM-EMEA-0006,,False,False,REF-124682,First Continental Bank,***9370,Globex Consulting UK Ltd.,UK,8377171.07
2023-11-15,2023-11-15,Client Receipt - Aurora Electronics GmbH #11,Sales Receipt,CEM-EMEA,0.0,41450.29,GBP,Faster Payments Credit,Aurora Electronics GmbH #11,***8872,INV-202311-CEM-EMEA-0015,,False,False,REF-385140,First Continental Bank,***7153,Globex Consulting UK Ltd.,UK,8418621.36
2023-11-16,2023-11-16,Marketing - Aurelia Media #4,Marketing,ALL,5113.8,0.0,GBP,Faster Payments,Aurelia Media #4,***8688,,,False,False,REF-921299,First Continental Bank,***3796,Globex Consulting UK Ltd.,UK,8413507.56
2023-11-16,2023-11-16,Client Receipt - CloudBridge Co. #15,Sales Receipt,SaaS-GL,0.0,4193.04,GBP,CHAPS Credit,CloudBridge Co. #15,***3509,INV-202311-SaaS-GL-0011,,False,False,REF-595779,First Continental Bank,***1062,Globex Consulting UK Ltd.,UK,8417700.6
2023-11-16,2023-11-16,Client Receipt - Aurora Electronics GmbH #10,Sales Receipt,CEM-EMEA,0.0,12031.56,GBP,CHAPS Credit,Aurora Electronics GmbH #10,***1776,INV-202311-CEM-EMEA-0011,,False,False,REF-324351,First Continental Bank,***3343,Globex Consulting UK Ltd.,UK,8429732.16
2023-11-16,2023-11-16,Client Receipt - Aurora Electronics GmbH #18,Sales Receipt,CEM-EMEA,0.0,106942.93,GBP,Faster Payments Credit,Aurora Electronics GmbH #18,***4101,INV-202311-CEM-EMEA-0010,,False,False,REF-769714,First Continental Bank,***5292,Globex Consulting UK Ltd.,UK,8536675.09
2023-11-17,2023-11-17,Client Receipt - Vertex Advisory Client #30,Sales Receipt,PS-GL,0.0,7662.51,GBP,CHAPS Credit,Vertex Advisory Client #30,***8502,INV-202311-PS-GL-0001,,False,False,REF-676108,First Continental Bank,***7236,Globex Consulting UK Ltd.,UK,8544337.6
2023-11-17,2023-11-17,Client Receipt - Aurora Electronics GmbH #15,Sales Receipt,CEM-EMEA,0.0,57606.24,GBP,CHAPS Credit,Aurora Electronics GmbH #15,***8603,INV-202311-CEM-EMEA-0008,,False,False,REF-624942,First Continental Bank,***8000,Globex Consulting UK Ltd.,UK,8601943.84
2023-11-20,2023-11-20,Client Receipt - Vertex Advisory Client #31,Sales Receipt,PS-GL,0.0,15986.25,GBP,Faster Payments Credit,Vertex Advisory Client #31,***4774,INV-202311-PS-GL-0006,,False,False,REF-495393,First Continental Bank,***4602,Globex Consulting UK Ltd.,UK,8617930.09
2023-11-20,2023-11-20,Client Receipt - Novatek Components Ltd #13,Sales Receipt,CEM-EMEA,0.0,31362.37,GBP,Faster Payments Credit,Novatek Components Ltd #13,***1321,INV-202311-CEM-EMEA-0016,,False,False,REF-933703,First Continental Bank,***7004,Globex Consulting UK Ltd.,UK,8649292.46
2023-11-21,2023-11-21,Supplier Payment - Stelliform Parts BV #11,Supplier Payment,CEM-EMEA,18176.78,0.0,GBP,CHAPS,Stelliform Parts BV #11,***1731,,PO-202311-CEM-EMEA-0006,False,False,REF-184607,First Continental Bank,***6055,Globex Consulting UK Ltd.,UK,8631115.68
2023-11-21,2023-11-21,Client Receipt - CloudBridge Co. #14,Sales Receipt,SaaS-GL,0.0,17351.7,GBP,Faster Payments Credit,CloudBridge Co. #14,***4080,INV-202311-SaaS-GL-0009,,False,False,REF-213242,First Continental Bank,***9853,Globex Consulting UK Ltd.,UK,8648467.38
2023-11-21,2023-11-21,Client Receipt - CloudBridge Co. #48,Sales Receipt,SaaS-GL,0.0,34243.76,GBP,Faster Payments Credit,CloudBridge Co. #48,***3668,INV-202311-SaaS-GL-0020,,False,False,REF-976738,First Continental Bank,***4345,Globex Consulting UK Ltd.,UK,8682711.14
2023-11-22,2023-11-22,VAT/GST Remittance - HMRC UK,Tax Payment,ALL,51193.62,0.0,GBP,Faster Payments,HMRC UK,***9435,,,False,False,REF-703561,First Continental Bank,***6472,Globex Consulting UK Ltd.,UK,8631517.52
2023-11-22,2023-11-22,Client Receipt - CloudBridge Co. #75,Sales Receipt,SaaS-GL,0.0,8404.97,GBP,CHAPS Credit,CloudBridge Co. #75,***1870,INV-202311-SaaS-GL-0018,,False,False,REF-706785,First Continental Bank,***1030,Globex Consulting UK Ltd.,UK,8639922.49
2023-11-23,2023-11-23,Alphagrid Utilities,Rent & Utilities,ALL,4572.0,0.0,GBP,CHAPS,Alphagrid Utilities,***6009,,,False,False,REF-229706,First Continental Bank,***3384,Globex Consulting UK Ltd.,UK,8635350.49
2023-11-23,2023-11-23,Supplier Payment - EuroFab Assembly #18,Supplier Payment,CEM-EMEA,17208.68,0.0,GBP,CHAPS,EuroFab Assembly #18,***6702,,PO-202311-CEM-EMEA-0002,False,False,REF-226221,First Continental Bank,***7004,Globex Consulting UK Ltd.,UK,8618141.81
2023-11-23,2023-11-23,Client Receipt - CloudBridge Co. #50,Sales Receipt,SaaS-GL,0.0,19198.85,GBP,CHAPS Credit,CloudBridge Co. #50,***7376,INV-202311-SaaS-GL-0019,,False,False,REF-649769,First Continental Bank,***5527,Globex Consulting UK Ltd.,UK,8637340.66
2023-11-24,2023-11-24,Merchant Processing Fees,Bank/Merchant Fees,ALL,794.08,0.0,GBP,Faster Payments,First Continental Bank,***1543,,,False,False,REF-597049,First Continental Bank,***3139,Globex Consulting UK Ltd.,UK,8636546.58
2023-11-24,2023-11-24,Merchant Processing Fees,Bank/Merchant Fees,ALL,1643.08,0.0,GBP,Faster Payments,First Continental Bank,***8841,,,False,False,REF-735364,First Continental Bank,***4413,Globex Consulting UK Ltd.,UK,8634903.5
2023-11-24,2023-11-24,Supplier Payment - CodeCraft Contractors #4,Supplier Payment,SaaS-GL,2465.69,0.0,GBP,Faster Payments,CodeCraft Contractors #4,***9091,,PO-202311-SaaS-GL-0004,False,False,REF-180160,First Continental Bank,***7008,Globex Consulting UK Ltd.,UK,8632437.81
2023-11-24,2023-11-24,Supplier Payment - CodeCraft Contractors #12,Supplier Payment,SaaS-GL,2900.46,0.0,GBP,CHAPS,CodeCraft Contractors #12,***9281,,PO-202311-SaaS-GL-0007,False,False,REF-446892,First Continental Bank,***8724,Globex Consulting UK Ltd.,UK,8629537.35
2023-11-24,2023-11-24,Client Receipt - CloudBridge Co. #42,Sales Receipt,SaaS-GL,0.0,1674.47,GBP,Faster Payments Credit,CloudBridge Co. #42,***5665,INV-202311-SaaS-GL-0001,,False,False,REF-426966,First Continental Bank,***4991,Globex Consulting UK Ltd.,UK,8631211.82
2023-11-24,2023-11-24,Client Receipt - Novatek Components Ltd #9,Sales Receipt,CEM-EMEA,0.0,5318.39,GBP,CHAPS Credit,Novatek Components Ltd #9,***1090,INV-202311-CEM-EMEA-0014,,False,False,REF-820992,First Continental Bank,***1746,Globex Consulting UK Ltd.,UK,8636530.21
2023-11-25,2023-11-25,Supplier Payment - ExpertNet Subcontractors #18,Supplier Payment,PS-GL,6482.27,0.0,GBP,CHAPS,ExpertNet Subcontractors #18,***5285,,PO-202311-PS-GL-0006,False,False,REF-536439,First Continental Bank,***1839,Globex Consulting UK Ltd.,UK,8630047.94
2023-11-25,2023-11-25,Payroll - GlobalPay Services Ltd,Payroll,ALL,64983.83,0.0,GBP,Faster Payments,GlobalPay Services Ltd,***2261,,,False,False,REF-684528,First Continental Bank,***6946,Globex Consulting UK Ltd.,UK,8565064.11
2023-11-26,2023-11-26,"Intercompany Settlement - Globex International Holdings, Inc.",Intercompany Transfer,ALL,663502.0,0.0,GBP,Internal Transfer,"Globex International Holdings, Inc.",***9368,,,True,True,REF-541956,First Continental Bank,***2904,Globex Consulting UK Ltd.,UK,7901562.11
2023-11-26,2023-11-26,"Intercompany Reimbursement - Globex International Holdings, Inc.",Intercompany Transfer,ALL,0.0,265400.8,GBP,Internal Transfer,"Globex International Holdings, Inc.",***1849,,,True,True,REF-964493,First Continental Bank,***6450,Globex Consulting UK Ltd.,UK,8166962.91
2023-11-27,2023-11-27,Client Receipt - CloudBridge Co. #17,Sales Receipt,SaaS-GL,0.0,779.81,GBP,Faster Payments Credit,CloudBridge Co. #17,***4396,INV-202311-SaaS-GL-0023,,False,False,REF-897247,First Continental Bank,***1241,Globex Consulting UK Ltd.,UK,8167742.72
2023-11-27,2023-11-27,Client Receipt - Aurora Electronics GmbH #8,Sales Receipt,CEM-EMEA,0.0,8101.8,GBP,Faster Payments Credit,Aurora Electronics GmbH #8,***4579,INV-202311-CEM-EMEA-0005,,False,False,REF-153507,First Continental Bank,***4460,Globex Consulting UK Ltd.,UK,8175844.52
2023-11-27,2023-11-27,Client Receipt - CloudBridge Co. #65,Sales Receipt,SaaS-GL,0.0,9197.49,GBP,CHAPS Credit,CloudBridge Co. #65,***9333,INV-202311-SaaS-GL-0021,,False,False,REF-821506,First Continental Bank,***7055,Globex Consulting UK Ltd.,UK,8185042.01
2023-11-28,2023-11-28,Supplier Payment - HyperCloud Infra #14,Supplier Payment,SaaS-GL,30.88,0.0,GBP,CHAPS,HyperCloud Infra #14,***5268,,PO-202311-SaaS-GL-0001,False,False,REF-858374,First Continental Bank,***5215,Globex Consulting UK Ltd.,UK,8185011.13
2023-11-28,2023-11-28,Supplier Payment - CodeCraft Contractors #9,Supplier Payment,SaaS-GL,3211.2,0.0,GBP,CHAPS,CodeCraft Contractors #9,***6711,,PO-202311-SaaS-GL-0002,False,False,REF-930933,First Continental Bank,***2316,Globex Consulting UK Ltd.,UK,8181799.93
2023-11-28,2023-11-28,Supplier Payment - CodeCraft Contractors #9,Supplier Payment,SaaS-GL,11927.3,0.0,GBP,Faster Payments,CodeCraft Contractors #9,***7078,,PO-202311-SaaS-GL-0005,False,False,REF-241486,First Continental Bank,***5743,Globex Consulting UK Ltd.,UK,8169872.63
2023-11-28,2023-11-28,Payroll - GlobalPay Services Ltd,Payroll,ALL,64983.83,0.0,GBP,CHAPS,GlobalPay Services Ltd,***7842,,,False,False,REF-267088,First Continental Bank,***1480,Globex Consulting UK Ltd.,UK,8104888.8
2023-11-28,2023-11-28,Client Receipt - Aurora Electronics GmbH #19,Sales Receipt,CEM-EMEA,0.0,3206.9,GBP,Faster Payments Credit,Aurora Electronics GmbH #19,***5525,INV-202311-CEM-EMEA-0003,,False,False,REF-188818,First Continental Bank,***6551,Globex Consulting UK Ltd.,UK,8108095.7
2023-11-28,2023-11-28,Client Receipt - CloudBridge Co. #78,Sales Receipt,SaaS-GL,0.0,3495.25,GBP,CHAPS Credit,CloudBridge Co. #78,***3337,INV-202311-SaaS-GL-0005,,False,False,REF-586142,First Continental Bank,***3051,Globex Consulting UK Ltd.,UK,8111590.95
2023-11-28,2023-11-28,Client Receipt - Aurora Electronics GmbH #19,Sales Receipt,CEM-EMEA,0.0,9109.62,GBP,CHAPS Credit,Aurora Electronics GmbH #19,***5959,INV-202311-CEM-EMEA-0007,,False,False,REF-344102,First Continental Bank,***6265,Globex Consulting UK Ltd.,UK,8120700.57
2023-11-28,2023-11-28,Client Receipt - Novatek Components Ltd #4,Sales Receipt,CEM-EMEA,0.0,9365.24,GBP,Faster Payments Credit,Novatek Components Ltd #4,***8434,INV-202311-CEM-EMEA-0002,,False,False,REF-698820,First Continental Bank,***3188,Globex Consulting UK Ltd.,UK,8130065.81
2023-11-28,2023-11-28,Client Receipt - Vertex Advisory Client #16,Sales Receipt,PS-GL,0.0,15591.49,GBP,Faster Payments Credit,Vertex Advisory Client #16,***6107,INV-202311-PS-GL-0010,,False,False,REF-143092,First Continental Bank,***3605,Globex Consulting UK Ltd.,UK,8145657.3
2023-11-29,2023-11-29,Supplier Payment - CodeCraft Contractors #7,Supplier Payment,SaaS-GL,10049.58,0.0,GBP,CHAPS,CodeCraft Contractors #7,***7187,,PO-202311-SaaS-GL-0009,False,False,REF-489380,First Continental Bank,***1321,Globex Consulting UK Ltd.,UK,8135607.72
2023-11-29,2023-11-29,Supplier Payment - ExpertNet Subcontractors #4,Supplier Payment,PS-GL,11441.69,0.0,GBP,CHAPS,ExpertNet Subcontractors #4,***5581,,PO-202311-PS-GL-0004,False,False,REF-119062,First Continental Bank,***6101,Globex Consulting UK Ltd.,UK,8124166.03
2023-11-29,2023-11-29,Marketing - Beacon Digital #3,Marketing,ALL,14446.4,0.0,GBP,Faster Payments,Beacon Digital #3,***2205,,,False,False,REF-761345,First Continental Bank,***6224,Globex Consulting UK Ltd.,UK,8109719.63
2023-11-29,2023-11-29,Client Receipt - Vertex Advisory Client #53,Sales Receipt,PS-GL,0.0,1724.69,GBP,Faster Payments Credit,Vertex Advisory Client #53,***2582,INV-202311-PS-GL-0007,,False,False,REF-542387,First Continental Bank,***4825,Globex Consulting UK Ltd.,UK,8111444.32
2023-11-29,2023-11-29,Client Receipt - Vertex Advisory Client #14,Sales Receipt,PS-GL,0.0,1984.92,GBP,Faster Payments Credit,Vertex Advisory Client #14,***9443,INV-202311-PS-GL-0012,,False,False,REF-811251,First Continental Bank,***2469,Globex Consulting UK Ltd.,UK,8113429.24
2023-11-29,2023-11-29,Client Receipt - CloudBridge Co. #63,Sales Receipt,SaaS-GL,0.0,10960.28,GBP,Faster Payments Credit,CloudBridge Co. #63,***2336,INV-202311-SaaS-GL-0017,,False,False,REF-910938,First Continental Bank,***5311,Globex Consulting UK Ltd.,UK,8124389.52
2023-11-29,2023-11-29,Client Receipt - Aurora Electronics GmbH #13,Sales Receipt,CEM-EMEA,0.0,11432.07,GBP,Faster Payments Credit,Aurora Electronics GmbH #13,***9287,INV-202311-CEM-EMEA-0009,,False,False,REF-725815,First Continental Bank,***2320,Globex Consulting UK Ltd.,UK,8135821.59
2023-11-30,2023-11-30,Client Receipt - Vertex Advisory Client #48,Sales Receipt,PS-GL,0.0,4641.49,GBP,Faster Payments Credit,Vertex Advisory Client #48,***6634,INV-202311-PS-GL-0009,,False,False,REF-360412,First Continental Bank,***1910,Globex Consulting UK Ltd.,UK,8140463.08
2023-11-30,2023-11-30,Interest Earned,Interest Income,ALL,0.0,10410.29,GBP,Faster Payments Credit,First Continental Bank,***2784,,,False,False,REF-843598,First Continental Bank,***2933,Globex Consulting UK Ltd.,UK,8150873.37
2023-11-30,2023-11-30,Client Receipt - CloudBridge Co. #32,Sales Receipt,SaaS-GL,0.0,19515.52,GBP,Faster Payments Credit,CloudBridge Co. #32,***8105,INV-202311-SaaS-GL-0015,,False,False,REF-299863,First Continental Bank,***1377,Globex Consulting UK Ltd.,UK,8170388.89
2023-12-01,2023-12-01,Supplier Payment - ExpertNet Subcontractors #9,Supplier Payment,PS-GL,270.48,0.0,GBP,Faster Payments,ExpertNet Subcontractors #9,***4512,,PO-202312-PS-GL-0007,False,False,REF-531567,First Continental Bank,***3389,Globex Consulting UK Ltd.,UK,8170118.41
2023-12-01,2023-12-01,Account Maintenance Fee,Bank/Merchant Fees,ALL,2500.0,0.0,GBP,Faster Payments,First Continental Bank,***2327,,,False,False,REF-892177,First Continental Bank,***2843,Globex Consulting UK Ltd.,UK,8167618.41
2023-12-01,2023-12-01,Supplier Payment - HyperCloud Infra #5,Supplier Payment,SaaS-GL,3096.6,0.0,GBP,CHAPS,HyperCloud Infra #5,***4313,,PO-202312-SaaS-GL-0004,False,False,REF-698014,First Continental Bank,***2052,Globex Consulting UK Ltd.,UK,8164521.81
2023-12-02,2023-12-02,Supplier Payment - CodeCraft Contractors #10,Supplier Payment,SaaS-GL,1360.78,0.0,GBP,CHAPS,CodeCraft Contractors #10,***5833,,PO-202312-SaaS-GL-0001,False,False,REF-974478,First Continental Bank,***3489,Globex Consulting UK Ltd.,UK,8163161.03
2023-12-03,2023-12-03,Client Receipt - CloudBridge Co. #77,Sales Receipt,SaaS-GL,0.0,1029.07,GBP,Faster Payments Credit,CloudBridge Co. #77,***8936,INV-202312-SaaS-GL-0028,,False,False,REF-787665,First Continental Bank,***4581,Globex Consulting UK Ltd.,UK,8164190.1
2023-12-04,2023-12-04,Client Receipt - CloudBridge Co. #4,Sales Receipt,SaaS-GL,0.0,20075.05,GBP,CHAPS Credit,CloudBridge Co. #4,***6980,INV-202312-SaaS-GL-0001,,False,False,REF-159907,First Continental Bank,***8468,Globex Consulting UK Ltd.,UK,8184265.15
2023-12-04,2023-12-04,Client Receipt - Novatek Components Ltd #9,Sales Receipt,CEM-EMEA,0.0,36959.12,GBP,Faster Payments Credit,Novatek Components Ltd #9,***1505,INV-202312-CEM-EMEA-0007,,False,False,REF-938632,First Continental Bank,***8953,Globex Consulting UK Ltd.,UK,8221224.27
2023-12-05,2023-12-05,Supplier Payment - ExpertNet Subcontractors #4,Supplier Payment,PS-GL,2921.14,0.0,GBP,CHAPS,ExpertNet Subcontractors #4,***9947,,PO-202312-PS-GL-0008,False,False,REF-433073,First Continental Bank,***4204,Globex Consulting UK Ltd.,UK,8218303.13
2023-12-05,2023-12-05,Supplier Payment - ExpertNet Subcontractors #17,Supplier Payment,PS-GL,4033.02,0.0,GBP,Faster Payments,ExpertNet Subcontractors #17,***5450,,PO-202312-PS-GL-0005,False,False,REF-794115,First Continental Bank,***5177,Globex Consulting UK Ltd.,UK,8214270.11
2023-12-05,2023-12-05,Northshore Power,Rent & Utilities,ALL,7239.05,0.0,GBP,CHAPS,Northshore Power,***2751,,,False,False,REF-203857,First Continental Bank,***8684,Globex Consulting UK Ltd.,UK,8207031.06
2023-12-05,2023-12-05,Supplier Payment - Stelliform Parts BV #30,Supplier Payment,CEM-EMEA,15964.87,0.0,GBP,CHAPS,Stelliform Parts BV #30,***3836,,PO-202312-CEM-EMEA-0005,False,False,REF-854158,First Continental Bank,***4373,Globex Consulting UK Ltd.,UK,8191066.19
2023-12-05,2023-12-05,Supplier Payment - EuroFab Assembly #22,Supplier Payment,CEM-EMEA,50886.2,0.0,GBP,Faster Payments,EuroFab Assembly #22,***6196,,PO-202312-CEM-EMEA-0004,False,False,REF-873810,First Continental Bank,***2853,Globex Consulting UK Ltd.,UK,8140179.99
2023-12-05,2023-12-05,Supplier Payment - EuroFab Assembly #1,Supplier Payment,CEM-EMEA,79590.36,0.0,GBP,CHAPS,EuroFab Assembly #1,***7275,,PO-202312-CEM-EMEA-0007,False,False,REF-627380,First Continental Bank,***1291,Globex Consulting UK Ltd.,UK,8060589.63
2023-12-05,2023-12-05,Client Receipt - CloudBridge Co. #66,Sales Receipt,SaaS-GL,0.0,8863.09,GBP,Faster Payments Credit,CloudBridge Co. #66,***2644,INV-202312-SaaS-GL-0019,,False,False,REF-584538,First Continental Bank,***5494,Globex Consulting UK Ltd.,UK,8069452.72
2023-12-05,2023-12-05,Client Receipt - Vertex Advisory Client #26,Sales Receipt,PS-GL,0.0,41692.59,GBP,CHAPS Credit,Vertex Advisory Client #26,***5547,INV-202312-PS-GL-0001,,False,False,REF-329368,First Continental Bank,***8092,Globex Consulting UK Ltd.,UK,8111145.31
2023-12-06,2023-12-06,Client Receipt - CloudBridge Co. #56,Sales Receipt,SaaS-GL,0.0,1587.02,GBP,CHAPS Credit,CloudBridge Co. #56,***2519,INV-202312-SaaS-GL-0014,,False,False,REF-540528,First Continental Bank,***6210,Globex Consulting UK Ltd.,UK,8112732.33
2023-12-06,2023-12-06,Client Receipt - CloudBridge Co. #10,Sales Receipt,SaaS-GL,0.0,3462.18,GBP,CHAPS Credit,CloudBridge Co. #10,***9755,INV-202312-SaaS-GL-0007,,False,False,REF-917879,First Continental Bank,***6610,Globex Consulting UK Ltd.,UK,8116194.51
2023-12-06,2023-12-06,Client Receipt - CloudBridge Co. #39,Sales Receipt,SaaS-GL,0.0,5126.01,GBP,CHAPS Credit,CloudBridge Co. #39,***5453,INV-202312-SaaS-GL-0004,,False,False,REF-144259,First Continental Bank,***4288,Globex Consulting UK Ltd.,UK,8121320.52
2023-12-07,2023-12-07,Client Receipt - CloudBridge Co. #11,Sales Receipt,SaaS-GL,0.0,3689.36,GBP,CHAPS Credit,CloudBridge Co. #11,***2653,INV-202312-SaaS-GL-0005,,False,False,REF-305839,First Continental Bank,***5850,Globex Consulting UK Ltd.,UK,8125009.88
2023-12-07,2023-12-07,Client Receipt - Novatek Components Ltd #13,Sales Receipt,CEM-EMEA,0.0,79174.33,GBP,CHAPS Credit,Novatek Components Ltd #13,***7425,INV-202312-CEM-EMEA-0005,,False,False,REF-620157,First Continental Bank,***4680,Globex Consulting UK Ltd.,UK,8204184.21
2023-12-09,2023-12-09,Client Receipt - Novatek Components Ltd #9,Sales Receipt,CEM-EMEA,0.0,80301.55,GBP,Faster Payments Credit,Novatek Components Ltd #9,***9550,INV-202312-CEM-EMEA-0004,,False,False,REF-783211,First Continental Bank,***5481,Globex Consulting UK Ltd.,UK,8284485.76
2023-12-11,2023-12-11,Supplier Payment - ExpertNet Subcontractors #15,Supplier Payment,PS-GL,16139.59,0.0,GBP,Faster Payments,ExpertNet Subcontractors #15,***3869,,PO-202312-PS-GL-0010,False,False,REF-284838,First Continental Bank,***9806,Globex Consulting UK Ltd.,UK,8268346.17
2023-12-11,2023-12-11,Client Receipt - CloudBridge Co. #30,Sales Receipt,SaaS-GL,0.0,2979.79,GBP,CHAPS Credit,CloudBridge Co. #30,***5890,INV-202312-SaaS-GL-0026,,False,False,REF-815671,First Continental Bank,***1310,Globex Consulting UK Ltd.,UK,8271325.96
2023-12-11,2023-12-11,Client Receipt - Vertex Advisory Client #14,Sales Receipt,PS-GL,0.0,13075.47,GBP,Faster Payments Credit,Vertex Advisory Client #14,***6423,INV-202312-PS-GL-0004,,False,False,REF-609600,First Continental Bank,***8792,Globex Consulting UK Ltd.,UK,8284401.43
2023-12-12,2023-12-12,Supplier Payment - HyperCloud Infra #14,Supplier Payment,SaaS-GL,4918.69,0.0,GBP,CHAPS,HyperCloud Infra #14,***8094,,PO-202312-SaaS-GL-0008,False,False,REF-491485,First Continental Bank,***1146,Globex Consulting UK Ltd.,UK,8279482.74
2023-12-12,2023-12-12,Supplier Payment - ExpertNet Subcontractors #3,Supplier Payment,PS-GL,13827.55,0.0,GBP,CHAPS,ExpertNet Subcontractors #3,***9820,,PO-202312-PS-GL-0002,False,False,REF-343105,First Continental Bank,***7358,Globex Consulting UK Ltd.,UK,8265655.19
2023-12-12,2023-12-12,Intercompany Settlement - Globex APAC Logistics Pte. Ltd.,Intercompany Transfer,ALL,695681.0,0.0,GBP,Internal Transfer,Globex APAC Logistics Pte. Ltd.,***8536,,,True,True,REF-161709,First Continental Bank,***9656,Globex Consulting UK Ltd.,UK,7569974.19
2023-12-12,2023-12-12,Client Receipt - CloudBridge Co. #6,Sales Receipt,SaaS-GL,0.0,2183.27,GBP,Faster Payments Credit,CloudBridge Co. #6,***5967,INV-202312-SaaS-GL-0029,,False,False,REF-859395,First Continental Bank,***1706,Globex Consulting UK Ltd.,UK,7572157.46
2023-12-12,2023-12-12,Client Receipt - CloudBridge Co. #56,Sales Receipt,SaaS-GL,0.0,2303.58,GBP,Faster Payments Credit,CloudBridge Co. #56,***3617,INV-202312-SaaS-GL-0002,,False,False,REF-423217,First Continental Bank,***1985,Globex Consulting UK Ltd.,UK,7574461.04
2023-12-12,2023-12-12,Client Receipt - Vertex Advisory Client #50,Sales Receipt,PS-GL,0.0,3020.75,GBP,CHAPS Credit,Vertex Advisory Client #50,***8132,INV-202312-PS-GL-0009,,False,False,REF-270925,First Continental Bank,***5353,Globex Consulting UK Ltd.,UK,7577481.79
2023-12-13,2023-12-13,Supplier Payment - HyperCloud Infra #5,Supplier Payment,SaaS-GL,8396.08,0.0,GBP,CHAPS,HyperCloud Infra #5,***4252,,PO-202312-SaaS-GL-0005,False,False,REF-317138,First Continental Bank,***4958,Globex Consulting UK Ltd.,UK,7569085.71
2023-12-13,2023-12-13,Supplier Payment - HyperCloud Infra #10,Supplier Payment,SaaS-GL,23827.41,0.0,GBP,CHAPS,HyperCloud Infra #10,***8496,,PO-202312-SaaS-GL-0006,False,False,REF-369056,First Continental Bank,***6836,Globex Consulting UK Ltd.,UK,7545258.3
2023-12-13,2023-12-13,Client Receipt - CloudBridge Co. #45,Sales Receipt,SaaS-GL,0.0,5580.28,GBP,CHAPS Credit,CloudBridge Co. #45,***6850,INV-202312-SaaS-GL-0021,,False,False,REF-406657,First Continental Bank,***3015,Globex Consulting UK Ltd.,UK,7550838.58
2023-12-13,2023-12-13,Client Receipt - Aurora Electronics GmbH #9,Sales Receipt,CEM-EMEA,0.0,15405.36,GBP,Faster Payments Credit,Aurora Electronics GmbH #9,***8763,INV-202312-CEM-EMEA-0006,,False,False,REF-561952,First Continental Bank,***2560,Globex Consulting UK Ltd.,UK,7566243.94
2023-12-14,2023-12-14,Supplier Payment - Stelliform Parts BV #29,Supplier Payment,CEM-EMEA,5797.82,0.0,GBP,Faster Payments,Stelliform Parts BV #29,***5222,,PO-202312-CEM-EMEA-0001,False,False,REF-367608,First Continental Bank,***8614,Globex Consulting UK Ltd.,UK,7560446.12
2023-12-14,2023-12-14,Supplier Payment - EuroFab Assembly #1,Supplier Payment,CEM-EMEA,8298.91,0.0,GBP,Faster Payments,EuroFab Assembly #1,***3497,,PO-202312-CEM-EMEA-0003,False,False,REF-177382,First Continental Bank,***6571,Globex Consulting UK Ltd.,UK,7552147.21
2023-12-14,2023-12-14,Client Receipt - CloudBridge Co. #1,Sales Receipt,SaaS-GL,0.0,10543.36,GBP,Faster Payments Credit,CloudBridge Co. #1,***4382,INV-202312-SaaS-GL-0006,,False,False,REF-402760,First Continental Bank,***4795,Globex Consulting UK Ltd.,UK,7562690.57
2023-12-15,2023-12-15,Supplier Payment - Stelliform Parts BV #3,Supplier Payment,CEM-EMEA,6605.5,0.0,GBP,CHAPS,Stelliform Parts BV #3,***7046,,PO-202312-CEM-EMEA-0006,False,False,REF-282583,First Continental Bank,***7767,Globex Consulting UK Ltd.,UK,7556085.07
2023-12-15,2023-12-15,Client Receipt - Aurora Electronics GmbH #18,Sales Receipt,CEM-EMEA,0.0,10108.95,GBP,CHAPS Credit,Aurora Electronics GmbH #18,***8405,INV-202312-CEM-EMEA-0010,,False,False,REF-964302,First Continental Bank,***5017,Globex Consulting UK Ltd.,UK,7566194.02
2023-12-15,2023-12-15,Client Receipt - Novatek Components Ltd #1,Sales Receipt,CEM-EMEA,0.0,10370.4,GBP,Faster Payments Credit,Novatek Components Ltd #1,***3395,INV-202312-CEM-EMEA-0009,,False,False,REF-914955,First Continental Bank,***3533,Globex Consulting UK Ltd.,UK,7576564.42
2023-12-15,2023-12-15,Client Receipt - CloudBridge Co. #36,Sales Receipt,SaaS-GL,0.0,37710.28,GBP,Faster Payments Credit,CloudBridge Co. #36,***3860,INV-202312-SaaS-GL-0018,,False,False,REF-875320,First Continental Bank,***1919,Globex Consulting UK Ltd.,UK,7614274.7
2023-12-16,2023-12-16,Client Receipt - CloudBridge Co. #38,Sales Receipt,SaaS-GL,0.0,20603.69,GBP,Faster Payments Credit,CloudBridge Co. #38,***9226,INV-202312-SaaS-GL-0027,,False,False,REF-275990,First Continental Bank,***9507,Globex Consulting UK Ltd.,UK,7634878.39
2023-12-18,2023-12-18,Supplier Payment - ExpertNet Subcontractors #10,Supplier Payment,PS-GL,1586.05,0.0,GBP,Faster Payments,ExpertNet Subcontractors #10,***9908,,PO-202312-PS-GL-0004,False,False,REF-288151,First Continental Bank,***2239,Globex Consulting UK Ltd.,UK,7633292.34
2023-12-18,2023-12-18,Client Receipt - CloudBridge Co. #49,Sales Receipt,SaaS-GL,0.0,3126.61,GBP,CHAPS Credit,CloudBridge Co. #49,***9547,INV-202312-SaaS-GL-0012,,False,False,REF-270875,First Continental Bank,***7284,Globex Consulting UK Ltd.,UK,7636418.95
2023-12-18,2023-12-18,Client Receipt - Novatek Components Ltd #11,Sales Receipt,CEM-EMEA,0.0,23472.65,GBP,Faster Payments Credit,Novatek Components Ltd #11,***8729,INV-202312-CEM-EMEA-0001,,False,False,REF-705013,First Continental Bank,***8506,Globex Consulting UK Ltd.,UK,7659891.6
2023-12-19,2023-12-19,Supplier Payment - ExpertNet Subcontractors #7,Supplier Payment,PS-GL,6401.38,0.0,GBP,CHAPS,ExpertNet Subcontractors #7,***6204,,PO-202312-PS-GL-0001,False,False,REF-732619,First Continental Bank,***1754,Globex Consulting UK Ltd.,UK,7653490.22
2023-12-19,2023-12-19,Client Receipt - Vertex Advisory Client #12,Sales Receipt,PS-GL,0.0,5854.76,GBP,CHAPS Credit,Vertex Advisory Client #12,***6139,INV-202312-PS-GL-0002,,False,False,REF-873181,First Continental Bank,***5654,Globex Consulting UK Ltd.,UK,7659344.98
2023-12-20,2023-12-20,Supplier Payment - CodeCraft Contractors #11,Supplier Payment,SaaS-GL,4016.97,0.0,GBP,CHAPS,CodeCraft Contractors #11,***1296,,PO-202312-SaaS-GL-0007,False,False,REF-296641,First Continental Bank,***8171,Globex Consulting UK Ltd.,UK,7655328.01
2023-12-20,2023-12-20,Supplier Payment - CodeCraft Contractors #13,Supplier Payment,SaaS-GL,9008.86,0.0,GBP,Faster Payments,CodeCraft Contractors #13,***7629,,PO-202312-SaaS-GL-0002,False,False,REF-797627,First Continental Bank,***4596,Globex Consulting UK Ltd.,UK,7646319.15
2023-12-20,2023-12-20,Supplier Payment - EuroFab Assembly #9,Supplier Payment,CEM-EMEA,31720.78,0.0,GBP,CHAPS,EuroFab Assembly #9,***7172,,PO-202312-CEM-EMEA-0008,False,False,REF-526328,First Continental Bank,***1460,Globex Consulting UK Ltd.,UK,7614598.37
2023-12-20,2023-12-20,Client Receipt - CloudBridge Co. #22,Sales Receipt,SaaS-GL,0.0,3311.77,GBP,Faster Payments Credit,CloudBridge Co. #22,***4776,INV-202312-SaaS-GL-0023,,False,False,REF-822218,First Continental Bank,***4280,Globex Consulting UK Ltd.,UK,7617910.14
2023-12-20,2023-12-20,Client Receipt - CloudBridge Co. #28,Sales Receipt,SaaS-GL,0.0,4212.55,GBP,CHAPS Credit,CloudBridge Co. #28,***9982,INV-202312-SaaS-GL-0003,,False,False,REF-586554,First Continental Bank,***5390,Globex Consulting UK Ltd.,UK,7622122.69
2023-12-20,2023-12-20,Client Receipt - CloudBridge Co. #23,Sales Receipt,SaaS-GL,0.0,12484.12,GBP,CHAPS Credit,CloudBridge Co. #23,***8868,INV-202312-SaaS-GL-0009,,False,False,REF-107443,First Continental Bank,***8949,Globex Consulting UK Ltd.,UK,7634606.81
2023-12-21,2023-12-21,Merchant Processing Fees,Bank/Merchant Fees,ALL,1272.79,0.0,GBP,CHAPS,First Continental Bank,***7685,,,False,False,REF-481713,First Continental Bank,***6478,Globex Consulting UK Ltd.,UK,7633334.02
2023-12-21,2023-12-21,Marketing - Aurelia Media #1,Marketing,ALL,6540.59,0.0,GBP,CHAPS,Aurelia Media #1,***9522,,,False,False,REF-220670,First Continental Bank,***3581,Globex Consulting UK Ltd.,UK,7626793.43
2023-12-21,2023-12-21,Client Receipt - CloudBridge Co. #32,Sales Receipt,SaaS-GL,0.0,29621.99,GBP,CHAPS Credit,CloudBridge Co. #32,***4227,INV-202312-SaaS-GL-0013,,False,False,REF-946998,First Continental Bank,***2498,Globex Consulting UK Ltd.,UK,7656415.42
2023-12-21,2023-12-21,Client Receipt - Aurora Electronics GmbH #10,Sales Receipt,CEM-EMEA,0.0,31747.63,GBP,CHAPS Credit,Aurora Electronics GmbH #10,***2234,INV-202312-CEM-EMEA-0002,,False,False,REF-818848,First Continental Bank,***6472,Globex Consulting UK Ltd.,UK,7688163.05
2023-12-22,2023-12-22,Supplier Payment - Stelliform Parts BV #16,Supplier Payment,CEM-EMEA,5281.1,0.0,GBP,CHAPS,Stelliform Parts BV #16,***7115,,PO-202312-CEM-EMEA-0002,False,False,REF-856529,First Continental Bank,***8419,Globex Consulting UK Ltd.,UK,7682881.95
2023-12-22,2023-12-22,VAT/GST Remittance - HMRC UK,Tax Payment,ALL,52822.55,0.0,GBP,SWIFT MT103,HMRC UK,***4682,,,False,False,REF-192465,First Continental Bank,***3448,Globex Consulting UK Ltd.,UK,7630059.4
2023-12-22,2023-12-22,Client Receipt - CloudBridge Co. #20,Sales Receipt,SaaS-GL,0.0,2586.69,GBP,Faster Payments Credit,CloudBridge Co. #20,***1681,INV-202312-SaaS-GL-0016,,False,False,REF-965623,First Continental Bank,***6651,Globex Consulting UK Ltd.,UK,7632646.09
2023-12-22,2023-12-22,Client Receipt - CloudBridge Co. #20,Sales Receipt,SaaS-GL,0.0,8156.45,GBP,Faster Payments Credit,CloudBridge Co. #20,***5340,INV-202312-SaaS-GL-0020,,False,False,REF-630086,First Continental Bank,***4826,Globex Consulting UK Ltd.,UK,7640802.54
2023-12-22,2023-12-22,Client Receipt - CloudBridge Co. #18,Sales Receipt,SaaS-GL,0.0,12770.0,GBP,Faster Payments Credit,CloudBridge Co. #18,***4794,INV-202312-SaaS-GL-0011,,False,False,REF-186802,First Continental Bank,***6642,Globex Consulting UK Ltd.,UK,7653572.54
2023-12-22,2023-12-22,Client Receipt - Aurora Electronics GmbH #19,Sales Receipt,CEM-EMEA,0.0,35896.9,GBP,CHAPS Credit,Aurora Electronics GmbH #19,***8210,INV-202312-CEM-EMEA-0008,,False,False,REF-626881,First Continental Bank,***8772,Globex Consulting UK Ltd.,UK,7689469.44
2023-12-23,2023-12-23,Client Receipt - Vertex Advisory Client #58,Sales Receipt,PS-GL,0.0,30361.62,GBP,CHAPS Credit,Vertex Advisory Client #58,***4381,INV-202312-PS-GL-0007,,False,False,REF-920019,First Continental Bank,***6079,Globex Consulting UK Ltd.,UK,7719831.06
2023-12-24,2023-12-24,Supplier Payment - Stelliform Parts BV #18,Supplier Payment,CEM-EMEA,51908.68,0.0,GBP,CHAPS,Stelliform Parts BV #18,***6546,,PO-202312-CEM-EMEA-0010,False,False,REF-679886,First Continental Bank,***4690,Globex Consulting UK Ltd.,UK,7667922.38
2023-12-24,2023-12-24,Client Receipt - Vertex Advisory Client #51,Sales Receipt,PS-GL,0.0,5009.26,GBP,CHAPS Credit,Vertex Advisory Client #51,***9362,INV-202312-PS-GL-0010,,False,False,REF-189542,First Continental Bank,***8854,Globex Consulting UK Ltd.,UK,7672931.64
2023-12-25,2023-12-25,Marketing - Aurelia Media #4,Marketing,ALL,9603.87,0.0,GBP,CHAPS,Aurelia Media #4,***9599,,,False,False,REF-147754,First Continental Bank,***2989,Globex Consulting UK Ltd.,UK,7663327.77
2023-12-25,2023-12-25,Client Receipt - CloudBridge Co. #35,Sales Receipt,SaaS-GL,0.0,32061.65,GBP,Faster Payments Credit,CloudBridge Co. #35,***7377,INV-202312-SaaS-GL-0008,,False,False,REF-392855,First Continental Bank,***3780,Globex Consulting UK Ltd.,UK,7695389.42
2023-12-26,2023-12-26,Supplier Payment - ExpertNet Subcontractors #6,Supplier Payment,PS-GL,4335.73,0.0,GBP,CHAPS,ExpertNet Subcontractors #6,***8041,,PO-202312-PS-GL-0009,False,False,REF-117917,First Continental Bank,***3681,Globex Consulting UK Ltd.,UK,7691053.69
2023-12-26,2023-12-26,Payroll - GlobalPay Services Ltd,Payroll,ALL,71243.75,0.0,GBP,CHAPS,GlobalPay Services Ltd,***7322,,,False,False,REF-438386,First Continental Bank,***8079,Globex Consulting UK Ltd.,UK,7619809.94
2023-12-26,2023-12-26,Intercompany Settlement - Globex APAC Logistics Pte. Ltd.,Intercompany Transfer,ALL,892736.0,0.0,GBP,Internal Transfer,Globex APAC Logistics Pte. Ltd.,***5068,,,True,True,REF-536996,First Continental Bank,***5725,Globex Consulting UK Ltd.,UK,6727073.94
2023-12-26,2023-12-26,Client Receipt - CloudBridge Co. #33,Sales Receipt,SaaS-GL,0.0,4204.35,GBP,CHAPS Credit,CloudBridge Co. #33,***4157,INV-202312-SaaS-GL-0025,,False,False,REF-807044,First Continental Bank,***8712,Globex Consulting UK Ltd.,UK,6731278.29
2023-12-26,2023-12-26,Client Receipt - Vertex Advisory Client #36,Sales Receipt,PS-GL,0.0,7227.96,GBP,CHAPS Credit,Vertex Advisory Client #36,***5754,INV-202312-PS-GL-0008,,False,False,REF-855761,First Continental Bank,***8899,Globex Consulting UK Ltd.,UK,6738506.25
2023-12-26,2023-12-26,Client Receipt - CloudBridge Co. #30,Sales Receipt,SaaS-GL,0.0,10121.05,GBP,CHAPS Credit,CloudBridge Co. #30,***5221,INV-202312-SaaS-GL-0010,,False,False,REF-486891,First Continental Bank,***5824,Globex Consulting UK Ltd.,UK,6748627.3
2023-12-26,2023-12-26,Client Receipt - Vertex Advisory Client #55,Sales Receipt,PS-GL,0.0,70023.01,GBP,CHAPS Credit,Vertex Advisory Client #55,***7088,INV-202312-PS-GL-0005,,False,False,REF-628196,First Continental Bank,***6414,Globex Consulting UK Ltd.,UK,6818650.31
2023-12-27,2023-12-27,Merchant Processing Fees,Bank/Merchant Fees,ALL,1450.57,0.0,GBP,Faster Payments,First Continental Bank,***5622,,,False,False,REF-337136,First Continental Bank,***3555,Globex Consulting UK Ltd.,UK,6817199.74
2023-12-27,2023-12-27,Client Receipt - CloudBridge Co. #8,Sales Receipt,SaaS-GL,0.0,18062.74,GBP,Faster Payments Credit,CloudBridge Co. #8,***4090,INV-202312-SaaS-GL-0015,,False,False,REF-550916,First Continental Bank,***1522,Globex Consulting UK Ltd.,UK,6835262.48
2023-12-28,2023-12-28,Supplier Payment - EuroFab Assembly #19,Supplier Payment,CEM-EMEA,7696.83,0.0,GBP,CHAPS,EuroFab Assembly #19,***9893,,PO-202312-CEM-EMEA-0009,False,False,REF-830556,First Continental Bank,***1422,Globex Consulting UK Ltd.,UK,6827565.65
2023-12-29,2023-12-29,Supplier Payment - ExpertNet Subcontractors #15,Supplier Payment,PS-GL,6621.43,0.0,GBP,Faster Payments,ExpertNet Subcontractors #15,***8607,,PO-202312-PS-GL-0006,False,False,REF-132523,First Continental Bank,***8841,Globex Consulting UK Ltd.,UK,6820944.22
2023-12-29,2023-12-29,Marketing - Aurelia Media #1,Marketing,ALL,6879.87,0.0,GBP,CHAPS,Aurelia Media #1,***7447,,,False,False,REF-856508,First Continental Bank,***9036,Globex Consulting UK Ltd.,UK,6814064.35
2023-12-29,2023-12-29,Supplier Payment - CodeCraft Contractors #4,Supplier Payment,SaaS-GL,7544.5,0.0,GBP,CHAPS,CodeCraft Contractors #4,***1160,,PO-202312-SaaS-GL-0003,False,False,REF-583026,First Continental Bank,***5874,Globex Consulting UK Ltd.,UK,6806519.85
2023-12-29,2023-12-29,Client Receipt - CloudBridge Co. #28,Sales Receipt,SaaS-GL,0.0,1273.85,GBP,Faster Payments Credit,CloudBridge Co. #28,***7282,INV-202312-SaaS-GL-0024,,False,False,REF-457409,First Continental Bank,***8457,Globex Consulting UK Ltd.,UK,6807793.7
2023-12-29,2023-12-29,Client Receipt - CloudBridge Co. #78,Sales Receipt,SaaS-GL,0.0,3891.72,GBP,Faster Payments Credit,CloudBridge Co. #78,***4817,INV-202312-SaaS-GL-0022,,False,False,REF-210025,First Continental Bank,***1619,Globex Consulting UK Ltd.,UK,6811685.42
2023-12-29,2023-12-29,Client Receipt - Vertex Advisory Client #39,Sales Receipt,PS-GL,0.0,5803.01,GBP,CHAPS Credit,Vertex Advisory Client #39,***8811,INV-202312-PS-GL-0006,,False,False,REF-546349,First Continental Bank,***9230,Globex Consulting UK Ltd.,UK,6817488.43
2023-12-29,2023-12-29,Client Receipt - Vertex Advisory Client #14,Sales Receipt,PS-GL,0.0,6325.18,GBP,Faster Payments Credit,Vertex Advisory Client #14,***7658,INV-202312-PS-GL-0003,,False,False,REF-540118,First Continental Bank,***9072,Globex Consulting UK Ltd.,UK,6823813.61
2023-12-29,2023-12-29,Client Receipt - CloudBridge Co. #57,Sales Receipt,SaaS-GL,0.0,10968.84,GBP,CHAPS Credit,CloudBridge Co. #57,***5203,INV-202312-SaaS-GL-0017,,False,False,REF-838093,First Continental Bank,***2510,Globex Consulting UK Ltd.,UK,6834782.45
2023-12-29,2023-12-29,Client Receipt - Novatek Components Ltd #6,Sales Receipt,CEM-EMEA,0.0,90006.49,GBP,CHAPS Credit,Novatek Components Ltd #6,***9681,INV-202312-CEM-EMEA-0011,,False,False,REF-785191,First Continental Bank,***9282,Globex Consulting UK Ltd.,UK,6924788.94
2023-12-30,2023-12-30,Supplier Payment - ExpertNet Subcontractors #7,Supplier Payment,PS-GL,381.71,0.0,GBP,CHAPS,ExpertNet Subcontractors #7,***4086,,PO-202312-PS-GL-0003,False,False,REF-575460,First Continental Bank,***8332,Globex Consulting UK Ltd.,UK,6924407.23
2023-12-30,2023-12-30,Payroll - GlobalPay Services Ltd,Payroll,ALL,71243.75,0.0,GBP,CHAPS,GlobalPay Services Ltd,***6218,,,False,False,REF-703547,First Continental Bank,***6321,Globex Consulting UK Ltd.,UK,6853163.48
2023-12-30,2023-12-30,Interest Earned,Interest Income,ALL,0.0,12485.01,GBP,Faster Payments Credit,First Continental Bank,***9777,,,False,False,REF-740124,First Continental Bank,***8444,Globex Consulting UK Ltd.,UK,6865648.49
2023-12-31,2023-12-31,Client Receipt - Aurora Electronics GmbH #14,Sales Receipt,CEM-EMEA,0.0,26141.71,GBP,Faster Payments Credit,Aurora Electronics GmbH #14,***7298,INV-202312-CEM-EMEA-0003,,False,False,REF-523133,First Continental Bank,***3873,Globex Consulting UK Ltd.,UK,6891790.2
2024-01-01,2024-01-01,Supplier Payment - ExpertNet Subcontractors #14,Supplier Payment,PS-GL,106.99,0.0,GBP,Faster Payments,ExpertNet Subcontractors #14,***2359,,PO-202401-PS-GL-0003,False,False,REF-313078,First Continental Bank,***7113,Globex Consulting UK Ltd.,UK,6891683.21
2024-01-01,2024-01-01,Account Maintenance Fee,Bank/Merchant Fees,ALL,2500.0,0.0,GBP,CHAPS,First Continental Bank,***9568,,,False,False,REF-250064,First Continental Bank,***6123,Globex Consulting UK Ltd.,UK,6889183.21
2024-01-02,2024-01-02,Supplier Payment - ExpertNet Subcontractors #18,Supplier Payment,PS-GL,992.34,0.0,GBP,Faster Payments,ExpertNet Subcontractors #18,***7136,,PO-202401-PS-GL-0011,False,False,REF-353144,First Continental Bank,***4533,Globex Consulting UK Ltd.,UK,6888190.87
2024-01-02,2024-01-02,Supplier Payment - HyperCloud Infra #3,Supplier Payment,SaaS-GL,1514.78,0.0,GBP,Faster Payments,HyperCloud Infra #3,***1528,,PO-202401-SaaS-GL-0003,False,False,REF-304891,First Continental Bank,***7898,Globex Consulting UK Ltd.,UK,6886676.09
2024-01-02,2024-01-02,Client Receipt - CloudBridge Co. #17,Sales Receipt,SaaS-GL,0.0,3182.96,GBP,CHAPS Credit,CloudBridge Co. #17,***3736,INV-202401-SaaS-GL-0013,,False,False,REF-228820,First Continental Bank,***7275,Globex Consulting UK Ltd.,UK,6889859.05
2024-01-02,2024-01-02,Client Receipt - CloudBridge Co. #50,Sales Receipt,SaaS-GL,0.0,5949.28,GBP,Faster Payments Credit,CloudBridge Co. #50,***4253,INV-202401-SaaS-GL-0008,,False,False,REF-958667,First Continental Bank,***4982,Globex Consulting UK Ltd.,UK,6895808.33
2024-01-03,2024-01-03,Supplier Payment - ExpertNet Subcontractors #6,Supplier Payment,PS-GL,302.77,0.0,GBP,CHAPS,ExpertNet Subcontractors #6,***1722,,PO-202401-PS-GL-0007,False,False,REF-757425,First Continental Bank,***8017,Globex Consulting UK Ltd.,UK,6895505.56
2024-01-03,2024-01-03,Supplier Payment - EuroFab Assembly #20,Supplier Payment,CEM-EMEA,419.92,0.0,GBP,CHAPS,EuroFab Assembly #20,***6839,,PO-202401-CEM-EMEA-0002,False,False,REF-823066,First Continental Bank,***6256,Globex Consulting UK Ltd.,UK,6895085.64
2024-01-03,2024-01-03,Supplier Payment - ExpertNet Subcontractors #2,Supplier Payment,PS-GL,1121.65,0.0,GBP,Faster Payments,ExpertNet Subcontractors #2,***9995,,PO-202401-PS-GL-0002,False,False,REF-582963,First Continental Bank,***1097,Globex Consulting UK Ltd.,UK,6893963.99
2024-01-03,2024-01-03,Supplier Payment - ExpertNet Subcontractors #3,Supplier Payment,PS-GL,11335.57,0.0,GBP,Faster Payments,ExpertNet Subcontractors #3,***3512,,PO-202401-PS-GL-0006,False,False,REF-876450,First Continental Bank,***1427,Globex Consulting UK Ltd.,UK,6882628.42
2024-01-03,2024-01-03,Client Receipt - Aurora Electronics GmbH #10,Sales Receipt,CEM-EMEA,0.0,15178.33,GBP,Faster Payments Credit,Aurora Electronics GmbH #10,***6936,INV-202401-CEM-EMEA-0012,,False,False,REF-663122,First Continental Bank,***8831,Globex Consulting UK Ltd.,UK,6897806.75
2024-01-03,2024-01-03,Client Receipt - Novatek Components Ltd #8,Sales Receipt,CEM-EMEA,0.0,21713.33,GBP,Faster Payments Credit,Novatek Components Ltd #8,***6797,INV-202401-CEM-EMEA-0009,,False,False,REF-663726,First Continental Bank,***4242,Globex Consulting UK Ltd.,UK,6919520.08
2024-01-04,2024-01-04,Client Receipt - CloudBridge Co. #54,Sales Receipt,SaaS-GL,0.0,1116.87,GBP,CHAPS Credit,CloudBridge Co. #54,***5609,INV-202401-SaaS-GL-0022,,False,False,REF-646430,First Continental Bank,***2358,Globex Consulting UK Ltd.,UK,6920636.95
2024-01-04,2024-01-04,Client Receipt - CloudBridge Co. #48,Sales Receipt,SaaS-GL,0.0,2771.0,GBP,CHAPS Credit,CloudBridge Co. #48,***4282,INV-202401-SaaS-GL-0025,,False,False,REF-402675,First Continental Bank,***6394,Globex Consulting UK Ltd.,UK,6923407.95
2024-01-04,2024-01-04,Client Receipt - CloudBridge Co. #67,Sales Receipt,SaaS-GL,0.0,3064.58,GBP,Faster Payments Credit,CloudBridge Co. #67,***2597,INV-202401-SaaS-GL-0017,,False,False,REF-511204,First Continental Bank,***9043,Globex Consulting UK Ltd.,UK,6926472.53
2024-01-04,2024-01-04,Client Receipt - Aurora Electronics GmbH #6,Sales Receipt,CEM-EMEA,0.0,6674.29,GBP,CHAPS Credit,Aurora Electronics GmbH #6,***3712,INV-202401-CEM-EMEA-0010,,False,False,REF-514911,First Continental Bank,***3980,Globex Consulting UK Ltd.,UK,6933146.82
2024-01-04,2024-01-04,Client Receipt - Aurora Electronics GmbH #12,Sales Receipt,CEM-EMEA,0.0,32201.31,GBP,Faster Payments Credit,Aurora Electronics GmbH #12,***3032,INV-202401-CEM-EMEA-0014,,False,False,REF-619226,First Continental Bank,***5240,Globex Consulting UK Ltd.,UK,6965348.13
2024-01-05,2024-01-05,Merchant Processing Fees,Bank/Merchant Fees,ALL,134.54,0.0,GBP,CHAPS,First Continental Bank,***4571,,,False,False,REF-421591,First Continental Bank,***2679,Globex Consulting UK Ltd.,UK,6965213.59
2024-01-06,2024-01-06,Supplier Payment - CodeCraft Contractors #13,Supplier Payment,SaaS-GL,448.67,0.0,GBP,Faster Payments,CodeCraft Contractors #13,***4398,,PO-202401-SaaS-GL-0010,False,False,REF-142658,First Continental Bank,***2433,Globex Consulting UK Ltd.,UK,6964764.92
2024-01-06,2024-01-06,Supplier Payment - EuroFab Assembly #21,Supplier Payment,CEM-EMEA,5694.74,0.0,GBP,Faster Payments,EuroFab Assembly #21,***4533,,PO-202401-CEM-EMEA-0008,False,False,REF-833476,First Continental Bank,***6954,Globex Consulting UK Ltd.,UK,6959070.18
2024-01-06,2024-01-06,Client Receipt - Vertex Advisory Client #22,Sales Receipt,PS-GL,0.0,5027.29,GBP,CHAPS Credit,Vertex Advisory Client #22,***7012,INV-202401-PS-GL-0003,,False,False,REF-312997,First Continental Bank,***7895,Globex Consulting UK Ltd.,UK,6964097.47
2024-01-08,2024-01-08,Supplier Payment - HyperCloud Infra #5,Supplier Payment,SaaS-GL,6168.04,0.0,GBP,CHAPS,HyperCloud Infra #5,***8799,,PO-202401-SaaS-GL-0006,False,False,REF-688419,First Continental Bank,***6228,Globex Consulting UK Ltd.,UK,6957929.43
2024-01-08,2024-01-08,Supplier Payment - CodeCraft Contractors #12,Supplier Payment,SaaS-GL,7674.08,0.0,GBP,Faster Payments,CodeCraft Contractors #12,***5768,,PO-202401-SaaS-GL-0004,False,False,REF-168489,First Continental Bank,***9804,Globex Consulting UK Ltd.,UK,6950255.35
2024-01-08,2024-01-08,Client Receipt - CloudBridge Co. #13,Sales Receipt,SaaS-GL,0.0,4903.22,GBP,CHAPS Credit,CloudBridge Co. #13,***3827,INV-202401-SaaS-GL-0014,,False,False,REF-941697,First Continental Bank,***4722,Globex Consulting UK Ltd.,UK,6955158.57
2024-01-08,2024-01-08,Client Receipt - CloudBridge Co. #51,Sales Receipt,SaaS-GL,0.0,13432.42,GBP,CHAPS Credit,CloudBridge Co. #51,***1607,INV-202401-SaaS-GL-0027,,False,False,REF-279480,First Continental Bank,***6438,Globex Consulting UK Ltd.,UK,6968590.99
2024-01-08,2024-01-08,Client Receipt - Novatek Components Ltd #4,Sales Receipt,CEM-EMEA,0.0,28275.92,GBP,CHAPS Credit,Novatek Components Ltd #4,***2855,INV-202401-CEM-EMEA-0006,,False,False,REF-451218,First Continental Bank,***4111,Globex Consulting UK Ltd.,UK,6996866.91
2024-01-09,2024-01-09,Supplier Payment - ExpertNet Subcontractors #11,Supplier Payment,PS-GL,1050.68,0.0,GBP,CHAPS,ExpertNet Subcontractors #11,***9723,,PO-202401-PS-GL-0008,False,False,REF-478273,First Continental Bank,***2633,Globex Consulting UK Ltd.,UK,6995816.23
2024-01-09,2024-01-09,Marketing - Aurelia Media #10,Marketing,ALL,10203.78,0.0,GBP,Faster Payments,Aurelia Media #10,***7645,,,False,False,REF-403104,First Continental Bank,***9836,Globex Consulting UK Ltd.,UK,6985612.45
2024-01-09,2024-01-09,Client Receipt - CloudBridge Co. #1,Sales Receipt,SaaS-GL,0.0,8986.93,GBP,Faster Payments Credit,CloudBridge Co. #1,***2380,INV-202401-SaaS-GL-0029,,False,False,REF-555073,First Continental Bank,***1728,Globex Consulting UK Ltd.,UK,6994599.38
2024-01-10,2024-01-10,Client Receipt - CloudBridge Co. #7,Sales Receipt,SaaS-GL,0.0,1310.15,GBP,CHAPS Credit,CloudBridge Co. #7,***9661,INV-202401-SaaS-GL-0001,,False,False,REF-886236,First Continental Bank,***2110,Globex Consulting UK Ltd.,UK,6995909.53
2024-01-10,2024-01-10,Client Receipt - Vertex Advisory Client #18,Sales Receipt,PS-GL,0.0,7950.48,GBP,CHAPS Credit,Vertex Advisory Client #18,***1519,INV-202401-PS-GL-0002,,False,False,REF-333810,First Continental Bank,***8158,Globex Consulting UK Ltd.,UK,7003860.01
2024-01-10,2024-01-10,Client Receipt - Aurora Electronics GmbH #1,Sales Receipt,CEM-EMEA,0.0,8488.7,GBP,Faster Payments Credit,Aurora Electronics GmbH #1,***3204,INV-202401-CEM-EMEA-0003,,False,False,REF-500139,First Continental Bank,***4429,Globex Consulting UK Ltd.,UK,7012348.71
2024-01-10,2024-01-10,Client Receipt - CloudBridge Co. #61,Sales Receipt,SaaS-GL,0.0,14981.79,GBP,CHAPS Credit,CloudBridge Co. #61,***9552,INV-202401-SaaS-GL-0015,,False,False,REF-655162,First Continental Bank,***9407,Globex Consulting UK Ltd.,UK,7027330.5
2024-01-11,2024-01-11,Supplier Payment - ExpertNet Subcontractors #8,Supplier Payment,PS-GL,464.55,0.0,GBP,Faster Payments,ExpertNet Subcontractors #8,***2156,,PO-202401-PS-GL-0005,False,False,REF-178883,First Continental Bank,***5646,Globex Consulting UK Ltd.,UK,7026865.95
2024-01-11,2024-01-11,Supplier Payment - ExpertNet Subcontractors #5,Supplier Payment,PS-GL,777.88,0.0,GBP,CHAPS,ExpertNet Subcontractors #5,***9184,,PO-202401-PS-GL-0010,False,False,REF-530468,First Continental Bank,***2486,Globex Consulting UK Ltd.,UK,7026088.07
2024-01-11,2024-01-11,Supplier Payment - CodeCraft Contractors #3,Supplier Payment,SaaS-GL,2468.49,0.0,GBP,Faster Payments,CodeCraft Contractors #3,***8003,,PO-202401-SaaS-GL-0002,False,False,REF-464773,First Continental Bank,***9063,Globex Consulting UK Ltd.,UK,7023619.58
2024-01-11,2024-01-11,Supplier Payment - HyperCloud Infra #11,Supplier Payment,SaaS-GL,5934.19,0.0,GBP,CHAPS,HyperCloud Infra #11,***5839,,PO-202401-SaaS-GL-0008,False,False,REF-607905,First Continental Bank,***5919,Globex Consulting UK Ltd.,UK,7017685.39
2024-01-11,2024-01-11,Client Receipt - CloudBridge Co. #62,Sales Receipt,SaaS-GL,0.0,1166.08,GBP,CHAPS Credit,CloudBridge Co. #62,***6920,INV-202401-SaaS-GL-0011,,False,False,REF-621265,First Continental Bank,***8617,Globex Consulting UK Ltd.,UK,7018851.47
2024-01-11,2024-01-11,Client Receipt - Vertex Advisory Client #23,Sales Receipt,PS-GL,0.0,7040.78,GBP,Faster Payments Credit,Vertex Advisory Client #23,***8367,INV-202401-PS-GL-0001,,False,False,REF-863349,First Continental Bank,***8483,Globex Consulting UK Ltd.,UK,7025892.25
2024-01-11,2024-01-11,Client Receipt - Aurora Electronics GmbH #1,Sales Receipt,CEM-EMEA,0.0,10082.14,GBP,Faster Payments Credit,Aurora Electronics GmbH #1,***7162,INV-202401-CEM-EMEA-0007,,False,False,REF-585055,First Continental Bank,***7115,Globex Consulting UK Ltd.,UK,7035974.39
2024-01-11,2024-01-11,Client Receipt - Aurora Electronics GmbH #6,Sales Receipt,CEM-EMEA,0.0,11309.85,GBP,CHAPS Credit,Aurora Electronics GmbH #6,***4473,INV-202401-CEM-EMEA-0013,,False,False,REF-224138,First Continental Bank,***1036,Globex Consulting UK Ltd.,UK,7047284.24
2024-01-11,2024-01-11,Client Receipt - Vertex Advisory Client #14,Sales Receipt,PS-GL,0.0,32092.51,GBP,Faster Payments Credit,Vertex Advisory Client #14,***7821,INV-202401-PS-GL-0007,,False,False,REF-563877,First Continental Bank,***1828,Globex Consulting UK Ltd.,UK,7079376.75
2024-01-12,2024-01-12,Intercompany Settlement - Globex APAC Logistics Pte. Ltd.,Intercompany Transfer,ALL,394736.0,0.0,GBP,Internal Transfer,Globex APAC Logistics Pte. Ltd.,***3495,,,True,True,REF-505690,First Continental Bank,***8866,Globex Consulting UK Ltd.,UK,6684640.75
2024-01-12,2024-01-12,Client Receipt - Vertex Advisory Client #28,Sales Receipt,PS-GL,0.0,6440.31,GBP,Faster Payments Credit,Vertex Advisory Client #28,***1898,INV-202401-PS-GL-0009,,False,False,REF-331274,First Continental Bank,***4312,Globex Consulting UK Ltd.,UK,6691081.06
2024-01-13,2024-01-13,Supplier Payment - HyperCloud Infra #15,Supplier Payment,SaaS-GL,514.02,0.0,GBP,Faster Payments,HyperCloud Infra #15,***1633,,PO-202401-SaaS-GL-0005,False,False,REF-709916,First Continental Bank,***7395,Globex Consulting UK Ltd.,UK,6690567.04
2024-01-13,2024-01-13,Client Receipt - Novatek Components Ltd #10,Sales Receipt,CEM-EMEA,0.0,7337.03,GBP,CHAPS Credit,Novatek Components Ltd #10,***9588,INV-202401-CEM-EMEA-0002,,False,False,REF-346373,First Continental Bank,***1020,Globex Consulting UK Ltd.,UK,6697904.07
2024-01-14,2024-01-14,Merchant Processing Fees,Bank/Merchant Fees,ALL,1197.47,0.0,GBP,Faster Payments,First Continental Bank,***6143,,,False,False,REF-386359,First Continental Bank,***7839,Globex Consulting UK Ltd.,UK,6696706.6
2024-01-15,2024-01-15,Supplier Payment - EuroFab Assembly #3,Supplier Payment,CEM-EMEA,19315.16,0.0,GBP,CHAPS,EuroFab Assembly #3,***5725,,PO-202401-CEM-EMEA-0007,False,False,REF-950149,First Continental Bank,***4933,Globex Consulting UK Ltd.,UK,6677391.44
2024-01-15,2024-01-15,Supplier Payment - EuroFab Assembly #2,Supplier Payment,CEM-EMEA,27127.39,0.0,GBP,CHAPS,EuroFab Assembly #2,***6683,,PO-202401-CEM-EMEA-0006,False,False,REF-218478,First Continental Bank,***2616,Globex Consulting UK Ltd.,UK,6650264.05
2024-01-15,2024-01-15,Client Receipt - Novatek Components Ltd #11,Sales Receipt,CEM-EMEA,0.0,3513.19,GBP,Faster Payments Credit,Novatek Components Ltd #11,***3410,INV-202401-CEM-EMEA-0018,,False,False,REF-698744,First Continental Bank,***5506,Globex Consulting UK Ltd.,UK,6653777.24
2024-01-16,2024-01-16,Supplier Payment - HyperCloud Infra #16,Supplier Payment,SaaS-GL,493.2,0.0,GBP,CHAPS,HyperCloud Infra #16,***3234,,PO-202401-SaaS-GL-0007,False,False,REF-354588,First Continental Bank,***3572,Globex Consulting UK Ltd.,UK,6653284.04
2024-01-16,2024-01-16,Client Receipt - CloudBridge Co. #37,Sales Receipt,SaaS-GL,0.0,2942.58,GBP,Faster Payments Credit,CloudBridge Co. #37,***3156,INV-202401-SaaS-GL-0028,,False,False,REF-112943,First Continental Bank,***4724,Globex Consulting UK Ltd.,UK,6656226.62
2024-01-16,2024-01-16,Client Receipt - CloudBridge Co. #24,Sales Receipt,SaaS-GL,0.0,3711.76,GBP,Faster Payments Credit,CloudBridge Co. #24,***8401,INV-202401-SaaS-GL-0032,,False,False,REF-431826,First Continental Bank,***5739,Globex Consulting UK Ltd.,UK,6659938.38
2024-01-16,2024-01-16,Client Receipt - Vertex Advisory Client #54,Sales Receipt,PS-GL,0.0,10808.8,GBP,CHAPS Credit,Vertex Advisory Client #54,***8513,INV-202401-PS-GL-0008,,False,False,REF-448945,First Continental Bank,***1053,Globex Consulting UK Ltd.,UK,6670747.18
2024-01-17,2024-01-17,Client Receipt - CloudBridge Co. #21,Sales Receipt,SaaS-GL,0.0,2396.17,GBP,CHAPS Credit,CloudBridge Co. #21,***2927,INV-202401-SaaS-GL-0020,,False,False,REF-762689,First Continental Bank,***2247,Globex Consulting UK Ltd.,UK,6673143.35
2024-01-18,2024-01-18,Supplier Payment - ExpertNet Subcontractors #19,Supplier Payment,PS-GL,2667.06,0.0,GBP,CHAPS,ExpertNet Subcontractors #19,***2821,,PO-202401-PS-GL-0009,False,False,REF-675251,First Continental Bank,***8538,Globex Consulting UK Ltd.,UK,6670476.29
2024-01-18,2024-01-18,Skyline Internet Services,Rent & Utilities,ALL,3675.64,0.0,GBP,CHAPS,Skyline Internet Services,***1552,,,False,False,REF-646167,First Continental Bank,***9629,Globex Consulting UK Ltd.,UK,6666800.65
2024-01-18,2024-01-18,Supplier Payment - ExpertNet Subcontractors #16,Supplier Payment,PS-GL,5206.82,0.0,GBP,CHAPS,ExpertNet Subcontractors #16,***9407,,PO-202401-PS-GL-0001,False,False,REF-936476,First Continental Bank,***9029,Globex Consulting UK Ltd.,UK,6661593.83
2024-01-18,2024-01-18,VAT/GST Remittance - HMRC UK,Tax Payment,ALL,28475.58,0.0,GBP,SWIFT MT103,HMRC UK,***6468,,,False,False,REF-118782,First Continental Bank,***3329,Globex Consulting UK Ltd.,UK,6633118.25
2024-01-18,2024-01-18,Client Receipt - CloudBridge Co. #62,Sales Receipt,SaaS-GL,0.0,91.36,GBP,CHAPS Credit,CloudBridge Co. #62,***5218,INV-202401-SaaS-GL-0009,,False,False,REF-872986,First Continental Bank,***5901,Globex Consulting UK Ltd.,UK,6633209.61
2024-01-18,2024-01-18,Client Receipt - CloudBridge Co. #72,Sales Receipt,SaaS-GL,0.0,786.96,GBP,CHAPS Credit,CloudBridge Co. #72,***7564,INV-202401-SaaS-GL-0019,,False,False,REF-185545,First Continental Bank,***5382,Globex Consulting UK Ltd.,UK,6633996.57
2024-01-18,2024-01-18,Client Receipt - CloudBridge Co. #68,Sales Receipt,SaaS-GL,0.0,2436.66,GBP,Faster Payments Credit,CloudBridge Co. #68,***4079,INV-202401-SaaS-GL-0002,,False,False,REF-886349,First Continental Bank,***5838,Globex Consulting UK Ltd.,UK,6636433.23
2024-01-18,2024-01-18,Client Receipt - Novatek Components Ltd #7,Sales Receipt,CEM-EMEA,0.0,6818.78,GBP,CHAPS Credit,Novatek Components Ltd #7,***5811,INV-202401-CEM-EMEA-0015,,False,False,REF-757052,First Continental Bank,***6327,Globex Consulting UK Ltd.,UK,6643252.01
2024-01-19,2024-01-19,Supplier Payment - Stelliform Parts BV #33,Supplier Payment,CEM-EMEA,12659.13,0.0,GBP,Faster Payments,Stelliform Parts BV #33,***7552,,PO-202401-CEM-EMEA-0001,False,False,REF-601399,First Continental Bank,***5605,Globex Consulting UK Ltd.,UK,6630592.88
2024-01-19,2024-01-19,Client Receipt - Aurora Electronics GmbH #4,Sales Receipt,CEM-EMEA,0.0,8186.95,GBP,CHAPS Credit,Aurora Electronics GmbH #4,***2565,INV-202401-CEM-EMEA-0008,,False,False,REF-507099,First Continental Bank,***2529,Globex Consulting UK Ltd.,UK,6638779.83
2024-01-19,2024-01-19,Client Receipt - CloudBridge Co. #60,Sales Receipt,SaaS-GL,0.0,9058.79,GBP,CHAPS Credit,CloudBridge Co. #60,***1345,INV-202401-SaaS-GL-0005,,False,False,REF-963193,First Continental Bank,***2002,Globex Consulting UK Ltd.,UK,6647838.62
2024-01-20,2024-01-20,Marketing - Aurelia Media #7,Marketing,ALL,987.47,0.0,GBP,CHAPS,Aurelia Media #7,***2425,,,False,False,REF-214447,First Continental Bank,***8035,Globex Consulting UK Ltd.,UK,6646851.15
2024-01-20,2024-01-20,Client Receipt - Vertex Advisory Client #6,Sales Receipt,PS-GL,0.0,12440.6,GBP,CHAPS Credit,Vertex Advisory Client #6,***9488,INV-202401-PS-GL-0005,,False,False,REF-540373,First Continental Bank,***6797,Globex Consulting UK Ltd.,UK,6659291.75
2024-01-21,2024-01-21,Supplier Payment - EuroFab Assembly #11,Supplier Payment,CEM-EMEA,10394.08,0.0,GBP,CHAPS,EuroFab Assembly #11,***1282,,PO-202401-CEM-EMEA-0003,False,False,REF-655287,First Continental Bank,***8224,Globex Consulting UK Ltd.,UK,6648897.67
2024-01-22,2024-01-22,Client Receipt - CloudBridge Co. #76,Sales Receipt,SaaS-GL,0.0,4494.48,GBP,Faster Payments Credit,CloudBridge Co. #76,***8962,INV-202401-SaaS-GL-0021,,False,False,REF-720588,First Continental Bank,***1634,Globex Consulting UK Ltd.,UK,6653392.15
2024-01-23,2024-01-23,Supplier Payment - EuroFab Assembly #17,Supplier Payment,CEM-EMEA,1458.93,0.0,GBP,Faster Payments,EuroFab Assembly #17,***6843,,PO-202401-CEM-EMEA-0004,False,False,REF-323843,First Continental Bank,***2309,Globex Consulting UK Ltd.,UK,6651933.22
2024-01-23,2024-01-23,Client Receipt - Vertex Advisory Client #24,Sales Receipt,PS-GL,0.0,1360.24,GBP,CHAPS Credit,Vertex Advisory Client #24,***2110,INV-202401-PS-GL-0004,,False,False,REF-923835,First Continental Bank,***7730,Globex Consulting UK Ltd.,UK,6653293.46
2024-01-23,2024-01-23,Client Receipt - Novatek Components Ltd #9,Sales Receipt,CEM-EMEA,0.0,2017.35,GBP,CHAPS Credit,Novatek Components Ltd #9,***3793,INV-202401-CEM-EMEA-0005,,False,False,REF-385209,First Continental Bank,***5936,Globex Consulting UK Ltd.,UK,6655310.81
2024-01-23,2024-01-23,Client Receipt - CloudBridge Co. #45,Sales Receipt,SaaS-GL,0.0,2502.92,GBP,CHAPS Credit,CloudBridge Co. #45,***4422,INV-202401-SaaS-GL-0012,,False,False,REF-790483,First Continental Bank,***5294,Globex Consulting UK Ltd.,UK,6657813.73
2024-01-23,2024-01-23,Client Receipt - CloudBridge Co. #17,Sales Receipt,SaaS-GL,0.0,8825.47,GBP,CHAPS Credit,CloudBridge Co. #17,***9087,INV-202401-SaaS-GL-0004,,False,False,REF-189891,First Continental Bank,***2052,Globex Consulting UK Ltd.,UK,6666639.2
2024-01-24,2024-01-24,Client Receipt - CloudBridge Co. #78,Sales Receipt,SaaS-GL,0.0,682.41,GBP,Faster Payments Credit,CloudBridge Co. #78,***2691,INV-202401-SaaS-GL-0006,,False,False,REF-743136,First Continental Bank,***2040,Globex Consulting UK Ltd.,UK,6667321.61
2024-01-24,2024-01-24,Client Receipt - CloudBridge Co. #38,Sales Receipt,SaaS-GL,0.0,5354.75,GBP,CHAPS Credit,CloudBridge Co. #38,***9380,INV-202401-SaaS-GL-0007,,False,False,REF-442191,First Continental Bank,***4017,Globex Consulting UK Ltd.,UK,6672676.36
2024-01-24,2024-01-24,Client Receipt - CloudBridge Co. #9,Sales Receipt,SaaS-GL,0.0,5477.15,GBP,Faster Payments Credit,CloudBridge Co. #9,***6659,INV-202401-SaaS-GL-0031,,False,False,REF-843398,First Continental Bank,***4445,Globex Consulting UK Ltd.,UK,6678153.51
2024-01-24,2024-01-24,Client Receipt - Vertex Advisory Client #2,Sales Receipt,PS-GL,0.0,11035.79,GBP,CHAPS Credit,Vertex Advisory Client #2,***4270,INV-202401-PS-GL-0006,,False,False,REF-975622,First Continental Bank,***6436,Globex Consulting UK Ltd.,UK,6689189.3
2024-01-25,2024-01-25,Supplier Payment - Stelliform Parts BV #30,Supplier Payment,CEM-EMEA,25309.58,0.0,GBP,CHAPS,Stelliform Parts BV #30,***4624,,PO-202401-CEM-EMEA-0009,False,False,REF-824182,First Continental Bank,***9699,Globex Consulting UK Ltd.,UK,6663879.72
2024-01-25,2024-01-25,Client Receipt - CloudBridge Co. #59,Sales Receipt,SaaS-GL,0.0,6871.92,GBP,CHAPS Credit,CloudBridge Co. #59,***6605,INV-202401-SaaS-GL-0018,,False,False,REF-438227,First Continental Bank,***1551,Globex Consulting UK Ltd.,UK,6670751.64
2024-01-25,2024-01-25,Client Receipt - Novatek Components Ltd #7,Sales Receipt,CEM-EMEA,0.0,7622.78,GBP,Faster Payments Credit,Novatek Components Ltd #7,***7705,INV-202401-CEM-EMEA-0004,,False,False,REF-869383,First Continental Bank,***4806,Globex Consulting UK Ltd.,UK,6678374.42
2024-01-25,2024-01-25,Client Receipt - CloudBridge Co. #11,Sales Receipt,SaaS-GL,0.0,8285.08,GBP,Faster Payments Credit,CloudBridge Co. #11,***3618,INV-202401-SaaS-GL-0016,,False,False,REF-723737,First Continental Bank,***2003,Globex Consulting UK Ltd.,UK,6686659.5
2024-01-26,2024-01-26,Supplier Payment - Stelliform Parts BV #23,Supplier Payment,CEM-EMEA,1186.29,0.0,GBP,CHAPS,Stelliform Parts BV #23,***4284,,PO-202401-CEM-EMEA-0010,False,False,REF-418034,First Continental Bank,***3458,Globex Consulting UK Ltd.,UK,6685473.21
2024-01-26,2024-01-26,Supplier Payment - CodeCraft Contractors #8,Supplier Payment,SaaS-GL,4876.61,0.0,GBP,Faster Payments,CodeCraft Contractors #8,***1410,,PO-202401-SaaS-GL-0001,False,False,REF-612741,First Continental Bank,***9005,Globex Consulting UK Ltd.,UK,6680596.6
2024-01-26,2024-01-26,Payroll - GlobalPay Services Ltd,Payroll,ALL,72833.38,0.0,GBP,CHAPS,GlobalPay Services Ltd,***4741,,,False,False,REF-908540,First Continental Bank,***1703,Globex Consulting UK Ltd.,UK,6607763.22
2024-01-26,2024-01-26,Intercompany Settlement - Globex Retail NA LLC,Intercompany Transfer,ALL,179119.0,0.0,GBP,Internal Transfer,Globex Retail NA LLC,***4051,,,True,True,REF-583197,First Continental Bank,***4438,Globex Consulting UK Ltd.,UK,6428644.22
2024-01-26,2024-01-26,Client Receipt - CloudBridge Co. #52,Sales Receipt,SaaS-GL,0.0,101.33,GBP,CHAPS Credit,CloudBridge Co. #52,***3792,INV-202401-SaaS-GL-0026,,False,False,REF-714347,First Continental Bank,***2815,Globex Consulting UK Ltd.,UK,6428745.55
2024-01-26,2024-01-26,Client Receipt - CloudBridge Co. #51,Sales Receipt,SaaS-GL,0.0,577.99,GBP,Faster Payments Credit,CloudBridge Co. #51,***9664,INV-202401-SaaS-GL-0030,,False,False,REF-525290,First Continental Bank,***6991,Globex Consulting UK Ltd.,UK,6429323.54
2024-01-26,2024-01-26,Client Receipt - Novatek Components Ltd #14,Sales Receipt,CEM-EMEA,0.0,16536.76,GBP,Faster Payments Credit,Novatek Components Ltd #14,***8878,INV-202401-CEM-EMEA-0016,,False,False,REF-816901,First Continental Bank,***5981,Globex Consulting UK Ltd.,UK,6445860.3
2024-01-28,2024-01-28,Corporate Tax Estimate,Tax Payment,ALL,20407.01,0.0,GBP,Faster Payments,HMRC UK,***5877,,,False,False,REF-805072,First Continental Bank,***8358,Globex Consulting UK Ltd.,UK,6425453.29
2024-01-28,2024-01-28,Client Receipt - Aurora Electronics GmbH #19,Sales Receipt,CEM-EMEA,0.0,8138.36,GBP,CHAPS Credit,Aurora Electronics GmbH #19,***4381,INV-202401-CEM-EMEA-0017,,False,False,REF-825115,First Continental Bank,***3124,Globex Consulting UK Ltd.,UK,6433591.65
2024-01-29,2024-01-29,Supplier Payment - EuroFab Assembly #4,Supplier Payment,CEM-EMEA,377.23,0.0,GBP,CHAPS,EuroFab Assembly #4,***1170,,PO-202401-CEM-EMEA-0005,False,False,REF-390006,First Continental Bank,***4273,Globex Consulting UK Ltd.,UK,6433214.42
2024-01-29,2024-01-29,Supplier Payment - ExpertNet Subcontractors #10,Supplier Payment,PS-GL,4232.73,0.0,GBP,CHAPS,ExpertNet Subcontractors #10,***8602,,PO-202401-PS-GL-0004,False,False,REF-723478,First Continental Bank,***4566,Globex Consulting UK Ltd.,UK,6428981.69
2024-01-29,2024-01-29,Client Receipt - CloudBridge Co. #8,Sales Receipt,SaaS-GL,0.0,5464.06,GBP,Faster Payments Credit,CloudBridge Co. #8,***1882,INV-202401-SaaS-GL-0023,,False,False,REF-439644,First Continental Bank,***6751,Globex Consulting UK Ltd.,UK,6434445.75
2024-01-29,2024-01-29,Client Receipt - Aurora Electronics GmbH #19,Sales Receipt,CEM-EMEA,0.0,13580.67,GBP,Faster Payments Credit,Aurora Electronics GmbH #19,***6691,INV-202401-CEM-EMEA-0011,,False,False,REF-995417,First Continental Bank,***7218,Globex Consulting UK Ltd.,UK,6448026.42
2024-01-30,2024-01-30,Supplier Payment - CodeCraft Contractors #14,Supplier Payment,SaaS-GL,522.85,0.0,GBP,Faster Payments,CodeCraft Contractors #14,***7906,,PO-202401-SaaS-GL-0009,False,False,REF-160066,First Continental Bank,***1884,Globex Consulting UK Ltd.,UK,6447503.57
2024-01-30,2024-01-30,Supplier Payment - Stelliform Parts BV #4,Supplier Payment,CEM-EMEA,27933.08,0.0,GBP,CHAPS,Stelliform Parts BV #4,***3518,,PO-202401-CEM-EMEA-0011,False,False,REF-893850,First Continental Bank,***1936,Globex Consulting UK Ltd.,UK,6419570.49
2024-01-30,2024-01-30,Client Receipt - CloudBridge Co. #68,Sales Receipt,SaaS-GL,0.0,2658.09,GBP,Faster Payments Credit,CloudBridge Co. #68,***5288,INV-202401-SaaS-GL-0010,,False,False,REF-296641,First Continental Bank,***1654,Globex Consulting UK Ltd.,UK,6422228.58
2024-01-30,2024-01-30,Client Receipt - CloudBridge Co. #76,Sales Receipt,SaaS-GL,0.0,5479.08,GBP,Faster Payments Credit,CloudBridge Co. #76,***5745,INV-202401-SaaS-GL-0003,,False,False,REF-808241,First Continental Bank,***8077,Globex Consulting UK Ltd.,UK,6427707.66
2024-01-30,2024-01-30,Interest Earned,Interest Income,ALL,0.0,10356.55,GBP,Faster Payments Credit,First Continental Bank,***2025,,,False,False,REF-294226,First Continental Bank,***5313,Globex Consulting UK Ltd.,UK,6438064.21
2024-01-31,2024-01-31,Supplier Payment - HyperCloud Infra #9,Supplier Payment,SaaS-GL,470.02,0.0,GBP,Faster Payments,HyperCloud Infra #9,***1595,,PO-202401-SaaS-GL-0011,False,False,REF-632541,First Continental Bank,***1709,Globex Consulting UK Ltd.,UK,6437594.19
2024-01-31,2024-01-31,Client Receipt - CloudBridge Co. #79,Sales Receipt,SaaS-GL,0.0,2230.92,GBP,CHAPS Credit,CloudBridge Co. #79,***9183,INV-202401-SaaS-GL-0024,,False,False,REF-621472,First Continental Bank,***2346,Globex Consulting UK Ltd.,UK,6439825.11
2024-01-31,2024-01-31,Client Receipt - Novatek Components Ltd #2,Sales Receipt,CEM-EMEA,0.0,12116.8,GBP,Faster Payments Credit,Novatek Components Ltd #2,***6282,INV-202401-CEM-EMEA-0001,,False,False,REF-651403,First Continental Bank,***5955,Globex Consulting UK Ltd.,UK,6451941.91
2024-02-01,2024-02-01,Account Maintenance Fee,Bank/Merchant Fees,ALL,2500.0,0.0,GBP,CHAPS,First Continental Bank,***6079,,,False,False,REF-864596,First Continental Bank,***2528,Globex Consulting UK Ltd.,UK,6449441.91
2024-02-01,2024-02-01,Client Receipt - CloudBridge Co. #71,Sales Receipt,SaaS-GL,0.0,10406.51,GBP,CHAPS Credit,CloudBridge Co. #71,***9078,INV-202402-SaaS-GL-0016,,False,False,REF-397167,First Continental Bank,***1150,Globex Consulting UK Ltd.,UK,6459848.42
2024-02-01,2024-02-01,Client Receipt - Aurora Electronics GmbH #13,Sales Receipt,CEM-EMEA,0.0,21592.19,GBP,CHAPS Credit,Aurora Electronics GmbH #13,***7168,INV-202402-CEM-EMEA-0003,,False,False,REF-974155,First Continental Bank,***5075,Globex Consulting UK Ltd.,UK,6481440.61
2024-02-02,2024-02-02,BluePeak Property Mgmt,Rent & Utilities,ALL,792.18,0.0,GBP,CHAPS,BluePeak Property Mgmt,***2248,,,False,False,REF-549694,First Continental Bank,***9288,Globex Consulting UK Ltd.,UK,6480648.43
2024-02-02,2024-02-02,Supplier Payment - ExpertNet Subcontractors #12,Supplier Payment,PS-GL,7604.57,0.0,GBP,CHAPS,ExpertNet Subcontractors #12,***8777,,PO-202402-PS-GL-0001,False,False,REF-123072,First Continental Bank,***4098,Globex Consulting UK Ltd.,UK,6473043.86
2024-02-03,2024-02-03,Supplier Payment - HyperCloud Infra #2,Supplier Payment,SaaS-GL,4727.15,0.0,GBP,Faster Payments,HyperCloud Infra #2,***9428,,PO-202402-SaaS-GL-0002,False,False,REF-189940,First Continental Bank,***6345,Globex Consulting UK Ltd.,UK,6468316.71
2024-02-03,2024-02-03,Client Receipt - CloudBridge Co. #44,Sales Receipt,SaaS-GL,0.0,14741.9,GBP,Faster Payments Credit,CloudBridge Co. #44,***4019,INV-202402-SaaS-GL-0013,,False,False,REF-326364,First Continental Bank,***7945,Globex Consulting UK Ltd.,UK,6483058.61
2024-02-05,2024-02-05,Supplier Payment - ExpertNet Subcontractors #9,Supplier Payment,PS-GL,6056.48,0.0,GBP,Faster Payments,ExpertNet Subcontractors #9,***7031,,PO-202402-PS-GL-0007,False,False,REF-843997,First Continental Bank,***3113,Globex Consulting UK Ltd.,UK,6477002.13
2024-02-05,2024-02-05,Supplier Payment - Stelliform Parts BV #19,Supplier Payment,CEM-EMEA,65992.2,0.0,GBP,Faster Payments,Stelliform Parts BV #19,***8303,,PO-202402-CEM-EMEA-0008,False,False,REF-846200,First Continental Bank,***5525,Globex Consulting UK Ltd.,UK,6411009.93
2024-02-06,2024-02-06,Supplier Payment - HyperCloud Infra #5,Supplier Payment,SaaS-GL,7638.04,0.0,GBP,CHAPS,HyperCloud Infra #5,***7931,,PO-202402-SaaS-GL-0001,False,False,REF-676225,First Continental Bank,***3926,Globex Consulting UK Ltd.,UK,6403371.89
2024-02-06,2024-02-06,Client Receipt - Vertex Advisory Client #22,Sales Receipt,PS-GL,0.0,4296.54,GBP,CHAPS Credit,Vertex Advisory Client #22,***3558,INV-202402-PS-GL-0004,,False,False,REF-197997,First Continental Bank,***3007,Globex Consulting UK Ltd.,UK,6407668.43
2024-02-06,2024-02-06,Client Receipt - Vertex Advisory Client #7,Sales Receipt,PS-GL,0.0,6206.85,GBP,CHAPS Credit,Vertex Advisory Client #7,***7823,INV-202402-PS-GL-0006,,False,False,REF-379150,First Continental Bank,***3590,Globex Consulting UK Ltd.,UK,6413875.28
2024-02-06,2024-02-06,Client Receipt - CloudBridge Co. #59,Sales Receipt,SaaS-GL,0.0,23274.29,GBP,Faster Payments Credit,CloudBridge Co. #59,***6295,INV-202402-SaaS-GL-0021,,False,False,REF-436396,First Continental Bank,***7214,Globex Consulting UK Ltd.,UK,6437149.57
2024-02-07,2024-02-07,Marketing - Aurelia Media #9,Marketing,ALL,853.67,0.0,GBP,CHAPS,Aurelia Media #9,***9199,,,False,False,REF-382855,First Continental Bank,***8787,Globex Consulting UK Ltd.,UK,6436295.9
2024-02-07,2024-02-07,Supplier Payment - CodeCraft Contractors #14,Supplier Payment,SaaS-GL,3385.02,0.0,GBP,Faster Payments,CodeCraft Contractors #14,***5851,,PO-202402-SaaS-GL-0008,False,False,REF-156682,First Continental Bank,***7070,Globex Consulting UK Ltd.,UK,6432910.88
2024-02-07,2024-02-07,Client Receipt - CloudBridge Co. #40,Sales Receipt,SaaS-GL,0.0,312.41,GBP,Faster Payments Credit,CloudBridge Co. #40,***9152,INV-202402-SaaS-GL-0015,,False,False,REF-582591,First Continental Bank,***3477,Globex Consulting UK Ltd.,UK,6433223.29
2024-02-07,2024-02-07,Client Receipt - CloudBridge Co. #71,Sales Receipt,SaaS-GL,0.0,7356.74,GBP,CHAPS Credit,CloudBridge Co. #71,***5124,INV-202402-SaaS-GL-0022,,False,False,REF-407062,First Continental Bank,***4442,Globex Consulting UK Ltd.,UK,6440580.03
2024-02-07,2024-02-07,Client Receipt - Vertex Advisory Client #33,Sales Receipt,PS-GL,0.0,21875.83,GBP,CHAPS Credit,Vertex Advisory Client #33,***9988,INV-202402-PS-GL-0008,,False,False,REF-466078,First Continental Bank,***2812,Globex Consulting UK Ltd.,UK,6462455.86
2024-02-08,2024-02-08,Client Receipt - CloudBridge Co. #5,Sales Receipt,SaaS-GL,0.0,1249.42,GBP,CHAPS Credit,CloudBridge Co. #5,***2382,INV-202402-SaaS-GL-0020,,False,False,REF-181920,First Continental Bank,***3301,Globex Consulting UK Ltd.,UK,6463705.28
2024-02-08,2024-02-08,Client Receipt - Vertex Advisory Client #24,Sales Receipt,PS-GL,0.0,2236.47,GBP,Faster Payments Credit,Vertex Advisory Client #24,***2596,INV-202402-PS-GL-0002,,False,False,REF-362874,First Continental Bank,***1187,Globex Consulting UK Ltd.,UK,6465941.75
2024-02-08,2024-02-08,Client Receipt - CloudBridge Co. #48,Sales Receipt,SaaS-GL,0.0,3088.19,GBP,Faster Payments Credit,CloudBridge Co. #48,***6598,INV-202402-SaaS-GL-0002,,False,False,REF-208589,First Continental Bank,***4663,Globex Consulting UK Ltd.,UK,6469029.94
2024-02-08,2024-02-08,Client Receipt - CloudBridge Co. #25,Sales Receipt,SaaS-GL,0.0,5770.44,GBP,CHAPS Credit,CloudBridge Co. #25,***8801,INV-202402-SaaS-GL-0008,,False,False,REF-432215,First Continental Bank,***6057,Globex Consulting UK Ltd.,UK,6474800.38
2024-02-09,2024-02-09,Supplier Payment - ExpertNet Subcontractors #17,Supplier Payment,PS-GL,1789.95,0.0,GBP,Faster Payments,ExpertNet Subcontractors #17,***9339,,PO-202402-PS-GL-0010,False,False,REF-369895,First Continental Bank,***6667,Globex Consulting UK Ltd.,UK,6473010.43
2024-02-09,2024-02-09,Client Receipt - CloudBridge Co. #76,Sales Receipt,SaaS-GL,0.0,1787.21,GBP,Faster Payments Credit,CloudBridge Co. #76,***4716,INV-202402-SaaS-GL-0003,,False,False,REF-353497,First Continental Bank,***1088,Globex Consulting UK Ltd.,UK,6474797.64
2024-02-10,2024-02-10,Client Receipt - CloudBridge Co. #28,Sales Receipt,SaaS-GL,0.0,2242.33,GBP,CHAPS Credit,CloudBridge Co. #28,***4615,INV-202402-SaaS-GL-0009,,False,False,REF-885200,First Continental Bank,***6367,Globex Consulting UK Ltd.,UK,6477039.97
2024-02-11,2024-02-11,Client Receipt - Vertex Advisory Client #33,Sales Receipt,PS-GL,0.0,1695.85,GBP,CHAPS Credit,Vertex Advisory Client #33,***5799,INV-202402-PS-GL-0010,,False,False,REF-336116,First Continental Bank,***3932,Globex Consulting UK Ltd.,UK,6478735.82
2024-02-12,2024-02-12,Supplier Payment - ExpertNet Subcontractors #3,Supplier Payment,PS-GL,5273.57,0.0,GBP,CHAPS,ExpertNet Subcontractors #3,***6357,,PO-202402-PS-GL-0002,False,False,REF-669015,First Continental Bank,***8967,Globex Consulting UK Ltd.,UK,6473462.25
2024-02-12,2024-02-12,"Intercompany Settlement - Globex International Holdings, Inc.",Intercompany Transfer,ALL,616536.0,0.0,GBP,Internal Transfer,"Globex International Holdings, Inc.",***9151,,,True,True,REF-558111,First Continental Bank,***5532,Globex Consulting UK Ltd.,UK,5856926.25
2024-02-12,2024-02-12,Client Receipt - Novatek Components Ltd #1,Sales Receipt,CEM-EMEA,0.0,1965.51,GBP,Faster Payments Credit,Novatek Components Ltd #1,***1051,INV-202402-CEM-EMEA-0002,,False,False,REF-718401,First Continental Bank,***4163,Globex Consulting UK Ltd.,UK,5858891.76
2024-02-12,2024-02-12,Client Receipt - CloudBridge Co. #68,Sales Receipt,SaaS-GL,0.0,2297.83,GBP,CHAPS Credit,CloudBridge Co. #68,***2249,INV-202402-SaaS-GL-0014,,False,False,REF-264595,First Continental Bank,***6022,Globex Consulting UK Ltd.,UK,5861189.59
2024-02-12,2024-02-12,Client Receipt - CloudBridge Co. #67,Sales Receipt,SaaS-GL,0.0,25035.59,GBP,CHAPS Credit,CloudBridge Co. #67,***4040,INV-202402-SaaS-GL-0019,,False,False,REF-154088,First Continental Bank,***1940,Globex Consulting UK Ltd.,UK,5886225.18
2024-02-12,2024-02-12,Client Receipt - Novatek Components Ltd #11,Sales Receipt,CEM-EMEA,0.0,41713.54,GBP,CHAPS Credit,Novatek Components Ltd #11,***9749,INV-202402-CEM-EMEA-0009,,False,False,REF-201450,First Continental Bank,***5793,Globex Consulting UK Ltd.,UK,5927938.72
2024-02-12,2024-02-12,"Intercompany Reimbursement - Globex International Holdings, Inc.",Intercompany Transfer,ALL,0.0,246614.4,GBP,Internal Transfer,"Globex International Holdings, Inc.",***6646,,,True,True,REF-539217,First Continental Bank,***1745,Globex Consulting UK Ltd.,UK,6174553.12
2024-02-13,2024-02-13,Supplier Payment - ExpertNet Subcontractors #12,Supplier Payment,PS-GL,2336.33,0.0,GBP,CHAPS,ExpertNet Subcontractors #12,***4957,,PO-202402-PS-GL-0009,False,False,REF-509984,First Continental Bank,***5335,Globex Consulting UK Ltd.,UK,6172216.79
2024-02-13,2024-02-13,Supplier Payment - Stelliform Parts BV #5,Supplier Payment,CEM-EMEA,11772.83,0.0,GBP,Faster Payments,Stelliform Parts BV #5,***9877,,PO-202402-CEM-EMEA-0002,False,False,REF-705744,First Continental Bank,***2864,Globex Consulting UK Ltd.,UK,6160443.96
2024-02-13,2024-02-13,Supplier Payment - HyperCloud Infra #15,Supplier Payment,SaaS-GL,13443.69,0.0,GBP,Faster Payments,HyperCloud Infra #15,***2356,,PO-202402-SaaS-GL-0004,False,False,REF-986153,First Continental Bank,***8076,Globex Consulting UK Ltd.,UK,6147000.27
2024-02-13,2024-02-13,Client Receipt - CloudBridge Co. #8,Sales Receipt,SaaS-GL,0.0,2175.66,GBP,Faster Payments Credit,CloudBridge Co. #8,***7803,INV-202402-SaaS-GL-0017,,False,False,REF-646416,First Continental Bank,***1352,Globex Consulting UK Ltd.,UK,6149175.93
2024-02-13,2024-02-13,Client Receipt - CloudBridge Co. #8,Sales Receipt,SaaS-GL,0.0,5274.01,GBP,Faster Payments Credit,CloudBridge Co. #8,***6502,INV-202402-SaaS-GL-0023,,False,False,REF-965609,First Continental Bank,***2312,Globex Consulting UK Ltd.,UK,6154449.94
2024-02-13,2024-02-13,Client Receipt - Aurora Electronics GmbH #7,Sales Receipt,CEM-EMEA,0.0,7545.69,GBP,Faster Payments Credit,Aurora Electronics GmbH #7,***2284,INV-202402-CEM-EMEA-0014,,False,False,REF-399109,First Continental Bank,***4782,Globex Consulting UK Ltd.,UK,6161995.63
2024-02-13,2024-02-13,Client Receipt - Aurora Electronics GmbH #19,Sales Receipt,CEM-EMEA,0.0,14231.23,GBP,Faster Payments Credit,Aurora Electronics GmbH #19,***4679,INV-202402-CEM-EMEA-0006,,False,False,REF-788293,First Continental Bank,***2214,Globex Consulting UK Ltd.,UK,6176226.86
2024-02-14,2024-02-14,Client Receipt - Novatek Components Ltd #5,Sales Receipt,CEM-EMEA,0.0,14246.16,GBP,CHAPS Credit,Novatek Components Ltd #5,***5821,INV-202402-CEM-EMEA-0007,,False,False,REF-362891,First Continental Bank,***7642,Globex Consulting UK Ltd.,UK,6190473.02
2024-02-15,2024-02-15,Supplier Payment - CodeCraft Contractors #9,Supplier Payment,SaaS-GL,840.64,0.0,GBP,CHAPS,CodeCraft Contractors #9,***5224,,PO-202402-SaaS-GL-0007,False,False,REF-198826,First Continental Bank,***5630,Globex Consulting UK Ltd.,UK,6189632.38
2024-02-15,2024-02-15,Supplier Payment - ExpertNet Subcontractors #7,Supplier Payment,PS-GL,1106.98,0.0,GBP,CHAPS,ExpertNet Subcontractors #7,***1463,,PO-202402-PS-GL-0006,False,False,REF-426537,First Continental Bank,***8763,Globex Consulting UK Ltd.,UK,6188525.4
2024-02-15,2024-02-15,Supplier Payment - EuroFab Assembly #20,Supplier Payment,CEM-EMEA,2879.87,0.0,GBP,Faster Payments,EuroFab Assembly #20,***4413,,PO-202402-CEM-EMEA-0001,False,False,REF-257334,First Continental Bank,***5061,Globex Consulting UK Ltd.,UK,6185645.53
2024-02-15,2024-02-15,Supplier Payment - EuroFab Assembly #10,Supplier Payment,CEM-EMEA,4515.69,0.0,GBP,CHAPS,EuroFab Assembly #10,***6119,,PO-202402-CEM-EMEA-0007,False,False,REF-322060,First Continental Bank,***9989,Globex Consulting UK Ltd.,UK,6181129.84
2024-02-15,2024-02-15,Supplier Payment - EuroFab Assembly #6,Supplier Payment,CEM-EMEA,40400.01,0.0,GBP,CHAPS,EuroFab Assembly #6,***8784,,PO-202402-CEM-EMEA-0004,False,False,REF-388590,First Continental Bank,***3310,Globex Consulting UK Ltd.,UK,6140729.83
2024-02-15,2024-02-15,Client Receipt - Vertex Advisory Client #50,Sales Receipt,PS-GL,0.0,2862.06,GBP,CHAPS Credit,Vertex Advisory Client #50,***2195,INV-202402-PS-GL-0003,,False,False,REF-685560,First Continental Bank,***6160,Globex Consulting UK Ltd.,UK,6143591.89
2024-02-16,2024-02-16,Client Receipt - CloudBridge Co. #54,Sales Receipt,SaaS-GL,0.0,2629.44,GBP,Faster Payments Credit,CloudBridge Co. #54,***5589,INV-202402-SaaS-GL-0004,,False,False,REF-550831,First Continental Bank,***5692,Globex Consulting UK Ltd.,UK,6146221.33
2024-02-16,2024-02-16,Client Receipt - CloudBridge Co. #51,Sales Receipt,SaaS-GL,0.0,11389.44,GBP,Faster Payments Credit,CloudBridge Co. #51,***9670,INV-202402-SaaS-GL-0025,,False,False,REF-446299,First Continental Bank,***7095,Globex Consulting UK Ltd.,UK,6157610.77
2024-02-16,2024-02-16,Client Receipt - Novatek Components Ltd #8,Sales Receipt,CEM-EMEA,0.0,12101.52,GBP,Faster Payments Credit,Novatek Components Ltd #8,***7717,INV-202402-CEM-EMEA-0011,,False,False,REF-938989,First Continental Bank,***4213,Globex Consulting UK Ltd.,UK,6169712.29
2024-02-17,2024-02-17,Client Receipt - Vertex Advisory Client #7,Sales Receipt,PS-GL,0.0,3021.0,GBP,Faster Payments Credit,Vertex Advisory Client #7,***7414,INV-202402-PS-GL-0001,,False,False,REF-925553,First Continental Bank,***8340,Globex Consulting UK Ltd.,UK,6172733.29
2024-02-18,2024-02-18,VAT/GST Remittance - HMRC UK,Tax Payment,ALL,34123.5,0.0,GBP,SWIFT MT103,HMRC UK,***8370,,,False,False,REF-381940,First Continental Bank,***8329,Globex Consulting UK Ltd.,UK,6138609.79
2024-02-19,2024-02-19,Supplier Payment - ExpertNet Subcontractors #13,Supplier Payment,PS-GL,2363.56,0.0,GBP,Faster Payments,ExpertNet Subcontractors #13,***2450,,PO-202402-PS-GL-0003,False,False,REF-847589,First Continental Bank,***8039,Globex Consulting UK Ltd.,UK,6136246.23
2024-02-19,2024-02-19,Marketing - Aurelia Media #4,Marketing,ALL,13042.96,0.0,GBP,Faster Payments,Aurelia Media #4,***4528,,,False,False,REF-993778,First Continental Bank,***3444,Globex Consulting UK Ltd.,UK,6123203.27
2024-02-19,2024-02-19,Client Receipt - CloudBridge Co. #33,Sales Receipt,SaaS-GL,0.0,398.38,GBP,CHAPS Credit,CloudBridge Co. #33,***6213,INV-202402-SaaS-GL-0011,,False,False,REF-101851,First Continental Bank,***5849,Globex Consulting UK Ltd.,UK,6123601.65
2024-02-20,2024-02-20,Client Receipt - CloudBridge Co. #37,Sales Receipt,SaaS-GL,0.0,1838.35,GBP,Faster Payments Credit,CloudBridge Co. #37,***9526,INV-202402-SaaS-GL-0006,,False,False,REF-869167,First Continental Bank,***7609,Globex Consulting UK Ltd.,UK,6125440.0
2024-02-20,2024-02-20,Client Receipt - Aurora Electronics GmbH #19,Sales Receipt,CEM-EMEA,0.0,3485.0,GBP,Faster Payments Credit,Aurora Electronics GmbH #19,***9235,INV-202402-CEM-EMEA-0008,,False,False,REF-622499,First Continental Bank,***1874,Globex Consulting UK Ltd.,UK,6128925.0
2024-02-20,2024-02-20,Client Receipt - CloudBridge Co. #62,Sales Receipt,SaaS-GL,0.0,13408.21,GBP,Faster Payments Credit,CloudBridge Co. #62,***1123,INV-202402-SaaS-GL-0018,,False,False,REF-213229,First Continental Bank,***4712,Globex Consulting UK Ltd.,UK,6142333.21
2024-02-20,2024-02-20,Client Receipt - Vertex Advisory Client #19,Sales Receipt,PS-GL,0.0,20614.0,GBP,CHAPS Credit,Vertex Advisory Client #19,***5099,INV-202402-PS-GL-0005,,False,False,REF-918778,First Continental Bank,***5022,Globex Consulting UK Ltd.,UK,6162947.21
2024-02-20,2024-02-20,Client Receipt - Aurora Electronics GmbH #17,Sales Receipt,CEM-EMEA,0.0,21559.89,GBP,CHAPS Credit,Aurora Electronics GmbH #17,***6624,INV-202402-CEM-EMEA-0001,,False,False,REF-132655,First Continental Bank,***3988,Globex Consulting UK Ltd.,UK,6184507.1
2024-02-21,2024-02-21,Merchant Processing Fees,Bank/Merchant Fees,ALL,1199.55,0.0,GBP,Faster Payments,First Continental Bank,***2829,,,False,False,REF-575619,First Continental Bank,***5818,Globex Consulting UK Ltd.,UK,6183307.55
2024-02-21,2024-02-21,Client Receipt - Aurora Electronics GmbH #7,Sales Receipt,CEM-EMEA,0.0,5800.06,GBP,Faster Payments Credit,Aurora Electronics GmbH #7,***5825,INV-202402-CEM-EMEA-0012,,False,False,REF-189593,First Continental Bank,***5246,Globex Consulting UK Ltd.,UK,6189107.61
2024-02-22,2024-02-22,Supplier Payment - ExpertNet Subcontractors #16,Supplier Payment,PS-GL,5014.6,0.0,GBP,Faster Payments,ExpertNet Subcontractors #16,***7923,,PO-202402-PS-GL-0005,False,False,REF-153177,First Continental Bank,***4440,Globex Consulting UK Ltd.,UK,6184093.01
2024-02-22,2024-02-22,Client Receipt - CloudBridge Co. #48,Sales Receipt,SaaS-GL,0.0,4330.57,GBP,CHAPS Credit,CloudBridge Co. #48,***4735,INV-202402-SaaS-GL-0005,,False,False,REF-890802,First Continental Bank,***5086,Globex Consulting UK Ltd.,UK,6188423.58
2024-02-22,2024-02-22,Client Receipt - CloudBridge Co. #28,Sales Receipt,SaaS-GL,0.0,11277.19,GBP,CHAPS Credit,CloudBridge Co. #28,***5111,INV-202402-SaaS-GL-0012,,False,False,REF-959829,First Continental Bank,***9933,Globex Consulting UK Ltd.,UK,6199700.77
2024-02-22,2024-02-22,Client Receipt - Aurora Electronics GmbH #1,Sales Receipt,CEM-EMEA,0.0,14819.31,GBP,CHAPS Credit,Aurora Electronics GmbH #1,***6940,INV-202402-CEM-EMEA-0013,,False,False,REF-407392,First Continental Bank,***1490,Globex Consulting UK Ltd.,UK,6214520.08
2024-02-22,2024-02-22,Client Receipt - Vertex Advisory Client #45,Sales Receipt,PS-GL,0.0,20408.52,GBP,CHAPS Credit,Vertex Advisory Client #45,***1846,INV-202402-PS-GL-0007,,False,False,REF-907230,First Continental Bank,***3787,Globex Consulting UK Ltd.,UK,6234928.6
2024-02-23,2024-02-23,Merchant Processing Fees,Bank/Merchant Fees,ALL,493.81,0.0,GBP,Faster Payments,First Continental Bank,***6994,,,False,False,REF-505403,First Continental Bank,***5063,Globex Consulting UK Ltd.,UK,6234434.79
2024-02-23,2024-02-23,Client Receipt - CloudBridge Co. #6,Sales Receipt,SaaS-GL,0.0,9387.48,GBP,CHAPS Credit,CloudBridge Co. #6,***3709,INV-202402-SaaS-GL-0010,,False,False,REF-823288,First Continental Bank,***7524,Globex Consulting UK Ltd.,UK,6243822.27
2024-02-23,2024-02-23,Client Receipt - Vertex Advisory Client #5,Sales Receipt,PS-GL,0.0,13507.64,GBP,CHAPS Credit,Vertex Advisory Client #5,***2500,INV-202402-PS-GL-0009,,False,False,REF-969701,First Continental Bank,***8114,Globex Consulting UK Ltd.,UK,6257329.91
2024-02-24,2024-02-24,Supplier Payment - EuroFab Assembly #13,Supplier Payment,CEM-EMEA,8882.95,0.0,GBP,Faster Payments,EuroFab Assembly #13,***9041,,PO-202402-CEM-EMEA-0003,False,False,REF-801975,First Continental Bank,***1174,Globex Consulting UK Ltd.,UK,6248446.96
2024-02-25,2024-02-25,Client Receipt - Aurora Electronics GmbH #1,Sales Receipt,CEM-EMEA,0.0,9461.96,GBP,Faster Payments Credit,Aurora Electronics GmbH #1,***1665,INV-202402-CEM-EMEA-0010,,False,False,REF-758599,First Continental Bank,***3389,Globex Consulting UK Ltd.,UK,6257908.92
2024-02-26,2024-02-26,Supplier Payment - ExpertNet Subcontractors #6,Supplier Payment,PS-GL,579.16,0.0,GBP,CHAPS,ExpertNet Subcontractors #6,***1019,,PO-202402-PS-GL-0008,False,False,REF-243599,First Continental Bank,***6470,Globex Consulting UK Ltd.,UK,6257329.76
2024-02-26,2024-02-26,Intercompany Settlement - Globex Retail NA LLC,Intercompany Transfer,ALL,335467.0,0.0,GBP,Internal Transfer,Globex Retail NA LLC,***6712,,,True,True,REF-549359,First Continental Bank,***7713,Globex Consulting UK Ltd.,UK,5921862.76
2024-02-26,2024-02-26,Client Receipt - Novatek Components Ltd #14,Sales Receipt,CEM-EMEA,0.0,9344.68,GBP,Faster Payments Credit,Novatek Components Ltd #14,***3088,INV-202402-CEM-EMEA-0005,,False,False,REF-809296,First Continental Bank,***9772,Globex Consulting UK Ltd.,UK,5931207.44
2024-02-27,2024-02-27,Supplier Payment - CodeCraft Contractors #4,Supplier Payment,SaaS-GL,831.55,0.0,GBP,CHAPS,CodeCraft Contractors #4,***6911,,PO-202402-SaaS-GL-0003,False,False,REF-163345,First Continental Bank,***4220,Globex Consulting UK Ltd.,UK,5930375.89
2024-02-27,2024-02-27,Supplier Payment - HyperCloud Infra #5,Supplier Payment,SaaS-GL,2325.32,0.0,GBP,Faster Payments,HyperCloud Infra #5,***2508,,PO-202402-SaaS-GL-0009,False,False,REF-533048,First Continental Bank,***4656,Globex Consulting UK Ltd.,UK,5928050.57
2024-02-27,2024-02-27,Client Receipt - Vertex Advisory Client #11,Sales Receipt,PS-GL,0.0,12964.44,GBP,Faster Payments Credit,Vertex Advisory Client #11,***3080,INV-202402-PS-GL-0011,,False,False,REF-868934,First Continental Bank,***6079,Globex Consulting UK Ltd.,UK,5941015.01
2024-02-28,2024-02-28,Supplier Payment - HyperCloud Infra #1,Supplier Payment,SaaS-GL,899.21,0.0,GBP,CHAPS,HyperCloud Infra #1,***9028,,PO-202402-SaaS-GL-0005,False,False,REF-146331,First Continental Bank,***3550,Globex Consulting UK Ltd.,UK,5940115.8
2024-02-28,2024-02-28,Metro Water & Waste,Rent & Utilities,ALL,3551.11,0.0,GBP,CHAPS,Metro Water & Waste,***4568,,,False,False,REF-661631,First Continental Bank,***4004,Globex Consulting UK Ltd.,UK,5936564.69
2024-02-28,2024-02-28,Supplier Payment - CodeCraft Contractors #7,Supplier Payment,SaaS-GL,3655.39,0.0,GBP,Faster Payments,CodeCraft Contractors #7,***8248,,PO-202402-SaaS-GL-0006,False,False,REF-285470,First Continental Bank,***7638,Globex Consulting UK Ltd.,UK,5932909.3
2024-02-28,2024-02-28,Supplier Payment - EuroFab Assembly #6,Supplier Payment,CEM-EMEA,15440.6,0.0,GBP,Faster Payments,EuroFab Assembly #6,***2368,,PO-202402-CEM-EMEA-0005,False,False,REF-389224,First Continental Bank,***9930,Globex Consulting UK Ltd.,UK,5917468.7
2024-02-28,2024-02-28,Payroll - GlobalPay Services Ltd,Payroll,ALL,89211.42,0.0,GBP,CHAPS,GlobalPay Services Ltd,***5084,,,False,False,REF-577197,First Continental Bank,***5919,Globex Consulting UK Ltd.,UK,5828257.28
2024-02-28,2024-02-28,Client Receipt - CloudBridge Co. #3,Sales Receipt,SaaS-GL,0.0,128.01,GBP,CHAPS Credit,CloudBridge Co. #3,***7348,INV-202402-SaaS-GL-0024,,False,False,REF-678542,First Continental Bank,***4744,Globex Consulting UK Ltd.,UK,5828385.29
2024-02-28,2024-02-28,Client Receipt - CloudBridge Co. #62,Sales Receipt,SaaS-GL,0.0,9636.99,GBP,CHAPS Credit,CloudBridge Co. #62,***3225,INV-202402-SaaS-GL-0001,,False,False,REF-419512,First Continental Bank,***9414,Globex Consulting UK Ltd.,UK,5838022.28
2024-02-28,2024-02-28,Client Receipt - Novatek Components Ltd #2,Sales Receipt,CEM-EMEA,0.0,32928.6,GBP,Faster Payments Credit,Novatek Components Ltd #2,***9185,INV-202402-CEM-EMEA-0015,,False,False,REF-892580,First Continental Bank,***3902,Globex Consulting UK Ltd.,UK,5870950.88
2024-02-29,2024-02-29,Supplier Payment - ExpertNet Subcontractors #8,Supplier Payment,PS-GL,2189.35,0.0,GBP,CHAPS,ExpertNet Subcontractors #8,***9726,,PO-202402-PS-GL-0004,False,False,REF-288699,First Continental Bank,***2514,Globex Consulting UK Ltd.,UK,5868761.53
2024-02-29,2024-02-29,Supplier Payment - EuroFab Assembly #4,Supplier Payment,CEM-EMEA,10250.42,0.0,GBP,CHAPS,EuroFab Assembly #4,***8508,,PO-202402-CEM-EMEA-0006,False,False,REF-564226,First Continental Bank,***4368,Globex Consulting UK Ltd.,UK,5858511.11
2024-02-29,2024-02-29,Client Receipt - CloudBridge Co. #24,Sales Receipt,SaaS-GL,0.0,2136.16,GBP,CHAPS Credit,CloudBridge Co. #24,***1470,INV-202402-SaaS-GL-0007,,False,False,REF-797964,First Continental Bank,***2910,Globex Consulting UK Ltd.,UK,5860647.27
2024-02-29,2024-02-29,Client Receipt - Vertex Advisory Client #11,Sales Receipt,PS-GL,0.0,4692.63,GBP,Faster Payments Credit,Vertex Advisory Client #11,***9840,INV-202402-PS-GL-0012,,False,False,REF-743115,First Continental Bank,***6869,Globex Consulting UK Ltd.,UK,5865339.9
2024-02-29,2024-02-29,Interest Earned,Interest Income,ALL,0.0,10853.74,GBP,Faster Payments Credit,First Continental Bank,***3513,,,False,False,REF-424405,First Continental Bank,***8954,Globex Consulting UK Ltd.,UK,5876193.64
2024-02-29,2024-02-29,Client Receipt - Aurora Electronics GmbH #7,Sales Receipt,CEM-EMEA,0.0,27936.24,GBP,Faster Payments Credit,Aurora Electronics GmbH #7,***7008,INV-202402-CEM-EMEA-0004,,False,False,REF-694626,First Continental Bank,***8796,Globex Consulting UK Ltd.,UK,5904129.88
2024-02-29,2024-02-29,Client Receipt - Aurora Electronics GmbH #1,Sales Receipt,CEM-EMEA,0.0,28159.36,GBP,Faster Payments Credit,Aurora Electronics GmbH #1,***7715,INV-202402-CEM-EMEA-0016,,False,False,REF-706749,First Continental Bank,***8297,Globex Consulting UK Ltd.,UK,5932289.24
2024-03-01,2024-03-01,Supplier Payment - ExpertNet Subcontractors #13,Supplier Payment,PS-GL,708.22,0.0,GBP,Faster Payments,ExpertNet Subcontractors #13,***2841,,PO-202403-PS-GL-0011,False,False,REF-666214,First Continental Bank,***1031,Globex Consulting UK Ltd.,UK,5931581.02
2024-03-01,2024-03-01,Account Maintenance Fee,Bank/Merchant Fees,ALL,2500.0,0.0,GBP,Faster Payments,First Continental Bank,***4465,,,False,False,REF-893260,First Continental Bank,***7336,Globex Consulting UK Ltd.,UK,5929081.02
2024-03-01,2024-03-01,Supplier Payment - Stelliform Parts BV #2,Supplier Payment,CEM-EMEA,18258.58,0.0,GBP,CHAPS,Stelliform Parts BV #2,***3393,,PO-202403-CEM-EMEA-0004,False,False,REF-180181,First Continental Bank,***3641,Globex Consulting UK Ltd.,UK,5910822.44
2024-03-01,2024-03-01,Client Receipt - CloudBridge Co. #14,Sales Receipt,SaaS-GL,0.0,1196.28,GBP,CHAPS Credit,CloudBridge Co. #14,***3742,INV-202403-SaaS-GL-0035,,False,False,REF-372766,First Continental Bank,***3534,Globex Consulting UK Ltd.,UK,5912018.72
2024-03-01,2024-03-01,Client Receipt - CloudBridge Co. #60,Sales Receipt,SaaS-GL,0.0,36283.74,GBP,Faster Payments Credit,CloudBridge Co. #60,***3003,INV-202403-SaaS-GL-0011,,False,False,REF-602301,First Continental Bank,***1315,Globex Consulting UK Ltd.,UK,5948302.46
2024-03-02,2024-03-02,Supplier Payment - HyperCloud Infra #17,Supplier Payment,SaaS-GL,868.41,0.0,GBP,CHAPS,HyperCloud Infra #17,***4302,,PO-202403-SaaS-GL-0002,False,False,REF-504840,First Continental Bank,***7221,Globex Consulting UK Ltd.,UK,5947434.05
2024-03-02,2024-03-02,Client Receipt - CloudBridge Co. #12,Sales Receipt,SaaS-GL,0.0,8570.41,GBP,Faster Payments Credit,CloudBridge Co. #12,***5896,INV-202403-SaaS-GL-0009,,False,False,REF-320119,First Continental Bank,***2221,Globex Consulting UK Ltd.,UK,5956004.46
2024-03-04,2024-03-04,Northshore Power,Rent & Utilities,ALL,1043.92,0.0,GBP,CHAPS,Northshore Power,***7625,,,False,False,REF-795464,First Continental Bank,***3844,Globex Consulting UK Ltd.,UK,5954960.54
2024-03-04,2024-03-04,Supplier Payment - Stelliform Parts BV #29,Supplier Payment,CEM-EMEA,12296.16,0.0,GBP,CHAPS,Stelliform Parts BV #29,***9090,,PO-202403-CEM-EMEA-0005,False,False,REF-443081,First Continental Bank,***2033,Globex Consulting UK Ltd.,UK,5942664.38
2024-03-04,2024-03-04,Client Receipt - Vertex Advisory Client #20,Sales Receipt,PS-GL,0.0,19473.0,GBP,CHAPS Credit,Vertex Advisory Client #20,***7127,INV-202403-PS-GL-0007,,False,False,REF-549593,First Continental Bank,***6037,Globex Consulting UK Ltd.,UK,5962137.38
2024-03-05,2024-03-05,Supplier Payment - CodeCraft Contractors #14,Supplier Payment,SaaS-GL,4312.04,0.0,GBP,CHAPS,CodeCraft Contractors #14,***5417,,PO-202403-SaaS-GL-0012,False,False,REF-826080,First Continental Bank,***5791,Globex Consulting UK Ltd.,UK,5957825.34
2024-03-05,2024-03-05,Client Receipt - CloudBridge Co. #53,Sales Receipt,SaaS-GL,0.0,937.43,GBP,CHAPS Credit,CloudBridge Co. #53,***1553,INV-202403-SaaS-GL-0025,,False,False,REF-441262,First Continental Bank,***7618,Globex Consulting UK Ltd.,UK,5958762.77
2024-03-05,2024-03-05,Client Receipt - Vertex Advisory Client #45,Sales Receipt,PS-GL,0.0,2470.38,GBP,Faster Payments Credit,Vertex Advisory Client #45,***1334,INV-202403-PS-GL-0008,,False,False,REF-150756,First Continental Bank,***8952,Globex Consulting UK Ltd.,UK,5961233.15
2024-03-05,2024-03-05,Client Receipt - Vertex Advisory Client #23,Sales Receipt,PS-GL,0.0,3111.84,GBP,Faster Payments Credit,Vertex Advisory Client #23,***7272,INV-202403-PS-GL-0005,,False,False,REF-384395,First Continental Bank,***4641,Globex Consulting UK Ltd.,UK,5964344.99
2024-03-05,2024-03-05,Client Receipt - CloudBridge Co. #55,Sales Receipt,SaaS-GL,0.0,6329.39,GBP,CHAPS Credit,CloudBridge Co. #55,***6121,INV-202403-SaaS-GL-0021,,False,False,REF-177351,First Continental Bank,***9001,Globex Consulting UK Ltd.,UK,5970674.38
2024-03-06,2024-03-06,Supplier Payment - ExpertNet Subcontractors #5,Supplier Payment,PS-GL,11077.99,0.0,GBP,CHAPS,ExpertNet Subcontractors #5,***7130,,PO-202403-PS-GL-0004,False,False,REF-226134,First Continental Bank,***8660,Globex Consulting UK Ltd.,UK,5959596.39
2024-03-06,2024-03-06,Client Receipt - CloudBridge Co. #1,Sales Receipt,SaaS-GL,0.0,2817.8,GBP,Faster Payments Credit,CloudBridge Co. #1,***8761,INV-202403-SaaS-GL-0020,,False,False,REF-637307,First Continental Bank,***7648,Globex Consulting UK Ltd.,UK,5962414.19
2024-03-06,2024-03-06,Client Receipt - CloudBridge Co. #14,Sales Receipt,SaaS-GL,0.0,3657.09,GBP,Faster Payments Credit,CloudBridge Co. #14,***7102,INV-202403-SaaS-GL-0003,,False,False,REF-145994,First Continental Bank,***4707,Globex Consulting UK Ltd.,UK,5966071.28
2024-03-07,2024-03-07,Client Receipt - CloudBridge Co. #17,Sales Receipt,SaaS-GL,0.0,3350.9,GBP,CHAPS Credit,CloudBridge Co. #17,***4869,INV-202403-SaaS-GL-0016,,False,False,REF-787744,First Continental Bank,***3584,Globex Consulting UK Ltd.,UK,5969422.18
2024-03-07,2024-03-07,Client Receipt - CloudBridge Co. #22,Sales Receipt,SaaS-GL,0.0,4527.28,GBP,CHAPS Credit,CloudBridge Co. #22,***3375,INV-202403-SaaS-GL-0012,,False,False,REF-897146,First Continental Bank,***3783,Globex Consulting UK Ltd.,UK,5973949.46
2024-03-08,2024-03-08,Supplier Payment - CodeCraft Contractors #11,Supplier Payment,SaaS-GL,1570.1,0.0,GBP,CHAPS,CodeCraft Contractors #11,***8166,,PO-202403-SaaS-GL-0007,False,False,REF-368617,First Continental Bank,***8590,Globex Consulting UK Ltd.,UK,5972379.36
2024-03-09,2024-03-09,Client Receipt - CloudBridge Co. #29,Sales Receipt,SaaS-GL,0.0,4611.47,GBP,CHAPS Credit,CloudBridge Co. #29,***8248,INV-202403-SaaS-GL-0004,,False,False,REF-352777,First Continental Bank,***6753,Globex Consulting UK Ltd.,UK,5976990.83
2024-03-10,2024-03-10,Client Receipt - Novatek Components Ltd #2,Sales Receipt,CEM-EMEA,0.0,2456.78,GBP,CHAPS Credit,Novatek Components Ltd #2,***5019,INV-202403-CEM-EMEA-0009,,False,False,REF-960131,First Continental Bank,***5777,Globex Consulting UK Ltd.,UK,5979447.61
2024-03-11,2024-03-11,Supplier Payment - HyperCloud Infra #3,Supplier Payment,SaaS-GL,1057.24,0.0,GBP,Faster Payments,HyperCloud Infra #3,***1602,,PO-202403-SaaS-GL-0009,False,False,REF-187009,First Continental Bank,***3573,Globex Consulting UK Ltd.,UK,5978390.37
2024-03-11,2024-03-11,Supplier Payment - CodeCraft Contractors #12,Supplier Payment,SaaS-GL,9309.13,0.0,GBP,Faster Payments,CodeCraft Contractors #12,***6949,,PO-202403-SaaS-GL-0010,False,False,REF-956349,First Continental Bank,***9987,Globex Consulting UK Ltd.,UK,5969081.24
2024-03-11,2024-03-11,Client Receipt - Novatek Components Ltd #4,Sales Receipt,CEM-EMEA,0.0,3950.02,GBP,Faster Payments Credit,Novatek Components Ltd #4,***1602,INV-202403-CEM-EMEA-0010,,False,False,REF-808952,First Continental Bank,***7520,Globex Consulting UK Ltd.,UK,5973031.26
2024-03-11,2024-03-11,Client Receipt - CloudBridge Co. #74,Sales Receipt,SaaS-GL,0.0,6663.73,GBP,Faster Payments Credit,CloudBridge Co. #74,***4546,INV-202403-SaaS-GL-0024,,False,False,REF-780051,First Continental Bank,***1097,Globex Consulting UK Ltd.,UK,5979694.99
2024-03-11,2024-03-11,Client Receipt - CloudBridge Co. #5,Sales Receipt,SaaS-GL,0.0,11510.01,GBP,CHAPS Credit,CloudBridge Co. #5,***3349,INV-202403-SaaS-GL-0002,,False,False,REF-420624,First Continental Bank,***8104,Globex Consulting UK Ltd.,UK,5991205.0
2024-03-12,2024-03-12,Merchant Processing Fees,Bank/Merchant Fees,ALL,726.25,0.0,GBP,Faster Payments,First Continental Bank,***4035,,,False,False,REF-643256,First Continental Bank,***9361,Globex Consulting UK Ltd.,UK,5990478.75
2024-03-12,2024-03-12,Merchant Processing Fees,Bank/Merchant Fees,ALL,1122.49,0.0,GBP,Faster Payments,First Continental Bank,***7930,,,False,False,REF-485926,First Continental Bank,***6531,Globex Consulting UK Ltd.,UK,5989356.26
2024-03-12,2024-03-12,Supplier Payment - ExpertNet Subcontractors #14,Supplier Payment,PS-GL,1142.51,0.0,GBP,Faster Payments,ExpertNet Subcontractors #14,***2177,,PO-202403-PS-GL-0002,False,False,REF-268636,First Continental Bank,***5143,Globex Consulting UK Ltd.,UK,5988213.75
2024-03-12,2024-03-12,Supplier Payment - Stelliform Parts BV #28,Supplier Payment,CEM-EMEA,36663.9,0.0,GBP,Faster Payments,Stelliform Parts BV #28,***5332,,PO-202403-CEM-EMEA-0010,False,False,REF-171959,First Continental Bank,***8075,Globex Consulting UK Ltd.,UK,5951549.85
2024-03-12,2024-03-12,Intercompany Settlement - Globex Retail NA LLC,Intercompany Transfer,ALL,332905.0,0.0,GBP,Internal Transfer,Globex Retail NA LLC,***8076,,,True,True,REF-378997,First Continental Bank,***7714,Globex Consulting UK Ltd.,UK,5618644.85
2024-03-12,2024-03-12,Client Receipt - CloudBridge Co. #10,Sales Receipt,SaaS-GL,0.0,4901.32,GBP,Faster Payments Credit,CloudBridge Co. #10,***1801,INV-202403-SaaS-GL-0001,,False,False,REF-375969,First Continental Bank,***4588,Globex Consulting UK Ltd.,UK,5623546.17
2024-03-12,2024-03-12,Client Receipt - Novatek Components Ltd #5,Sales Receipt,CEM-EMEA,0.0,12220.96,GBP,CHAPS Credit,Novatek Components Ltd #5,***7364,INV-202403-CEM-EMEA-0003,,False,False,REF-597952,First Continental Bank,***7166,Globex Consulting UK Ltd.,UK,5635767.13
2024-03-12,2024-03-12,Client Receipt - Vertex Advisory Client #6,Sales Receipt,PS-GL,0.0,24898.19,GBP,CHAPS Credit,Vertex Advisory Client #6,***1255,INV-202403-PS-GL-0001,,False,False,REF-341798,First Continental Bank,***8265,Globex Consulting UK Ltd.,UK,5660665.32
2024-03-13,2024-03-13,Supplier Payment - Stelliform Parts BV #15,Supplier Payment,CEM-EMEA,7861.82,0.0,GBP,CHAPS,Stelliform Parts BV #15,***3365,,PO-202403-CEM-EMEA-0007,False,False,REF-993470,First Continental Bank,***3761,Globex Consulting UK Ltd.,UK,5652803.5
2024-03-13,2024-03-13,Client Receipt - CloudBridge Co. #49,Sales Receipt,SaaS-GL,0.0,2163.4,GBP,CHAPS Credit,CloudBridge Co. #49,***5041,INV-202403-SaaS-GL-0023,,False,False,REF-501668,First Continental Bank,***7842,Globex Consulting UK Ltd.,UK,5654966.9
2024-03-13,2024-03-13,Client Receipt - Aurora Electronics GmbH #3,Sales Receipt,CEM-EMEA,0.0,12044.83,GBP,Faster Payments Credit,Aurora Electronics GmbH #3,***4317,INV-202403-CEM-EMEA-0008,,False,False,REF-267432,First Continental Bank,***4090,Globex Consulting UK Ltd.,UK,5667011.73
2024-03-13,2024-03-13,Client Receipt - Aurora Electronics GmbH #2,Sales Receipt,CEM-EMEA,0.0,16605.93,GBP,Faster Payments Credit,Aurora Electronics GmbH #2,***4715,INV-202403-CEM-EMEA-0013,,False,False,REF-670819,First Continental Bank,***3462,Globex Consulting UK Ltd.,UK,5683617.66
2024-03-13,2024-03-13,Client Receipt - Aurora Electronics GmbH #5,Sales Receipt,CEM-EMEA,0.0,28175.94,GBP,CHAPS Credit,Aurora Electronics GmbH #5,***3917,INV-202403-CEM-EMEA-0007,,False,False,REF-802995,First Continental Bank,***3131,Globex Consulting UK Ltd.,UK,5711793.6
2024-03-14,2024-03-14,Supplier Payment - ExpertNet Subcontractors #10,Supplier Payment,PS-GL,612.82,0.0,GBP,CHAPS,ExpertNet Subcontractors #10,***5243,,PO-202403-PS-GL-0007,False,False,REF-616850,First Continental Bank,***7207,Globex Consulting UK Ltd.,UK,5711180.78
2024-03-14,2024-03-14,Client Receipt - CloudBridge Co. #71,Sales Receipt,SaaS-GL,0.0,747.62,GBP,Faster Payments Credit,CloudBridge Co. #71,***3840,INV-202403-SaaS-GL-0006,,False,False,REF-541008,First Continental Bank,***3804,Globex Consulting UK Ltd.,UK,5711928.4
2024-03-14,2024-03-14,Client Receipt - CloudBridge Co. #2,Sales Receipt,SaaS-GL,0.0,1188.62,GBP,CHAPS Credit,CloudBridge Co. #2,***4498,INV-202403-SaaS-GL-0005,,False,False,REF-900968,First Continental Bank,***1723,Globex Consulting UK Ltd.,UK,5713117.02
2024-03-14,2024-03-14,Client Receipt - CloudBridge Co. #55,Sales Receipt,SaaS-GL,0.0,1296.27,GBP,Faster Payments Credit,CloudBridge Co. #55,***6318,INV-202403-SaaS-GL-0032,,False,False,REF-254455,First Continental Bank,***5768,Globex Consulting UK Ltd.,UK,5714413.29
2024-03-14,2024-03-14,Client Receipt - Aurora Electronics GmbH #16,Sales Receipt,CEM-EMEA,0.0,5324.76,GBP,CHAPS Credit,Aurora Electronics GmbH #16,***2260,INV-202403-CEM-EMEA-0006,,False,False,REF-257172,First Continental Bank,***1473,Globex Consulting UK Ltd.,UK,5719738.05
2024-03-15,2024-03-15,Client Receipt - CloudBridge Co. #29,Sales Receipt,SaaS-GL,0.0,3664.77,GBP,Faster Payments Credit,CloudBridge Co. #29,***2387,INV-202403-SaaS-GL-0015,,False,False,REF-430327,First Continental Bank,***5829,Globex Consulting UK Ltd.,UK,5723402.82
2024-03-16,2024-03-16,Supplier Payment - CodeCraft Contractors #11,Supplier Payment,SaaS-GL,5342.74,0.0,GBP,Faster Payments,CodeCraft Contractors #11,***9337,,PO-202403-SaaS-GL-0001,False,False,REF-473343,First Continental Bank,***3220,Globex Consulting UK Ltd.,UK,5718060.08
2024-03-16,2024-03-16,Client Receipt - Vertex Advisory Client #2,Sales Receipt,PS-GL,0.0,13366.89,GBP,Faster Payments Credit,Vertex Advisory Client #2,***9935,INV-202403-PS-GL-0006,,False,False,REF-343898,First Continental Bank,***2685,Globex Consulting UK Ltd.,UK,5731426.97
2024-03-17,2024-03-17,Client Receipt - CloudBridge Co. #36,Sales Receipt,SaaS-GL,0.0,4599.23,GBP,CHAPS Credit,CloudBridge Co. #36,***1014,INV-202403-SaaS-GL-0030,,False,False,REF-145689,First Continental Bank,***1652,Globex Consulting UK Ltd.,UK,5736026.2
2024-03-18,2024-03-18,Supplier Payment - CodeCraft Contractors #3,Supplier Payment,SaaS-GL,1308.57,0.0,GBP,CHAPS,CodeCraft Contractors #3,***3010,,PO-202403-SaaS-GL-0005,False,False,REF-509275,First Continental Bank,***1865,Globex Consulting UK Ltd.,UK,5734717.63
2024-03-18,2024-03-18,Supplier Payment - CodeCraft Contractors #8,Supplier Payment,SaaS-GL,2629.67,0.0,GBP,CHAPS,CodeCraft Contractors #8,***9741,,PO-202403-SaaS-GL-0011,False,False,REF-501123,First Continental Bank,***6815,Globex Consulting UK Ltd.,UK,5732087.96
2024-03-18,2024-03-18,Supplier Payment - EuroFab Assembly #21,Supplier Payment,CEM-EMEA,10712.2,0.0,GBP,Faster Payments,EuroFab Assembly #21,***2463,,PO-202403-CEM-EMEA-0009,False,False,REF-201787,First Continental Bank,***4575,Globex Consulting UK Ltd.,UK,5721375.76
2024-03-18,2024-03-18,VAT/GST Remittance - HMRC UK,Tax Payment,ALL,37580.87,0.0,GBP,SWIFT MT103,HMRC UK,***3256,,,False,False,REF-150392,First Continental Bank,***3429,Globex Consulting UK Ltd.,UK,5683794.89
2024-03-18,2024-03-18,Client Receipt - CloudBridge Co. #39,Sales Receipt,SaaS-GL,0.0,800.31,GBP,CHAPS Credit,CloudBridge Co. #39,***2430,INV-202403-SaaS-GL-0019,,False,False,REF-934022,First Continental Bank,***9517,Globex Consulting UK Ltd.,UK,5684595.2
2024-03-18,2024-03-18,Client Receipt - Novatek Components Ltd #3,Sales Receipt,CEM-EMEA,0.0,29076.44,GBP,CHAPS Credit,Novatek Components Ltd #3,***2514,INV-202403-CEM-EMEA-0012,,False,False,REF-773699,First Continental Bank,***9748,Globex Consulting UK Ltd.,UK,5713671.64
2024-03-19,2024-03-19,Supplier Payment - ExpertNet Subcontractors #6,Supplier Payment,PS-GL,1178.71,0.0,GBP,Faster Payments,ExpertNet Subcontractors #6,***2880,,PO-202403-PS-GL-0003,False,False,REF-721183,First Continental Bank,***4494,Globex Consulting UK Ltd.,UK,5712492.93
2024-03-19,2024-03-19,Supplier Payment - Stelliform Parts BV #21,Supplier Payment,CEM-EMEA,16256.87,0.0,GBP,CHAPS,Stelliform Parts BV #21,***5181,,PO-202403-CEM-EMEA-0001,False,False,REF-747155,First Continental Bank,***9067,Globex Consulting UK Ltd.,UK,5696236.06
2024-03-19,2024-03-19,Client Receipt - CloudBridge Co. #37,Sales Receipt,SaaS-GL,0.0,1326.41,GBP,Faster Payments Credit,CloudBridge Co. #37,***5768,INV-202403-SaaS-GL-0008,,False,False,REF-739944,First Continental Bank,***7756,Globex Consulting UK Ltd.,UK,5697562.47
2024-03-19,2024-03-19,Client Receipt - CloudBridge Co. #43,Sales Receipt,SaaS-GL,0.0,1616.7,GBP,CHAPS Credit,CloudBridge Co. #43,***4330,INV-202403-SaaS-GL-0018,,False,False,REF-838440,First Continental Bank,***2977,Globex Consulting UK Ltd.,UK,5699179.17
2024-03-19,2024-03-19,Client Receipt - CloudBridge Co. #27,Sales Receipt,SaaS-GL,0.0,3606.88,GBP,CHAPS Credit,CloudBridge Co. #27,***4891,INV-202403-SaaS-GL-0022,,False,False,REF-623911,First Continental Bank,***8957,Globex Consulting UK Ltd.,UK,5702786.05
2024-03-19,2024-03-19,Client Receipt - CloudBridge Co. #10,Sales Receipt,SaaS-GL,0.0,5872.59,GBP,CHAPS Credit,CloudBridge Co. #10,***5299,INV-202403-SaaS-GL-0013,,False,False,REF-622441,First Continental Bank,***1164,Globex Consulting UK Ltd.,UK,5708658.64
2024-03-20,2024-03-20,Client Receipt - CloudBridge Co. #68,Sales Receipt,SaaS-GL,0.0,759.36,GBP,CHAPS Credit,CloudBridge Co. #68,***7078,INV-202403-SaaS-GL-0007,,False,False,REF-219776,First Continental Bank,***3106,Globex Consulting UK Ltd.,UK,5709418.0
2024-03-20,2024-03-20,Client Receipt - Aurora Electronics GmbH #13,Sales Receipt,CEM-EMEA,0.0,1156.72,GBP,Faster Payments Credit,Aurora Electronics GmbH #13,***7951,INV-202403-CEM-EMEA-0011,,False,False,REF-469488,First Continental Bank,***6738,Globex Consulting UK Ltd.,UK,5710574.72
2024-03-20,2024-03-20,Client Receipt - CloudBridge Co. #33,Sales Receipt,SaaS-GL,0.0,3976.7,GBP,Faster Payments Credit,CloudBridge Co. #33,***6349,INV-202403-SaaS-GL-0028,,False,False,REF-443989,First Continental Bank,***8158,Globex Consulting UK Ltd.,UK,5714551.42
2024-03-20,2024-03-20,Client Receipt - Novatek Components Ltd #14,Sales Receipt,CEM-EMEA,0.0,4347.01,GBP,CHAPS Credit,Novatek Components Ltd #14,***7174,INV-202403-CEM-EMEA-0001,,False,False,REF-168762,First Continental Bank,***3324,Globex Consulting UK Ltd.,UK,5718898.43
2024-03-20,2024-03-20,Client Receipt - CloudBridge Co. #9,Sales Receipt,SaaS-GL,0.0,4841.04,GBP,Faster Payments Credit,CloudBridge Co. #9,***7567,INV-202403-SaaS-GL-0034,,False,False,REF-414211,First Continental Bank,***6311,Globex Consulting UK Ltd.,UK,5723739.47
2024-03-20,2024-03-20,Client Receipt - CloudBridge Co. #55,Sales Receipt,SaaS-GL,0.0,13736.72,GBP,CHAPS Credit,CloudBridge Co. #55,***9072,INV-202403-SaaS-GL-0010,,False,False,REF-768747,First Continental Bank,***4866,Globex Consulting UK Ltd.,UK,5737476.19
2024-03-20,2024-03-20,Client Receipt - CloudBridge Co. #37,Sales Receipt,SaaS-GL,0.0,21422.75,GBP,Faster Payments Credit,CloudBridge Co. #37,***6057,INV-202403-SaaS-GL-0029,,False,False,REF-232419,First Continental Bank,***6394,Globex Consulting UK Ltd.,UK,5758898.94
2024-03-20,2024-03-20,Client Receipt - Novatek Components Ltd #14,Sales Receipt,CEM-EMEA,0.0,30633.84,GBP,CHAPS Credit,Novatek Components Ltd #14,***6169,INV-202403-CEM-EMEA-0002,,False,False,REF-119181,First Continental Bank,***5118,Globex Consulting UK Ltd.,UK,5789532.78
2024-03-21,2024-03-21,Marketing - Aurelia Media #7,Marketing,ALL,2730.1,0.0,GBP,Faster Payments,Aurelia Media #7,***7422,,,False,False,REF-219496,First Continental Bank,***7781,Globex Consulting UK Ltd.,UK,5786802.68
2024-03-21,2024-03-21,Supplier Payment - HyperCloud Infra #17,Supplier Payment,SaaS-GL,9570.73,0.0,GBP,CHAPS,HyperCloud Infra #17,***5892,,PO-202403-SaaS-GL-0004,False,False,REF-806536,First Continental Bank,***1276,Globex Consulting UK Ltd.,UK,5777231.95
2024-03-21,2024-03-21,Client Receipt - Aurora Electronics GmbH #9,Sales Receipt,CEM-EMEA,0.0,20245.05,GBP,Faster Payments Credit,Aurora Electronics GmbH #9,***4078,INV-202403-CEM-EMEA-0016,,False,False,REF-638487,First Continental Bank,***3981,Globex Consulting UK Ltd.,UK,5797477.0
2024-03-22,2024-03-22,Supplier Payment - Stelliform Parts BV #24,Supplier Payment,CEM-EMEA,32813.86,0.0,GBP,Faster Payments,Stelliform Parts BV #24,***7839,,PO-202403-CEM-EMEA-0006,False,False,REF-278579,First Continental Bank,***8907,Globex Consulting UK Ltd.,UK,5764663.14
2024-03-22,2024-03-22,Client Receipt - Novatek Components Ltd #6,Sales Receipt,CEM-EMEA,0.0,23253.42,GBP,CHAPS Credit,Novatek Components Ltd #6,***8043,INV-202403-CEM-EMEA-0014,,False,False,REF-807315,First Continental Bank,***7654,Globex Consulting UK Ltd.,UK,5787916.56
2024-03-24,2024-03-24,Supplier Payment - ExpertNet Subcontractors #15,Supplier Payment,PS-GL,3441.46,0.0,GBP,Faster Payments,ExpertNet Subcontractors #15,***2182,,PO-202403-PS-GL-0005,False,False,REF-221377,First Continental Bank,***1897,Globex Consulting UK Ltd.,UK,5784475.1
2024-03-25,2024-03-25,BluePeak Property Mgmt,Rent & Utilities,ALL,3822.16,0.0,GBP,Faster Payments,BluePeak Property Mgmt,***7520,,,False,False,REF-923606,First Continental Bank,***6923,Globex Consulting UK Ltd.,UK,5780652.94
2024-03-25,2024-03-25,Supplier Payment - ExpertNet Subcontractors #15,Supplier Payment,PS-GL,6164.64,0.0,GBP,CHAPS,ExpertNet Subcontractors #15,***9416,,PO-202403-PS-GL-0009,False,False,REF-973290,First Continental Bank,***2054,Globex Consulting UK Ltd.,UK,5774488.3
2024-03-25,2024-03-25,Supplier Payment - EuroFab Assembly #3,Supplier Payment,CEM-EMEA,25472.68,0.0,GBP,Faster Payments,EuroFab Assembly #3,***8374,,PO-202403-CEM-EMEA-0002,False,False,REF-682549,First Continental Bank,***4240,Globex Consulting UK Ltd.,UK,5749015.62
2024-03-25,2024-03-25,Client Receipt - CloudBridge Co. #75,Sales Receipt,SaaS-GL,0.0,1435.97,GBP,CHAPS Credit,CloudBridge Co. #75,***7305,INV-202403-SaaS-GL-0031,,False,False,REF-545398,First Continental Bank,***1113,Globex Consulting UK Ltd.,UK,5750451.59
2024-03-25,2024-03-25,Client Receipt - CloudBridge Co. #13,Sales Receipt,SaaS-GL,0.0,2061.97,GBP,CHAPS Credit,CloudBridge Co. #13,***4589,INV-202403-SaaS-GL-0026,,False,False,REF-540184,First Continental Bank,***1234,Globex Consulting UK Ltd.,UK,5752513.56
2024-03-26,2024-03-26,Supplier Payment - CodeCraft Contractors #2,Supplier Payment,SaaS-GL,1930.42,0.0,GBP,CHAPS,CodeCraft Contractors #2,***4906,,PO-202403-SaaS-GL-0006,False,False,REF-540312,First Continental Bank,***1731,Globex Consulting UK Ltd.,UK,5750583.14
2024-03-26,2024-03-26,Supplier Payment - ExpertNet Subcontractors #15,Supplier Payment,PS-GL,7363.33,0.0,GBP,Faster Payments,ExpertNet Subcontractors #15,***8399,,PO-202403-PS-GL-0010,False,False,REF-196716,First Continental Bank,***8301,Globex Consulting UK Ltd.,UK,5743219.81
2024-03-26,2024-03-26,Payroll - GlobalPay Services Ltd,Payroll,ALL,49648.65,0.0,GBP,CHAPS,GlobalPay Services Ltd,***3698,,,False,False,REF-783630,First Continental Bank,***3570,Globex Consulting UK Ltd.,UK,5693571.16
2024-03-26,2024-03-26,"Intercompany Settlement - Globex International Holdings, Inc.",Intercompany Transfer,ALL,740440.0,0.0,GBP,Internal Transfer,"Globex International Holdings, Inc.",***6687,,,True,True,REF-199768,First Continental Bank,***3056,Globex Consulting UK Ltd.,UK,4953131.16
2024-03-26,2024-03-26,Client Receipt - CloudBridge Co. #37,Sales Receipt,SaaS-GL,0.0,9742.07,GBP,Faster Payments Credit,CloudBridge Co. #37,***1618,INV-202403-SaaS-GL-0014,,False,False,REF-668172,First Continental Bank,***2671,Globex Consulting UK Ltd.,UK,4962873.23
2024-03-27,2024-03-27,Supplier Payment - HyperCloud Infra #5,Supplier Payment,SaaS-GL,49.78,0.0,GBP,Faster Payments,HyperCloud Infra #5,***8623,,PO-202403-SaaS-GL-0008,False,False,REF-365375,First Continental Bank,***3547,Globex Consulting UK Ltd.,UK,4962823.45
2024-03-27,2024-03-27,Supplier Payment - ExpertNet Subcontractors #14,Supplier Payment,PS-GL,2105.24,0.0,GBP,CHAPS,ExpertNet Subcontractors #14,***2019,,PO-202403-PS-GL-0001,False,False,REF-289609,First Continental Bank,***5220,Globex Consulting UK Ltd.,UK,4960718.21
2024-03-27,2024-03-27,Marketing - Aurelia Media #5,Marketing,ALL,3438.94,0.0,GBP,CHAPS,Aurelia Media #5,***4482,,,False,False,REF-598483,First Continental Bank,***5634,Globex Consulting UK Ltd.,UK,4957279.27
2024-03-27,2024-03-27,Supplier Payment - CodeCraft Contractors #3,Supplier Payment,SaaS-GL,4237.88,0.0,GBP,CHAPS,CodeCraft Contractors #3,***7731,,PO-202403-SaaS-GL-0003,False,False,REF-815472,First Continental Bank,***6571,Globex Consulting UK Ltd.,UK,4953041.39
2024-03-27,2024-03-27,Client Receipt - Vertex Advisory Client #19,Sales Receipt,PS-GL,0.0,1025.42,GBP,CHAPS Credit,Vertex Advisory Client #19,***3406,INV-202403-PS-GL-0004,,False,False,REF-970024,First Continental Bank,***6025,Globex Consulting UK Ltd.,UK,4954066.81
2024-03-27,2024-03-27,Client Receipt - Aurora Electronics GmbH #10,Sales Receipt,CEM-EMEA,0.0,11156.22,GBP,Faster Payments Credit,Aurora Electronics GmbH #10,***8534,INV-202403-CEM-EMEA-0004,,False,False,REF-692685,First Continental Bank,***2396,Globex Consulting UK Ltd.,UK,4965223.03
2024-03-27,2024-03-27,Client Receipt - Novatek Components Ltd #3,Sales Receipt,CEM-EMEA,0.0,34212.39,GBP,CHAPS Credit,Novatek Components Ltd #3,***2014,INV-202403-CEM-EMEA-0005,,False,False,REF-546706,First Continental Bank,***9522,Globex Consulting UK Ltd.,UK,4999435.42
2024-03-28,2024-03-28,Supplier Payment - ExpertNet Subcontractors #12,Supplier Payment,PS-GL,2176.9,0.0,GBP,Faster Payments,ExpertNet Subcontractors #12,***4739,,PO-202403-PS-GL-0006,False,False,REF-724291,First Continental Bank,***5011,Globex Consulting UK Ltd.,UK,4997258.52
2024-03-28,2024-03-28,Supplier Payment - ExpertNet Subcontractors #16,Supplier Payment,PS-GL,2379.74,0.0,GBP,CHAPS,ExpertNet Subcontractors #16,***6441,,PO-202403-PS-GL-0008,False,False,REF-563708,First Continental Bank,***7755,Globex Consulting UK Ltd.,UK,4994878.78
2024-03-28,2024-03-28,Client Receipt - Vertex Advisory Client #47,Sales Receipt,PS-GL,0.0,7129.08,GBP,Faster Payments Credit,Vertex Advisory Client #47,***6245,INV-202403-PS-GL-0003,,False,False,REF-749880,First Continental Bank,***1009,Globex Consulting UK Ltd.,UK,5002007.86
2024-03-28,2024-03-28,Client Receipt - Novatek Components Ltd #8,Sales Receipt,CEM-EMEA,0.0,63429.57,GBP,CHAPS Credit,Novatek Components Ltd #8,***1949,INV-202403-CEM-EMEA-0015,,False,False,REF-410777,First Continental Bank,***8666,Globex Consulting UK Ltd.,UK,5065437.43
2024-03-29,2024-03-29,Supplier Payment - Stelliform Parts BV #18,Supplier Payment,CEM-EMEA,15060.74,0.0,GBP,Faster Payments,Stelliform Parts BV #18,***9187,,PO-202403-CEM-EMEA-0008,False,False,REF-209669,First Continental Bank,***7596,Globex Consulting UK Ltd.,UK,5050376.69
2024-03-29,2024-03-29,Client Receipt - CloudBridge Co. #2,Sales Receipt,SaaS-GL,0.0,378.8,GBP,Faster Payments Credit,CloudBridge Co. #2,***5719,INV-202403-SaaS-GL-0033,,False,False,REF-425081,First Continental Bank,***7752,Globex Consulting UK Ltd.,UK,5050755.49
2024-03-29,2024-03-29,Client Receipt - CloudBridge Co. #36,Sales Receipt,SaaS-GL,0.0,1377.17,GBP,CHAPS Credit,CloudBridge Co. #36,***7039,INV-202403-SaaS-GL-0027,,False,False,REF-227121,First Continental Bank,***4592,Globex Consulting UK Ltd.,UK,5052132.66
2024-03-29,2024-03-29,Client Receipt - CloudBridge Co. #1,Sales Receipt,SaaS-GL,0.0,9785.58,GBP,Faster Payments Credit,CloudBridge Co. #1,***3627,INV-202403-SaaS-GL-0017,,False,False,REF-389909,First Continental Bank,***7578,Globex Consulting UK Ltd.,UK,5061918.24
2024-03-29,2024-03-29,Client Receipt - Vertex Advisory Client #25,Sales Receipt,PS-GL,0.0,56363.72,GBP,CHAPS Credit,Vertex Advisory Client #25,***4399,INV-202403-PS-GL-0002,,False,False,REF-959899,First Continental Bank,***1863,Globex Consulting UK Ltd.,UK,5118281.96
2024-03-30,2024-03-30,Marketing - Beacon Digital #5,Marketing,ALL,9543.64,0.0,GBP,CHAPS,Beacon Digital #5,***1131,,,False,False,REF-813230,First Continental Bank,***5335,Globex Consulting UK Ltd.,UK,5108738.32
2024-03-30,2024-03-30,Payroll - GlobalPay Services Ltd,Payroll,ALL,49648.65,0.0,GBP,CHAPS,GlobalPay Services Ltd,***5844,,,False,False,REF-944281,First Continental Bank,***1152,Globex Consulting UK Ltd.,UK,5059089.67
2024-03-30,2024-03-30,Interest Earned,Interest Income,ALL,0.0,10420.55,GBP,CHAPS Credit,First Continental Bank,***9336,,,False,False,REF-875978,First Continental Bank,***5043,Globex Consulting UK Ltd.,UK,5069510.22
2024-03-31,2024-03-31,Supplier Payment - EuroFab Assembly #12,Supplier Payment,CEM-EMEA,3577.12,0.0,GBP,CHAPS,EuroFab Assembly #12,***4064,,PO-202403-CEM-EMEA-0003,False,False,REF-762750,First Continental Bank,***6685,Globex Consulting UK Ltd.,UK,5065933.1
2024-04-01,2024-04-01,Account Maintenance Fee,Bank/Merchant Fees,ALL,2500.0,0.0,GBP,Faster Payments,First Continental Bank,***1136,,,False,False,REF-378649,First Continental Bank,***7905,Globex Consulting UK Ltd.,UK,5063433.1
2024-04-01,2024-04-01,Client Receipt - Vertex Advisory Client #11,Sales Receipt,PS-GL,0.0,6598.11,GBP,CHAPS Credit,Vertex Advisory Client #11,***6789,INV-202404-PS-GL-0006,,False,False,REF-337913,First Continental Bank,***4134,Globex Consulting UK Ltd.,UK,5070031.21
2024-04-01,2024-04-01,Client Receipt - CloudBridge Co. #51,Sales Receipt,SaaS-GL,0.0,16380.07,GBP,Faster Payments Credit,CloudBridge Co. #51,***5701,INV-202404-SaaS-GL-0004,,False,False,REF-587267,First Continental Bank,***3598,Globex Consulting UK Ltd.,UK,5086411.28
2024-04-02,2024-04-02,Supplier Payment - ExpertNet Subcontractors #6,Supplier Payment,PS-GL,4324.63,0.0,GBP,Faster Payments,ExpertNet Subcontractors #6,***1889,,PO-202404-PS-GL-0008,False,False,REF-250405,First Continental Bank,***8205,Globex Consulting UK Ltd.,UK,5082086.65
2024-04-02,2024-04-02,Client Receipt - Vertex Advisory Client #8,Sales Receipt,PS-GL,0.0,7138.9,GBP,CHAPS Credit,Vertex Advisory Client #8,***1904,INV-202404-PS-GL-0009,,False,False,REF-319551,First Continental Bank,***3467,Globex Consulting UK Ltd.,UK,5089225.55
2024-04-02,2024-04-02,Client Receipt - CloudBridge Co. #67,Sales Receipt,SaaS-GL,0.0,8203.54,GBP,Faster Payments Credit,CloudBridge Co. #67,***5308,INV-202404-SaaS-GL-0012,,False,False,REF-169124,First Continental Bank,***3768,Globex Consulting UK Ltd.,UK,5097429.09
2024-04-02,2024-04-02,Client Receipt - CloudBridge Co. #70,Sales Receipt,SaaS-GL,0.0,11209.57,GBP,Faster Payments Credit,CloudBridge Co. #70,***5957,INV-202404-SaaS-GL-0015,,False,False,REF-725737,First Continental Bank,***7900,Globex Consulting UK Ltd.,UK,5108638.66
2024-04-02,2024-04-02,Client Receipt - Vertex Advisory Client #44,Sales Receipt,PS-GL,0.0,22715.17,GBP,CHAPS Credit,Vertex Advisory Client #44,***1132,INV-202404-PS-GL-0002,,False,False,REF-799185,First Continental Bank,***2351,Globex Consulting UK Ltd.,UK,5131353.83
2024-04-03,2024-04-03,Supplier Payment - HyperCloud Infra #1,Supplier Payment,SaaS-GL,7152.15,0.0,GBP,Faster Payments,HyperCloud Infra #1,***6650,,PO-202404-SaaS-GL-0003,False,False,REF-207103,First Continental Bank,***6959,Globex Consulting UK Ltd.,UK,5124201.68
2024-04-03,2024-04-03,Supplier Payment - Stelliform Parts BV #16,Supplier Payment,CEM-EMEA,8532.71,0.0,GBP,Faster Payments,Stelliform Parts BV #16,***9440,,PO-202404-CEM-EMEA-0004,False,False,REF-985547,First Continental Bank,***6133,Globex Consulting UK Ltd.,UK,5115668.97
2024-04-03,2024-04-03,Client Receipt - Aurora Electronics GmbH #5,Sales Receipt,CEM-EMEA,0.0,886.6,GBP,CHAPS Credit,Aurora Electronics GmbH #5,***4295,INV-202404-CEM-EMEA-0013,,False,False,REF-830212,First Continental Bank,***1170,Globex Consulting UK Ltd.,UK,5116555.57
2024-04-03,2024-04-03,Client Receipt - Aurora Electronics GmbH #14,Sales Receipt,CEM-EMEA,0.0,6921.37,GBP,Faster Payments Credit,Aurora Electronics GmbH #14,***9139,INV-202404-CEM-EMEA-0012,,False,False,REF-862424,First Continental Bank,***6803,Globex Consulting UK Ltd.,UK,5123476.94
2024-04-03,2024-04-03,Client Receipt - Vertex Advisory Client #24,Sales Receipt,PS-GL,0.0,11930.76,GBP,CHAPS Credit,Vertex Advisory Client #24,***9392,INV-202404-PS-GL-0007,,False,False,REF-210662,First Continental Bank,***5100,Globex Consulting UK Ltd.,UK,5135407.7
2024-04-04,2024-04-04,Client Receipt - CloudBridge Co. #23,Sales Receipt,SaaS-GL,0.0,6155.09,GBP,Faster Payments Credit,CloudBridge Co. #23,***7939,INV-202404-SaaS-GL-0022,,False,False,REF-826215,First Continental Bank,***3308,Globex Consulting UK Ltd.,UK,5141562.79
2024-04-04,2024-04-04,Client Receipt - CloudBridge Co. #78,Sales Receipt,SaaS-GL,0.0,13778.25,GBP,CHAPS Credit,CloudBridge Co. #78,***2259,INV-202404-SaaS-GL-0001,,False,False,REF-274387,First Continental Bank,***3490,Globex Consulting UK Ltd.,UK,5155341.04
2024-04-07,2024-04-07,Supplier Payment - Stelliform Parts BV #3,Supplier Payment,CEM-EMEA,10591.66,0.0,GBP,Faster Payments,Stelliform Parts BV #3,***2430,,PO-202404-CEM-EMEA-0009,False,False,REF-731560,First Continental Bank,***4539,Globex Consulting UK Ltd.,UK,5144749.38
2024-04-08,2024-04-08,Supplier Payment - CodeCraft Contractors #13,Supplier Payment,SaaS-GL,371.21,0.0,GBP,CHAPS,CodeCraft Contractors #13,***3814,,PO-202404-SaaS-GL-0010,False,False,REF-750918,First Continental Bank,***4391,Globex Consulting UK Ltd.,UK,5144378.17
2024-04-08,2024-04-08,Client Receipt - Novatek Components Ltd #12,Sales Receipt,CEM-EMEA,0.0,6281.75,GBP,CHAPS Credit,Novatek Components Ltd #12,***4435,INV-202404-CEM-EMEA-0001,,False,False,REF-715500,First Continental Bank,***8946,Globex Consulting UK Ltd.,UK,5150659.92
2024-04-08,2024-04-08,Client Receipt - CloudBridge Co. #20,Sales Receipt,SaaS-GL,0.0,7610.35,GBP,CHAPS Credit,CloudBridge Co. #20,***2697,INV-202404-SaaS-GL-0017,,False,False,REF-506937,First Continental Bank,***9522,Globex Consulting UK Ltd.,UK,5158270.27
2024-04-09,2024-04-09,Supplier Payment - Stelliform Parts BV #9,Supplier Payment,CEM-EMEA,16246.43,0.0,GBP,CHAPS,Stelliform Parts BV #9,***7976,,PO-202404-CEM-EMEA-0007,False,False,REF-808852,First Continental Bank,***1279,Globex Consulting UK Ltd.,UK,5142023.84
2024-04-09,2024-04-09,Client Receipt - CloudBridge Co. #64,Sales Receipt,SaaS-GL,0.0,9931.4,GBP,CHAPS Credit,CloudBridge Co. #64,***3408,INV-202404-SaaS-GL-0011,,False,False,REF-452331,First Continental Bank,***8092,Globex Consulting UK Ltd.,UK,5151955.24
2024-04-10,2024-04-10,Supplier Payment - ExpertNet Subcontractors #3,Supplier Payment,PS-GL,1983.27,0.0,GBP,CHAPS,ExpertNet Subcontractors #3,***4244,,PO-202404-PS-GL-0006,False,False,REF-594166,First Continental Bank,***1135,Globex Consulting UK Ltd.,UK,5149971.97
2024-04-10,2024-04-10,Supplier Payment - ExpertNet Subcontractors #10,Supplier Payment,PS-GL,2329.47,0.0,GBP,CHAPS,ExpertNet Subcontractors #10,***8855,,PO-202404-PS-GL-0004,False,False,REF-640367,First Continental Bank,***1449,Globex Consulting UK Ltd.,UK,5147642.5
2024-04-10,2024-04-10,Supplier Payment - CodeCraft Contractors #7,Supplier Payment,SaaS-GL,4403.03,0.0,GBP,Faster Payments,CodeCraft Contractors #7,***5457,,PO-202404-SaaS-GL-0005,False,False,REF-925139,First Continental Bank,***5880,Globex Consulting UK Ltd.,UK,5143239.47
2024-04-10,2024-04-10,Client Receipt - Aurora Electronics GmbH #17,Sales Receipt,CEM-EMEA,0.0,1059.87,GBP,CHAPS Credit,Aurora Electronics GmbH #17,***8453,INV-202404-CEM-EMEA-0018,,False,False,REF-428852,First Continental Bank,***6878,Globex Consulting UK Ltd.,UK,5144299.34
2024-04-10,2024-04-10,Client Receipt - Vertex Advisory Client #27,Sales Receipt,PS-GL,0.0,1630.47,GBP,Faster Payments Credit,Vertex Advisory Client #27,***5533,INV-202404-PS-GL-0011,,False,False,REF-494730,First Continental Bank,***8900,Globex Consulting UK Ltd.,UK,5145929.81
2024-04-10,2024-04-10,Client Receipt - CloudBridge Co. #72,Sales Receipt,SaaS-GL,0.0,10481.9,GBP,Faster Payments Credit,CloudBridge Co. #72,***1596,INV-202404-SaaS-GL-0002,,False,False,REF-606815,First Continental Bank,***1282,Globex Consulting UK Ltd.,UK,5156411.71
2024-04-11,2024-04-11,Merchant Processing Fees,Bank/Merchant Fees,ALL,1466.93,0.0,GBP,CHAPS,First Continental Bank,***2105,,,False,False,REF-453664,First Continental Bank,***4623,Globex Consulting UK Ltd.,UK,5154944.78
2024-04-11,2024-04-11,Client Receipt - Aurora Electronics GmbH #8,Sales Receipt,CEM-EMEA,0.0,36800.23,GBP,Faster Payments Credit,Aurora Electronics GmbH #8,***5200,INV-202404-CEM-EMEA-0007,,False,False,REF-552467,First Continental Bank,***5632,Globex Consulting UK Ltd.,UK,5191745.01
2024-04-12,2024-04-12,Merchant Processing Fees,Bank/Merchant Fees,ALL,501.13,0.0,GBP,CHAPS,First Continental Bank,***7738,,,False,False,REF-927241,First Continental Bank,***1507,Globex Consulting UK Ltd.,UK,5191243.88
2024-04-12,2024-04-12,Supplier Payment - HyperCloud Infra #12,Supplier Payment,SaaS-GL,6072.82,0.0,GBP,CHAPS,HyperCloud Infra #12,***2208,,PO-202404-SaaS-GL-0004,False,False,REF-506051,First Continental Bank,***5252,Globex Consulting UK Ltd.,UK,5185171.06
2024-04-12,2024-04-12,Marketing - Aurelia Media #3,Marketing,ALL,10504.48,0.0,GBP,CHAPS,Aurelia Media #3,***9293,,,False,False,REF-171375,First Continental Bank,***2765,Globex Consulting UK Ltd.,UK,5174666.58
2024-04-12,2024-04-12,Intercompany Settlement - Globex Retail NA LLC,Intercompany Transfer,ALL,326619.0,0.0,GBP,Internal Transfer,Globex Retail NA LLC,***1930,,,True,True,REF-882016,First Continental Bank,***9789,Globex Consulting UK Ltd.,UK,4848047.58
2024-04-12,2024-04-12,Client Receipt - CloudBridge Co. #9,Sales Receipt,SaaS-GL,0.0,8033.18,GBP,Faster Payments Credit,CloudBridge Co. #9,***2233,INV-202404-SaaS-GL-0018,,False,False,REF-268872,First Continental Bank,***8216,Globex Consulting UK Ltd.,UK,4856080.76
2024-04-12,2024-04-12,Client Receipt - CloudBridge Co. #11,Sales Receipt,SaaS-GL,0.0,14491.02,GBP,Faster Payments Credit,CloudBridge Co. #11,***3964,INV-202404-SaaS-GL-0008,,False,False,REF-548724,First Continental Bank,***2488,Globex Consulting UK Ltd.,UK,4870571.78
2024-04-12,2024-04-12,Intercompany Reimbursement - Globex Retail NA LLC,Intercompany Transfer,ALL,0.0,130647.6,GBP,Internal Transfer,Globex Retail NA LLC,***8723,,,True,True,REF-150237,First Continental Bank,***9714,Globex Consulting UK Ltd.,UK,5001219.38
2024-04-15,2024-04-15,Supplier Payment - ExpertNet Subcontractors #14,Supplier Payment,PS-GL,2418.5,0.0,GBP,CHAPS,ExpertNet Subcontractors #14,***2167,,PO-202404-PS-GL-0002,False,False,REF-741083,First Continental Bank,***7856,Globex Consulting UK Ltd.,UK,4998800.88
2024-04-15,2024-04-15,Supplier Payment - EuroFab Assembly #21,Supplier Payment,CEM-EMEA,5925.95,0.0,GBP,Faster Payments,EuroFab Assembly #21,***5929,,PO-202404-CEM-EMEA-0003,False,False,REF-538913,First Continental Bank,***1988,Globex Consulting UK Ltd.,UK,4992874.93
2024-04-15,2024-04-15,Client Receipt - Aurora Electronics GmbH #12,Sales Receipt,CEM-EMEA,0.0,8346.87,GBP,Faster Payments Credit,Aurora Electronics GmbH #12,***9960,INV-202404-CEM-EMEA-0017,,False,False,REF-668387,First Continental Bank,***5226,Globex Consulting UK Ltd.,UK,5001221.8
2024-04-15,2024-04-15,Client Receipt - Vertex Advisory Client #15,Sales Receipt,PS-GL,0.0,12211.22,GBP,Faster Payments Credit,Vertex Advisory Client #15,***1967,INV-202404-PS-GL-0004,,False,False,REF-948483,First Continental Bank,***3669,Globex Consulting UK Ltd.,UK,5013433.02
2024-04-15,2024-04-15,Client Receipt - Novatek Components Ltd #5,Sales Receipt,CEM-EMEA,0.0,16822.95,GBP,CHAPS Credit,Novatek Components Ltd #5,***7681,INV-202404-CEM-EMEA-0006,,False,False,REF-536552,First Continental Bank,***9165,Globex Consulting UK Ltd.,UK,5030255.97
2024-04-16,2024-04-16,Marketing - Aurelia Media #7,Marketing,ALL,6054.86,0.0,GBP,Faster Payments,Aurelia Media #7,***6814,,,False,False,REF-147160,First Continental Bank,***4672,Globex Consulting UK Ltd.,UK,5024201.11
2024-04-16,2024-04-16,Supplier Payment - EuroFab Assembly #16,Supplier Payment,CEM-EMEA,9487.99,0.0,GBP,CHAPS,EuroFab Assembly #16,***7836,,PO-202404-CEM-EMEA-0005,False,False,REF-539894,First Continental Bank,***3855,Globex Consulting UK Ltd.,UK,5014713.12
2024-04-16,2024-04-16,Client Receipt - Vertex Advisory Client #43,Sales Receipt,PS-GL,0.0,10499.22,GBP,Faster Payments Credit,Vertex Advisory Client #43,***8349,INV-202404-PS-GL-0003,,False,False,REF-103003,First Continental Bank,***6974,Globex Consulting UK Ltd.,UK,5025212.34
2024-04-16,2024-04-16,Client Receipt - Vertex Advisory Client #1,Sales Receipt,PS-GL,0.0,27598.76,GBP,Faster Payments Credit,Vertex Advisory Client #1,***3558,INV-202404-PS-GL-0012,,False,False,REF-954089,First Continental Bank,***3211,Globex Consulting UK Ltd.,UK,5052811.1
2024-04-17,2024-04-17,Supplier Payment - HyperCloud Infra #16,Supplier Payment,SaaS-GL,564.16,0.0,GBP,CHAPS,HyperCloud Infra #16,***2659,,PO-202404-SaaS-GL-0002,False,False,REF-293572,First Continental Bank,***3869,Globex Consulting UK Ltd.,UK,5052246.94
2024-04-17,2024-04-17,Supplier Payment - CodeCraft Contractors #8,Supplier Payment,SaaS-GL,1847.87,0.0,GBP,Faster Payments,CodeCraft Contractors #8,***7399,,PO-202404-SaaS-GL-0008,False,False,REF-585475,First Continental Bank,***1114,Globex Consulting UK Ltd.,UK,5050399.07
2024-04-17,2024-04-17,Supplier Payment - CodeCraft Contractors #4,Supplier Payment,SaaS-GL,5245.86,0.0,GBP,Faster Payments,CodeCraft Contractors #4,***9139,,PO-202404-SaaS-GL-0011,False,False,REF-974418,First Continental Bank,***9059,Globex Consulting UK Ltd.,UK,5045153.21
2024-04-17,2024-04-17,Client Receipt - CloudBridge Co. #71,Sales Receipt,SaaS-GL,0.0,4339.6,GBP,Faster Payments Credit,CloudBridge Co. #71,***8131,INV-202404-SaaS-GL-0023,,False,False,REF-489995,First Continental Bank,***2328,Globex Consulting UK Ltd.,UK,5049492.81
2024-04-17,2024-04-17,Client Receipt - CloudBridge Co. #69,Sales Receipt,SaaS-GL,0.0,26612.33,GBP,Faster Payments Credit,CloudBridge Co. #69,***3995,INV-202404-SaaS-GL-0010,,False,False,REF-654844,First Continental Bank,***6021,Globex Consulting UK Ltd.,UK,5076105.14
2024-04-18,2024-04-18,Supplier Payment - CodeCraft Contractors #8,Supplier Payment,SaaS-GL,286.86,0.0,GBP,CHAPS,CodeCraft Contractors #8,***5148,,PO-202404-SaaS-GL-0007,False,False,REF-901865,First Continental Bank,***9865,Globex Consulting UK Ltd.,UK,5075818.28
2024-04-18,2024-04-18,Client Receipt - CloudBridge Co. #20,Sales Receipt,SaaS-GL,0.0,14089.42,GBP,CHAPS Credit,CloudBridge Co. #20,***8266,INV-202404-SaaS-GL-0024,,False,False,REF-813965,First Continental Bank,***8045,Globex Consulting UK Ltd.,UK,5089907.7
2024-04-18,2024-04-18,Client Receipt - Vertex Advisory Client #11,Sales Receipt,PS-GL,0.0,20818.48,GBP,Faster Payments Credit,Vertex Advisory Client #11,***3433,INV-202404-PS-GL-0005,,False,False,REF-109759,First Continental Bank,***9880,Globex Consulting UK Ltd.,UK,5110726.18
2024-04-19,2024-04-19,Supplier Payment - EuroFab Assembly #10,Supplier Payment,CEM-EMEA,2489.89,0.0,GBP,Faster Payments,EuroFab Assembly #10,***7195,,PO-202404-CEM-EMEA-0010,False,False,REF-323037,First Continental Bank,***1426,Globex Consulting UK Ltd.,UK,5108236.29
2024-04-19,2024-04-19,VAT/GST Remittance - HMRC UK,Tax Payment,ALL,37539.91,0.0,GBP,SWIFT MT103,HMRC UK,***4699,,,False,False,REF-320245,First Continental Bank,***1617,Globex Consulting UK Ltd.,UK,5070696.38
2024-04-19,2024-04-19,Client Receipt - CloudBridge Co. #68,Sales Receipt,SaaS-GL,0.0,3306.24,GBP,Faster Payments Credit,CloudBridge Co. #68,***4637,INV-202404-SaaS-GL-0009,,False,False,REF-239598,First Continental Bank,***8846,Globex Consulting UK Ltd.,UK,5074002.62
2024-04-19,2024-04-19,Client Receipt - CloudBridge Co. #20,Sales Receipt,SaaS-GL,0.0,4997.7,GBP,CHAPS Credit,CloudBridge Co. #20,***4687,INV-202404-SaaS-GL-0020,,False,False,REF-745267,First Continental Bank,***1912,Globex Consulting UK Ltd.,UK,5079000.32
2024-04-19,2024-04-19,Client Receipt - Aurora Electronics GmbH #10,Sales Receipt,CEM-EMEA,0.0,12623.34,GBP,Faster Payments Credit,Aurora Electronics GmbH #10,***9816,INV-202404-CEM-EMEA-0014,,False,False,REF-519909,First Continental Bank,***6385,Globex Consulting UK Ltd.,UK,5091623.66
2024-04-19,2024-04-19,Client Receipt - Aurora Electronics GmbH #6,Sales Receipt,CEM-EMEA,0.0,19997.3,GBP,CHAPS Credit,Aurora Electronics GmbH #6,***7614,INV-202404-CEM-EMEA-0004,,False,False,REF-197981,First Continental Bank,***6662,Globex Consulting UK Ltd.,UK,5111620.96
2024-04-20,2024-04-20,Supplier Payment - ExpertNet Subcontractors #12,Supplier Payment,PS-GL,15298.96,0.0,GBP,CHAPS,ExpertNet Subcontractors #12,***6126,,PO-202404-PS-GL-0005,False,False,REF-352973,First Continental Bank,***6214,Globex Consulting UK Ltd.,UK,5096322.0
2024-04-21,2024-04-21,Client Receipt - Vertex Advisory Client #16,Sales Receipt,PS-GL,0.0,5648.66,GBP,CHAPS Credit,Vertex Advisory Client #16,***1362,INV-202404-PS-GL-0008,,False,False,REF-332647,First Continental Bank,***8138,Globex Consulting UK Ltd.,UK,5101970.66
2024-04-21,2024-04-21,Client Receipt - CloudBridge Co. #63,Sales Receipt,SaaS-GL,0.0,14476.4,GBP,CHAPS Credit,CloudBridge Co. #63,***3789,INV-202404-SaaS-GL-0006,,False,False,REF-741994,First Continental Bank,***5710,Globex Consulting UK Ltd.,UK,5116447.06
2024-04-22,2024-04-22,Supplier Payment - Stelliform Parts BV #24,Supplier Payment,CEM-EMEA,1790.73,0.0,GBP,Faster Payments,Stelliform Parts BV #24,***8291,,PO-202404-CEM-EMEA-0006,False,False,REF-755884,First Continental Bank,***8532,Globex Consulting UK Ltd.,UK,5114656.33
2024-04-22,2024-04-22,Supplier Payment - ExpertNet Subcontractors #14,Supplier Payment,PS-GL,7232.06,0.0,GBP,CHAPS,ExpertNet Subcontractors #14,***9330,,PO-202404-PS-GL-0001,False,False,REF-308991,First Continental Bank,***9525,Globex Consulting UK Ltd.,UK,5107424.27
2024-04-22,2024-04-22,Client Receipt - Aurora Electronics GmbH #13,Sales Receipt,CEM-EMEA,0.0,12775.69,GBP,Faster Payments Credit,Aurora Electronics GmbH #13,***9312,INV-202404-CEM-EMEA-0005,,False,False,REF-979809,First Continental Bank,***7471,Globex Consulting UK Ltd.,UK,5120199.96
2024-04-22,2024-04-22,Client Receipt - Aurora Electronics GmbH #18,Sales Receipt,CEM-EMEA,0.0,21576.18,GBP,CHAPS Credit,Aurora Electronics GmbH #18,***4328,INV-202404-CEM-EMEA-0008,,False,False,REF-272520,First Continental Bank,***9500,Globex Consulting UK Ltd.,UK,5141776.14
2024-04-23,2024-04-23,Supplier Payment - HyperCloud Infra #3,Supplier Payment,SaaS-GL,6024.09,0.0,GBP,Faster Payments,HyperCloud Infra #3,***5690,,PO-202404-SaaS-GL-0006,False,False,REF-166793,First Continental Bank,***3206,Globex Consulting UK Ltd.,UK,5135752.05
2024-04-23,2024-04-23,Client Receipt - CloudBridge Co. #9,Sales Receipt,SaaS-GL,0.0,153.69,GBP,Faster Payments Credit,CloudBridge Co. #9,***2926,INV-202404-SaaS-GL-0016,,False,False,REF-989341,First Continental Bank,***3526,Globex Consulting UK Ltd.,UK,5135905.74
2024-04-23,2024-04-23,Client Receipt - CloudBridge Co. #7,Sales Receipt,SaaS-GL,0.0,1952.57,GBP,CHAPS Credit,CloudBridge Co. #7,***7055,INV-202404-SaaS-GL-0007,,False,False,REF-748467,First Continental Bank,***1480,Globex Consulting UK Ltd.,UK,5137858.31
2024-04-23,2024-04-23,Client Receipt - CloudBridge Co. #60,Sales Receipt,SaaS-GL,0.0,9069.26,GBP,CHAPS Credit,CloudBridge Co. #60,***8458,INV-202404-SaaS-GL-0019,,False,False,REF-216932,First Continental Bank,***8933,Globex Consulting UK Ltd.,UK,5146927.57
2024-04-23,2024-04-23,Client Receipt - Aurora Electronics GmbH #9,Sales Receipt,CEM-EMEA,0.0,32807.18,GBP,Faster Payments Credit,Aurora Electronics GmbH #9,***8868,INV-202404-CEM-EMEA-0016,,False,False,REF-862912,First Continental Bank,***8236,Globex Consulting UK Ltd.,UK,5179734.75
2024-04-23,2024-04-23,Client Receipt - Novatek Components Ltd #3,Sales Receipt,CEM-EMEA,0.0,50119.69,GBP,CHAPS Credit,Novatek Components Ltd #3,***6637,INV-202404-CEM-EMEA-0009,,False,False,REF-488256,First Continental Bank,***5241,Globex Consulting UK Ltd.,UK,5229854.44
2024-04-24,2024-04-24,Metro Water & Waste,Rent & Utilities,ALL,5156.45,0.0,GBP,Faster Payments,Metro Water & Waste,***7394,,,False,False,REF-574151,First Continental Bank,***7049,Globex Consulting UK Ltd.,UK,5224697.99
2024-04-24,2024-04-24,Supplier Payment - EuroFab Assembly #23,Supplier Payment,CEM-EMEA,61517.18,0.0,GBP,Faster Payments,EuroFab Assembly #23,***8582,,PO-202404-CEM-EMEA-0002,False,False,REF-328084,First Continental Bank,***9257,Globex Consulting UK Ltd.,UK,5163180.81
2024-04-25,2024-04-25,Supplier Payment - ExpertNet Subcontractors #14,Supplier Payment,PS-GL,437.86,0.0,GBP,Faster Payments,ExpertNet Subcontractors #14,***8516,,PO-202404-PS-GL-0007,False,False,REF-729728,First Continental Bank,***1391,Globex Consulting UK Ltd.,UK,5162742.95
2024-04-25,2024-04-25,Supplier Payment - Stelliform Parts BV #4,Supplier Payment,CEM-EMEA,57384.65,0.0,GBP,CHAPS,Stelliform Parts BV #4,***8430,,PO-202404-CEM-EMEA-0008,False,False,REF-279846,First Continental Bank,***9398,Globex Consulting UK Ltd.,UK,5105358.3
2024-04-25,2024-04-25,Client Receipt - Aurora Electronics GmbH #14,Sales Receipt,CEM-EMEA,0.0,2693.74,GBP,Faster Payments Credit,Aurora Electronics GmbH #14,***6817,INV-202404-CEM-EMEA-0010,,False,False,REF-326213,First Continental Bank,***8327,Globex Consulting UK Ltd.,UK,5108052.04
2024-04-25,2024-04-25,Client Receipt - CloudBridge Co. #43,Sales Receipt,SaaS-GL,0.0,9820.95,GBP,CHAPS Credit,CloudBridge Co. #43,***6585,INV-202404-SaaS-GL-0021,,False,False,REF-923155,First Continental Bank,***6749,Globex Consulting UK Ltd.,UK,5117872.99
2024-04-26,2024-04-26,Supplier Payment - CodeCraft Contractors #1,Supplier Payment,SaaS-GL,2197.95,0.0,GBP,CHAPS,CodeCraft Contractors #1,***9841,,PO-202404-SaaS-GL-0009,False,False,REF-958320,First Continental Bank,***4585,Globex Consulting UK Ltd.,UK,5115675.04
2024-04-26,2024-04-26,Intercompany Settlement - Globex Retail NA LLC,Intercompany Transfer,ALL,508895.0,0.0,GBP,Internal Transfer,Globex Retail NA LLC,***4180,,,True,True,REF-877462,First Continental Bank,***6200,Globex Consulting UK Ltd.,UK,4606780.04
2024-04-26,2024-04-26,Client Receipt - CloudBridge Co. #66,Sales Receipt,SaaS-GL,0.0,810.82,GBP,CHAPS Credit,CloudBridge Co. #66,***7752,INV-202404-SaaS-GL-0025,,False,False,REF-806420,First Continental Bank,***2366,Globex Consulting UK Ltd.,UK,4607590.86
2024-04-26,2024-04-26,Client Receipt - Aurora Electronics GmbH #7,Sales Receipt,CEM-EMEA,0.0,15622.04,GBP,Faster Payments Credit,Aurora Electronics GmbH #7,***6973,INV-202404-CEM-EMEA-0015,,False,False,REF-845584,First Continental Bank,***5448,Globex Consulting UK Ltd.,UK,4623212.9
2024-04-27,2024-04-27,Client Receipt - CloudBridge Co. #75,Sales Receipt,SaaS-GL,0.0,1108.51,GBP,CHAPS Credit,CloudBridge Co. #75,***1941,INV-202404-SaaS-GL-0005,,False,False,REF-442133,First Continental Bank,***2978,Globex Consulting UK Ltd.,UK,4624321.41
2024-04-27,2024-04-27,Client Receipt - Vertex Advisory Client #31,Sales Receipt,PS-GL,0.0,6837.58,GBP,CHAPS Credit,Vertex Advisory Client #31,***9704,INV-202404-PS-GL-0010,,False,False,REF-597377,First Continental Bank,***2365,Globex Consulting UK Ltd.,UK,4631158.99
2024-04-27,2024-04-27,Client Receipt - Aurora Electronics GmbH #14,Sales Receipt,CEM-EMEA,0.0,36433.42,GBP,CHAPS Credit,Aurora Electronics GmbH #14,***3404,INV-202404-CEM-EMEA-0002,,False,False,REF-141857,First Continental Bank,***7859,Globex Consulting UK Ltd.,UK,4667592.41
2024-04-28,2024-04-28,Supplier Payment - ExpertNet Subcontractors #7,Supplier Payment,PS-GL,6345.31,0.0,GBP,Faster Payments,ExpertNet Subcontractors #7,***9455,,PO-202404-PS-GL-0003,False,False,REF-626152,First Continental Bank,***7907,Globex Consulting UK Ltd.,UK,4661247.1
2024-04-28,2024-04-28,Corporate Tax Estimate,Tax Payment,ALL,28274.45,0.0,GBP,SWIFT MT103,HMRC UK,***2604,,,False,False,REF-154034,First Continental Bank,***6521,Globex Consulting UK Ltd.,UK,4632972.65
2024-04-28,2024-04-28,Payroll - GlobalPay Services Ltd,Payroll,ALL,52228.62,0.0,GBP,Faster Payments,GlobalPay Services Ltd,***2260,,,False,False,REF-450859,First Continental Bank,***5869,Globex Consulting UK Ltd.,UK,4580744.03
2024-04-28,2024-04-28,Payroll - GlobalPay Services Ltd,Payroll,ALL,52228.62,0.0,GBP,Faster Payments,GlobalPay Services Ltd,***3376,,,False,False,REF-860366,First Continental Bank,***9030,Globex Consulting UK Ltd.,UK,4528515.41
2024-04-28,2024-04-28,Client Receipt - CloudBridge Co. #8,Sales Receipt,SaaS-GL,0.0,1231.1,GBP,Faster Payments Credit,CloudBridge Co. #8,***6302,INV-202404-SaaS-GL-0003,,False,False,REF-439565,First Continental Bank,***3702,Globex Consulting UK Ltd.,UK,4529746.51
2024-04-29,2024-04-29,Supplier Payment - HyperCloud Infra #7,Supplier Payment,SaaS-GL,10241.06,0.0,GBP,Faster Payments,HyperCloud Infra #7,***2802,,PO-202404-SaaS-GL-0001,False,False,REF-667355,First Continental Bank,***8731,Globex Consulting UK Ltd.,UK,4519505.45
2024-04-29,2024-04-29,Supplier Payment - EuroFab Assembly #2,Supplier Payment,CEM-EMEA,14426.42,0.0,GBP,Faster Payments,EuroFab Assembly #2,***7877,,PO-202404-CEM-EMEA-0001,False,False,REF-810211,First Continental Bank,***7443,Globex Consulting UK Ltd.,UK,4505079.03
2024-04-29,2024-04-29,Client Receipt - CloudBridge Co. #67,Sales Receipt,SaaS-GL,0.0,419.36,GBP,CHAPS Credit,CloudBridge Co. #67,***7694,INV-202404-SaaS-GL-0014,,False,False,REF-616440,First Continental Bank,***8668,Globex Consulting UK Ltd.,UK,4505498.39
2024-04-29,2024-04-29,Client Receipt - Vertex Advisory Client #21,Sales Receipt,PS-GL,0.0,939.53,GBP,Faster Payments Credit,Vertex Advisory Client #21,***9880,INV-202404-PS-GL-0001,,False,False,REF-285592,First Continental Bank,***4311,Globex Consulting UK Ltd.,UK,4506437.92
2024-04-30,2024-04-30,Client Receipt - CloudBridge Co. #44,Sales Receipt,SaaS-GL,0.0,3187.97,GBP,Faster Payments Credit,CloudBridge Co. #44,***8025,INV-202404-SaaS-GL-0013,,False,False,REF-297406,First Continental Bank,***9808,Globex Consulting UK Ltd.,UK,4509625.89
2024-04-30,2024-04-30,Interest Earned,Interest Income,ALL,0.0,9622.11,GBP,Faster Payments Credit,First Continental Bank,***1718,,,False,False,REF-371317,First Continental Bank,***3506,Globex Consulting UK Ltd.,UK,4519248.0
2024-04-30,2024-04-30,Client Receipt - Novatek Components Ltd #7,Sales Receipt,CEM-EMEA,0.0,12041.1,GBP,CHAPS Credit,Novatek Components Ltd #7,***3919,INV-202404-CEM-EMEA-0003,,False,False,REF-917819,First Continental Bank,***3898,Globex Consulting UK Ltd.,UK,4531289.1
2024-04-30,2024-04-30,Client Receipt - Novatek Components Ltd #2,Sales Receipt,CEM-EMEA,0.0,20180.03,GBP,Faster Payments Credit,Novatek Components Ltd #2,***9617,INV-202404-CEM-EMEA-0011,,False,False,REF-685746,First Continental Bank,***1080,Globex Consulting UK Ltd.,UK,4551469.13
2024-05-01,2024-05-01,Account Maintenance Fee,Bank/Merchant Fees,ALL,2500.0,0.0,GBP,Faster Payments,First Continental Bank,***5545,,,False,False,REF-705507,First Continental Bank,***9094,Globex Consulting UK Ltd.,UK,4548969.13
2024-05-01,2024-05-01,Marketing - Beacon Digital #7,Marketing,ALL,3468.17,0.0,GBP,CHAPS,Beacon Digital #7,***9798,,,False,False,REF-678443,First Continental Bank,***3741,Globex Consulting UK Ltd.,UK,4545500.96
2024-05-01,2024-05-01,Client Receipt - CloudBridge Co. #5,Sales Receipt,SaaS-GL,0.0,552.69,GBP,CHAPS Credit,CloudBridge Co. #5,***5795,INV-202405-SaaS-GL-0013,,False,False,REF-237146,First Continental Bank,***4757,Globex Consulting UK Ltd.,UK,4546053.65
2024-05-01,2024-05-01,Client Receipt - CloudBridge Co. #33,Sales Receipt,SaaS-GL,0.0,8951.7,GBP,CHAPS Credit,CloudBridge Co. #33,***3222,INV-202405-SaaS-GL-0016,,False,False,REF-415093,First Continental Bank,***2462,Globex Consulting UK Ltd.,UK,4555005.35
2024-05-01,2024-05-01,Client Receipt - CloudBridge Co. #3,Sales Receipt,SaaS-GL,0.0,10134.65,GBP,CHAPS Credit,CloudBridge Co. #3,***8920,INV-202405-SaaS-GL-0010,,False,False,REF-276319,First Continental Bank,***4095,Globex Consulting UK Ltd.,UK,4565140.0
2024-05-01,2024-05-01,Client Receipt - Vertex Advisory Client #5,Sales Receipt,PS-GL,0.0,15524.46,GBP,CHAPS Credit,Vertex Advisory Client #5,***1073,INV-202405-PS-GL-0004,,False,False,REF-701528,First Continental Bank,***4014,Globex Consulting UK Ltd.,UK,4580664.46
2024-05-02,2024-05-02,Supplier Payment - Stelliform Parts BV #11,Supplier Payment,CEM-EMEA,1824.18,0.0,GBP,Faster Payments,Stelliform Parts BV #11,***4804,,PO-202405-CEM-EMEA-0012,False,False,REF-729878,First Continental Bank,***8203,Globex Consulting UK Ltd.,UK,4578840.28
2024-05-02,2024-05-02,Supplier Payment - ExpertNet Subcontractors #5,Supplier Payment,PS-GL,1855.95,0.0,GBP,Faster Payments,ExpertNet Subcontractors #5,***9002,,PO-202405-PS-GL-0003,False,False,REF-963941,First Continental Bank,***3173,Globex Consulting UK Ltd.,UK,4576984.33
2024-05-02,2024-05-02,Marketing - Beacon Digital #7,Marketing,ALL,13375.93,0.0,GBP,Faster Payments,Beacon Digital #7,***1563,,,False,False,REF-526473,First Continental Bank,***2635,Globex Consulting UK Ltd.,UK,4563608.4
2024-05-02,2024-05-02,Client Receipt - CloudBridge Co. #67,Sales Receipt,SaaS-GL,0.0,544.48,GBP,Faster Payments Credit,CloudBridge Co. #67,***6184,INV-202405-SaaS-GL-0025,,False,False,REF-605381,First Continental Bank,***9769,Globex Consulting UK Ltd.,UK,4564152.88
2024-05-03,2024-05-03,Supplier Payment - HyperCloud Infra #4,Supplier Payment,SaaS-GL,7758.22,0.0,GBP,CHAPS,HyperCloud Infra #4,***7249,,PO-202405-SaaS-GL-0006,False,False,REF-578078,First Continental Bank,***4425,Globex Consulting UK Ltd.,UK,4556394.66
2024-05-03,2024-05-03,Supplier Payment - EuroFab Assembly #16,Supplier Payment,CEM-EMEA,22726.25,0.0,GBP,Faster Payments,EuroFab Assembly #16,***9581,,PO-202405-CEM-EMEA-0002,False,False,REF-490333,First Continental Bank,***5349,Globex Consulting UK Ltd.,UK,4533668.41
2024-05-03,2024-05-03,Client Receipt - CloudBridge Co. #29,Sales Receipt,SaaS-GL,0.0,1058.06,GBP,Faster Payments Credit,CloudBridge Co. #29,***3580,INV-202405-SaaS-GL-0029,,False,False,REF-388633,First Continental Bank,***2398,Globex Consulting UK Ltd.,UK,4534726.47
2024-05-03,2024-05-03,Client Receipt - Aurora Electronics GmbH #2,Sales Receipt,CEM-EMEA,0.0,9692.92,GBP,Faster Payments Credit,Aurora Electronics GmbH #2,***5164,INV-202405-CEM-EMEA-0002,,False,False,REF-851351,First Continental Bank,***4803,Globex Consulting UK Ltd.,UK,4544419.39
2024-05-03,2024-05-03,Client Receipt - Novatek Components Ltd #11,Sales Receipt,CEM-EMEA,0.0,12763.16,GBP,CHAPS Credit,Novatek Components Ltd #11,***4423,INV-202405-CEM-EMEA-0016,,False,False,REF-465631,First Continental Bank,***8495,Globex Consulting UK Ltd.,UK,4557182.55
2024-05-03,2024-05-03,Client Receipt - CloudBridge Co. #42,Sales Receipt,SaaS-GL,0.0,15563.25,GBP,CHAPS Credit,CloudBridge Co. #42,***6015,INV-202405-SaaS-GL-0015,,False,False,REF-293419,First Continental Bank,***9839,Globex Consulting UK Ltd.,UK,4572745.8
2024-05-03,2024-05-03,Client Receipt - Aurora Electronics GmbH #6,Sales Receipt,CEM-EMEA,0.0,25689.3,GBP,Faster Payments Credit,Aurora Electronics GmbH #6,***9154,INV-202405-CEM-EMEA-0009,,False,False,REF-685560,First Continental Bank,***4314,Globex Consulting UK Ltd.,UK,4598435.1
2024-05-03,2024-05-03,Client Receipt - Novatek Components Ltd #1,Sales Receipt,CEM-EMEA,0.0,65105.17,GBP,CHAPS Credit,Novatek Components Ltd #1,***6752,INV-202405-CEM-EMEA-0007,,False,False,REF-732623,First Continental Bank,***6419,Globex Consulting UK Ltd.,UK,4663540.27
2024-05-04,2024-05-04,Northshore Power,Rent & Utilities,ALL,3407.07,0.0,GBP,CHAPS,Northshore Power,***3784,,,False,False,REF-347658,First Continental Bank,***4196,Globex Consulting UK Ltd.,UK,4660133.2
2024-05-04,2024-05-04,Supplier Payment - EuroFab Assembly #11,Supplier Payment,CEM-EMEA,7493.59,0.0,GBP,CHAPS,EuroFab Assembly #11,***8612,,PO-202405-CEM-EMEA-0009,False,False,REF-726669,First Continental Bank,***4921,Globex Consulting UK Ltd.,UK,4652639.61
2024-05-04,2024-05-04,Client Receipt - Vertex Advisory Client #37,Sales Receipt,PS-GL,0.0,17457.06,GBP,Faster Payments Credit,Vertex Advisory Client #37,***1707,INV-202405-PS-GL-0009,,False,False,REF-927747,First Continental Bank,***7658,Globex Consulting UK Ltd.,UK,4670096.67
2024-05-04,2024-05-04,Client Receipt - CloudBridge Co. #40,Sales Receipt,SaaS-GL,0.0,30658.1,GBP,Faster Payments Credit,CloudBridge Co. #40,***4408,INV-202405-SaaS-GL-0027,,False,False,REF-737923,First Continental Bank,***8623,Globex Consulting UK Ltd.,UK,4700754.77
2024-05-04,2024-05-04,Client Receipt - Aurora Electronics GmbH #10,Sales Receipt,CEM-EMEA,0.0,46291.76,GBP,CHAPS Credit,Aurora Electronics GmbH #10,***2890,INV-202405-CEM-EMEA-0001,,False,False,REF-300129,First Continental Bank,***5258,Globex Consulting UK Ltd.,UK,4747046.53
2024-05-06,2024-05-06,Supplier Payment - ExpertNet Subcontractors #11,Supplier Payment,PS-GL,12716.37,0.0,GBP,CHAPS,ExpertNet Subcontractors #11,***6766,,PO-202405-PS-GL-0005,False,False,REF-273537,First Continental Bank,***3570,Globex Consulting UK Ltd.,UK,4734330.16
2024-05-06,2024-05-06,Supplier Payment - Stelliform Parts BV #27,Supplier Payment,CEM-EMEA,39656.31,0.0,GBP,CHAPS,Stelliform Parts BV #27,***2977,,PO-202405-CEM-EMEA-0001,False,False,REF-563975,First Continental Bank,***7705,Globex Consulting UK Ltd.,UK,4694673.85
2024-05-06,2024-05-06,Client Receipt - CloudBridge Co. #42,Sales Receipt,SaaS-GL,0.0,4426.11,GBP,Faster Payments Credit,CloudBridge Co. #42,***8779,INV-202405-SaaS-GL-0021,,False,False,REF-591614,First Continental Bank,***7313,Globex Consulting UK Ltd.,UK,4699099.96
2024-05-06,2024-05-06,Client Receipt - Aurora Electronics GmbH #1,Sales Receipt,CEM-EMEA,0.0,4961.98,GBP,CHAPS Credit,Aurora Electronics GmbH #1,***9786,INV-202405-CEM-EMEA-0004,,False,False,REF-235547,First Continental Bank,***3161,Globex Consulting UK Ltd.,UK,4704061.94
2024-05-06,2024-05-06,Client Receipt - Vertex Advisory Client #8,Sales Receipt,PS-GL,0.0,14101.13,GBP,Faster Payments Credit,Vertex Advisory Client #8,***1565,INV-202405-PS-GL-0010,,False,False,REF-413957,First Continental Bank,***4645,Globex Consulting UK Ltd.,UK,4718163.07
2024-05-07,2024-05-07,Supplier Payment - CodeCraft Contractors #11,Supplier Payment,SaaS-GL,2836.95,0.0,GBP,CHAPS,CodeCraft Contractors #11,***2294,,PO-202405-SaaS-GL-0002,False,False,REF-104862,First Continental Bank,***3950,Globex Consulting UK Ltd.,UK,4715326.12
2024-05-07,2024-05-07,Supplier Payment - EuroFab Assembly #21,Supplier Payment,CEM-EMEA,22189.68,0.0,GBP,Faster Payments,EuroFab Assembly #21,***7150,,PO-202405-CEM-EMEA-0004,False,False,REF-603054,First Continental Bank,***6668,Globex Consulting UK Ltd.,UK,4693136.44
2024-05-07,2024-05-07,Client Receipt - CloudBridge Co. #79,Sales Receipt,SaaS-GL,0.0,1544.2,GBP,CHAPS Credit,CloudBridge Co. #79,***4887,INV-202405-SaaS-GL-0005,,False,False,REF-476036,First Continental Bank,***8966,Globex Consulting UK Ltd.,UK,4694680.64
2024-05-07,2024-05-07,Client Receipt - CloudBridge Co. #53,Sales Receipt,SaaS-GL,0.0,5082.52,GBP,CHAPS Credit,CloudBridge Co. #53,***2944,INV-202405-SaaS-GL-0030,,False,False,REF-806235,First Continental Bank,***1119,Globex Consulting UK Ltd.,UK,4699763.16
2024-05-07,2024-05-07,Client Receipt - Novatek Components Ltd #5,Sales Receipt,CEM-EMEA,0.0,19622.29,GBP,Faster Payments Credit,Novatek Components Ltd #5,***6652,INV-202405-CEM-EMEA-0012,,False,False,REF-936840,First Continental Bank,***2598,Globex Consulting UK Ltd.,UK,4719385.45
2024-05-09,2024-05-09,Supplier Payment - ExpertNet Subcontractors #18,Supplier Payment,PS-GL,6897.88,0.0,GBP,Faster Payments,ExpertNet Subcontractors #18,***8470,,PO-202405-PS-GL-0004,False,False,REF-788147,First Continental Bank,***6953,Globex Consulting UK Ltd.,UK,4712487.57
2024-05-09,2024-05-09,Client Receipt - CloudBridge Co. #40,Sales Receipt,SaaS-GL,0.0,388.55,GBP,CHAPS Credit,CloudBridge Co. #40,***7593,INV-202405-SaaS-GL-0008,,False,False,REF-650453,First Continental Bank,***3234,Globex Consulting UK Ltd.,UK,4712876.12
2024-05-09,2024-05-09,Client Receipt - CloudBridge Co. #71,Sales Receipt,SaaS-GL,0.0,853.1,GBP,Faster Payments Credit,CloudBridge Co. #71,***3433,INV-202405-SaaS-GL-0031,,False,False,REF-337428,First Continental Bank,***6695,Globex Consulting UK Ltd.,UK,4713729.22
2024-05-09,2024-05-09,Client Receipt - CloudBridge Co. #15,Sales Receipt,SaaS-GL,0.0,5641.63,GBP,Faster Payments Credit,CloudBridge Co. #15,***4587,INV-202405-SaaS-GL-0024,,False,False,REF-391804,First Continental Bank,***4646,Globex Consulting UK Ltd.,UK,4719370.85
2024-05-09,2024-05-09,Client Receipt - Aurora Electronics GmbH #19,Sales Receipt,CEM-EMEA,0.0,11672.1,GBP,CHAPS Credit,Aurora Electronics GmbH #19,***5183,INV-202405-CEM-EMEA-0006,,False,False,REF-475726,First Continental Bank,***4544,Globex Consulting UK Ltd.,UK,4731042.95
2024-05-09,2024-05-09,Client Receipt - Aurora Electronics GmbH #10,Sales Receipt,CEM-EMEA,0.0,15416.73,GBP,Faster Payments Credit,Aurora Electronics GmbH #10,***9712,INV-202405-CEM-EMEA-0011,,False,False,REF-775057,First Continental Bank,***6527,Globex Consulting UK Ltd.,UK,4746459.68
2024-05-10,2024-05-10,Supplier Payment - CodeCraft Contractors #2,Supplier Payment,SaaS-GL,5177.67,0.0,GBP,Faster Payments,CodeCraft Contractors #2,***5297,,PO-202405-SaaS-GL-0008,False,False,REF-533777,First Continental Bank,***4357,Globex Consulting UK Ltd.,UK,4741282.01
2024-05-10,2024-05-10,Supplier Payment - ExpertNet Subcontractors #19,Supplier Payment,PS-GL,9905.02,0.0,GBP,CHAPS,ExpertNet Subcontractors #19,***5758,,PO-202405-PS-GL-0001,False,False,REF-253182,First Continental Bank,***9383,Globex Consulting UK Ltd.,UK,4731376.99
2024-05-11,2024-05-11,Supplier Payment - EuroFab Assembly #6,Supplier Payment,CEM-EMEA,4973.0,0.0,GBP,CHAPS,EuroFab Assembly #6,***6480,,PO-202405-CEM-EMEA-0007,False,False,REF-811762,First Continental Bank,***4586,Globex Consulting UK Ltd.,UK,4726403.99
2024-05-11,2024-05-11,Client Receipt - CloudBridge Co. #23,Sales Receipt,SaaS-GL,0.0,4022.24,GBP,Faster Payments Credit,CloudBridge Co. #23,***7898,INV-202405-SaaS-GL-0004,,False,False,REF-659280,First Continental Bank,***5771,Globex Consulting UK Ltd.,UK,4730426.23
2024-05-12,2024-05-12,Intercompany Settlement - Globex APAC Logistics Pte. Ltd.,Intercompany Transfer,ALL,405009.0,0.0,GBP,Internal Transfer,Globex APAC Logistics Pte. Ltd.,***4573,,,True,True,REF-824129,First Continental Bank,***5112,Globex Consulting UK Ltd.,UK,4325417.23
2024-05-13,2024-05-13,Supplier Payment - CodeCraft Contractors #12,Supplier Payment,SaaS-GL,10996.75,0.0,GBP,Faster Payments,CodeCraft Contractors #12,***4267,,PO-202405-SaaS-GL-0005,False,False,REF-918391,First Continental Bank,***4982,Globex Consulting UK Ltd.,UK,4314420.48
2024-05-14,2024-05-14,Client Receipt - CloudBridge Co. #77,Sales Receipt,SaaS-GL,0.0,5657.64,GBP,CHAPS Credit,CloudBridge Co. #77,***1389,INV-202405-SaaS-GL-0003,,False,False,REF-346096,First Continental Bank,***5552,Globex Consulting UK Ltd.,UK,4320078.12
2024-05-14,2024-05-14,Client Receipt - CloudBridge Co. #4,Sales Receipt,SaaS-GL,0.0,6839.78,GBP,Faster Payments Credit,CloudBridge Co. #4,***6483,INV-202405-SaaS-GL-0001,,False,False,REF-301923,First Continental Bank,***1463,Globex Consulting UK Ltd.,UK,4326917.9
2024-05-14,2024-05-14,Client Receipt - Vertex Advisory Client #54,Sales Receipt,PS-GL,0.0,12612.27,GBP,Faster Payments Credit,Vertex Advisory Client #54,***1893,INV-202405-PS-GL-0002,,False,False,REF-270322,First Continental Bank,***6660,Globex Consulting UK Ltd.,UK,4339530.17
2024-05-14,2024-05-14,Client Receipt - CloudBridge Co. #43,Sales Receipt,SaaS-GL,0.0,12932.86,GBP,CHAPS Credit,CloudBridge Co. #43,***7723,INV-202405-SaaS-GL-0002,,False,False,REF-914065,First Continental Bank,***5257,Globex Consulting UK Ltd.,UK,4352463.03
2024-05-15,2024-05-15,Supplier Payment - Stelliform Parts BV #22,Supplier Payment,CEM-EMEA,11311.98,0.0,GBP,CHAPS,Stelliform Parts BV #22,***7910,,PO-202405-CEM-EMEA-0011,False,False,REF-580055,First Continental Bank,***2259,Globex Consulting UK Ltd.,UK,4341151.05
2024-05-15,2024-05-15,Client Receipt - CloudBridge Co. #61,Sales Receipt,SaaS-GL,0.0,1475.19,GBP,Faster Payments Credit,CloudBridge Co. #61,***6706,INV-202405-SaaS-GL-0019,,False,False,REF-922248,First Continental Bank,***6626,Globex Consulting UK Ltd.,UK,4342626.24
2024-05-15,2024-05-15,Client Receipt - Vertex Advisory Client #53,Sales Receipt,PS-GL,0.0,5564.53,GBP,CHAPS Credit,Vertex Advisory Client #53,***3962,INV-202405-PS-GL-0011,,False,False,REF-221956,First Continental Bank,***2790,Globex Consulting UK Ltd.,UK,4348190.77
2024-05-15,2024-05-15,Client Receipt - Novatek Components Ltd #8,Sales Receipt,CEM-EMEA,0.0,50350.99,GBP,Faster Payments Credit,Novatek Components Ltd #8,***6487,INV-202405-CEM-EMEA-0010,,False,False,REF-684946,First Continental Bank,***3464,Globex Consulting UK Ltd.,UK,4398541.76
2024-05-16,2024-05-16,Supplier Payment - HyperCloud Infra #8,Supplier Payment,SaaS-GL,55.52,0.0,GBP,CHAPS,HyperCloud Infra #8,***4764,,PO-202405-SaaS-GL-0009,False,False,REF-288382,First Continental Bank,***8476,Globex Consulting UK Ltd.,UK,4398486.24
2024-05-16,2024-05-16,Supplier Payment - HyperCloud Infra #16,Supplier Payment,SaaS-GL,1308.94,0.0,GBP,Faster Payments,HyperCloud Infra #16,***5554,,PO-202405-SaaS-GL-0001,False,False,REF-941487,First Continental Bank,***5761,Globex Consulting UK Ltd.,UK,4397177.3
2024-05-16,2024-05-16,Supplier Payment - ExpertNet Subcontractors #13,Supplier Payment,PS-GL,1526.74,0.0,GBP,CHAPS,ExpertNet Subcontractors #13,***5010,,PO-202405-PS-GL-0008,False,False,REF-663372,First Continental Bank,***2886,Globex Consulting UK Ltd.,UK,4395650.56
2024-05-16,2024-05-16,Supplier Payment - ExpertNet Subcontractors #3,Supplier Payment,PS-GL,4104.44,0.0,GBP,Faster Payments,ExpertNet Subcontractors #3,***7898,,PO-202405-PS-GL-0002,False,False,REF-827620,First Continental Bank,***2144,Globex Consulting UK Ltd.,UK,4391546.12
2024-05-17,2024-05-17,Client Receipt - Aurora Electronics GmbH #14,Sales Receipt,CEM-EMEA,0.0,9098.04,GBP,CHAPS Credit,Aurora Electronics GmbH #14,***6457,INV-202405-CEM-EMEA-0008,,False,False,REF-526890,First Continental Bank,***4000,Globex Consulting UK Ltd.,UK,4400644.16
2024-05-17,2024-05-17,Client Receipt - Vertex Advisory Client #32,Sales Receipt,PS-GL,0.0,19901.28,GBP,CHAPS Credit,Vertex Advisory Client #32,***7157,INV-202405-PS-GL-0012,,False,False,REF-905032,First Continental Bank,***2720,Globex Consulting UK Ltd.,UK,4420545.44
2024-05-18,2024-05-18,Client Receipt - CloudBridge Co. #18,Sales Receipt,SaaS-GL,0.0,2713.7,GBP,Faster Payments Credit,CloudBridge Co. #18,***3107,INV-202405-SaaS-GL-0020,,False,False,REF-163297,First Continental Bank,***9817,Globex Consulting UK Ltd.,UK,4423259.14
2024-05-21,2024-05-21,Merchant Processing Fees,Bank/Merchant Fees,ALL,913.6,0.0,GBP,Faster Payments,First Continental Bank,***7893,,,False,False,REF-865306,First Continental Bank,***1713,Globex Consulting UK Ltd.,UK,4422345.54
2024-05-21,2024-05-21,Supplier Payment - Stelliform Parts BV #25,Supplier Payment,CEM-EMEA,22233.68,0.0,GBP,Faster Payments,Stelliform Parts BV #25,***5683,,PO-202405-CEM-EMEA-0008,False,False,REF-289287,First Continental Bank,***1402,Globex Consulting UK Ltd.,UK,4400111.86
2024-05-21,2024-05-21,VAT/GST Remittance - HMRC UK,Tax Payment,ALL,41637.79,0.0,GBP,Faster Payments,HMRC UK,***9499,,,False,False,REF-982542,First Continental Bank,***7714,Globex Consulting UK Ltd.,UK,4358474.07
2024-05-21,2024-05-21,Client Receipt - CloudBridge Co. #56,Sales Receipt,SaaS-GL,0.0,939.55,GBP,CHAPS Credit,CloudBridge Co. #56,***1139,INV-202405-SaaS-GL-0026,,False,False,REF-170381,First Continental Bank,***1723,Globex Consulting UK Ltd.,UK,4359413.62
2024-05-21,2024-05-21,Client Receipt - Vertex Advisory Client #18,Sales Receipt,PS-GL,0.0,3067.74,GBP,CHAPS Credit,Vertex Advisory Client #18,***5106,INV-202405-PS-GL-0006,,False,False,REF-426571,First Continental Bank,***4349,Globex Consulting UK Ltd.,UK,4362481.36
2024-05-21,2024-05-21,Client Receipt - Aurora Electronics GmbH #8,Sales Receipt,CEM-EMEA,0.0,22107.98,GBP,Faster Payments Credit,Aurora Electronics GmbH #8,***5729,INV-202405-CEM-EMEA-0005,,False,False,REF-169927,First Continental Bank,***9806,Globex Consulting UK Ltd.,UK,4384589.34
2024-05-22,2024-05-22,Supplier Payment - Stelliform Parts BV #20,Supplier Payment,CEM-EMEA,1717.25,0.0,GBP,Faster Payments,Stelliform Parts BV #20,***5475,,PO-202405-CEM-EMEA-0003,False,False,REF-169763,First Continental Bank,***4648,Globex Consulting UK Ltd.,UK,4382872.09
2024-05-22,2024-05-22,Supplier Payment - ExpertNet Subcontractors #8,Supplier Payment,PS-GL,5123.48,0.0,GBP,Faster Payments,ExpertNet Subcontractors #8,***1236,,PO-202405-PS-GL-0006,False,False,REF-671606,First Continental Bank,***7565,Globex Consulting UK Ltd.,UK,4377748.61
2024-05-22,2024-05-22,Supplier Payment - Stelliform Parts BV #4,Supplier Payment,CEM-EMEA,27690.68,0.0,GBP,CHAPS,Stelliform Parts BV #4,***3432,,PO-202405-CEM-EMEA-0006,False,False,REF-508474,First Continental Bank,***1546,Globex Consulting UK Ltd.,UK,4350057.93
2024-05-22,2024-05-22,Supplier Payment - Stelliform Parts BV #18,Supplier Payment,CEM-EMEA,31517.5,0.0,GBP,CHAPS,Stelliform Parts BV #18,***3828,,PO-202405-CEM-EMEA-0010,False,False,REF-574209,First Continental Bank,***2109,Globex Consulting UK Ltd.,UK,4318540.43
2024-05-22,2024-05-22,Client Receipt - CloudBridge Co. #72,Sales Receipt,SaaS-GL,0.0,2853.84,GBP,Faster Payments Credit,CloudBridge Co. #72,***7877,INV-202405-SaaS-GL-0011,,False,False,REF-145710,First Continental Bank,***5960,Globex Consulting UK Ltd.,UK,4321394.27
2024-05-22,2024-05-22,Client Receipt - CloudBridge Co. #71,Sales Receipt,SaaS-GL,0.0,3686.65,GBP,CHAPS Credit,CloudBridge Co. #71,***1791,INV-202405-SaaS-GL-0009,,False,False,REF-442929,First Continental Bank,***3280,Globex Consulting UK Ltd.,UK,4325080.92
2024-05-22,2024-05-22,Client Receipt - CloudBridge Co. #21,Sales Receipt,SaaS-GL,0.0,6193.16,GBP,Faster Payments Credit,CloudBridge Co. #21,***2368,INV-202405-SaaS-GL-0023,,False,False,REF-752663,First Continental Bank,***4157,Globex Consulting UK Ltd.,UK,4331274.08
2024-05-22,2024-05-22,Client Receipt - CloudBridge Co. #62,Sales Receipt,SaaS-GL,0.0,10681.67,GBP,CHAPS Credit,CloudBridge Co. #62,***9727,INV-202405-SaaS-GL-0017,,False,False,REF-602886,First Continental Bank,***4654,Globex Consulting UK Ltd.,UK,4341955.75
2024-05-22,2024-05-22,Client Receipt - Vertex Advisory Client #55,Sales Receipt,PS-GL,0.0,17627.47,GBP,CHAPS Credit,Vertex Advisory Client #55,***9716,INV-202405-PS-GL-0001,,False,False,REF-606747,First Continental Bank,***4424,Globex Consulting UK Ltd.,UK,4359583.22
2024-05-23,2024-05-23,Supplier Payment - Stelliform Parts BV #16,Supplier Payment,CEM-EMEA,4479.19,0.0,GBP,Faster Payments,Stelliform Parts BV #16,***7225,,PO-202405-CEM-EMEA-0005,False,False,REF-449073,First Continental Bank,***2239,Globex Consulting UK Ltd.,UK,4355104.03
2024-05-23,2024-05-23,Client Receipt - Vertex Advisory Client #38,Sales Receipt,PS-GL,0.0,4510.34,GBP,CHAPS Credit,Vertex Advisory Client #38,***2714,INV-202405-PS-GL-0005,,False,False,REF-485122,First Continental Bank,***5361,Globex Consulting UK Ltd.,UK,4359614.37
2024-05-24,2024-05-24,Merchant Processing Fees,Bank/Merchant Fees,ALL,1197.97,0.0,GBP,Faster Payments,First Continental Bank,***8145,,,False,False,REF-866770,First Continental Bank,***4864,Globex Consulting UK Ltd.,UK,4358416.4
2024-05-24,2024-05-24,Supplier Payment - HyperCloud Infra #14,Supplier Payment,SaaS-GL,5734.21,0.0,GBP,CHAPS,HyperCloud Infra #14,***2518,,PO-202405-SaaS-GL-0003,False,False,REF-372996,First Continental Bank,***8938,Globex Consulting UK Ltd.,UK,4352682.19
2024-05-24,2024-05-24,Client Receipt - CloudBridge Co. #6,Sales Receipt,SaaS-GL,0.0,712.81,GBP,Faster Payments Credit,CloudBridge Co. #6,***6992,INV-202405-SaaS-GL-0028,,False,False,REF-361730,First Continental Bank,***2350,Globex Consulting UK Ltd.,UK,4353395.0
2024-05-24,2024-05-24,Client Receipt - Vertex Advisory Client #34,Sales Receipt,PS-GL,0.0,3917.52,GBP,Faster Payments Credit,Vertex Advisory Client #34,***2185,INV-202405-PS-GL-0007,,False,False,REF-357370,First Continental Bank,***9426,Globex Consulting UK Ltd.,UK,4357312.52
2024-05-25,2024-05-25,Supplier Payment - HyperCloud Infra #19,Supplier Payment,SaaS-GL,6074.33,0.0,GBP,CHAPS,HyperCloud Infra #19,***9669,,PO-202405-SaaS-GL-0004,False,False,REF-518149,First Continental Bank,***4545,Globex Consulting UK Ltd.,UK,4351238.19
2024-05-25,2024-05-25,Payroll - GlobalPay Services Ltd,Payroll,ALL,54979.28,0.0,GBP,CHAPS,GlobalPay Services Ltd,***9608,,,False,False,REF-216064,First Continental Bank,***4583,Globex Consulting UK Ltd.,UK,4296258.91
2024-05-25,2024-05-25,Client Receipt - CloudBridge Co. #11,Sales Receipt,SaaS-GL,0.0,8192.76,GBP,Faster Payments Credit,CloudBridge Co. #11,***7507,INV-202405-SaaS-GL-0007,,False,False,REF-440367,First Continental Bank,***5093,Globex Consulting UK Ltd.,UK,4304451.67
2024-05-25,2024-05-25,Client Receipt - CloudBridge Co. #50,Sales Receipt,SaaS-GL,0.0,20684.23,GBP,Faster Payments Credit,CloudBridge Co. #50,***7139,INV-202405-SaaS-GL-0018,,False,False,REF-916813,First Continental Bank,***4615,Globex Consulting UK Ltd.,UK,4325135.9
2024-05-26,2024-05-26,Intercompany Settlement - Globex Retail NA LLC,Intercompany Transfer,ALL,811892.0,0.0,GBP,Internal Transfer,Globex Retail NA LLC,***2477,,,True,True,REF-591516,First Continental Bank,***1384,Globex Consulting UK Ltd.,UK,3513243.9
2024-05-26,2024-05-26,Client Receipt - Vertex Advisory Client #58,Sales Receipt,PS-GL,0.0,8433.48,GBP,Faster Payments Credit,Vertex Advisory Client #58,***6348,INV-202405-PS-GL-0003,,False,False,REF-893518,First Continental Bank,***7024,Globex Consulting UK Ltd.,UK,3521677.38
2024-05-26,2024-05-26,Client Receipt - Vertex Advisory Client #4,Sales Receipt,PS-GL,0.0,18577.93,GBP,Faster Payments Credit,Vertex Advisory Client #4,***4213,INV-202405-PS-GL-0008,,False,False,REF-493320,First Continental Bank,***5756,Globex Consulting UK Ltd.,UK,3540255.31
2024-05-27,2024-05-27,Marketing - Beacon Digital #1,Marketing,ALL,456.67,0.0,GBP,CHAPS,Beacon Digital #1,***3205,,,False,False,REF-858018,First Continental Bank,***1843,Globex Consulting UK Ltd.,UK,3539798.64
2024-05-27,2024-05-27,Northshore Power,Rent & Utilities,ALL,2045.11,0.0,GBP,Faster Payments,Northshore Power,***9342,,,False,False,REF-628115,First Continental Bank,***9409,Globex Consulting UK Ltd.,UK,3537753.53
2024-05-27,2024-05-27,Payroll - GlobalPay Services Ltd,Payroll,ALL,54979.28,0.0,GBP,CHAPS,GlobalPay Services Ltd,***6618,,,False,False,REF-462291,First Continental Bank,***2503,Globex Consulting UK Ltd.,UK,3482774.25
2024-05-27,2024-05-27,Client Receipt - Novatek Components Ltd #8,Sales Receipt,CEM-EMEA,0.0,2962.64,GBP,Faster Payments Credit,Novatek Components Ltd #8,***7755,INV-202405-CEM-EMEA-0015,,False,False,REF-961526,First Continental Bank,***1890,Globex Consulting UK Ltd.,UK,3485736.89
2024-05-27,2024-05-27,Client Receipt - CloudBridge Co. #54,Sales Receipt,SaaS-GL,0.0,4864.32,GBP,Faster Payments Credit,CloudBridge Co. #54,***3766,INV-202405-SaaS-GL-0032,,False,False,REF-929263,First Continental Bank,***9566,Globex Consulting UK Ltd.,UK,3490601.21
2024-05-28,2024-05-28,Client Receipt - Novatek Components Ltd #6,Sales Receipt,CEM-EMEA,0.0,20436.82,GBP,Faster Payments Credit,Novatek Components Ltd #6,***8905,INV-202405-CEM-EMEA-0003,,False,False,REF-235767,First Continental Bank,***2398,Globex Consulting UK Ltd.,UK,3511038.03
2024-05-29,2024-05-29,Client Receipt - CloudBridge Co. #24,Sales Receipt,SaaS-GL,0.0,4003.44,GBP,CHAPS Credit,CloudBridge Co. #24,***3925,INV-202405-SaaS-GL-0014,,False,False,REF-580862,First Continental Bank,***1958,Globex Consulting UK Ltd.,UK,3515041.47
2024-05-29,2024-05-29,Client Receipt - CloudBridge Co. #45,Sales Receipt,SaaS-GL,0.0,8687.95,GBP,CHAPS Credit,CloudBridge Co. #45,***6799,INV-202405-SaaS-GL-0006,,False,False,REF-568254,First Continental Bank,***6505,Globex Consulting UK Ltd.,UK,3523729.42
2024-05-30,2024-05-30,Supplier Payment - CodeCraft Contractors #13,Supplier Payment,SaaS-GL,1362.55,0.0,GBP,CHAPS,CodeCraft Contractors #13,***6772,,PO-202405-SaaS-GL-0010,False,False,REF-909885,First Continental Bank,***1863,Globex Consulting UK Ltd.,UK,3522366.87
2024-05-30,2024-05-30,Interest Earned,Interest Income,ALL,0.0,9124.0,GBP,Faster Payments Credit,First Continental Bank,***4705,,,False,False,REF-617910,First Continental Bank,***8104,Globex Consulting UK Ltd.,UK,3531490.87
2024-05-30,2024-05-30,Client Receipt - CloudBridge Co. #43,Sales Receipt,SaaS-GL,0.0,9592.52,GBP,Faster Payments Credit,CloudBridge Co. #43,***3440,INV-202405-SaaS-GL-0022,,False,False,REF-929292,First Continental Bank,***7007,Globex Consulting UK Ltd.,UK,3541083.39
2024-05-30,2024-05-30,Client Receipt - CloudBridge Co. #12,Sales Receipt,SaaS-GL,0.0,11809.46,GBP,Faster Payments Credit,CloudBridge Co. #12,***7562,INV-202405-SaaS-GL-0012,,False,False,REF-130334,First Continental Bank,***6136,Globex Consulting UK Ltd.,UK,3552892.85
2024-05-30,2024-05-30,Client Receipt - Aurora Electronics GmbH #13,Sales Receipt,CEM-EMEA,0.0,11970.88,GBP,CHAPS Credit,Aurora Electronics GmbH #13,***2833,INV-202405-CEM-EMEA-0014,,False,False,REF-582224,First Continental Bank,***1594,Globex Consulting UK Ltd.,UK,3564863.73
2024-05-31,2024-05-31,Supplier Payment - ExpertNet Subcontractors #16,Supplier Payment,PS-GL,258.68,0.0,GBP,Faster Payments,ExpertNet Subcontractors #16,***3353,,PO-202405-PS-GL-0007,False,False,REF-406056,First Continental Bank,***8341,Globex Consulting UK Ltd.,UK,3564605.05
2024-05-31,2024-05-31,Supplier Payment - CodeCraft Contractors #1,Supplier Payment,SaaS-GL,5322.28,0.0,GBP,Faster Payments,CodeCraft Contractors #1,***5297,,PO-202405-SaaS-GL-0007,False,False,REF-603274,First Continental Bank,***1160,Globex Consulting UK Ltd.,UK,3559282.77
2024-05-31,2024-05-31,Client Receipt - Aurora Electronics GmbH #17,Sales Receipt,CEM-EMEA,0.0,1546.05,GBP,Faster Payments Credit,Aurora Electronics GmbH #17,***8970,INV-202405-CEM-EMEA-0013,,False,False,REF-156546,First Continental Bank,***6249,Globex Consulting UK Ltd.,UK,3560828.82
2024-06-01,2024-06-01,Account Maintenance Fee,Bank/Merchant Fees,ALL,2500.0,0.0,GBP,CHAPS,First Continental Bank,***3318,,,False,False,REF-791660,First Continental Bank,***6627,Globex Consulting UK Ltd.,UK,3558328.82
2024-06-01,2024-06-01,Client Receipt - CloudBridge Co. #6,Sales Receipt,SaaS-GL,0.0,2355.61,GBP,CHAPS Credit,CloudBridge Co. #6,***6247,INV-202406-SaaS-GL-0020,,False,False,REF-232169,First Continental Bank,***5251,Globex Consulting UK Ltd.,UK,3560684.43
2024-06-02,2024-06-02,Supplier Payment - ExpertNet Subcontractors #11,Supplier Payment,PS-GL,7051.23,0.0,GBP,CHAPS,ExpertNet Subcontractors #11,***3072,,PO-202406-PS-GL-0009,False,False,REF-832676,First Continental Bank,***2726,Globex Consulting UK Ltd.,UK,3553633.2
2024-06-03,2024-06-03,Marketing - Beacon Digital #9,Marketing,ALL,8370.49,0.0,GBP,Faster Payments,Beacon Digital #9,***3968,,,False,False,REF-409345,First Continental Bank,***3230,Globex Consulting UK Ltd.,UK,3545262.71
2024-06-03,2024-06-03,Client Receipt - CloudBridge Co. #8,Sales Receipt,SaaS-GL,0.0,1648.81,GBP,CHAPS Credit,CloudBridge Co. #8,***5312,INV-202406-SaaS-GL-0030,,False,False,REF-463168,First Continental Bank,***9975,Globex Consulting UK Ltd.,UK,3546911.52
2024-06-03,2024-06-03,Client Receipt - CloudBridge Co. #47,Sales Receipt,SaaS-GL,0.0,3066.36,GBP,Faster Payments Credit,CloudBridge Co. #47,***2699,INV-202406-SaaS-GL-0004,,False,False,REF-802198,First Continental Bank,***2241,Globex Consulting UK Ltd.,UK,3549977.88
2024-06-03,2024-06-03,Client Receipt - Vertex Advisory Client #13,Sales Receipt,PS-GL,0.0,15412.17,GBP,CHAPS Credit,Vertex Advisory Client #13,***3125,INV-202406-PS-GL-0007,,False,False,REF-358016,First Continental Bank,***9183,Globex Consulting UK Ltd.,UK,3565390.05
2024-06-04,2024-06-04,Client Receipt - CloudBridge Co. #16,Sales Receipt,SaaS-GL,0.0,5226.01,GBP,CHAPS Credit,CloudBridge Co. #16,***3392,INV-202406-SaaS-GL-0001,,False,False,REF-852785,First Continental Bank,***4980,Globex Consulting UK Ltd.,UK,3570616.06
2024-06-04,2024-06-04,Client Receipt - Vertex Advisory Client #41,Sales Receipt,PS-GL,0.0,8700.2,GBP,Faster Payments Credit,Vertex Advisory Client #41,***6251,INV-202406-PS-GL-0008,,False,False,REF-195395,First Continental Bank,***8866,Globex Consulting UK Ltd.,UK,3579316.26
2024-06-04,2024-06-04,Client Receipt - Vertex Advisory Client #59,Sales Receipt,PS-GL,0.0,18914.03,GBP,Faster Payments Credit,Vertex Advisory Client #59,***5061,INV-202406-PS-GL-0004,,False,False,REF-445135,First Continental Bank,***6916,Globex Consulting UK Ltd.,UK,3598230.29
2024-06-04,2024-06-04,Client Receipt - Vertex Advisory Client #49,Sales Receipt,PS-GL,0.0,20856.54,GBP,CHAPS Credit,Vertex Advisory Client #49,***2487,INV-202406-PS-GL-0001,,False,False,REF-166761,First Continental Bank,***4220,Globex Consulting UK Ltd.,UK,3619086.83
2024-06-05,2024-06-05,Metro Water & Waste,Rent & Utilities,ALL,1165.79,0.0,GBP,CHAPS,Metro Water & Waste,***5396,,,False,False,REF-810752,First Continental Bank,***7994,Globex Consulting UK Ltd.,UK,3617921.04
2024-06-05,2024-06-05,Supplier Payment - Stelliform Parts BV #18,Supplier Payment,CEM-EMEA,6960.96,0.0,GBP,Faster Payments,Stelliform Parts BV #18,***5068,,PO-202406-CEM-EMEA-0005,False,False,REF-379811,First Continental Bank,***6401,Globex Consulting UK Ltd.,UK,3610960.08
2024-06-06,2024-06-06,Supplier Payment - Stelliform Parts BV #11,Supplier Payment,CEM-EMEA,38910.42,0.0,GBP,Faster Payments,Stelliform Parts BV #11,***4419,,PO-202406-CEM-EMEA-0007,False,False,REF-542926,First Continental Bank,***6283,Globex Consulting UK Ltd.,UK,3572049.66
2024-06-06,2024-06-06,Client Receipt - CloudBridge Co. #29,Sales Receipt,SaaS-GL,0.0,1483.03,GBP,CHAPS Credit,CloudBridge Co. #29,***2903,INV-202406-SaaS-GL-0002,,False,False,REF-781617,First Continental Bank,***1436,Globex Consulting UK Ltd.,UK,3573532.69
2024-06-06,2024-06-06,Client Receipt - CloudBridge Co. #35,Sales Receipt,SaaS-GL,0.0,7301.78,GBP,CHAPS Credit,CloudBridge Co. #35,***9741,INV-202406-SaaS-GL-0005,,False,False,REF-750598,First Continental Bank,***8132,Globex Consulting UK Ltd.,UK,3580834.47
2024-06-07,2024-06-07,Supplier Payment - ExpertNet Subcontractors #16,Supplier Payment,PS-GL,4404.9,0.0,GBP,CHAPS,ExpertNet Subcontractors #16,***1933,,PO-202406-PS-GL-0001,False,False,REF-483118,First Continental Bank,***2707,Globex Consulting UK Ltd.,UK,3576429.57
2024-06-07,2024-06-07,Client Receipt - CloudBridge Co. #48,Sales Receipt,SaaS-GL,0.0,3157.71,GBP,Faster Payments Credit,CloudBridge Co. #48,***7361,INV-202406-SaaS-GL-0017,,False,False,REF-697646,First Continental Bank,***2502,Globex Consulting UK Ltd.,UK,3579587.28
2024-06-10,2024-06-10,Supplier Payment - ExpertNet Subcontractors #8,Supplier Payment,PS-GL,2439.84,0.0,GBP,Faster Payments,ExpertNet Subcontractors #8,***3939,,PO-202406-PS-GL-0003,False,False,REF-619470,First Continental Bank,***9576,Globex Consulting UK Ltd.,UK,3577147.44
2024-06-10,2024-06-10,Supplier Payment - CodeCraft Contractors #4,Supplier Payment,SaaS-GL,8298.28,0.0,GBP,CHAPS,CodeCraft Contractors #4,***3470,,PO-202406-SaaS-GL-0008,False,False,REF-338230,First Continental Bank,***2040,Globex Consulting UK Ltd.,UK,3568849.16
2024-06-10,2024-06-10,Supplier Payment - EuroFab Assembly #16,Supplier Payment,CEM-EMEA,38120.89,0.0,GBP,CHAPS,EuroFab Assembly #16,***8604,,PO-202406-CEM-EMEA-0003,False,False,REF-806685,First Continental Bank,***1605,Globex Consulting UK Ltd.,UK,3530728.27
2024-06-10,2024-06-10,Client Receipt - CloudBridge Co. #64,Sales Receipt,SaaS-GL,0.0,51.44,GBP,CHAPS Credit,CloudBridge Co. #64,***7310,INV-202406-SaaS-GL-0021,,False,False,REF-897421,First Continental Bank,***6317,Globex Consulting UK Ltd.,UK,3530779.71
2024-06-10,2024-06-10,Client Receipt - CloudBridge Co. #10,Sales Receipt,SaaS-GL,0.0,562.82,GBP,Faster Payments Credit,CloudBridge Co. #10,***1423,INV-202406-SaaS-GL-0028,,False,False,REF-272639,First Continental Bank,***2331,Globex Consulting UK Ltd.,UK,3531342.53
2024-06-10,2024-06-10,Client Receipt - CloudBridge Co. #23,Sales Receipt,SaaS-GL,0.0,11399.28,GBP,CHAPS Credit,CloudBridge Co. #23,***9446,INV-202406-SaaS-GL-0035,,False,False,REF-174761,First Continental Bank,***8478,Globex Consulting UK Ltd.,UK,3542741.81
2024-06-10,2024-06-10,Client Receipt - Novatek Components Ltd #10,Sales Receipt,CEM-EMEA,0.0,25453.03,GBP,CHAPS Credit,Novatek Components Ltd #10,***3723,INV-202406-CEM-EMEA-0011,,False,False,REF-207417,First Continental Bank,***9735,Globex Consulting UK Ltd.,UK,3568194.84
2024-06-10,2024-06-10,Client Receipt - Novatek Components Ltd #8,Sales Receipt,CEM-EMEA,0.0,40939.58,GBP,Faster Payments Credit,Novatek Components Ltd #8,***1715,INV-202406-CEM-EMEA-0002,,False,False,REF-404454,First Continental Bank,***7440,Globex Consulting UK Ltd.,UK,3609134.42
2024-06-11,2024-06-11,Supplier Payment - CodeCraft Contractors #13,Supplier Payment,SaaS-GL,1308.44,0.0,GBP,CHAPS,CodeCraft Contractors #13,***1511,,PO-202406-SaaS-GL-0006,False,False,REF-372245,First Continental Bank,***5725,Globex Consulting UK Ltd.,UK,3607825.98
2024-06-11,2024-06-11,Supplier Payment - ExpertNet Subcontractors #13,Supplier Payment,PS-GL,4112.2,0.0,GBP,CHAPS,ExpertNet Subcontractors #13,***8147,,PO-202406-PS-GL-0005,False,False,REF-917597,First Continental Bank,***4301,Globex Consulting UK Ltd.,UK,3603713.78
2024-06-11,2024-06-11,Supplier Payment - ExpertNet Subcontractors #11,Supplier Payment,PS-GL,5255.29,0.0,GBP,CHAPS,ExpertNet Subcontractors #11,***4547,,PO-202406-PS-GL-0008,False,False,REF-644245,First Continental Bank,***6590,Globex Consulting UK Ltd.,UK,3598458.49
2024-06-11,2024-06-11,Supplier Payment - Stelliform Parts BV #13,Supplier Payment,CEM-EMEA,19034.71,0.0,GBP,Faster Payments,Stelliform Parts BV #13,***6018,,PO-202406-CEM-EMEA-0001,False,False,REF-856612,First Continental Bank,***4397,Globex Consulting UK Ltd.,UK,3579423.78
2024-06-11,2024-06-11,Client Receipt - Vertex Advisory Client #38,Sales Receipt,PS-GL,0.0,25628.37,GBP,CHAPS Credit,Vertex Advisory Client #38,***4963,INV-202406-PS-GL-0002,,False,False,REF-743844,First Continental Bank,***4348,Globex Consulting UK Ltd.,UK,3605052.15
2024-06-12,2024-06-12,Supplier Payment - HyperCloud Infra #18,Supplier Payment,SaaS-GL,12617.42,0.0,GBP,Faster Payments,HyperCloud Infra #18,***3246,,PO-202406-SaaS-GL-0002,False,False,REF-685128,First Continental Bank,***7866,Globex Consulting UK Ltd.,UK,3592434.73
2024-06-12,2024-06-12,Intercompany Settlement - Globex EMEA Manufacturing Ltd.,Intercompany Transfer,ALL,691042.0,0.0,GBP,Internal Transfer,Globex EMEA Manufacturing Ltd.,***1112,,,True,True,REF-946025,First Continental Bank,***8484,Globex Consulting UK Ltd.,UK,2901392.73
2024-06-12,2024-06-12,Client Receipt - CloudBridge Co. #43,Sales Receipt,SaaS-GL,0.0,13.7,GBP,Faster Payments Credit,CloudBridge Co. #43,***3288,INV-202406-SaaS-GL-0018,,False,False,REF-752021,First Continental Bank,***1825,Globex Consulting UK Ltd.,UK,2901406.43
2024-06-12,2024-06-12,Client Receipt - CloudBridge Co. #22,Sales Receipt,SaaS-GL,0.0,252.94,GBP,CHAPS Credit,CloudBridge Co. #22,***1514,INV-202406-SaaS-GL-0009,,False,False,REF-269103,First Continental Bank,***7918,Globex Consulting UK Ltd.,UK,2901659.37
2024-06-12,2024-06-12,Client Receipt - CloudBridge Co. #65,Sales Receipt,SaaS-GL,0.0,3663.42,GBP,Faster Payments Credit,CloudBridge Co. #65,***2821,INV-202406-SaaS-GL-0025,,False,False,REF-873918,First Continental Bank,***3046,Globex Consulting UK Ltd.,UK,2905322.79
2024-06-12,2024-06-12,Client Receipt - CloudBridge Co. #22,Sales Receipt,SaaS-GL,0.0,5453.52,GBP,CHAPS Credit,CloudBridge Co. #22,***2209,INV-202406-SaaS-GL-0015,,False,False,REF-364067,First Continental Bank,***5630,Globex Consulting UK Ltd.,UK,2910776.31
2024-06-12,2024-06-12,Client Receipt - Novatek Components Ltd #7,Sales Receipt,CEM-EMEA,0.0,28171.83,GBP,Faster Payments Credit,Novatek Components Ltd #7,***5536,INV-202406-CEM-EMEA-0013,,False,False,REF-344072,First Continental Bank,***9511,Globex Consulting UK Ltd.,UK,2938948.14
2024-06-12,2024-06-12,Intercompany Reimbursement - Globex EMEA Manufacturing Ltd.,Intercompany Transfer,ALL,0.0,276416.8,GBP,Internal Transfer,Globex EMEA Manufacturing Ltd.,***2562,,,True,True,REF-992161,First Continental Bank,***7910,Globex Consulting UK Ltd.,UK,3215364.94
2024-06-13,2024-06-13,Client Receipt - CloudBridge Co. #48,Sales Receipt,SaaS-GL,0.0,3035.08,GBP,Faster Payments Credit,CloudBridge Co. #48,***3409,INV-202406-SaaS-GL-0013,,False,False,REF-839636,First Continental Bank,***8539,Globex Consulting UK Ltd.,UK,3218400.02
2024-06-13,2024-06-13,Client Receipt - CloudBridge Co. #53,Sales Receipt,SaaS-GL,0.0,3837.0,GBP,CHAPS Credit,CloudBridge Co. #53,***8027,INV-202406-SaaS-GL-0029,,False,False,REF-435230,First Continental Bank,***8390,Globex Consulting UK Ltd.,UK,3222237.02
2024-06-13,2024-06-13,Client Receipt - CloudBridge Co. #72,Sales Receipt,SaaS-GL,0.0,9080.31,GBP,Faster Payments Credit,CloudBridge Co. #72,***4875,INV-202406-SaaS-GL-0027,,False,False,REF-729640,First Continental Bank,***6301,Globex Consulting UK Ltd.,UK,3231317.33
2024-06-14,2024-06-14,Supplier Payment - ExpertNet Subcontractors #4,Supplier Payment,PS-GL,6023.58,0.0,GBP,Faster Payments,ExpertNet Subcontractors #4,***1442,,PO-202406-PS-GL-0007,False,False,REF-352523,First Continental Bank,***8245,Globex Consulting UK Ltd.,UK,3225293.75
2024-06-14,2024-06-14,Supplier Payment - CodeCraft Contractors #2,Supplier Payment,SaaS-GL,8867.21,0.0,GBP,CHAPS,CodeCraft Contractors #2,***6774,,PO-202406-SaaS-GL-0005,False,False,REF-368771,First Continental Bank,***3812,Globex Consulting UK Ltd.,UK,3216426.54
2024-06-14,2024-06-14,Supplier Payment - EuroFab Assembly #1,Supplier Payment,CEM-EMEA,15036.67,0.0,GBP,CHAPS,EuroFab Assembly #1,***8446,,PO-202406-CEM-EMEA-0011,False,False,REF-548175,First Continental Bank,***1888,Globex Consulting UK Ltd.,UK,3201389.87
2024-06-14,2024-06-14,Client Receipt - Aurora Electronics GmbH #18,Sales Receipt,CEM-EMEA,0.0,15939.68,GBP,CHAPS Credit,Aurora Electronics GmbH #18,***3940,INV-202406-CEM-EMEA-0015,,False,False,REF-315339,First Continental Bank,***5151,Globex Consulting UK Ltd.,UK,3217329.55
2024-06-14,2024-06-14,Client Receipt - Aurora Electronics GmbH #17,Sales Receipt,CEM-EMEA,0.0,30643.2,GBP,Faster Payments Credit,Aurora Electronics GmbH #17,***3638,INV-202406-CEM-EMEA-0009,,False,False,REF-546715,First Continental Bank,***2451,Globex Consulting UK Ltd.,UK,3247972.75
2024-06-15,2024-06-15,Merchant Processing Fees,Bank/Merchant Fees,ALL,1067.93,0.0,GBP,CHAPS,First Continental Bank,***4715,,,False,False,REF-108229,First Continental Bank,***4296,Globex Consulting UK Ltd.,UK,3246904.82
2024-06-15,2024-06-15,Supplier Payment - EuroFab Assembly #1,Supplier Payment,CEM-EMEA,9403.66,0.0,GBP,Faster Payments,EuroFab Assembly #1,***3232,,PO-202406-CEM-EMEA-0004,False,False,REF-132346,First Continental Bank,***8640,Globex Consulting UK Ltd.,UK,3237501.16
2024-06-15,2024-06-15,Client Receipt - Novatek Components Ltd #4,Sales Receipt,CEM-EMEA,0.0,9555.22,GBP,CHAPS Credit,Novatek Components Ltd #4,***1702,INV-202406-CEM-EMEA-0007,,False,False,REF-679706,First Continental Bank,***4541,Globex Consulting UK Ltd.,UK,3247056.38
2024-06-15,2024-06-15,Client Receipt - CloudBridge Co. #60,Sales Receipt,SaaS-GL,0.0,16784.71,GBP,Faster Payments Credit,CloudBridge Co. #60,***4653,INV-202406-SaaS-GL-0006,,False,False,REF-360800,First Continental Bank,***3898,Globex Consulting UK Ltd.,UK,3263841.09
2024-06-15,2024-06-15,Client Receipt - Novatek Components Ltd #10,Sales Receipt,CEM-EMEA,0.0,24151.59,GBP,CHAPS Credit,Novatek Components Ltd #10,***3437,INV-202406-CEM-EMEA-0010,,False,False,REF-844666,First Continental Bank,***9163,Globex Consulting UK Ltd.,UK,3287992.68
2024-06-16,2024-06-16,Client Receipt - Aurora Electronics GmbH #1,Sales Receipt,CEM-EMEA,0.0,728.82,GBP,Faster Payments Credit,Aurora Electronics GmbH #1,***5350,INV-202406-CEM-EMEA-0014,,False,False,REF-360788,First Continental Bank,***3213,Globex Consulting UK Ltd.,UK,3288721.5
2024-06-18,2024-06-18,Metro Water & Waste,Rent & Utilities,ALL,4294.08,0.0,GBP,CHAPS,Metro Water & Waste,***1288,,,False,False,REF-965141,First Continental Bank,***2261,Globex Consulting UK Ltd.,UK,3284427.42
2024-06-18,2024-06-18,Client Receipt - CloudBridge Co. #78,Sales Receipt,SaaS-GL,0.0,4154.84,GBP,Faster Payments Credit,CloudBridge Co. #78,***8068,INV-202406-SaaS-GL-0007,,False,False,REF-516162,First Continental Bank,***9229,Globex Consulting UK Ltd.,UK,3288582.26
2024-06-18,2024-06-18,Client Receipt - Vertex Advisory Client #25,Sales Receipt,PS-GL,0.0,15216.35,GBP,CHAPS Credit,Vertex Advisory Client #25,***2175,INV-202406-PS-GL-0003,,False,False,REF-934966,First Continental Bank,***1807,Globex Consulting UK Ltd.,UK,3303798.61
2024-06-18,2024-06-18,Client Receipt - CloudBridge Co. #6,Sales Receipt,SaaS-GL,0.0,18525.39,GBP,Faster Payments Credit,CloudBridge Co. #6,***7789,INV-202406-SaaS-GL-0026,,False,False,REF-548455,First Continental Bank,***2972,Globex Consulting UK Ltd.,UK,3322324.0
2024-06-19,2024-06-19,Client Receipt - CloudBridge Co. #36,Sales Receipt,SaaS-GL,0.0,6802.07,GBP,CHAPS Credit,CloudBridge Co. #36,***7386,INV-202406-SaaS-GL-0014,,False,False,REF-135708,First Continental Bank,***5255,Globex Consulting UK Ltd.,UK,3329126.07
2024-06-19,2024-06-19,Client Receipt - Aurora Electronics GmbH #11,Sales Receipt,CEM-EMEA,0.0,24079.11,GBP,CHAPS Credit,Aurora Electronics GmbH #11,***7479,INV-202406-CEM-EMEA-0005,,False,False,REF-174597,First Continental Bank,***8567,Globex Consulting UK Ltd.,UK,3353205.18
2024-06-19,2024-06-19,Client Receipt - Novatek Components Ltd #6,Sales Receipt,CEM-EMEA,0.0,26865.53,GBP,Faster Payments Credit,Novatek Components Ltd #6,***8550,INV-202406-CEM-EMEA-0004,,False,False,REF-873311,First Continental Bank,***9013,Globex Consulting UK Ltd.,UK,3380070.71
2024-06-20,2024-06-20,Supplier Payment - EuroFab Assembly #12,Supplier Payment,CEM-EMEA,8905.45,0.0,GBP,CHAPS,EuroFab Assembly #12,***1459,,PO-202406-CEM-EMEA-0008,False,False,REF-791448,First Continental Bank,***1779,Globex Consulting UK Ltd.,UK,3371165.26
2024-06-20,2024-06-20,Supplier Payment - Stelliform Parts BV #12,Supplier Payment,CEM-EMEA,17367.39,0.0,GBP,CHAPS,Stelliform Parts BV #12,***1063,,PO-202406-CEM-EMEA-0002,False,False,REF-169607,First Continental Bank,***4763,Globex Consulting UK Ltd.,UK,3353797.87
2024-06-20,2024-06-20,Client Receipt - CloudBridge Co. #5,Sales Receipt,SaaS-GL,0.0,1795.16,GBP,CHAPS Credit,CloudBridge Co. #5,***2315,INV-202406-SaaS-GL-0023,,False,False,REF-603493,First Continental Bank,***5236,Globex Consulting UK Ltd.,UK,3355593.03
2024-06-20,2024-06-20,Client Receipt - CloudBridge Co. #5,Sales Receipt,SaaS-GL,0.0,9897.66,GBP,Faster Payments Credit,CloudBridge Co. #5,***9527,INV-202406-SaaS-GL-0003,,False,False,REF-769247,First Continental Bank,***4096,Globex Consulting UK Ltd.,UK,3365490.69
2024-06-20,2024-06-20,Client Receipt - Vertex Advisory Client #15,Sales Receipt,PS-GL,0.0,35674.09,GBP,CHAPS Credit,Vertex Advisory Client #15,***6435,INV-202406-PS-GL-0005,,False,False,REF-641743,First Continental Bank,***5706,Globex Consulting UK Ltd.,UK,3401164.78
2024-06-21,2024-06-21,Supplier Payment - ExpertNet Subcontractors #14,Supplier Payment,PS-GL,410.79,0.0,GBP,CHAPS,ExpertNet Subcontractors #14,***7600,,PO-202406-PS-GL-0002,False,False,REF-221786,First Continental Bank,***3378,Globex Consulting UK Ltd.,UK,3400753.99
2024-06-21,2024-06-21,Supplier Payment - CodeCraft Contractors #11,Supplier Payment,SaaS-GL,1206.3,0.0,GBP,Faster Payments,CodeCraft Contractors #11,***6185,,PO-202406-SaaS-GL-0003,False,False,REF-494562,First Continental Bank,***1940,Globex Consulting UK Ltd.,UK,3399547.69
2024-06-21,2024-06-21,VAT/GST Remittance - HMRC UK,Tax Payment,ALL,39259.13,0.0,GBP,CHAPS,HMRC UK,***4287,,,False,False,REF-895427,First Continental Bank,***2543,Globex Consulting UK Ltd.,UK,3360288.56
2024-06-21,2024-06-21,Client Receipt - Aurora Electronics GmbH #4,Sales Receipt,CEM-EMEA,0.0,345.94,GBP,CHAPS Credit,Aurora Electronics GmbH #4,***7195,INV-202406-CEM-EMEA-0012,,False,False,REF-862274,First Continental Bank,***6907,Globex Consulting UK Ltd.,UK,3360634.5
2024-06-21,2024-06-21,Client Receipt - CloudBridge Co. #32,Sales Receipt,SaaS-GL,0.0,1093.39,GBP,CHAPS Credit,CloudBridge Co. #32,***9221,INV-202406-SaaS-GL-0011,,False,False,REF-790289,First Continental Bank,***2851,Globex Consulting UK Ltd.,UK,3361727.89
2024-06-21,2024-06-21,Client Receipt - Novatek Components Ltd #6,Sales Receipt,CEM-EMEA,0.0,1624.29,GBP,CHAPS Credit,Novatek Components Ltd #6,***3894,INV-202406-CEM-EMEA-0018,,False,False,REF-605024,First Continental Bank,***6990,Globex Consulting UK Ltd.,UK,3363352.18
2024-06-21,2024-06-21,Client Receipt - Aurora Electronics GmbH #17,Sales Receipt,CEM-EMEA,0.0,27885.49,GBP,CHAPS Credit,Aurora Electronics GmbH #17,***5813,INV-202406-CEM-EMEA-0017,,False,False,REF-879907,First Continental Bank,***5461,Globex Consulting UK Ltd.,UK,3391237.67
2024-06-22,2024-06-22,Client Receipt - CloudBridge Co. #67,Sales Receipt,SaaS-GL,0.0,1493.68,GBP,CHAPS Credit,CloudBridge Co. #67,***8203,INV-202406-SaaS-GL-0031,,False,False,REF-182801,First Continental Bank,***6659,Globex Consulting UK Ltd.,UK,3392731.35
2024-06-23,2024-06-23,Client Receipt - Novatek Components Ltd #1,Sales Receipt,CEM-EMEA,0.0,29334.94,GBP,Faster Payments Credit,Novatek Components Ltd #1,***6102,INV-202406-CEM-EMEA-0008,,False,False,REF-933784,First Continental Bank,***6355,Globex Consulting UK Ltd.,UK,3422066.29
2024-06-24,2024-06-24,Supplier Payment - CodeCraft Contractors #2,Supplier Payment,SaaS-GL,7507.31,0.0,GBP,CHAPS,CodeCraft Contractors #2,***2591,,PO-202406-SaaS-GL-0004,False,False,REF-623727,First Continental Bank,***3023,Globex Consulting UK Ltd.,UK,3414558.98
2024-06-24,2024-06-24,Marketing - Aurelia Media #4,Marketing,ALL,8961.84,0.0,GBP,Faster Payments,Aurelia Media #4,***7449,,,False,False,REF-124536,First Continental Bank,***4970,Globex Consulting UK Ltd.,UK,3405597.14
2024-06-24,2024-06-24,Supplier Payment - Stelliform Parts BV #31,Supplier Payment,CEM-EMEA,11246.62,0.0,GBP,Faster Payments,Stelliform Parts BV #31,***9350,,PO-202406-CEM-EMEA-0012,False,False,REF-141985,First Continental Bank,***7649,Globex Consulting UK Ltd.,UK,3394350.52
2024-06-24,2024-06-24,Client Receipt - Aurora Electronics GmbH #13,Sales Receipt,CEM-EMEA,0.0,7095.32,GBP,CHAPS Credit,Aurora Electronics GmbH #13,***2547,INV-202406-CEM-EMEA-0006,,False,False,REF-991923,First Continental Bank,***6266,Globex Consulting UK Ltd.,UK,3401445.84
2024-06-24,2024-06-24,Client Receipt - CloudBridge Co. #73,Sales Receipt,SaaS-GL,0.0,9038.62,GBP,CHAPS Credit,CloudBridge Co. #73,***1070,INV-202406-SaaS-GL-0016,,False,False,REF-551022,First Continental Bank,***5447,Globex Consulting UK Ltd.,UK,3410484.46
2024-06-25,2024-06-25,Supplier Payment - ExpertNet Subcontractors #9,Supplier Payment,PS-GL,541.87,0.0,GBP,Faster Payments,ExpertNet Subcontractors #9,***5618,,PO-202406-PS-GL-0004,False,False,REF-440542,First Continental Bank,***2277,Globex Consulting UK Ltd.,UK,3409942.59
2024-06-25,2024-06-25,Supplier Payment - ExpertNet Subcontractors #11,Supplier Payment,PS-GL,12148.86,0.0,GBP,Faster Payments,ExpertNet Subcontractors #11,***8824,,PO-202406-PS-GL-0006,False,False,REF-895220,First Continental Bank,***7632,Globex Consulting UK Ltd.,UK,3397793.73
2024-06-25,2024-06-25,Payroll - GlobalPay Services Ltd,Payroll,ALL,54966.57,0.0,GBP,Faster Payments,GlobalPay Services Ltd,***9091,,,False,False,REF-345633,First Continental Bank,***7087,Globex Consulting UK Ltd.,UK,3342827.16
2024-06-25,2024-06-25,Client Receipt - CloudBridge Co. #79,Sales Receipt,SaaS-GL,0.0,2454.23,GBP,CHAPS Credit,CloudBridge Co. #79,***5487,INV-202406-SaaS-GL-0033,,False,False,REF-535405,First Continental Bank,***4816,Globex Consulting UK Ltd.,UK,3345281.39
2024-06-25,2024-06-25,Client Receipt - CloudBridge Co. #45,Sales Receipt,SaaS-GL,0.0,9796.96,GBP,CHAPS Credit,CloudBridge Co. #45,***8790,INV-202406-SaaS-GL-0010,,False,False,REF-730222,First Continental Bank,***8456,Globex Consulting UK Ltd.,UK,3355078.35
2024-06-25,2024-06-25,Client Receipt - CloudBridge Co. #45,Sales Receipt,SaaS-GL,0.0,11677.32,GBP,Faster Payments Credit,CloudBridge Co. #45,***6417,INV-202406-SaaS-GL-0034,,False,False,REF-943953,First Continental Bank,***1572,Globex Consulting UK Ltd.,UK,3366755.67
2024-06-25,2024-06-25,Client Receipt - CloudBridge Co. #54,Sales Receipt,SaaS-GL,0.0,16374.05,GBP,CHAPS Credit,CloudBridge Co. #54,***3109,INV-202406-SaaS-GL-0008,,False,False,REF-417769,First Continental Bank,***3161,Globex Consulting UK Ltd.,UK,3383129.72
2024-06-25,2024-06-25,Client Receipt - Aurora Electronics GmbH #17,Sales Receipt,CEM-EMEA,0.0,18765.15,GBP,CHAPS Credit,Aurora Electronics GmbH #17,***4845,INV-202406-CEM-EMEA-0001,,False,False,REF-790190,First Continental Bank,***5905,Globex Consulting UK Ltd.,UK,3401894.87
2024-06-26,2024-06-26,Merchant Processing Fees,Bank/Merchant Fees,ALL,945.19,0.0,GBP,CHAPS,First Continental Bank,***5476,,,False,False,REF-347147,First Continental Bank,***6142,Globex Consulting UK Ltd.,UK,3400949.68
2024-06-26,2024-06-26,"Intercompany Settlement - Globex International Holdings, Inc.",Intercompany Transfer,ALL,248658.0,0.0,GBP,Internal Transfer,"Globex International Holdings, Inc.",***6178,,,True,True,REF-856778,First Continental Bank,***9336,Globex Consulting UK Ltd.,UK,3152291.68
2024-06-26,2024-06-26,Client Receipt - Aurora Electronics GmbH #14,Sales Receipt,CEM-EMEA,0.0,8975.73,GBP,CHAPS Credit,Aurora Electronics GmbH #14,***4937,INV-202406-CEM-EMEA-0016,,False,False,REF-644440,First Continental Bank,***6163,Globex Consulting UK Ltd.,UK,3161267.41
2024-06-26,2024-06-26,Client Receipt - CloudBridge Co. #28,Sales Receipt,SaaS-GL,0.0,23909.06,GBP,Faster Payments Credit,CloudBridge Co. #28,***8640,INV-202406-SaaS-GL-0012,,False,False,REF-823865,First Continental Bank,***1067,Globex Consulting UK Ltd.,UK,3185176.47
2024-06-26,2024-06-26,"Intercompany Reimbursement - Globex International Holdings, Inc.",Intercompany Transfer,ALL,0.0,99463.2,GBP,Internal Transfer,"Globex International Holdings, Inc.",***2784,,,True,True,REF-552268,First Continental Bank,***5494,Globex Consulting UK Ltd.,UK,3284639.67
2024-06-27,2024-06-27,Supplier Payment - CodeCraft Contractors #13,Supplier Payment,SaaS-GL,1854.58,0.0,GBP,CHAPS,CodeCraft Contractors #13,***3717,,PO-202406-SaaS-GL-0007,False,False,REF-909728,First Continental Bank,***5196,Globex Consulting UK Ltd.,UK,3282785.09
2024-06-27,2024-06-27,Supplier Payment - Stelliform Parts BV #29,Supplier Payment,CEM-EMEA,3552.31,0.0,GBP,Faster Payments,Stelliform Parts BV #29,***2150,,PO-202406-CEM-EMEA-0010,False,False,REF-610516,First Continental Bank,***9050,Globex Consulting UK Ltd.,UK,3279232.78
2024-06-27,2024-06-27,Supplier Payment - Stelliform Parts BV #33,Supplier Payment,CEM-EMEA,7053.14,0.0,GBP,CHAPS,Stelliform Parts BV #33,***4261,,PO-202406-CEM-EMEA-0009,False,False,REF-467009,First Continental Bank,***6644,Globex Consulting UK Ltd.,UK,3272179.64
2024-06-27,2024-06-27,Payroll - GlobalPay Services Ltd,Payroll,ALL,54966.57,0.0,GBP,CHAPS,GlobalPay Services Ltd,***1303,,,False,False,REF-395913,First Continental Bank,***4956,Globex Consulting UK Ltd.,UK,3217213.07
2024-06-27,2024-06-27,Client Receipt - CloudBridge Co. #35,Sales Receipt,SaaS-GL,0.0,697.78,GBP,CHAPS Credit,CloudBridge Co. #35,***8253,INV-202406-SaaS-GL-0032,,False,False,REF-494366,First Continental Bank,***1555,Globex Consulting UK Ltd.,UK,3217910.85
2024-06-28,2024-06-28,Supplier Payment - Stelliform Parts BV #26,Supplier Payment,CEM-EMEA,22221.07,0.0,GBP,Faster Payments,Stelliform Parts BV #26,***4812,,PO-202406-CEM-EMEA-0006,False,False,REF-506016,First Continental Bank,***9176,Globex Consulting UK Ltd.,UK,3195689.78
2024-06-28,2024-06-28,Client Receipt - CloudBridge Co. #73,Sales Receipt,SaaS-GL,0.0,3210.97,GBP,CHAPS Credit,CloudBridge Co. #73,***7656,INV-202406-SaaS-GL-0022,,False,False,REF-904947,First Continental Bank,***5285,Globex Consulting UK Ltd.,UK,3198900.75
2024-06-28,2024-06-28,Client Receipt - CloudBridge Co. #75,Sales Receipt,SaaS-GL,0.0,4865.58,GBP,CHAPS Credit,CloudBridge Co. #75,***2526,INV-202406-SaaS-GL-0024,,False,False,REF-559270,First Continental Bank,***1612,Globex Consulting UK Ltd.,UK,3203766.33
2024-06-28,2024-06-28,Client Receipt - CloudBridge Co. #56,Sales Receipt,SaaS-GL,0.0,7782.52,GBP,Faster Payments Credit,CloudBridge Co. #56,***1491,INV-202406-SaaS-GL-0019,,False,False,REF-604354,First Continental Bank,***6881,Globex Consulting UK Ltd.,UK,3211548.85
2024-06-29,2024-06-29,Supplier Payment - HyperCloud Infra #8,Supplier Payment,SaaS-GL,4967.88,0.0,GBP,CHAPS,HyperCloud Infra #8,***4094,,PO-202406-SaaS-GL-0001,False,False,REF-166941,First Continental Bank,***5447,Globex Consulting UK Ltd.,UK,3206580.97
2024-06-29,2024-06-29,Client Receipt - Vertex Advisory Client #26,Sales Receipt,PS-GL,0.0,893.46,GBP,Faster Payments Credit,Vertex Advisory Client #26,***5750,INV-202406-PS-GL-0006,,False,False,REF-112473,First Continental Bank,***5607,Globex Consulting UK Ltd.,UK,3207474.43
2024-06-29,2024-06-29,Client Receipt - Aurora Electronics GmbH #8,Sales Receipt,CEM-EMEA,0.0,9134.36,GBP,Faster Payments Credit,Aurora Electronics GmbH #8,***8449,INV-202406-CEM-EMEA-0003,,False,False,REF-458873,First Continental Bank,***4351,Globex Consulting UK Ltd.,UK,3216608.79
2024-06-30,2024-06-30,Interest Earned,Interest Income,ALL,0.0,10615.91,GBP,CHAPS Credit,First Continental Bank,***6988,,,False,False,REF-860383,First Continental Bank,***7391,Globex Consulting UK Ltd.,UK,3227224.7
2024-07-01,2024-07-01,Account Maintenance Fee,Bank/Merchant Fees,ALL,2500.0,0.0,GBP,CHAPS,First Continental Bank,***5225,,,False,False,REF-958481,First Continental Bank,***9827,Globex Consulting UK Ltd.,UK,3224724.7
2024-07-01,2024-07-01,Supplier Payment - CodeCraft Contractors #1,Supplier Payment,SaaS-GL,4960.23,0.0,GBP,Faster Payments,CodeCraft Contractors #1,***1491,,PO-202407-SaaS-GL-0002,False,False,REF-464856,First Continental Bank,***9936,Globex Consulting UK Ltd.,UK,3219764.47
2024-07-01,2024-07-01,Supplier Payment - ExpertNet Subcontractors #8,Supplier Payment,PS-GL,7193.34,0.0,GBP,CHAPS,ExpertNet Subcontractors #8,***7128,,PO-202407-PS-GL-0004,False,False,REF-960331,First Continental Bank,***1158,Globex Consulting UK Ltd.,UK,3212571.13
2024-07-01,2024-07-01,Supplier Payment - HyperCloud Infra #11,Supplier Payment,SaaS-GL,8153.74,0.0,GBP,Faster Payments,HyperCloud Infra #11,***1140,,PO-202407-SaaS-GL-0007,False,False,REF-964047,First Continental Bank,***1136,Globex Consulting UK Ltd.,UK,3204417.39
2024-07-01,2024-07-01,Client Receipt - CloudBridge Co. #64,Sales Receipt,SaaS-GL,0.0,1368.9,GBP,Faster Payments Credit,CloudBridge Co. #64,***7124,INV-202407-SaaS-GL-0002,,False,False,REF-911937,First Continental Bank,***7593,Globex Consulting UK Ltd.,UK,3205786.29
2024-07-01,2024-07-01,Client Receipt - CloudBridge Co. #36,Sales Receipt,SaaS-GL,0.0,7669.84,GBP,Faster Payments Credit,CloudBridge Co. #36,***8628,INV-202407-SaaS-GL-0006,,False,False,REF-232126,First Continental Bank,***2605,Globex Consulting UK Ltd.,UK,3213456.13
2024-07-01,2024-07-01,Client Receipt - CloudBridge Co. #3,Sales Receipt,SaaS-GL,0.0,19432.31,GBP,CHAPS Credit,CloudBridge Co. #3,***7266,INV-202407-SaaS-GL-0026,,False,False,REF-402048,First Continental Bank,***5038,Globex Consulting UK Ltd.,UK,3232888.44
2024-07-01,2024-07-01,Client Receipt - Aurora Electronics GmbH #5,Sales Receipt,CEM-EMEA,0.0,20658.02,GBP,Faster Payments Credit,Aurora Electronics GmbH #5,***9445,INV-202407-CEM-EMEA-0003,,False,False,REF-661999,First Continental Bank,***6488,Globex Consulting UK Ltd.,UK,3253546.46
2024-07-02,2024-07-02,Supplier Payment - ExpertNet Subcontractors #5,Supplier Payment,PS-GL,756.4,0.0,GBP,CHAPS,ExpertNet Subcontractors #5,***2802,,PO-202407-PS-GL-0010,False,False,REF-335495,First Continental Bank,***3726,Globex Consulting UK Ltd.,UK,3252790.06
2024-07-02,2024-07-02,Client Receipt - CloudBridge Co. #69,Sales Receipt,SaaS-GL,0.0,2633.19,GBP,CHAPS Credit,CloudBridge Co. #69,***5875,INV-202407-SaaS-GL-0019,,False,False,REF-436384,First Continental Bank,***4510,Globex Consulting UK Ltd.,UK,3255423.25
2024-07-02,2024-07-02,Client Receipt - CloudBridge Co. #17,Sales Receipt,SaaS-GL,0.0,5834.33,GBP,Faster Payments Credit,CloudBridge Co. #17,***9559,INV-202407-SaaS-GL-0014,,False,False,REF-617144,First Continental Bank,***5294,Globex Consulting UK Ltd.,UK,3261257.58
2024-07-02,2024-07-02,Client Receipt - CloudBridge Co. #8,Sales Receipt,SaaS-GL,0.0,6408.32,GBP,CHAPS Credit,CloudBridge Co. #8,***6745,INV-202407-SaaS-GL-0020,,False,False,REF-477061,First Continental Bank,***7376,Globex Consulting UK Ltd.,UK,3267665.9
2024-07-03,2024-07-03,Merchant Processing Fees,Bank/Merchant Fees,ALL,712.77,0.0,GBP,CHAPS,First Continental Bank,***9117,,,False,False,REF-710563,First Continental Bank,***5795,Globex Consulting UK Ltd.,UK,3266953.13
2024-07-04,2024-07-04,Client Receipt - Aurora Electronics GmbH #5,Sales Receipt,CEM-EMEA,0.0,2926.77,GBP,CHAPS Credit,Aurora Electronics GmbH #5,***4926,INV-202407-CEM-EMEA-0007,,False,False,REF-468748,First Continental Bank,***4842,Globex Consulting UK Ltd.,UK,3269879.9
2024-07-04,2024-07-04,Client Receipt - Vertex Advisory Client #38,Sales Receipt,PS-GL,0.0,10877.48,GBP,CHAPS Credit,Vertex Advisory Client #38,***4185,INV-202407-PS-GL-0008,,False,False,REF-155821,First Continental Bank,***8004,Globex Consulting UK Ltd.,UK,3280757.38
2024-07-04,2024-07-04,Client Receipt - CloudBridge Co. #16,Sales Receipt,SaaS-GL,0.0,15967.94,GBP,Faster Payments Credit,CloudBridge Co. #16,***4436,INV-202407-SaaS-GL-0023,,False,False,REF-331951,First Continental Bank,***9242,Globex Consulting UK Ltd.,UK,3296725.32
2024-07-04,2024-07-04,Client Receipt - Novatek Components Ltd #14,Sales Receipt,CEM-EMEA,0.0,40063.28,GBP,Faster Payments Credit,Novatek Components Ltd #14,***7724,INV-202407-CEM-EMEA-0005,,False,False,REF-166056,First Continental Bank,***7303,Globex Consulting UK Ltd.,UK,3336788.6
2024-07-05,2024-07-05,Supplier Payment - ExpertNet Subcontractors #16,Supplier Payment,PS-GL,3287.39,0.0,GBP,Faster Payments,ExpertNet Subcontractors #16,***2050,,PO-202407-PS-GL-0003,False,False,REF-161103,First Continental Bank,***6500,Globex Consulting UK Ltd.,UK,3333501.21
2024-07-05,2024-07-05,Client Receipt - CloudBridge Co. #69,Sales Receipt,SaaS-GL,0.0,1670.66,GBP,CHAPS Credit,CloudBridge Co. #69,***5909,INV-202407-SaaS-GL-0005,,False,False,REF-471747,First Continental Bank,***2824,Globex Consulting UK Ltd.,UK,3335171.87
2024-07-05,2024-07-05,Client Receipt - CloudBridge Co. #44,Sales Receipt,SaaS-GL,0.0,4495.54,GBP,Faster Payments Credit,CloudBridge Co. #44,***4309,INV-202407-SaaS-GL-0018,,False,False,REF-294218,First Continental Bank,***7886,Globex Consulting UK Ltd.,UK,3339667.41
2024-07-05,2024-07-05,Client Receipt - CloudBridge Co. #27,Sales Receipt,SaaS-GL,0.0,14679.35,GBP,CHAPS Credit,CloudBridge Co. #27,***6585,INV-202407-SaaS-GL-0032,,False,False,REF-836299,First Continental Bank,***5736,Globex Consulting UK Ltd.,UK,3354346.76
2024-07-05,2024-07-05,Client Receipt - CloudBridge Co. #38,Sales Receipt,SaaS-GL,0.0,17428.28,GBP,Faster Payments Credit,CloudBridge Co. #38,***1604,INV-202407-SaaS-GL-0025,,False,False,REF-142838,First Continental Bank,***4664,Globex Consulting UK Ltd.,UK,3371775.04
2024-07-07,2024-07-07,Client Receipt - CloudBridge Co. #37,Sales Receipt,SaaS-GL,0.0,3808.34,GBP,Faster Payments Credit,CloudBridge Co. #37,***3557,INV-202407-SaaS-GL-0016,,False,False,REF-410561,First Continental Bank,***8913,Globex Consulting UK Ltd.,UK,3375583.38
2024-07-08,2024-07-08,Merchant Processing Fees,Bank/Merchant Fees,ALL,1312.41,0.0,GBP,CHAPS,First Continental Bank,***5169,,,False,False,REF-598238,First Continental Bank,***5278,Globex Consulting UK Ltd.,UK,3374270.97
2024-07-08,2024-07-08,Supplier Payment - ExpertNet Subcontractors #6,Supplier Payment,PS-GL,1829.7,0.0,GBP,Faster Payments,ExpertNet Subcontractors #6,***6686,,PO-202407-PS-GL-0011,False,False,REF-533263,First Continental Bank,***3060,Globex Consulting UK Ltd.,UK,3372441.27
2024-07-08,2024-07-08,Supplier Payment - EuroFab Assembly #12,Supplier Payment,CEM-EMEA,14558.82,0.0,GBP,CHAPS,EuroFab Assembly #12,***7586,,PO-202407-CEM-EMEA-0008,False,False,REF-283970,First Continental Bank,***2316,Globex Consulting UK Ltd.,UK,3357882.45
2024-07-08,2024-07-08,Client Receipt - CloudBridge Co. #65,Sales Receipt,SaaS-GL,0.0,6447.87,GBP,CHAPS Credit,CloudBridge Co. #65,***8801,INV-202407-SaaS-GL-0009,,False,False,REF-857716,First Continental Bank,***3035,Globex Consulting UK Ltd.,UK,3364330.32
2024-07-09,2024-07-09,Supplier Payment - ExpertNet Subcontractors #15,Supplier Payment,PS-GL,1396.55,0.0,GBP,Faster Payments,ExpertNet Subcontractors #15,***8815,,PO-202407-PS-GL-0005,False,False,REF-554010,First Continental Bank,***6154,Globex Consulting UK Ltd.,UK,3362933.77
2024-07-10,2024-07-10,Supplier Payment - ExpertNet Subcontractors #1,Supplier Payment,PS-GL,11345.66,0.0,GBP,CHAPS,ExpertNet Subcontractors #1,***8672,,PO-202407-PS-GL-0001,False,False,REF-356509,First Continental Bank,***1123,Globex Consulting UK Ltd.,UK,3351588.11
2024-07-10,2024-07-10,Client Receipt - CloudBridge Co. #48,Sales Receipt,SaaS-GL,0.0,1049.22,GBP,CHAPS Credit,CloudBridge Co. #48,***1174,INV-202407-SaaS-GL-0004,,False,False,REF-551132,First Continental Bank,***8913,Globex Consulting UK Ltd.,UK,3352637.33
2024-07-10,2024-07-10,Client Receipt - CloudBridge Co. #66,Sales Receipt,SaaS-GL,0.0,4050.7,GBP,CHAPS Credit,CloudBridge Co. #66,***5408,INV-202407-SaaS-GL-0003,,False,False,REF-180893,First Continental Bank,***9616,Globex Consulting UK Ltd.,UK,3356688.03
2024-07-10,2024-07-10,Client Receipt - Vertex Advisory Client #36,Sales Receipt,PS-GL,0.0,7194.61,GBP,CHAPS Credit,Vertex Advisory Client #36,***3418,INV-202407-PS-GL-0010,,False,False,REF-893485,First Continental Bank,***7272,Globex Consulting UK Ltd.,UK,3363882.64
2024-07-11,2024-07-11,Supplier Payment - ExpertNet Subcontractors #12,Supplier Payment,PS-GL,790.12,0.0,GBP,Faster Payments,ExpertNet Subcontractors #12,***9731,,PO-202407-PS-GL-0012,False,False,REF-778354,First Continental Bank,***4504,Globex Consulting UK Ltd.,UK,3363092.52
2024-07-11,2024-07-11,Client Receipt - CloudBridge Co. #25,Sales Receipt,SaaS-GL,0.0,4922.78,GBP,CHAPS Credit,CloudBridge Co. #25,***2314,INV-202407-SaaS-GL-0024,,False,False,REF-675609,First Continental Bank,***1187,Globex Consulting UK Ltd.,UK,3368015.3
2024-07-12,2024-07-12,Intercompany Settlement - Globex Retail NA LLC,Intercompany Transfer,ALL,816955.0,0.0,GBP,Internal Transfer,Globex Retail NA LLC,***7708,,,True,True,REF-673468,First Continental Bank,***2150,Globex Consulting UK Ltd.,UK,2551060.3
2024-07-12,2024-07-12,Client Receipt - CloudBridge Co. #35,Sales Receipt,SaaS-GL,0.0,321.43,GBP,Faster Payments Credit,CloudBridge Co. #35,***1544,INV-202407-SaaS-GL-0028,,False,False,REF-566348,First Continental Bank,***9986,Globex Consulting UK Ltd.,UK,2551381.73
2024-07-12,2024-07-12,Client Receipt - CloudBridge Co. #17,Sales Receipt,SaaS-GL,0.0,1133.3,GBP,Faster Payments Credit,CloudBridge Co. #17,***5275,INV-202407-SaaS-GL-0022,,False,False,REF-222425,First Continental Bank,***8058,Globex Consulting UK Ltd.,UK,2552515.03
2024-07-12,2024-07-12,Client Receipt - CloudBridge Co. #40,Sales Receipt,SaaS-GL,0.0,3606.67,GBP,Faster Payments Credit,CloudBridge Co. #40,***7892,INV-202407-SaaS-GL-0021,,False,False,REF-840877,First Continental Bank,***4670,Globex Consulting UK Ltd.,UK,2556121.7
2024-07-12,2024-07-12,Client Receipt - Novatek Components Ltd #5,Sales Receipt,CEM-EMEA,0.0,42114.46,GBP,Faster Payments Credit,Novatek Components Ltd #5,***5000,INV-202407-CEM-EMEA-0006,,False,False,REF-295830,First Continental Bank,***2223,Globex Consulting UK Ltd.,UK,2598236.16
2024-07-13,2024-07-13,Client Receipt - CloudBridge Co. #63,Sales Receipt,SaaS-GL,0.0,9345.25,GBP,CHAPS Credit,CloudBridge Co. #63,***7582,INV-202407-SaaS-GL-0030,,False,False,REF-688761,First Continental Bank,***6327,Globex Consulting UK Ltd.,UK,2607581.41
2024-07-15,2024-07-15,Supplier Payment - ExpertNet Subcontractors #18,Supplier Payment,PS-GL,800.06,0.0,GBP,CHAPS,ExpertNet Subcontractors #18,***4367,,PO-202407-PS-GL-0006,False,False,REF-692102,First Continental Bank,***3984,Globex Consulting UK Ltd.,UK,2606781.35
2024-07-15,2024-07-15,Supplier Payment - CodeCraft Contractors #9,Supplier Payment,SaaS-GL,4570.46,0.0,GBP,CHAPS,CodeCraft Contractors #9,***1309,,PO-202407-SaaS-GL-0006,False,False,REF-701739,First Continental Bank,***3721,Globex Consulting UK Ltd.,UK,2602210.89
2024-07-15,2024-07-15,Supplier Payment - Stelliform Parts BV #21,Supplier Payment,CEM-EMEA,12160.97,0.0,GBP,Faster Payments,Stelliform Parts BV #21,***8459,,PO-202407-CEM-EMEA-0009,False,False,REF-984732,First Continental Bank,***8914,Globex Consulting UK Ltd.,UK,2590049.92
2024-07-15,2024-07-15,Client Receipt - CloudBridge Co. #58,Sales Receipt,SaaS-GL,0.0,3890.85,GBP,CHAPS Credit,CloudBridge Co. #58,***5802,INV-202407-SaaS-GL-0031,,False,False,REF-556022,First Continental Bank,***3972,Globex Consulting UK Ltd.,UK,2593940.77
2024-07-15,2024-07-15,Client Receipt - Aurora Electronics GmbH #10,Sales Receipt,CEM-EMEA,0.0,20357.3,GBP,CHAPS Credit,Aurora Electronics GmbH #10,***8108,INV-202407-CEM-EMEA-0010,,False,False,REF-950610,First Continental Bank,***7146,Globex Consulting UK Ltd.,UK,2614298.07
2024-07-16,2024-07-16,Supplier Payment - CodeCraft Contractors #14,Supplier Payment,SaaS-GL,7602.72,0.0,GBP,CHAPS,CodeCraft Contractors #14,***4486,,PO-202407-SaaS-GL-0003,False,False,REF-113483,First Continental Bank,***3238,Globex Consulting UK Ltd.,UK,2606695.35
2024-07-16,2024-07-16,Client Receipt - CloudBridge Co. #24,Sales Receipt,SaaS-GL,0.0,3647.58,GBP,Faster Payments Credit,CloudBridge Co. #24,***2318,INV-202407-SaaS-GL-0001,,False,False,REF-767282,First Continental Bank,***1631,Globex Consulting UK Ltd.,UK,2610342.93
2024-07-16,2024-07-16,Client Receipt - CloudBridge Co. #19,Sales Receipt,SaaS-GL,0.0,4620.19,GBP,CHAPS Credit,CloudBridge Co. #19,***7591,INV-202407-SaaS-GL-0033,,False,False,REF-649465,First Continental Bank,***3218,Globex Consulting UK Ltd.,UK,2614963.12
2024-07-16,2024-07-16,Client Receipt - CloudBridge Co. #51,Sales Receipt,SaaS-GL,0.0,5661.28,GBP,Faster Payments Credit,CloudBridge Co. #51,***7254,INV-202407-SaaS-GL-0013,,False,False,REF-143301,First Continental Bank,***1982,Globex Consulting UK Ltd.,UK,2620624.4
2024-07-17,2024-07-17,Alphagrid Utilities,Rent & Utilities,ALL,825.37,0.0,GBP,CHAPS,Alphagrid Utilities,***7028,,,False,False,REF-907824,First Continental Bank,***1568,Globex Consulting UK Ltd.,UK,2619799.03
2024-07-17,2024-07-17,Client Receipt - CloudBridge Co. #55,Sales Receipt,SaaS-GL,0.0,2104.43,GBP,Faster Payments Credit,CloudBridge Co. #55,***1407,INV-202407-SaaS-GL-0017,,False,False,REF-829890,First Continental Bank,***7643,Globex Consulting UK Ltd.,UK,2621903.46
2024-07-17,2024-07-17,Client Receipt - CloudBridge Co. #11,Sales Receipt,SaaS-GL,0.0,3557.73,GBP,CHAPS Credit,CloudBridge Co. #11,***1335,INV-202407-SaaS-GL-0029,,False,False,REF-896820,First Continental Bank,***8484,Globex Consulting UK Ltd.,UK,2625461.19
2024-07-17,2024-07-17,Client Receipt - Vertex Advisory Client #14,Sales Receipt,PS-GL,0.0,27820.21,GBP,CHAPS Credit,Vertex Advisory Client #14,***6928,INV-202407-PS-GL-0004,,False,False,REF-687352,First Continental Bank,***1053,Globex Consulting UK Ltd.,UK,2653281.4
2024-07-18,2024-07-18,Supplier Payment - ExpertNet Subcontractors #17,Supplier Payment,PS-GL,3065.91,0.0,GBP,CHAPS,ExpertNet Subcontractors #17,***3336,,PO-202407-PS-GL-0002,False,False,REF-315780,First Continental Bank,***5211,Globex Consulting UK Ltd.,UK,2650215.49
2024-07-18,2024-07-18,Client Receipt - CloudBridge Co. #73,Sales Receipt,SaaS-GL,0.0,854.5,GBP,CHAPS Credit,CloudBridge Co. #73,***3955,INV-202407-SaaS-GL-0027,,False,False,REF-715982,First Continental Bank,***5339,Globex Consulting UK Ltd.,UK,2651069.99
2024-07-18,2024-07-18,Client Receipt - Novatek Components Ltd #5,Sales Receipt,CEM-EMEA,0.0,4599.74,GBP,CHAPS Credit,Novatek Components Ltd #5,***3952,INV-202407-CEM-EMEA-0009,,False,False,REF-214274,First Continental Bank,***4973,Globex Consulting UK Ltd.,UK,2655669.73
2024-07-18,2024-07-18,Client Receipt - CloudBridge Co. #1,Sales Receipt,SaaS-GL,0.0,15616.08,GBP,CHAPS Credit,CloudBridge Co. #1,***7063,INV-202407-SaaS-GL-0008,,False,False,REF-720478,First Continental Bank,***2178,Globex Consulting UK Ltd.,UK,2671285.81
2024-07-19,2024-07-19,Marketing - Beacon Digital #2,Marketing,ALL,2613.62,0.0,GBP,Faster Payments,Beacon Digital #2,***4110,,,False,False,REF-552515,First Continental Bank,***3083,Globex Consulting UK Ltd.,UK,2668672.19
2024-07-19,2024-07-19,Supplier Payment - CodeCraft Contractors #9,Supplier Payment,SaaS-GL,11494.1,0.0,GBP,CHAPS,CodeCraft Contractors #9,***5548,,PO-202407-SaaS-GL-0001,False,False,REF-513686,First Continental Bank,***2968,Globex Consulting UK Ltd.,UK,2657178.09
2024-07-19,2024-07-19,Marketing - Aurelia Media #6,Marketing,ALL,13457.48,0.0,GBP,CHAPS,Aurelia Media #6,***1171,,,False,False,REF-479162,First Continental Bank,***1237,Globex Consulting UK Ltd.,UK,2643720.61
2024-07-19,2024-07-19,Supplier Payment - Stelliform Parts BV #26,Supplier Payment,CEM-EMEA,56376.69,0.0,GBP,CHAPS,Stelliform Parts BV #26,***4999,,PO-202407-CEM-EMEA-0004,False,False,REF-854523,First Continental Bank,***5748,Globex Consulting UK Ltd.,UK,2587343.92
2024-07-20,2024-07-20,Supplier Payment - HyperCloud Infra #10,Supplier Payment,SaaS-GL,1290.69,0.0,GBP,CHAPS,HyperCloud Infra #10,***2186,,PO-202407-SaaS-GL-0004,False,False,REF-620142,First Continental Bank,***7588,Globex Consulting UK Ltd.,UK,2586053.23
2024-07-20,2024-07-20,Client Receipt - Vertex Advisory Client #11,Sales Receipt,PS-GL,0.0,5487.13,GBP,CHAPS Credit,Vertex Advisory Client #11,***4449,INV-202407-PS-GL-0003,,False,False,REF-431970,First Continental Bank,***8299,Globex Consulting UK Ltd.,UK,2591540.36
2024-07-20,2024-07-20,Client Receipt - Vertex Advisory Client #19,Sales Receipt,PS-GL,0.0,8262.96,GBP,CHAPS Credit,Vertex Advisory Client #19,***3711,INV-202407-PS-GL-0001,,False,False,REF-274757,First Continental Bank,***5536,Globex Consulting UK Ltd.,UK,2599803.32
2024-07-21,2024-07-21,BluePeak Property Mgmt,Rent & Utilities,ALL,4291.84,0.0,GBP,CHAPS,BluePeak Property Mgmt,***6196,,,False,False,REF-937361,First Continental Bank,***7709,Globex Consulting UK Ltd.,UK,2595511.48
2024-07-21,2024-07-21,VAT/GST Remittance - HMRC UK,Tax Payment,ALL,39527.12,0.0,GBP,CHAPS,HMRC UK,***5118,,,False,False,REF-405476,First Continental Bank,***6447,Globex Consulting UK Ltd.,UK,2555984.36
2024-07-22,2024-07-22,Supplier Payment - Stelliform Parts BV #30,Supplier Payment,CEM-EMEA,7061.2,0.0,GBP,CHAPS,Stelliform Parts BV #30,***9846,,PO-202407-CEM-EMEA-0007,False,False,REF-814137,First Continental Bank,***7270,Globex Consulting UK Ltd.,UK,2548923.16
2024-07-22,2024-07-22,Supplier Payment - EuroFab Assembly #17,Supplier Payment,CEM-EMEA,13490.33,0.0,GBP,CHAPS,EuroFab Assembly #17,***9267,,PO-202407-CEM-EMEA-0001,False,False,REF-702366,First Continental Bank,***3311,Globex Consulting UK Ltd.,UK,2535432.83
2024-07-23,2024-07-23,Supplier Payment - ExpertNet Subcontractors #17,Supplier Payment,PS-GL,4043.52,0.0,GBP,CHAPS,ExpertNet Subcontractors #17,***1170,,PO-202407-PS-GL-0009,False,False,REF-297135,First Continental Bank,***8965,Globex Consulting UK Ltd.,UK,2531389.31
2024-07-23,2024-07-23,Supplier Payment - Stelliform Parts BV #13,Supplier Payment,CEM-EMEA,33792.48,0.0,GBP,Faster Payments,Stelliform Parts BV #13,***5391,,PO-202407-CEM-EMEA-0006,False,False,REF-772692,First Continental Bank,***7324,Globex Consulting UK Ltd.,UK,2497596.83
2024-07-23,2024-07-23,Client Receipt - CloudBridge Co. #36,Sales Receipt,SaaS-GL,0.0,3533.58,GBP,Faster Payments Credit,CloudBridge Co. #36,***1166,INV-202407-SaaS-GL-0012,,False,False,REF-268789,First Continental Bank,***6745,Globex Consulting UK Ltd.,UK,2501130.41
2024-07-23,2024-07-23,Client Receipt - CloudBridge Co. #15,Sales Receipt,SaaS-GL,0.0,4939.71,GBP,CHAPS Credit,CloudBridge Co. #15,***1304,INV-202407-SaaS-GL-0007,,False,False,REF-357546,First Continental Bank,***5239,Globex Consulting UK Ltd.,UK,2506070.12
2024-07-23,2024-07-23,Client Receipt - Vertex Advisory Client #26,Sales Receipt,PS-GL,0.0,17292.58,GBP,CHAPS Credit,Vertex Advisory Client #26,***7120,INV-202407-PS-GL-0002,,False,False,REF-205825,First Continental Bank,***9093,Globex Consulting UK Ltd.,UK,2523362.7
2024-07-23,2024-07-23,Client Receipt - Aurora Electronics GmbH #6,Sales Receipt,CEM-EMEA,0.0,66408.54,GBP,CHAPS Credit,Aurora Electronics GmbH #6,***5636,INV-202407-CEM-EMEA-0002,,False,False,REF-984328,First Continental Bank,***5062,Globex Consulting UK Ltd.,UK,2589771.24
2024-07-24,2024-07-24,Supplier Payment - ExpertNet Subcontractors #10,Supplier Payment,PS-GL,4932.8,0.0,GBP,CHAPS,ExpertNet Subcontractors #10,***3328,,PO-202407-PS-GL-0007,False,False,REF-650857,First Continental Bank,***3179,Globex Consulting UK Ltd.,UK,2584838.44
2024-07-24,2024-07-24,Client Receipt - CloudBridge Co. #46,Sales Receipt,SaaS-GL,0.0,8725.58,GBP,CHAPS Credit,CloudBridge Co. #46,***9356,INV-202407-SaaS-GL-0011,,False,False,REF-460532,First Continental Bank,***1321,Globex Consulting UK Ltd.,UK,2593564.02
2024-07-25,2024-07-25,Client Receipt - Vertex Advisory Client #3,Sales Receipt,PS-GL,0.0,19092.79,GBP,Faster Payments Credit,Vertex Advisory Client #3,***1608,INV-202407-PS-GL-0009,,False,False,REF-860839,First Continental Bank,***3578,Globex Consulting UK Ltd.,UK,2612656.81
2024-07-25,2024-07-25,Client Receipt - Aurora Electronics GmbH #2,Sales Receipt,CEM-EMEA,0.0,80287.81,GBP,Faster Payments Credit,Aurora Electronics GmbH #2,***8538,INV-202407-CEM-EMEA-0008,,False,False,REF-143238,First Continental Bank,***9375,Globex Consulting UK Ltd.,UK,2692944.62
2024-07-26,2024-07-26,Payroll - GlobalPay Services Ltd,Payroll,ALL,103803.84,0.0,GBP,Faster Payments,GlobalPay Services Ltd,***8989,,,False,False,REF-503351,First Continental Bank,***1524,Globex Consulting UK Ltd.,UK,2589140.78
2024-07-26,2024-07-26,"Intercompany Settlement - Globex International Holdings, Inc.",Intercompany Transfer,ALL,465477.0,0.0,GBP,Internal Transfer,"Globex International Holdings, Inc.",***1253,,,True,True,REF-422684,First Continental Bank,***4428,Globex Consulting UK Ltd.,UK,2123663.78
2024-07-26,2024-07-26,"Intercompany Reimbursement - Globex International Holdings, Inc.",Intercompany Transfer,ALL,0.0,186190.8,GBP,Internal Transfer,"Globex International Holdings, Inc.",***1412,,,True,True,REF-802019,First Continental Bank,***6373,Globex Consulting UK Ltd.,UK,2309854.58
2024-07-27,2024-07-27,Client Receipt - Vertex Advisory Client #37,Sales Receipt,PS-GL,0.0,18860.56,GBP,CHAPS Credit,Vertex Advisory Client #37,***7670,INV-202407-PS-GL-0006,,False,False,REF-852679,First Continental Bank,***1690,Globex Consulting UK Ltd.,UK,2328715.14
2024-07-27,2024-07-27,Client Receipt - Aurora Electronics GmbH #2,Sales Receipt,CEM-EMEA,0.0,33454.8,GBP,Faster Payments Credit,Aurora Electronics GmbH #2,***1261,INV-202407-CEM-EMEA-0004,,False,False,REF-512363,First Continental Bank,***5027,Globex Consulting UK Ltd.,UK,2362169.94
2024-07-28,2024-07-28,Supplier Payment - ExpertNet Subcontractors #14,Supplier Payment,PS-GL,928.61,0.0,GBP,CHAPS,ExpertNet Subcontractors #14,***9661,,PO-202407-PS-GL-0008,False,False,REF-181979,First Continental Bank,***9511,Globex Consulting UK Ltd.,UK,2361241.33
2024-07-28,2024-07-28,Supplier Payment - EuroFab Assembly #6,Supplier Payment,CEM-EMEA,10825.03,0.0,GBP,Faster Payments,EuroFab Assembly #6,***8137,,PO-202407-CEM-EMEA-0005,False,False,REF-434865,First Continental Bank,***3184,Globex Consulting UK Ltd.,UK,2350416.3
2024-07-28,2024-07-28,Corporate Tax Estimate,Tax Payment,ALL,30266.83,0.0,GBP,CHAPS,HMRC UK,***8014,,,False,False,REF-209204,First Continental Bank,***5773,Globex Consulting UK Ltd.,UK,2320149.47
2024-07-28,2024-07-28,Client Receipt - CloudBridge Co. #34,Sales Receipt,SaaS-GL,0.0,3241.48,GBP,Faster Payments Credit,CloudBridge Co. #34,***1449,INV-202407-SaaS-GL-0015,,False,False,REF-337004,First Continental Bank,***5499,Globex Consulting UK Ltd.,UK,2323390.95
2024-07-29,2024-07-29,Supplier Payment - HyperCloud Infra #17,Supplier Payment,SaaS-GL,832.9,0.0,GBP,CHAPS,HyperCloud Infra #17,***7469,,PO-202407-SaaS-GL-0008,False,False,REF-761161,First Continental Bank,***9041,Globex Consulting UK Ltd.,UK,2322558.05
2024-07-29,2024-07-29,Supplier Payment - EuroFab Assembly #16,Supplier Payment,CEM-EMEA,22130.66,0.0,GBP,CHAPS,EuroFab Assembly #16,***5236,,PO-202407-CEM-EMEA-0002,False,False,REF-680221,First Continental Bank,***6984,Globex Consulting UK Ltd.,UK,2300427.39
2024-07-29,2024-07-29,Client Receipt - Vertex Advisory Client #7,Sales Receipt,PS-GL,0.0,3942.02,GBP,Faster Payments Credit,Vertex Advisory Client #7,***5932,INV-202407-PS-GL-0007,,False,False,REF-383793,First Continental Bank,***7876,Globex Consulting UK Ltd.,UK,2304369.41
2024-07-30,2024-07-30,Client Receipt - Aurora Electronics GmbH #2,Sales Receipt,CEM-EMEA,0.0,3118.63,GBP,CHAPS Credit,Aurora Electronics GmbH #2,***9167,INV-202407-CEM-EMEA-0001,,False,False,REF-743742,First Continental Bank,***5467,Globex Consulting UK Ltd.,UK,2307488.04
2024-07-30,2024-07-30,Interest Earned,Interest Income,ALL,0.0,12254.48,GBP,Faster Payments Credit,First Continental Bank,***4702,,,False,False,REF-725874,First Continental Bank,***3768,Globex Consulting UK Ltd.,UK,2319742.52
2024-07-30,2024-07-30,Client Receipt - Vertex Advisory Client #23,Sales Receipt,PS-GL,0.0,15736.52,GBP,CHAPS Credit,Vertex Advisory Client #23,***3353,INV-202407-PS-GL-0005,,False,False,REF-820004,First Continental Bank,***5772,Globex Consulting UK Ltd.,UK,2335479.04
2024-07-31,2024-07-31,Supplier Payment - CodeCraft Contractors #1,Supplier Payment,SaaS-GL,5502.22,0.0,GBP,CHAPS,CodeCraft Contractors #1,***5165,,PO-202407-SaaS-GL-0005,False,False,REF-690271,First Continental Bank,***8528,Globex Consulting UK Ltd.,UK,2329976.82
2024-07-31,2024-07-31,Supplier Payment - Stelliform Parts BV #7,Supplier Payment,CEM-EMEA,17997.43,0.0,GBP,Faster Payments,Stelliform Parts BV #7,***3035,,PO-202407-CEM-EMEA-0003,False,False,REF-822962,First Continental Bank,***7098,Globex Consulting UK Ltd.,UK,2311979.39
2024-07-31,2024-07-31,Client Receipt - CloudBridge Co. #25,Sales Receipt,SaaS-GL,0.0,9183.08,GBP,CHAPS Credit,CloudBridge Co. #25,***1005,INV-202407-SaaS-GL-0010,,False,False,REF-152336,First Continental Bank,***1004,Globex Consulting UK Ltd.,UK,2321162.47
2024-08-01,2024-08-01,Supplier Payment - ExpertNet Subcontractors #15,Supplier Payment,PS-GL,2168.28,0.0,GBP,CHAPS,ExpertNet Subcontractors #15,***5366,,PO-202408-PS-GL-0007,False,False,REF-934053,First Continental Bank,***7576,Globex Consulting UK Ltd.,UK,2318994.19
2024-08-01,2024-08-01,Account Maintenance Fee,Bank/Merchant Fees,ALL,2500.0,0.0,GBP,Faster Payments,First Continental Bank,***9895,,,False,False,REF-578164,First Continental Bank,***8264,Globex Consulting UK Ltd.,UK,2316494.19
2024-08-01,2024-08-01,Supplier Payment - ExpertNet Subcontractors #9,Supplier Payment,PS-GL,4710.88,0.0,GBP,Faster Payments,ExpertNet Subcontractors #9,***4538,,PO-202408-PS-GL-0002,False,False,REF-950191,First Continental Bank,***7824,Globex Consulting UK Ltd.,UK,2311783.31
2024-08-01,2024-08-01,Client Receipt - CloudBridge Co. #11,Sales Receipt,SaaS-GL,0.0,5251.6,GBP,CHAPS Credit,CloudBridge Co. #11,***7482,INV-202408-SaaS-GL-0013,,False,False,REF-873518,First Continental Bank,***3373,Globex Consulting UK Ltd.,UK,2317034.91
2024-08-01,2024-08-01,Client Receipt - Aurora Electronics GmbH #8,Sales Receipt,CEM-EMEA,0.0,6267.58,GBP,CHAPS Credit,Aurora Electronics GmbH #8,***1522,INV-202408-CEM-EMEA-0003,,False,False,REF-458337,First Continental Bank,***2672,Globex Consulting UK Ltd.,UK,2323302.49
2024-08-01,2024-08-01,Client Receipt - Aurora Electronics GmbH #8,Sales Receipt,CEM-EMEA,0.0,18152.2,GBP,CHAPS Credit,Aurora Electronics GmbH #8,***5950,INV-202408-CEM-EMEA-0011,,False,False,REF-100151,First Continental Bank,***6426,Globex Consulting UK Ltd.,UK,2341454.69
2024-08-01,2024-08-01,Client Receipt - Novatek Components Ltd #10,Sales Receipt,CEM-EMEA,0.0,23382.07,GBP,Faster Payments Credit,Novatek Components Ltd #10,***6254,INV-202408-CEM-EMEA-0007,,False,False,REF-813409,First Continental Bank,***9433,Globex Consulting UK Ltd.,UK,2364836.76
2024-08-02,2024-08-02,Supplier Payment - HyperCloud Infra #18,Supplier Payment,SaaS-GL,2271.05,0.0,GBP,Faster Payments,HyperCloud Infra #18,***3163,,PO-202408-SaaS-GL-0009,False,False,REF-874354,First Continental Bank,***1072,Globex Consulting UK Ltd.,UK,2362565.71
2024-08-02,2024-08-02,Client Receipt - CloudBridge Co. #39,Sales Receipt,SaaS-GL,0.0,4955.08,GBP,CHAPS Credit,CloudBridge Co. #39,***4659,INV-202408-SaaS-GL-0001,,False,False,REF-510083,First Continental Bank,***1347,Globex Consulting UK Ltd.,UK,2367520.79
2024-08-02,2024-08-02,Client Receipt - Vertex Advisory Client #2,Sales Receipt,PS-GL,0.0,14031.84,GBP,CHAPS Credit,Vertex Advisory Client #2,***5627,INV-202408-PS-GL-0009,,False,False,REF-580667,First Continental Bank,***6985,Globex Consulting UK Ltd.,UK,2381552.63
2024-08-02,2024-08-02,Client Receipt - Aurora Electronics GmbH #19,Sales Receipt,CEM-EMEA,0.0,36998.66,GBP,Faster Payments Credit,Aurora Electronics GmbH #19,***2819,INV-202408-CEM-EMEA-0006,,False,False,REF-536404,First Continental Bank,***1946,Globex Consulting UK Ltd.,UK,2418551.29
2024-08-04,2024-08-04,Client Receipt - CloudBridge Co. #22,Sales Receipt,SaaS-GL,0.0,6550.4,GBP,Faster Payments Credit,CloudBridge Co. #22,***8787,INV-202408-SaaS-GL-0016,,False,False,REF-870636,First Continental Bank,***1637,Globex Consulting UK Ltd.,UK,2425101.69
2024-08-04,2024-08-04,Client Receipt - CloudBridge Co. #15,Sales Receipt,SaaS-GL,0.0,6783.85,GBP,Faster Payments Credit,CloudBridge Co. #15,***3947,INV-202408-SaaS-GL-0012,,False,False,REF-120926,First Continental Bank,***6377,Globex Consulting UK Ltd.,UK,2431885.54
2024-08-04,2024-08-04,Client Receipt - CloudBridge Co. #53,Sales Receipt,SaaS-GL,0.0,8390.05,GBP,CHAPS Credit,CloudBridge Co. #53,***8693,INV-202408-SaaS-GL-0010,,False,False,REF-257165,First Continental Bank,***8299,Globex Consulting UK Ltd.,UK,2440275.59
2024-08-04,2024-08-04,Client Receipt - Vertex Advisory Client #56,Sales Receipt,PS-GL,0.0,15001.39,GBP,CHAPS Credit,Vertex Advisory Client #56,***1622,INV-202408-PS-GL-0003,,False,False,REF-599685,First Continental Bank,***4995,Globex Consulting UK Ltd.,UK,2455276.98
2024-08-06,2024-08-06,Supplier Payment - ExpertNet Subcontractors #11,Supplier Payment,PS-GL,655.56,0.0,GBP,Faster Payments,ExpertNet Subcontractors #11,***6563,,PO-202408-PS-GL-0003,False,False,REF-884537,First Continental Bank,***7675,Globex Consulting UK Ltd.,UK,2454621.42
2024-08-06,2024-08-06,Supplier Payment - HyperCloud Infra #11,Supplier Payment,SaaS-GL,1833.81,0.0,GBP,Faster Payments,HyperCloud Infra #11,***9505,,PO-202408-SaaS-GL-0002,False,False,REF-637085,First Continental Bank,***9986,Globex Consulting UK Ltd.,UK,2452787.61
2024-08-06,2024-08-06,Supplier Payment - CodeCraft Contractors #7,Supplier Payment,SaaS-GL,4398.92,0.0,GBP,CHAPS,CodeCraft Contractors #7,***7828,,PO-202408-SaaS-GL-0005,False,False,REF-355161,First Continental Bank,***6342,Globex Consulting UK Ltd.,UK,2448388.69
2024-08-06,2024-08-06,Marketing - Aurelia Media #1,Marketing,ALL,10095.43,0.0,GBP,CHAPS,Aurelia Media #1,***1931,,,False,False,REF-152070,First Continental Bank,***7125,Globex Consulting UK Ltd.,UK,2438293.26
2024-08-06,2024-08-06,Supplier Payment - ExpertNet Subcontractors #1,Supplier Payment,PS-GL,16026.08,0.0,GBP,CHAPS,ExpertNet Subcontractors #1,***8091,,PO-202408-PS-GL-0004,False,False,REF-299400,First Continental Bank,***6395,Globex Consulting UK Ltd.,UK,2422267.18
2024-08-06,2024-08-06,Client Receipt - CloudBridge Co. #18,Sales Receipt,SaaS-GL,0.0,9083.85,GBP,CHAPS Credit,CloudBridge Co. #18,***8504,INV-202408-SaaS-GL-0003,,False,False,REF-823761,First Continental Bank,***4653,Globex Consulting UK Ltd.,UK,2431351.03
2024-08-06,2024-08-06,Client Receipt - Aurora Electronics GmbH #15,Sales Receipt,CEM-EMEA,0.0,36801.29,GBP,CHAPS Credit,Aurora Electronics GmbH #15,***4423,INV-202408-CEM-EMEA-0008,,False,False,REF-491400,First Continental Bank,***8678,Globex Consulting UK Ltd.,UK,2468152.32
2024-08-07,2024-08-07,Client Receipt - CloudBridge Co. #27,Sales Receipt,SaaS-GL,0.0,13350.12,GBP,Faster Payments Credit,CloudBridge Co. #27,***7832,INV-202408-SaaS-GL-0009,,False,False,REF-875141,First Continental Bank,***8162,Globex Consulting UK Ltd.,UK,2481502.44
2024-08-08,2024-08-08,Supplier Payment - HyperCloud Infra #19,Supplier Payment,SaaS-GL,1186.54,0.0,GBP,CHAPS,HyperCloud Infra #19,***2117,,PO-202408-SaaS-GL-0008,False,False,REF-219020,First Continental Bank,***6783,Globex Consulting UK Ltd.,UK,2480315.9
2024-08-08,2024-08-08,Supplier Payment - CodeCraft Contractors #1,Supplier Payment,SaaS-GL,5183.26,0.0,GBP,Faster Payments,CodeCraft Contractors #1,***7891,,PO-202408-SaaS-GL-0004,False,False,REF-644719,First Continental Bank,***3047,Globex Consulting UK Ltd.,UK,2475132.64
2024-08-09,2024-08-09,Supplier Payment - ExpertNet Subcontractors #4,Supplier Payment,PS-GL,1320.57,0.0,GBP,Faster Payments,ExpertNet Subcontractors #4,***9775,,PO-202408-PS-GL-0001,False,False,REF-548119,First Continental Bank,***3170,Globex Consulting UK Ltd.,UK,2473812.07
2024-08-09,2024-08-09,Client Receipt - CloudBridge Co. #56,Sales Receipt,SaaS-GL,0.0,20096.04,GBP,CHAPS Credit,CloudBridge Co. #56,***8055,INV-202408-SaaS-GL-0015,,False,False,REF-205254,First Continental Bank,***6121,Globex Consulting UK Ltd.,UK,2493908.11
2024-08-10,2024-08-10,Client Receipt - CloudBridge Co. #16,Sales Receipt,SaaS-GL,0.0,9697.37,GBP,Faster Payments Credit,CloudBridge Co. #16,***1853,INV-202408-SaaS-GL-0007,,False,False,REF-961189,First Continental Bank,***8034,Globex Consulting UK Ltd.,UK,2503605.48
2024-08-12,2024-08-12,Supplier Payment - Stelliform Parts BV #26,Supplier Payment,CEM-EMEA,27812.53,0.0,GBP,Faster Payments,Stelliform Parts BV #26,***3001,,PO-202408-CEM-EMEA-0001,False,False,REF-752155,First Continental Bank,***6449,Globex Consulting UK Ltd.,UK,2475792.95
2024-08-12,2024-08-12,Supplier Payment - Stelliform Parts BV #34,Supplier Payment,CEM-EMEA,42001.52,0.0,GBP,Faster Payments,Stelliform Parts BV #34,***5833,,PO-202408-CEM-EMEA-0003,False,False,REF-341468,First Continental Bank,***3942,Globex Consulting UK Ltd.,UK,2433791.43
2024-08-12,2024-08-12,Intercompany Settlement - Globex EMEA Manufacturing Ltd.,Intercompany Transfer,ALL,580519.0,0.0,GBP,Internal Transfer,Globex EMEA Manufacturing Ltd.,***3759,,,True,True,REF-754238,First Continental Bank,***5219,Globex Consulting UK Ltd.,UK,1853272.43
2024-08-12,2024-08-12,Client Receipt - Novatek Components Ltd #4,Sales Receipt,CEM-EMEA,0.0,53497.92,GBP,Faster Payments Credit,Novatek Components Ltd #4,***7546,INV-202408-CEM-EMEA-0013,,False,False,REF-287606,First Continental Bank,***9981,Globex Consulting UK Ltd.,UK,1906770.35
2024-08-13,2024-08-13,Supplier Payment - EuroFab Assembly #21,Supplier Payment,CEM-EMEA,14773.28,0.0,GBP,Faster Payments,EuroFab Assembly #21,***1979,,PO-202408-CEM-EMEA-0007,False,False,REF-969908,First Continental Bank,***3780,Globex Consulting UK Ltd.,UK,1891997.07
2024-08-13,2024-08-13,Supplier Payment - EuroFab Assembly #16,Supplier Payment,CEM-EMEA,18856.74,0.0,GBP,Faster Payments,EuroFab Assembly #16,***2611,,PO-202408-CEM-EMEA-0004,False,False,REF-579149,First Continental Bank,***7103,Globex Consulting UK Ltd.,UK,1873140.33
2024-08-13,2024-08-13,Supplier Payment - Stelliform Parts BV #34,Supplier Payment,CEM-EMEA,18868.0,0.0,GBP,Faster Payments,Stelliform Parts BV #34,***4158,,PO-202408-CEM-EMEA-0005,False,False,REF-252672,First Continental Bank,***6761,Globex Consulting UK Ltd.,UK,1854272.33
2024-08-13,2024-08-13,Client Receipt - Aurora Electronics GmbH #9,Sales Receipt,CEM-EMEA,0.0,2544.42,GBP,Faster Payments Credit,Aurora Electronics GmbH #9,***4034,INV-202408-CEM-EMEA-0002,,False,False,REF-470500,First Continental Bank,***8511,Globex Consulting UK Ltd.,UK,1856816.75
2024-08-13,2024-08-13,Client Receipt - Vertex Advisory Client #10,Sales Receipt,PS-GL,0.0,6936.05,GBP,Faster Payments Credit,Vertex Advisory Client #10,***1457,INV-202408-PS-GL-0004,,False,False,REF-463246,First Continental Bank,***9667,Globex Consulting UK Ltd.,UK,1863752.8
2024-08-14,2024-08-14,Supplier Payment - Stelliform Parts BV #24,Supplier Payment,CEM-EMEA,14470.04,0.0,GBP,CHAPS,Stelliform Parts BV #24,***5754,,PO-202408-CEM-EMEA-0008,False,False,REF-576263,First Continental Bank,***5777,Globex Consulting UK Ltd.,UK,1849282.76
2024-08-14,2024-08-14,Client Receipt - Vertex Advisory Client #5,Sales Receipt,PS-GL,0.0,12059.49,GBP,CHAPS Credit,Vertex Advisory Client #5,***6252,INV-202408-PS-GL-0008,,False,False,REF-852456,First Continental Bank,***7013,Globex Consulting UK Ltd.,UK,1861342.25
2024-08-15,2024-08-15,Merchant Processing Fees,Bank/Merchant Fees,ALL,1549.29,0.0,GBP,CHAPS,First Continental Bank,***4532,,,False,False,REF-781980,First Continental Bank,***6871,Globex Consulting UK Ltd.,UK,1859792.96
2024-08-15,2024-08-15,Supplier Payment - ExpertNet Subcontractors #13,Supplier Payment,PS-GL,4931.98,0.0,GBP,Faster Payments,ExpertNet Subcontractors #13,***9720,,PO-202408-PS-GL-0005,False,False,REF-778266,First Continental Bank,***5987,Globex Consulting UK Ltd.,UK,1854860.98
2024-08-15,2024-08-15,Client Receipt - CloudBridge Co. #4,Sales Receipt,SaaS-GL,0.0,1151.72,GBP,CHAPS Credit,CloudBridge Co. #4,***6966,INV-202408-SaaS-GL-0017,,False,False,REF-800039,First Continental Bank,***2683,Globex Consulting UK Ltd.,UK,1856012.7
2024-08-15,2024-08-15,Client Receipt - Vertex Advisory Client #54,Sales Receipt,PS-GL,0.0,13985.74,GBP,CHAPS Credit,Vertex Advisory Client #54,***5843,INV-202408-PS-GL-0011,,False,False,REF-872214,First Continental Bank,***8162,Globex Consulting UK Ltd.,UK,1869998.44
2024-08-16,2024-08-16,Merchant Processing Fees,Bank/Merchant Fees,ALL,306.56,0.0,GBP,Faster Payments,First Continental Bank,***4324,,,False,False,REF-435327,First Continental Bank,***1241,Globex Consulting UK Ltd.,UK,1869691.88
2024-08-16,2024-08-16,Supplier Payment - HyperCloud Infra #12,Supplier Payment,SaaS-GL,3130.5,0.0,GBP,CHAPS,HyperCloud Infra #12,***2501,,PO-202408-SaaS-GL-0007,False,False,REF-608868,First Continental Bank,***1226,Globex Consulting UK Ltd.,UK,1866561.38
2024-08-16,2024-08-16,Supplier Payment - ExpertNet Subcontractors #4,Supplier Payment,PS-GL,3802.49,0.0,GBP,CHAPS,ExpertNet Subcontractors #4,***6545,,PO-202408-PS-GL-0006,False,False,REF-265206,First Continental Bank,***8660,Globex Consulting UK Ltd.,UK,1862758.89
2024-08-16,2024-08-16,Client Receipt - Vertex Advisory Client #29,Sales Receipt,PS-GL,0.0,9871.42,GBP,Faster Payments Credit,Vertex Advisory Client #29,***6132,INV-202408-PS-GL-0010,,False,False,REF-737814,First Continental Bank,***1471,Globex Consulting UK Ltd.,UK,1872630.31
2024-08-17,2024-08-17,Client Receipt - CloudBridge Co. #54,Sales Receipt,SaaS-GL,0.0,8316.39,GBP,CHAPS Credit,CloudBridge Co. #54,***8990,INV-202408-SaaS-GL-0014,,False,False,REF-145587,First Continental Bank,***7783,Globex Consulting UK Ltd.,UK,1880946.7
2024-08-17,2024-08-17,Client Receipt - Aurora Electronics GmbH #13,Sales Receipt,CEM-EMEA,0.0,18898.2,GBP,CHAPS Credit,Aurora Electronics GmbH #13,***5250,INV-202408-CEM-EMEA-0010,,False,False,REF-228833,First Continental Bank,***4831,Globex Consulting UK Ltd.,UK,1899844.9
2024-08-18,2024-08-18,Client Receipt - Novatek Components Ltd #1,Sales Receipt,CEM-EMEA,0.0,726.53,GBP,Faster Payments Credit,Novatek Components Ltd #1,***9067,INV-202408-CEM-EMEA-0012,,False,False,REF-945260,First Continental Bank,***2087,Globex Consulting UK Ltd.,UK,1900571.43
2024-08-19,2024-08-19,Supplier Payment - Stelliform Parts BV #31,Supplier Payment,CEM-EMEA,16420.52,0.0,GBP,Faster Payments,Stelliform Parts BV #31,***3972,,PO-202408-CEM-EMEA-0002,False,False,REF-423740,First Continental Bank,***3349,Globex Consulting UK Ltd.,UK,1884150.91
2024-08-19,2024-08-19,VAT/GST Remittance - HMRC UK,Tax Payment,ALL,37197.22,0.0,GBP,CHAPS,HMRC UK,***2263,,,False,False,REF-116724,First Continental Bank,***3633,Globex Consulting UK Ltd.,UK,1846953.69
2024-08-19,2024-08-19,Client Receipt - CloudBridge Co. #21,Sales Receipt,SaaS-GL,0.0,708.91,GBP,CHAPS Credit,CloudBridge Co. #21,***9542,INV-202408-SaaS-GL-0020,,False,False,REF-204428,First Continental Bank,***2321,Globex Consulting UK Ltd.,UK,1847662.6
2024-08-20,2024-08-20,Supplier Payment - ExpertNet Subcontractors #2,Supplier Payment,PS-GL,4735.72,0.0,GBP,CHAPS,ExpertNet Subcontractors #2,***7036,,PO-202408-PS-GL-0008,False,False,REF-196435,First Continental Bank,***7717,Globex Consulting UK Ltd.,UK,1842926.88
2024-08-21,2024-08-21,Marketing - Aurelia Media #5,Marketing,ALL,4073.74,0.0,GBP,Faster Payments,Aurelia Media #5,***3306,,,False,False,REF-887068,First Continental Bank,***4145,Globex Consulting UK Ltd.,UK,1838853.14
2024-08-21,2024-08-21,Alphagrid Utilities,Rent & Utilities,ALL,4995.59,0.0,GBP,CHAPS,Alphagrid Utilities,***2964,,,False,False,REF-840645,First Continental Bank,***1783,Globex Consulting UK Ltd.,UK,1833857.55
2024-08-21,2024-08-21,Client Receipt - CloudBridge Co. #21,Sales Receipt,SaaS-GL,0.0,2541.42,GBP,Faster Payments Credit,CloudBridge Co. #21,***7201,INV-202408-SaaS-GL-0005,,False,False,REF-321115,First Continental Bank,***1199,Globex Consulting UK Ltd.,UK,1836398.97
2024-08-21,2024-08-21,Client Receipt - CloudBridge Co. #28,Sales Receipt,SaaS-GL,0.0,6230.6,GBP,Faster Payments Credit,CloudBridge Co. #28,***8183,INV-202408-SaaS-GL-0019,,False,False,REF-380088,First Continental Bank,***4792,Globex Consulting UK Ltd.,UK,1842629.57
2024-08-22,2024-08-22,Supplier Payment - HyperCloud Infra #9,Supplier Payment,SaaS-GL,4422.31,0.0,GBP,Faster Payments,HyperCloud Infra #9,***5727,,PO-202408-SaaS-GL-0006,False,False,REF-823574,First Continental Bank,***2316,Globex Consulting UK Ltd.,UK,1838207.26
2024-08-22,2024-08-22,Client Receipt - CloudBridge Co. #53,Sales Receipt,SaaS-GL,0.0,5627.22,GBP,CHAPS Credit,CloudBridge Co. #53,***7788,INV-202408-SaaS-GL-0004,,False,False,REF-750395,First Continental Bank,***4250,Globex Consulting UK Ltd.,UK,1843834.48
2024-08-22,2024-08-22,Client Receipt - CloudBridge Co. #44,Sales Receipt,SaaS-GL,0.0,9294.32,GBP,CHAPS Credit,CloudBridge Co. #44,***3986,INV-202408-SaaS-GL-0008,,False,False,REF-623767,First Continental Bank,***7387,Globex Consulting UK Ltd.,UK,1853128.8
2024-08-22,2024-08-22,Client Receipt - Vertex Advisory Client #1,Sales Receipt,PS-GL,0.0,11912.29,GBP,CHAPS Credit,Vertex Advisory Client #1,***4691,INV-202408-PS-GL-0006,,False,False,REF-336208,First Continental Bank,***3937,Globex Consulting UK Ltd.,UK,1865041.09
2024-08-22,2024-08-22,Client Receipt - Vertex Advisory Client #17,Sales Receipt,PS-GL,0.0,22985.72,GBP,Faster Payments Credit,Vertex Advisory Client #17,***9460,INV-202408-PS-GL-0007,,False,False,REF-848304,First Continental Bank,***8354,Globex Consulting UK Ltd.,UK,1888026.81
2024-08-22,2024-08-22,Client Receipt - CloudBridge Co. #17,Sales Receipt,SaaS-GL,0.0,38982.74,GBP,CHAPS Credit,CloudBridge Co. #17,***1283,INV-202408-SaaS-GL-0002,,False,False,REF-120328,First Continental Bank,***4118,Globex Consulting UK Ltd.,UK,1927009.55
2024-08-23,2024-08-23,Client Receipt - CloudBridge Co. #43,Sales Receipt,SaaS-GL,0.0,5216.67,GBP,CHAPS Credit,CloudBridge Co. #43,***7755,INV-202408-SaaS-GL-0021,,False,False,REF-228893,First Continental Bank,***8060,Globex Consulting UK Ltd.,UK,1932226.22
2024-08-26,2024-08-26,Marketing - Aurelia Media #2,Marketing,ALL,1693.99,0.0,GBP,CHAPS,Aurelia Media #2,***7677,,,False,False,REF-265147,First Continental Bank,***9828,Globex Consulting UK Ltd.,UK,1930532.23
2024-08-26,2024-08-26,Supplier Payment - HyperCloud Infra #1,Supplier Payment,SaaS-GL,4546.79,0.0,GBP,Faster Payments,HyperCloud Infra #1,***5966,,PO-202408-SaaS-GL-0003,False,False,REF-309424,First Continental Bank,***6393,Globex Consulting UK Ltd.,UK,1925985.44
2024-08-26,2024-08-26,Intercompany Settlement - Globex APAC Logistics Pte. Ltd.,Intercompany Transfer,ALL,393407.0,0.0,GBP,Internal Transfer,Globex APAC Logistics Pte. Ltd.,***2767,,,True,True,REF-186903,First Continental Bank,***1932,Globex Consulting UK Ltd.,UK,1532578.44
2024-08-26,2024-08-26,Client Receipt - CloudBridge Co. #36,Sales Receipt,SaaS-GL,0.0,1330.4,GBP,Faster Payments Credit,CloudBridge Co. #36,***4183,INV-202408-SaaS-GL-0006,,False,False,REF-204798,First Continental Bank,***4988,Globex Consulting UK Ltd.,UK,1533908.84
2024-08-26,2024-08-26,Client Receipt - Vertex Advisory Client #11,Sales Receipt,PS-GL,0.0,4197.4,GBP,CHAPS Credit,Vertex Advisory Client #11,***5770,INV-202408-PS-GL-0002,,False,False,REF-327280,First Continental Bank,***1354,Globex Consulting UK Ltd.,UK,1538106.24
2024-08-26,2024-08-26,Client Receipt - Vertex Advisory Client #18,Sales Receipt,PS-GL,0.0,14174.91,GBP,CHAPS Credit,Vertex Advisory Client #18,***5630,INV-202408-PS-GL-0005,,False,False,REF-309477,First Continental Bank,***7639,Globex Consulting UK Ltd.,UK,1552281.15
2024-08-26,2024-08-26,Client Receipt - Aurora Electronics GmbH #13,Sales Receipt,CEM-EMEA,0.0,19368.22,GBP,Faster Payments Credit,Aurora Electronics GmbH #13,***6824,INV-202408-CEM-EMEA-0009,,False,False,REF-966066,First Continental Bank,***9204,Globex Consulting UK Ltd.,UK,1571649.37
2024-08-26,2024-08-26,Client Receipt - Aurora Electronics GmbH #16,Sales Receipt,CEM-EMEA,0.0,21386.33,GBP,CHAPS Credit,Aurora Electronics GmbH #16,***7976,INV-202408-CEM-EMEA-0004,,False,False,REF-242322,First Continental Bank,***1467,Globex Consulting UK Ltd.,UK,1593035.7
2024-08-27,2024-08-27,Payroll - GlobalPay Services Ltd,Payroll,ALL,49132.31,0.0,GBP,CHAPS,GlobalPay Services Ltd,***7608,,,False,False,REF-871438,First Continental Bank,***1238,Globex Consulting UK Ltd.,UK,1543903.39
2024-08-27,2024-08-27,Client Receipt - Vertex Advisory Client #53,Sales Receipt,PS-GL,0.0,2682.27,GBP,CHAPS Credit,Vertex Advisory Client #53,***3382,INV-202408-PS-GL-0001,,False,False,REF-136895,First Continental Bank,***4126,Globex Consulting UK Ltd.,UK,1546585.66
2024-08-27,2024-08-27,Client Receipt - CloudBridge Co. #42,Sales Receipt,SaaS-GL,0.0,17183.1,GBP,Faster Payments Credit,CloudBridge Co. #42,***2654,INV-202408-SaaS-GL-0018,,False,False,REF-547849,First Continental Bank,***7157,Globex Consulting UK Ltd.,UK,1563768.76
2024-08-28,2024-08-28,Supplier Payment - EuroFab Assembly #23,Supplier Payment,CEM-EMEA,25771.3,0.0,GBP,CHAPS,EuroFab Assembly #23,***1415,,PO-202408-CEM-EMEA-0006,False,False,REF-645413,First Continental Bank,***3852,Globex Consulting UK Ltd.,UK,1537997.46
2024-08-28,2024-08-28,Payroll - GlobalPay Services Ltd,Payroll,ALL,49132.31,0.0,GBP,CHAPS,GlobalPay Services Ltd,***2952,,,False,False,REF-810367,First Continental Bank,***9838,Globex Consulting UK Ltd.,UK,1488865.15
2024-08-28,2024-08-28,Client Receipt - Novatek Components Ltd #14,Sales Receipt,CEM-EMEA,0.0,19999.16,GBP,Faster Payments Credit,Novatek Components Ltd #14,***6275,INV-202408-CEM-EMEA-0001,,False,False,REF-337734,First Continental Bank,***6803,Globex Consulting UK Ltd.,UK,1508864.31
2024-08-29,2024-08-29,Supplier Payment - HyperCloud Infra #1,Supplier Payment,SaaS-GL,15213.53,0.0,GBP,CHAPS,HyperCloud Infra #1,***3346,,PO-202408-SaaS-GL-0001,False,False,REF-235505,First Continental Bank,***3686,Globex Consulting UK Ltd.,UK,1493650.78
2024-08-29,2024-08-29,Client Receipt - CloudBridge Co. #71,Sales Receipt,SaaS-GL,0.0,11015.93,GBP,Faster Payments Credit,CloudBridge Co. #71,***5287,INV-202408-SaaS-GL-0011,,False,False,REF-965331,First Continental Bank,***7698,Globex Consulting UK Ltd.,UK,1504666.71
2024-08-30,2024-08-30,Interest Earned,Interest Income,ALL,0.0,10557.18,GBP,CHAPS Credit,First Continental Bank,***1996,,,False,False,REF-461543,First Continental Bank,***6157,Globex Consulting UK Ltd.,UK,1515223.89
2024-08-31,2024-08-31,Client Receipt - Novatek Components Ltd #10,Sales Receipt,CEM-EMEA,0.0,40267.3,GBP,Faster Payments Credit,Novatek Components Ltd #10,***7278,INV-202408-CEM-EMEA-0005,,False,False,REF-916626,First Continental Bank,***6866,Globex Consulting UK Ltd.,UK,1555491.19
2024-09-01,2024-09-01,Account Maintenance Fee,Bank/Merchant Fees,ALL,2500.0,0.0,GBP,CHAPS,First Continental Bank,***3343,,,False,False,REF-491399,First Continental Bank,***9731,Globex Consulting UK Ltd.,UK,1552991.19
2024-09-02,2024-09-02,Alphagrid Utilities,Rent & Utilities,ALL,1227.59,0.0,GBP,CHAPS,Alphagrid Utilities,***7977,,,False,False,REF-226379,First Continental Bank,***8810,Globex Consulting UK Ltd.,UK,1551763.6
2024-09-02,2024-09-02,Marketing - Aurelia Media #3,Marketing,ALL,4918.12,0.0,GBP,CHAPS,Aurelia Media #3,***5643,,,False,False,REF-725578,First Continental Bank,***8365,Globex Consulting UK Ltd.,UK,1546845.48
2024-09-02,2024-09-02,Client Receipt - Novatek Components Ltd #12,Sales Receipt,CEM-EMEA,0.0,5459.81,GBP,Faster Payments Credit,Novatek Components Ltd #12,***9228,INV-202409-CEM-EMEA-0002,,False,False,REF-424726,First Continental Bank,***6694,Globex Consulting UK Ltd.,UK,1552305.29
2024-09-03,2024-09-03,Client Receipt - CloudBridge Co. #37,Sales Receipt,SaaS-GL,0.0,2233.53,GBP,Faster Payments Credit,CloudBridge Co. #37,***2828,INV-202409-SaaS-GL-0006,,False,False,REF-945944,First Continental Bank,***1403,Globex Consulting UK Ltd.,UK,1554538.82
2024-09-03,2024-09-03,Client Receipt - CloudBridge Co. #59,Sales Receipt,SaaS-GL,0.0,5401.12,GBP,Faster Payments Credit,CloudBridge Co. #59,***9702,INV-202409-SaaS-GL-0007,,False,False,REF-835655,First Continental Bank,***8251,Globex Consulting UK Ltd.,UK,1559939.94
2024-09-03,2024-09-03,Client Receipt - Novatek Components Ltd #8,Sales Receipt,CEM-EMEA,0.0,9805.47,GBP,Faster Payments Credit,Novatek Components Ltd #8,***3715,INV-202409-CEM-EMEA-0006,,False,False,REF-521013,First Continental Bank,***2486,Globex Consulting UK Ltd.,UK,1569745.41
2024-09-03,2024-09-03,Client Receipt - Aurora Electronics GmbH #2,Sales Receipt,CEM-EMEA,0.0,14383.35,GBP,Faster Payments Credit,Aurora Electronics GmbH #2,***8696,INV-202409-CEM-EMEA-0003,,False,False,REF-853948,First Continental Bank,***8863,Globex Consulting UK Ltd.,UK,1584128.76
2024-09-04,2024-09-04,Marketing - Aurelia Media #10,Marketing,ALL,9178.03,0.0,GBP,Faster Payments,Aurelia Media #10,***1662,,,False,False,REF-387018,First Continental Bank,***4016,Globex Consulting UK Ltd.,UK,1574950.73
2024-09-04,2024-09-04,Client Receipt - CloudBridge Co. #62,Sales Receipt,SaaS-GL,0.0,3769.39,GBP,Faster Payments Credit,CloudBridge Co. #62,***1298,INV-202409-SaaS-GL-0022,,False,False,REF-807719,First Continental Bank,***2799,Globex Consulting UK Ltd.,UK,1578720.12
2024-09-04,2024-09-04,Client Receipt - CloudBridge Co. #29,Sales Receipt,SaaS-GL,0.0,14909.54,GBP,CHAPS Credit,CloudBridge Co. #29,***8008,INV-202409-SaaS-GL-0014,,False,False,REF-639167,First Continental Bank,***5683,Globex Consulting UK Ltd.,UK,1593629.66
2024-09-04,2024-09-04,Client Receipt - Novatek Components Ltd #2,Sales Receipt,CEM-EMEA,0.0,31394.08,GBP,Faster Payments Credit,Novatek Components Ltd #2,***1606,INV-202409-CEM-EMEA-0012,,False,False,REF-942610,First Continental Bank,***7632,Globex Consulting UK Ltd.,UK,1625023.74
2024-09-05,2024-09-05,Client Receipt - Vertex Advisory Client #22,Sales Receipt,PS-GL,0.0,4663.65,GBP,CHAPS Credit,Vertex Advisory Client #22,***1966,INV-202409-PS-GL-0003,,False,False,REF-713900,First Continental Bank,***9326,Globex Consulting UK Ltd.,UK,1629687.39
2024-09-05,2024-09-05,Client Receipt - CloudBridge Co. #30,Sales Receipt,SaaS-GL,0.0,9918.04,GBP,Faster Payments Credit,CloudBridge Co. #30,***1409,INV-202409-SaaS-GL-0028,,False,False,REF-433584,First Continental Bank,***1247,Globex Consulting UK Ltd.,UK,1639605.43
2024-09-06,2024-09-06,Supplier Payment - ExpertNet Subcontractors #2,Supplier Payment,PS-GL,2765.89,0.0,GBP,Faster Payments,ExpertNet Subcontractors #2,***4036,,PO-202409-PS-GL-0004,False,False,REF-977942,First Continental Bank,***6384,Globex Consulting UK Ltd.,UK,1636839.54
2024-09-06,2024-09-06,Supplier Payment - EuroFab Assembly #24,Supplier Payment,CEM-EMEA,13617.46,0.0,GBP,CHAPS,EuroFab Assembly #24,***5893,,PO-202409-CEM-EMEA-0010,False,False,REF-963012,First Continental Bank,***9613,Globex Consulting UK Ltd.,UK,1623222.08
2024-09-06,2024-09-06,Client Receipt - Vertex Advisory Client #8,Sales Receipt,PS-GL,0.0,634.53,GBP,Faster Payments Credit,Vertex Advisory Client #8,***6947,INV-202409-PS-GL-0008,,False,False,REF-967455,First Continental Bank,***5742,Globex Consulting UK Ltd.,UK,1623856.61
2024-09-06,2024-09-06,Client Receipt - CloudBridge Co. #67,Sales Receipt,SaaS-GL,0.0,9683.62,GBP,CHAPS Credit,CloudBridge Co. #67,***5531,INV-202409-SaaS-GL-0001,,False,False,REF-873173,First Continental Bank,***6191,Globex Consulting UK Ltd.,UK,1633540.23
2024-09-06,2024-09-06,Client Receipt - Aurora Electronics GmbH #14,Sales Receipt,CEM-EMEA,0.0,28066.9,GBP,CHAPS Credit,Aurora Electronics GmbH #14,***7863,INV-202409-CEM-EMEA-0004,,False,False,REF-821994,First Continental Bank,***6846,Globex Consulting UK Ltd.,UK,1661607.13
2024-09-07,2024-09-07,Client Receipt - CloudBridge Co. #52,Sales Receipt,SaaS-GL,0.0,4093.25,GBP,CHAPS Credit,CloudBridge Co. #52,***3554,INV-202409-SaaS-GL-0011,,False,False,REF-885980,First Continental Bank,***8358,Globex Consulting UK Ltd.,UK,1665700.38
2024-09-08,2024-09-08,Client Receipt - CloudBridge Co. #48,Sales Receipt,SaaS-GL,0.0,10551.0,GBP,Faster Payments Credit,CloudBridge Co. #48,***3457,INV-202409-SaaS-GL-0027,,False,False,REF-769348,First Continental Bank,***5310,Globex Consulting UK Ltd.,UK,1676251.38
2024-09-09,2024-09-09,Client Receipt - CloudBridge Co. #46,Sales Receipt,SaaS-GL,0.0,1655.17,GBP,CHAPS Credit,CloudBridge Co. #46,***8613,INV-202409-SaaS-GL-0019,,False,False,REF-464647,First Continental Bank,***6635,Globex Consulting UK Ltd.,UK,1677906.55
2024-09-10,2024-09-10,Supplier Payment - EuroFab Assembly #23,Supplier Payment,CEM-EMEA,551.61,0.0,GBP,CHAPS,EuroFab Assembly #23,***6282,,PO-202409-CEM-EMEA-0006,False,False,REF-863712,First Continental Bank,***9587,Globex Consulting UK Ltd.,UK,1677354.94
2024-09-10,2024-09-10,Supplier Payment - EuroFab Assembly #3,Supplier Payment,CEM-EMEA,1901.08,0.0,GBP,CHAPS,EuroFab Assembly #3,***4650,,PO-202409-CEM-EMEA-0009,False,False,REF-847958,First Continental Bank,***2782,Globex Consulting UK Ltd.,UK,1675453.86
2024-09-10,2024-09-10,Supplier Payment - HyperCloud Infra #8,Supplier Payment,SaaS-GL,1982.83,0.0,GBP,CHAPS,HyperCloud Infra #8,***3641,,PO-202409-SaaS-GL-0006,False,False,REF-453287,First Continental Bank,***9620,Globex Consulting UK Ltd.,UK,1673471.03
2024-09-10,2024-09-10,Supplier Payment - ExpertNet Subcontractors #19,Supplier Payment,PS-GL,5109.49,0.0,GBP,Faster Payments,ExpertNet Subcontractors #19,***7263,,PO-202409-PS-GL-0001,False,False,REF-553697,First Continental Bank,***4463,Globex Consulting UK Ltd.,UK,1668361.54
2024-09-10,2024-09-10,Client Receipt - CloudBridge Co. #72,Sales Receipt,SaaS-GL,0.0,2339.84,GBP,CHAPS Credit,CloudBridge Co. #72,***4999,INV-202409-SaaS-GL-0017,,False,False,REF-472536,First Continental Bank,***3164,Globex Consulting UK Ltd.,UK,1670701.38
2024-09-10,2024-09-10,Client Receipt - Aurora Electronics GmbH #6,Sales Receipt,CEM-EMEA,0.0,3758.37,GBP,Faster Payments Credit,Aurora Electronics GmbH #6,***4407,INV-202409-CEM-EMEA-0014,,False,False,REF-795022,First Continental Bank,***7192,Globex Consulting UK Ltd.,UK,1674459.75
2024-09-12,2024-09-12,Intercompany Settlement - Globex Retail NA LLC,Intercompany Transfer,ALL,866822.0,0.0,GBP,Internal Transfer,Globex Retail NA LLC,***4426,,,True,True,REF-674981,First Continental Bank,***7499,Globex Consulting UK Ltd.,UK,807637.75
2024-09-12,2024-09-12,Client Receipt - CloudBridge Co. #67,Sales Receipt,SaaS-GL,0.0,487.74,GBP,CHAPS Credit,CloudBridge Co. #67,***2662,INV-202409-SaaS-GL-0020,,False,False,REF-895656,First Continental Bank,***3616,Globex Consulting UK Ltd.,UK,808125.49
2024-09-12,2024-09-12,Client Receipt - CloudBridge Co. #8,Sales Receipt,SaaS-GL,0.0,2108.29,GBP,Faster Payments Credit,CloudBridge Co. #8,***1761,INV-202409-SaaS-GL-0031,,False,False,REF-604132,First Continental Bank,***4627,Globex Consulting UK Ltd.,UK,810233.78
2024-09-12,2024-09-12,Client Receipt - CloudBridge Co. #46,Sales Receipt,SaaS-GL,0.0,5505.36,GBP,Faster Payments Credit,CloudBridge Co. #46,***9900,INV-202409-SaaS-GL-0026,,False,False,REF-267325,First Continental Bank,***5995,Globex Consulting UK Ltd.,UK,815739.14
2024-09-12,2024-09-12,Client Receipt - CloudBridge Co. #42,Sales Receipt,SaaS-GL,0.0,13398.45,GBP,Faster Payments Credit,CloudBridge Co. #42,***1181,INV-202409-SaaS-GL-0030,,False,False,REF-870484,First Continental Bank,***1277,Globex Consulting UK Ltd.,UK,829137.59
2024-09-12,2024-09-12,Client Receipt - CloudBridge Co. #38,Sales Receipt,SaaS-GL,0.0,19694.34,GBP,CHAPS Credit,CloudBridge Co. #38,***7447,INV-202409-SaaS-GL-0008,,False,False,REF-195937,First Continental Bank,***3918,Globex Consulting UK Ltd.,UK,848831.93
2024-09-13,2024-09-13,Supplier Payment - HyperCloud Infra #7,Supplier Payment,SaaS-GL,3234.29,0.0,GBP,CHAPS,HyperCloud Infra #7,***1058,,PO-202409-SaaS-GL-0008,False,False,REF-774479,First Continental Bank,***2029,Globex Consulting UK Ltd.,UK,845597.64
2024-09-13,2024-09-13,Supplier Payment - Stelliform Parts BV #20,Supplier Payment,CEM-EMEA,4047.2,0.0,GBP,CHAPS,Stelliform Parts BV #20,***5940,,PO-202409-CEM-EMEA-0002,False,False,REF-550638,First Continental Bank,***4108,Globex Consulting UK Ltd.,UK,841550.44
2024-09-13,2024-09-13,Client Receipt - Aurora Electronics GmbH #17,Sales Receipt,CEM-EMEA,0.0,24223.74,GBP,Faster Payments Credit,Aurora Electronics GmbH #17,***8713,INV-202409-CEM-EMEA-0007,,False,False,REF-784606,First Continental Bank,***4891,Globex Consulting UK Ltd.,UK,865774.18
2024-09-14,2024-09-14,Supplier Payment - ExpertNet Subcontractors #18,Supplier Payment,PS-GL,1100.89,0.0,GBP,Faster Payments,ExpertNet Subcontractors #18,***3356,,PO-202409-PS-GL-0007,False,False,REF-649745,First Continental Bank,***8197,Globex Consulting UK Ltd.,UK,864673.29
2024-09-15,2024-09-15,Client Receipt - Vertex Advisory Client #54,Sales Receipt,PS-GL,0.0,47396.09,GBP,Faster Payments Credit,Vertex Advisory Client #54,***3804,INV-202409-PS-GL-0002,,False,False,REF-535016,First Continental Bank,***1120,Globex Consulting UK Ltd.,UK,912069.38
2024-09-16,2024-09-16,Supplier Payment - ExpertNet Subcontractors #9,Supplier Payment,PS-GL,591.07,0.0,GBP,CHAPS,ExpertNet Subcontractors #9,***4742,,PO-202409-PS-GL-0002,False,False,REF-975625,First Continental Bank,***5947,Globex Consulting UK Ltd.,UK,911478.31
2024-09-16,2024-09-16,Supplier Payment - CodeCraft Contractors #9,Supplier Payment,SaaS-GL,10433.76,0.0,GBP,Faster Payments,CodeCraft Contractors #9,***1360,,PO-202409-SaaS-GL-0004,False,False,REF-503420,First Continental Bank,***1208,Globex Consulting UK Ltd.,UK,901044.55
2024-09-16,2024-09-16,Client Receipt - CloudBridge Co. #60,Sales Receipt,SaaS-GL,0.0,1742.41,GBP,Faster Payments Credit,CloudBridge Co. #60,***6111,INV-202409-SaaS-GL-0023,,False,False,REF-733862,First Continental Bank,***7437,Globex Consulting UK Ltd.,UK,902786.96
2024-09-16,2024-09-16,Client Receipt - CloudBridge Co. #41,Sales Receipt,SaaS-GL,0.0,4227.89,GBP,CHAPS Credit,CloudBridge Co. #41,***9828,INV-202409-SaaS-GL-0032,,False,False,REF-257859,First Continental Bank,***8970,Globex Consulting UK Ltd.,UK,907014.85
2024-09-16,2024-09-16,Client Receipt - Vertex Advisory Client #12,Sales Receipt,PS-GL,0.0,24845.3,GBP,Faster Payments Credit,Vertex Advisory Client #12,***4873,INV-202409-PS-GL-0006,,False,False,REF-156755,First Continental Bank,***1412,Globex Consulting UK Ltd.,UK,931860.15
2024-09-17,2024-09-17,Supplier Payment - HyperCloud Infra #16,Supplier Payment,SaaS-GL,676.24,0.0,GBP,CHAPS,HyperCloud Infra #16,***8574,,PO-202409-SaaS-GL-0005,False,False,REF-803496,First Continental Bank,***6003,Globex Consulting UK Ltd.,UK,931183.91
2024-09-17,2024-09-17,Supplier Payment - CodeCraft Contractors #4,Supplier Payment,SaaS-GL,1014.86,0.0,GBP,CHAPS,CodeCraft Contractors #4,***6326,,PO-202409-SaaS-GL-0003,False,False,REF-745351,First Continental Bank,***3779,Globex Consulting UK Ltd.,UK,930169.05
2024-09-17,2024-09-17,Supplier Payment - ExpertNet Subcontractors #2,Supplier Payment,PS-GL,10093.02,0.0,GBP,Faster Payments,ExpertNet Subcontractors #2,***2754,,PO-202409-PS-GL-0006,False,False,REF-805219,First Continental Bank,***9071,Globex Consulting UK Ltd.,UK,920076.03
2024-09-17,2024-09-17,Supplier Payment - Stelliform Parts BV #17,Supplier Payment,CEM-EMEA,22169.98,0.0,GBP,Faster Payments,Stelliform Parts BV #17,***8408,,PO-202409-CEM-EMEA-0008,False,False,REF-177585,First Continental Bank,***9329,Globex Consulting UK Ltd.,UK,897906.05
2024-09-17,2024-09-17,Client Receipt - CloudBridge Co. #41,Sales Receipt,SaaS-GL,0.0,576.99,GBP,CHAPS Credit,CloudBridge Co. #41,***9651,INV-202409-SaaS-GL-0010,,False,False,REF-581381,First Continental Bank,***7319,Globex Consulting UK Ltd.,UK,898483.04
2024-09-17,2024-09-17,Client Receipt - CloudBridge Co. #64,Sales Receipt,SaaS-GL,0.0,7185.8,GBP,CHAPS Credit,CloudBridge Co. #64,***2458,INV-202409-SaaS-GL-0025,,False,False,REF-273851,First Continental Bank,***2479,Globex Consulting UK Ltd.,UK,905668.84
2024-09-17,2024-09-17,Client Receipt - Novatek Components Ltd #13,Sales Receipt,CEM-EMEA,0.0,40392.89,GBP,CHAPS Credit,Novatek Components Ltd #13,***4711,INV-202409-CEM-EMEA-0009,,False,False,REF-710763,First Continental Bank,***4528,Globex Consulting UK Ltd.,UK,946061.73
2024-09-18,2024-09-18,Supplier Payment - ExpertNet Subcontractors #11,Supplier Payment,PS-GL,1486.36,0.0,GBP,Faster Payments,ExpertNet Subcontractors #11,***2093,,PO-202409-PS-GL-0008,False,False,REF-436594,First Continental Bank,***1714,Globex Consulting UK Ltd.,UK,944575.37
2024-09-18,2024-09-18,Marketing - Beacon Digital #8,Marketing,ALL,2357.5,0.0,GBP,Faster Payments,Beacon Digital #8,***6495,,,False,False,REF-127756,First Continental Bank,***2700,Globex Consulting UK Ltd.,UK,942217.87
2024-09-18,2024-09-18,Northshore Power,Rent & Utilities,ALL,3945.34,0.0,GBP,CHAPS,Northshore Power,***2946,,,False,False,REF-180141,First Continental Bank,***8677,Globex Consulting UK Ltd.,UK,938272.53
2024-09-18,2024-09-18,Client Receipt - Vertex Advisory Client #8,Sales Receipt,PS-GL,0.0,11906.8,GBP,Faster Payments Credit,Vertex Advisory Client #8,***2584,INV-202409-PS-GL-0005,,False,False,REF-536941,First Continental Bank,***9374,Globex Consulting UK Ltd.,UK,950179.33
2024-09-18,2024-09-18,Client Receipt - Novatek Components Ltd #1,Sales Receipt,CEM-EMEA,0.0,53730.82,GBP,Faster Payments Credit,Novatek Components Ltd #1,***8450,INV-202409-CEM-EMEA-0005,,False,False,REF-461865,First Continental Bank,***8054,Globex Consulting UK Ltd.,UK,1003910.15
2024-09-19,2024-09-19,Supplier Payment - HyperCloud Infra #13,Supplier Payment,SaaS-GL,9450.52,0.0,GBP,Faster Payments,HyperCloud Infra #13,***4660,,PO-202409-SaaS-GL-0010,False,False,REF-328378,First Continental Bank,***9341,Globex Consulting UK Ltd.,UK,994459.63
2024-09-19,2024-09-19,VAT/GST Remittance - HMRC UK,Tax Payment,ALL,40340.36,0.0,GBP,SWIFT MT103,HMRC UK,***8304,,,False,False,REF-637963,First Continental Bank,***3130,Globex Consulting UK Ltd.,UK,954119.27
2024-09-19,2024-09-19,Supplier Payment - Stelliform Parts BV #31,Supplier Payment,CEM-EMEA,56016.07,0.0,GBP,Faster Payments,Stelliform Parts BV #31,***2206,,PO-202409-CEM-EMEA-0007,False,False,REF-166623,First Continental Bank,***6745,Globex Consulting UK Ltd.,UK,898103.2
2024-09-19,2024-09-19,Client Receipt - CloudBridge Co. #20,Sales Receipt,SaaS-GL,0.0,205.48,GBP,CHAPS Credit,CloudBridge Co. #20,***3989,INV-202409-SaaS-GL-0004,,False,False,REF-329033,First Continental Bank,***5747,Globex Consulting UK Ltd.,UK,898308.68
2024-09-19,2024-09-19,Client Receipt - CloudBridge Co. #51,Sales Receipt,SaaS-GL,0.0,3869.9,GBP,Faster Payments Credit,CloudBridge Co. #51,***8050,INV-202409-SaaS-GL-0021,,False,False,REF-369700,First Continental Bank,***1540,Globex Consulting UK Ltd.,UK,902178.58
2024-09-19,2024-09-19,Client Receipt - CloudBridge Co. #73,Sales Receipt,SaaS-GL,0.0,23467.3,GBP,Faster Payments Credit,CloudBridge Co. #73,***8979,INV-202409-SaaS-GL-0016,,False,False,REF-619175,First Continental Bank,***8527,Globex Consulting UK Ltd.,UK,925645.88
2024-09-19,2024-09-19,Client Receipt - Novatek Components Ltd #8,Sales Receipt,CEM-EMEA,0.0,31769.34,GBP,CHAPS Credit,Novatek Components Ltd #8,***5224,INV-202409-CEM-EMEA-0010,,False,False,REF-464722,First Continental Bank,***9282,Globex Consulting UK Ltd.,UK,957415.22
2024-09-20,2024-09-20,Supplier Payment - ExpertNet Subcontractors #16,Supplier Payment,PS-GL,12614.97,0.0,GBP,Faster Payments,ExpertNet Subcontractors #16,***7724,,PO-202409-PS-GL-0005,False,False,REF-731255,First Continental Bank,***4138,Globex Consulting UK Ltd.,UK,944800.25
2024-09-20,2024-09-20,Client Receipt - CloudBridge Co. #65,Sales Receipt,SaaS-GL,0.0,832.52,GBP,Faster Payments Credit,CloudBridge Co. #65,***2950,INV-202409-SaaS-GL-0029,,False,False,REF-234445,First Continental Bank,***2684,Globex Consulting UK Ltd.,UK,945632.77
2024-09-20,2024-09-20,Client Receipt - CloudBridge Co. #10,Sales Receipt,SaaS-GL,0.0,3287.4,GBP,Faster Payments Credit,CloudBridge Co. #10,***8442,INV-202409-SaaS-GL-0015,,False,False,REF-495096,First Continental Bank,***6520,Globex Consulting UK Ltd.,UK,948920.17
2024-09-21,2024-09-21,Supplier Payment - ExpertNet Subcontractors #1,Supplier Payment,PS-GL,2614.36,0.0,GBP,Faster Payments,ExpertNet Subcontractors #1,***3990,,PO-202409-PS-GL-0003,False,False,REF-828613,First Continental Bank,***1157,Globex Consulting UK Ltd.,UK,946305.81
2024-09-21,2024-09-21,Supplier Payment - Stelliform Parts BV #15,Supplier Payment,CEM-EMEA,8868.13,0.0,GBP,CHAPS,Stelliform Parts BV #15,***1828,,PO-202409-CEM-EMEA-0004,False,False,REF-165331,First Continental Bank,***1675,Globex Consulting UK Ltd.,UK,937437.68
2024-09-21,2024-09-21,Client Receipt - CloudBridge Co. #36,Sales Receipt,SaaS-GL,0.0,3730.04,GBP,Faster Payments Credit,CloudBridge Co. #36,***2375,INV-202409-SaaS-GL-0012,,False,False,REF-783368,First Continental Bank,***4077,Globex Consulting UK Ltd.,UK,941167.72
2024-09-21,2024-09-21,Client Receipt - Vertex Advisory Client #21,Sales Receipt,PS-GL,0.0,3986.25,GBP,CHAPS Credit,Vertex Advisory Client #21,***4825,INV-202409-PS-GL-0004,,False,False,REF-580012,First Continental Bank,***9281,Globex Consulting UK Ltd.,UK,945153.97
2024-09-22,2024-09-22,Client Receipt - Vertex Advisory Client #24,Sales Receipt,PS-GL,0.0,7135.78,GBP,CHAPS Credit,Vertex Advisory Client #24,***2432,INV-202409-PS-GL-0001,,False,False,REF-357384,First Continental Bank,***8861,Globex Consulting UK Ltd.,UK,952289.75
2024-09-22,2024-09-22,Client Receipt - CloudBridge Co. #70,Sales Receipt,SaaS-GL,0.0,10110.37,GBP,Faster Payments Credit,CloudBridge Co. #70,***2770,INV-202409-SaaS-GL-0009,,False,False,REF-206001,First Continental Bank,***7379,Globex Consulting UK Ltd.,UK,962400.12
2024-09-23,2024-09-23,Supplier Payment - EuroFab Assembly #10,Supplier Payment,CEM-EMEA,10999.36,0.0,GBP,CHAPS,EuroFab Assembly #10,***4418,,PO-202409-CEM-EMEA-0003,False,False,REF-394821,First Continental Bank,***2935,Globex Consulting UK Ltd.,UK,951400.76
2024-09-23,2024-09-23,Client Receipt - CloudBridge Co. #57,Sales Receipt,SaaS-GL,0.0,3154.18,GBP,CHAPS Credit,CloudBridge Co. #57,***9369,INV-202409-SaaS-GL-0033,,False,False,REF-271170,First Continental Bank,***4522,Globex Consulting UK Ltd.,UK,954554.94
2024-09-24,2024-09-24,Supplier Payment - HyperCloud Infra #1,Supplier Payment,SaaS-GL,1720.88,0.0,GBP,CHAPS,HyperCloud Infra #1,***8905,,PO-202409-SaaS-GL-0007,False,False,REF-212090,First Continental Bank,***5500,Globex Consulting UK Ltd.,UK,952834.06
2024-09-24,2024-09-24,Supplier Payment - ExpertNet Subcontractors #12,Supplier Payment,PS-GL,3994.01,0.0,GBP,Faster Payments,ExpertNet Subcontractors #12,***6773,,PO-202409-PS-GL-0009,False,False,REF-814767,First Continental Bank,***5296,Globex Consulting UK Ltd.,UK,948840.05
2024-09-24,2024-09-24,Supplier Payment - Stelliform Parts BV #19,Supplier Payment,CEM-EMEA,29485.01,0.0,GBP,Faster Payments,Stelliform Parts BV #19,***7987,,PO-202409-CEM-EMEA-0001,False,False,REF-460487,First Continental Bank,***9816,Globex Consulting UK Ltd.,UK,919355.04
2024-09-24,2024-09-24,Client Receipt - CloudBridge Co. #38,Sales Receipt,SaaS-GL,0.0,467.28,GBP,Faster Payments Credit,CloudBridge Co. #38,***5470,INV-202409-SaaS-GL-0005,,False,False,REF-755847,First Continental Bank,***7169,Globex Consulting UK Ltd.,UK,919822.32
2024-09-24,2024-09-24,Client Receipt - Novatek Components Ltd #14,Sales Receipt,CEM-EMEA,0.0,21311.34,GBP,CHAPS Credit,Novatek Components Ltd #14,***3988,INV-202409-CEM-EMEA-0008,,False,False,REF-896323,First Continental Bank,***5630,Globex Consulting UK Ltd.,UK,941133.66
2024-09-25,2024-09-25,Supplier Payment - HyperCloud Infra #17,Supplier Payment,SaaS-GL,5359.51,0.0,GBP,Faster Payments,HyperCloud Infra #17,***2235,,PO-202409-SaaS-GL-0002,False,False,REF-933113,First Continental Bank,***3965,Globex Consulting UK Ltd.,UK,935774.15
2024-09-25,2024-09-25,Payroll - GlobalPay Services Ltd,Payroll,ALL,53159.62,0.0,GBP,Faster Payments,GlobalPay Services Ltd,***9146,,,False,False,REF-144104,First Continental Bank,***6747,Globex Consulting UK Ltd.,UK,882614.53
2024-09-26,2024-09-26,Merchant Processing Fees,Bank/Merchant Fees,ALL,408.88,0.0,GBP,Faster Payments,First Continental Bank,***4618,,,False,False,REF-844537,First Continental Bank,***5978,Globex Consulting UK Ltd.,UK,882205.65
2024-09-26,2024-09-26,Merchant Processing Fees,Bank/Merchant Fees,ALL,1541.39,0.0,GBP,Faster Payments,First Continental Bank,***6362,,,False,False,REF-857530,First Continental Bank,***4061,Globex Consulting UK Ltd.,UK,880664.26
2024-09-26,2024-09-26,"Intercompany Settlement - Globex International Holdings, Inc.",Intercompany Transfer,ALL,695513.0,0.0,GBP,Internal Transfer,"Globex International Holdings, Inc.",***1364,,,True,True,REF-350074,First Continental Bank,***2704,Globex Consulting UK Ltd.,UK,185151.26
2024-09-26,2024-09-26,Client Receipt - CloudBridge Co. #11,Sales Receipt,SaaS-GL,0.0,1499.08,GBP,Faster Payments Credit,CloudBridge Co. #11,***7951,INV-202409-SaaS-GL-0013,,False,False,REF-486870,First Continental Bank,***4677,Globex Consulting UK Ltd.,UK,186650.34
2024-09-26,2024-09-26,Client Receipt - CloudBridge Co. #25,Sales Receipt,SaaS-GL,0.0,3376.61,GBP,Faster Payments Credit,CloudBridge Co. #25,***8334,INV-202409-SaaS-GL-0018,,False,False,REF-327180,First Continental Bank,***4661,Globex Consulting UK Ltd.,UK,190026.95
2024-09-26,2024-09-26,Client Receipt - Aurora Electronics GmbH #15,Sales Receipt,CEM-EMEA,0.0,11871.54,GBP,CHAPS Credit,Aurora Electronics GmbH #15,***2486,INV-202409-CEM-EMEA-0013,,False,False,REF-793810,First Continental Bank,***3784,Globex Consulting UK Ltd.,UK,201898.49
2024-09-27,2024-09-27,Supplier Payment - HyperCloud Infra #11,Supplier Payment,SaaS-GL,2813.11,0.0,GBP,Faster Payments,HyperCloud Infra #11,***2840,,PO-202409-SaaS-GL-0009,False,False,REF-618048,First Continental Bank,***6185,Globex Consulting UK Ltd.,UK,199085.38
2024-09-27,2024-09-27,Supplier Payment - CodeCraft Contractors #5,Supplier Payment,SaaS-GL,7721.06,0.0,GBP,CHAPS,CodeCraft Contractors #5,***6524,,PO-202409-SaaS-GL-0001,False,False,REF-203739,First Continental Bank,***9908,Globex Consulting UK Ltd.,UK,191364.32
2024-09-27,2024-09-27,Client Receipt - Aurora Electronics GmbH #19,Sales Receipt,CEM-EMEA,0.0,10994.41,GBP,Faster Payments Credit,Aurora Electronics GmbH #19,***5601,INV-202409-CEM-EMEA-0015,,False,False,REF-652391,First Continental Bank,***4467,Globex Consulting UK Ltd.,UK,202358.73
2024-09-27,2024-09-27,Client Receipt - Aurora Electronics GmbH #11,Sales Receipt,CEM-EMEA,0.0,23646.67,GBP,Faster Payments Credit,Aurora Electronics GmbH #11,***5599,INV-202409-CEM-EMEA-0001,,False,False,REF-346713,First Continental Bank,***8170,Globex Consulting UK Ltd.,UK,226005.4
2024-09-27,2024-09-27,Client Receipt - Vertex Advisory Client #25,Sales Receipt,PS-GL,0.0,33998.46,GBP,CHAPS Credit,Vertex Advisory Client #25,***3985,INV-202409-PS-GL-0007,,False,False,REF-606357,First Continental Bank,***6290,Globex Consulting UK Ltd.,UK,260003.86
2024-09-28,2024-09-28,Client Receipt - CloudBridge Co. #6,Sales Receipt,SaaS-GL,0.0,5580.14,GBP,CHAPS Credit,CloudBridge Co. #6,***5567,INV-202409-SaaS-GL-0003,,False,False,REF-937709,First Continental Bank,***4940,Globex Consulting UK Ltd.,UK,265584.0
2024-09-29,2024-09-29,Payroll - GlobalPay Services Ltd,Payroll,ALL,53159.62,0.0,GBP,Faster Payments,GlobalPay Services Ltd,***4675,,,False,False,REF-333287,First Continental Bank,***3299,Globex Consulting UK Ltd.,UK,212424.38
2024-09-29,2024-09-29,Client Receipt - CloudBridge Co. #75,Sales Receipt,SaaS-GL,0.0,6531.12,GBP,Faster Payments Credit,CloudBridge Co. #75,***7758,INV-202409-SaaS-GL-0024,,False,False,REF-834733,First Continental Bank,***4684,Globex Consulting UK Ltd.,UK,218955.5
2024-09-29,2024-09-29,Client Receipt - CloudBridge Co. #21,Sales Receipt,SaaS-GL,0.0,16257.1,GBP,CHAPS Credit,CloudBridge Co. #21,***5902,INV-202409-SaaS-GL-0002,,False,False,REF-638639,First Continental Bank,***2966,Globex Consulting UK Ltd.,UK,235212.6
2024-09-30,2024-09-30,Supplier Payment - Stelliform Parts BV #23,Supplier Payment,CEM-EMEA,40737.71,0.0,GBP,Faster Payments,Stelliform Parts BV #23,***7229,,PO-202409-CEM-EMEA-0005,False,False,REF-441821,First Continental Bank,***5396,Globex Consulting UK Ltd.,UK,194474.89
2024-09-30,2024-09-30,Client Receipt - Aurora Electronics GmbH #10,Sales Receipt,CEM-EMEA,0.0,3180.62,GBP,CHAPS Credit,Aurora Electronics GmbH #10,***7385,INV-202409-CEM-EMEA-0011,,False,False,REF-442145,First Continental Bank,***7455,Globex Consulting UK Ltd.,UK,197655.51
2024-09-30,2024-09-30,Interest Earned,Interest Income,ALL,0.0,11456.6,GBP,CHAPS Credit,First Continental Bank,***4559,,,False,False,REF-647314,First Continental Bank,***8137,Globex Consulting UK Ltd.,UK,209112.11
2024-10-01,2024-10-01,Account Maintenance Fee,Bank/Merchant Fees,ALL,2500.0,0.0,GBP,Faster Payments,First Continental Bank,***8357,,,False,False,REF-245002,First Continental Bank,***4864,Globex Consulting UK Ltd.,UK,206612.11
2024-10-01,2024-10-01,Supplier Payment - CodeCraft Contractors #10,Supplier Payment,SaaS-GL,5854.36,0.0,GBP,Faster Payments,CodeCraft Contractors #10,***4438,,PO-202410-SaaS-GL-0005,False,False,REF-104993,First Continental Bank,***1391,Globex Consulting UK Ltd.,UK,200757.75
2024-10-01,2024-10-01,Supplier Payment - ExpertNet Subcontractors #9,Supplier Payment,PS-GL,9812.59,0.0,GBP,Faster Payments,ExpertNet Subcontractors #9,***2625,,PO-202410-PS-GL-0004,False,False,REF-630596,First Continental Bank,***4055,Globex Consulting UK Ltd.,UK,190945.16
2024-10-01,2024-10-01,Client Receipt - Vertex Advisory Client #11,Sales Receipt,PS-GL,0.0,9490.84,GBP,CHAPS Credit,Vertex Advisory Client #11,***2503,INV-202410-PS-GL-0007,,False,False,REF-281494,First Continental Bank,***7262,Globex Consulting UK Ltd.,UK,200436.0
2024-10-02,2024-10-02,Marketing - Aurelia Media #5,Marketing,ALL,865.28,0.0,GBP,Faster Payments,Aurelia Media #5,***6960,,,False,False,REF-823390,First Continental Bank,***2521,Globex Consulting UK Ltd.,UK,199570.72
2024-10-02,2024-10-02,Supplier Payment - ExpertNet Subcontractors #10,Supplier Payment,PS-GL,1415.26,0.0,GBP,CHAPS,ExpertNet Subcontractors #10,***4780,,PO-202410-PS-GL-0008,False,False,REF-649888,First Continental Bank,***8857,Globex Consulting UK Ltd.,UK,198155.46
2024-10-02,2024-10-02,Client Receipt - CloudBridge Co. #63,Sales Receipt,SaaS-GL,0.0,1558.4,GBP,Faster Payments Credit,CloudBridge Co. #63,***7673,INV-202410-SaaS-GL-0010,,False,False,REF-992866,First Continental Bank,***5416,Globex Consulting UK Ltd.,UK,199713.86
2024-10-02,2024-10-02,Client Receipt - CloudBridge Co. #22,Sales Receipt,SaaS-GL,0.0,26136.09,GBP,CHAPS Credit,CloudBridge Co. #22,***2688,INV-202410-SaaS-GL-0019,,False,False,REF-266786,First Continental Bank,***7945,Globex Consulting UK Ltd.,UK,225849.95
2024-10-02,2024-10-02,Client Receipt - Aurora Electronics GmbH #16,Sales Receipt,CEM-EMEA,0.0,27405.54,GBP,CHAPS Credit,Aurora Electronics GmbH #16,***1410,INV-202410-CEM-EMEA-0004,,False,False,REF-147904,First Continental Bank,***8882,Globex Consulting UK Ltd.,UK,253255.49
2024-10-03,2024-10-03,Supplier Payment - EuroFab Assembly #23,Supplier Payment,CEM-EMEA,20333.02,0.0,GBP,CHAPS,EuroFab Assembly #23,***8336,,PO-202410-CEM-EMEA-0004,False,False,REF-265542,First Continental Bank,***7139,Globex Consulting UK Ltd.,UK,232922.47
2024-10-03,2024-10-03,Client Receipt - CloudBridge Co. #20,Sales Receipt,SaaS-GL,0.0,3527.54,GBP,CHAPS Credit,CloudBridge Co. #20,***6685,INV-202410-SaaS-GL-0002,,False,False,REF-645263,First Continental Bank,***2304,Globex Consulting UK Ltd.,UK,236450.01
2024-10-03,2024-10-03,Client Receipt - CloudBridge Co. #50,Sales Receipt,SaaS-GL,0.0,3897.1,GBP,Faster Payments Credit,CloudBridge Co. #50,***4843,INV-202410-SaaS-GL-0007,,False,False,REF-146305,First Continental Bank,***6182,Globex Consulting UK Ltd.,UK,240347.11
2024-10-03,2024-10-03,Client Receipt - Novatek Components Ltd #10,Sales Receipt,CEM-EMEA,0.0,12072.77,GBP,Faster Payments Credit,Novatek Components Ltd #10,***8640,INV-202410-CEM-EMEA-0008,,False,False,REF-831968,First Continental Bank,***4119,Globex Consulting UK Ltd.,UK,252419.88
2024-10-03,2024-10-03,Client Receipt - Aurora Electronics GmbH #7,Sales Receipt,CEM-EMEA,0.0,31113.1,GBP,Faster Payments Credit,Aurora Electronics GmbH #7,***9157,INV-202410-CEM-EMEA-0014,,False,False,REF-480097,First Continental Bank,***8682,Globex Consulting UK Ltd.,UK,283532.98
2024-10-03,2024-10-03,Client Receipt - Novatek Components Ltd #11,Sales Receipt,CEM-EMEA,0.0,52377.61,GBP,Faster Payments Credit,Novatek Components Ltd #11,***8088,INV-202410-CEM-EMEA-0007,,False,False,REF-262554,First Continental Bank,***9999,Globex Consulting UK Ltd.,UK,335910.59
2024-10-04,2024-10-04,Client Receipt - Novatek Components Ltd #5,Sales Receipt,CEM-EMEA,0.0,2451.72,GBP,CHAPS Credit,Novatek Components Ltd #5,***7201,INV-202410-CEM-EMEA-0018,,False,False,REF-183565,First Continental Bank,***9877,Globex Consulting UK Ltd.,UK,338362.31
2024-10-05,2024-10-05,Supplier Payment - ExpertNet Subcontractors #14,Supplier Payment,PS-GL,13418.2,0.0,GBP,CHAPS,ExpertNet Subcontractors #14,***7910,,PO-202410-PS-GL-0009,False,False,REF-700365,First Continental Bank,***6732,Globex Consulting UK Ltd.,UK,324944.11
2024-10-05,2024-10-05,Client Receipt - Novatek Components Ltd #3,Sales Receipt,CEM-EMEA,0.0,748.18,GBP,Faster Payments Credit,Novatek Components Ltd #3,***4541,INV-202410-CEM-EMEA-0009,,False,False,REF-362077,First Continental Bank,***5230,Globex Consulting UK Ltd.,UK,325692.29
2024-10-05,2024-10-05,Client Receipt - CloudBridge Co. #28,Sales Receipt,SaaS-GL,0.0,4114.13,GBP,CHAPS Credit,CloudBridge Co. #28,***4621,INV-202410-SaaS-GL-0004,,False,False,REF-982280,First Continental Bank,***5896,Globex Consulting UK Ltd.,UK,329806.42
2024-10-06,2024-10-06,Client Receipt - Vertex Advisory Client #55,Sales Receipt,PS-GL,0.0,4136.12,GBP,Faster Payments Credit,Vertex Advisory Client #55,***6103,INV-202410-PS-GL-0001,,False,False,REF-267732,First Continental Bank,***3653,Globex Consulting UK Ltd.,UK,333942.54
2024-10-06,2024-10-06,Client Receipt - CloudBridge Co. #79,Sales Receipt,SaaS-GL,0.0,10471.36,GBP,Faster Payments Credit,CloudBridge Co. #79,***3364,INV-202410-SaaS-GL-0018,,False,False,REF-883305,First Continental Bank,***3098,Globex Consulting UK Ltd.,UK,344413.9
2024-10-06,2024-10-06,Client Receipt - Vertex Advisory Client #21,Sales Receipt,PS-GL,0.0,17376.24,GBP,Faster Payments Credit,Vertex Advisory Client #21,***2941,INV-202410-PS-GL-0005,,False,False,REF-147703,First Continental Bank,***1657,Globex Consulting UK Ltd.,UK,361790.14
2024-10-07,2024-10-07,Supplier Payment - ExpertNet Subcontractors #12,Supplier Payment,PS-GL,2225.31,0.0,GBP,CHAPS,ExpertNet Subcontractors #12,***4082,,PO-202410-PS-GL-0010,False,False,REF-121728,First Continental Bank,***7991,Globex Consulting UK Ltd.,UK,359564.83
2024-10-07,2024-10-07,Supplier Payment - HyperCloud Infra #1,Supplier Payment,SaaS-GL,9590.45,0.0,GBP,Faster Payments,HyperCloud Infra #1,***7470,,PO-202410-SaaS-GL-0009,False,False,REF-604724,First Continental Bank,***7186,Globex Consulting UK Ltd.,UK,349974.38
2024-10-07,2024-10-07,Supplier Payment - EuroFab Assembly #9,Supplier Payment,CEM-EMEA,12321.58,0.0,GBP,CHAPS,EuroFab Assembly #9,***3865,,PO-202410-CEM-EMEA-0008,False,False,REF-636640,First Continental Bank,***2687,Globex Consulting UK Ltd.,UK,337652.8
2024-10-07,2024-10-07,Client Receipt - CloudBridge Co. #3,Sales Receipt,SaaS-GL,0.0,11171.32,GBP,CHAPS Credit,CloudBridge Co. #3,***2204,INV-202410-SaaS-GL-0009,,False,False,REF-227356,First Continental Bank,***8904,Globex Consulting UK Ltd.,UK,348824.12
2024-10-07,2024-10-07,Client Receipt - CloudBridge Co. #7,Sales Receipt,SaaS-GL,0.0,16392.6,GBP,Faster Payments Credit,CloudBridge Co. #7,***1642,INV-202410-SaaS-GL-0020,,False,False,REF-513618,First Continental Bank,***7495,Globex Consulting UK Ltd.,UK,365216.72
2024-10-08,2024-10-08,Supplier Payment - CodeCraft Contractors #11,Supplier Payment,SaaS-GL,2590.12,0.0,GBP,CHAPS,CodeCraft Contractors #11,***6015,,PO-202410-SaaS-GL-0003,False,False,REF-662562,First Continental Bank,***1682,Globex Consulting UK Ltd.,UK,362626.6
2024-10-09,2024-10-09,Merchant Processing Fees,Bank/Merchant Fees,ALL,718.57,0.0,GBP,Faster Payments,First Continental Bank,***9179,,,False,False,REF-125480,First Continental Bank,***4833,Globex Consulting UK Ltd.,UK,361908.03
2024-10-09,2024-10-09,Metro Water & Waste,Rent & Utilities,ALL,5607.6,0.0,GBP,CHAPS,Metro Water & Waste,***9149,,,False,False,REF-133568,First Continental Bank,***2064,Globex Consulting UK Ltd.,UK,356300.43
2024-10-10,2024-10-10,Supplier Payment - Stelliform Parts BV #31,Supplier Payment,CEM-EMEA,18049.61,0.0,GBP,CHAPS,Stelliform Parts BV #31,***1956,,PO-202410-CEM-EMEA-0006,False,False,REF-750927,First Continental Bank,***4093,Globex Consulting UK Ltd.,UK,338250.82
2024-10-10,2024-10-10,Client Receipt - Vertex Advisory Client #29,Sales Receipt,PS-GL,0.0,12611.3,GBP,Faster Payments Credit,Vertex Advisory Client #29,***4533,INV-202410-PS-GL-0009,,False,False,REF-249877,First Continental Bank,***3120,Globex Consulting UK Ltd.,UK,350862.12
2024-10-10,2024-10-10,Client Receipt - Aurora Electronics GmbH #10,Sales Receipt,CEM-EMEA,0.0,19259.8,GBP,Faster Payments Credit,Aurora Electronics GmbH #10,***5523,INV-202410-CEM-EMEA-0002,,False,False,REF-321712,First Continental Bank,***7387,Globex Consulting UK Ltd.,UK,370121.92
2024-10-10,2024-10-10,Client Receipt - Novatek Components Ltd #5,Sales Receipt,CEM-EMEA,0.0,19488.98,GBP,Faster Payments Credit,Novatek Components Ltd #5,***8696,INV-202410-CEM-EMEA-0011,,False,False,REF-769438,First Continental Bank,***4461,Globex Consulting UK Ltd.,UK,389610.9
2024-10-10,2024-10-10,Client Receipt - Aurora Electronics GmbH #5,Sales Receipt,CEM-EMEA,0.0,36284.87,GBP,Faster Payments Credit,Aurora Electronics GmbH #5,***7453,INV-202410-CEM-EMEA-0006,,False,False,REF-429801,First Continental Bank,***7151,Globex Consulting UK Ltd.,UK,425895.77
2024-10-11,2024-10-11,Supplier Payment - CodeCraft Contractors #7,Supplier Payment,SaaS-GL,453.28,0.0,GBP,Faster Payments,CodeCraft Contractors #7,***4818,,PO-202410-SaaS-GL-0004,False,False,REF-981755,First Continental Bank,***5021,Globex Consulting UK Ltd.,UK,425442.49
2024-10-11,2024-10-11,Supplier Payment - ExpertNet Subcontractors #14,Supplier Payment,PS-GL,1518.4,0.0,GBP,CHAPS,ExpertNet Subcontractors #14,***5717,,PO-202410-PS-GL-0005,False,False,REF-609304,First Continental Bank,***2356,Globex Consulting UK Ltd.,UK,423924.09
2024-10-11,2024-10-11,Supplier Payment - Stelliform Parts BV #1,Supplier Payment,CEM-EMEA,33502.22,0.0,GBP,Faster Payments,Stelliform Parts BV #1,***1608,,PO-202410-CEM-EMEA-0007,False,False,REF-425010,First Continental Bank,***2618,Globex Consulting UK Ltd.,UK,390421.87
2024-10-12,2024-10-12,Intercompany Settlement - Globex APAC Logistics Pte. Ltd.,Intercompany Transfer,ALL,840797.0,0.0,GBP,Internal Transfer,Globex APAC Logistics Pte. Ltd.,***3033,,,True,True,REF-967632,First Continental Bank,***8376,Globex Consulting UK Ltd.,UK,-450375.13
2024-10-15,2024-10-15,Supplier Payment - Stelliform Parts BV #13,Supplier Payment,CEM-EMEA,26855.24,0.0,GBP,Faster Payments,Stelliform Parts BV #13,***4021,,PO-202410-CEM-EMEA-0005,False,False,REF-663846,First Continental Bank,***1305,Globex Consulting UK Ltd.,UK,-477230.37
2024-10-15,2024-10-15,Client Receipt - CloudBridge Co. #35,Sales Receipt,SaaS-GL,0.0,1914.7,GBP,Faster Payments Credit,CloudBridge Co. #35,***9349,INV-202410-SaaS-GL-0017,,False,False,REF-557144,First Continental Bank,***8720,Globex Consulting UK Ltd.,UK,-475315.67
2024-10-15,2024-10-15,Client Receipt - CloudBridge Co. #51,Sales Receipt,SaaS-GL,0.0,9112.43,GBP,Faster Payments Credit,CloudBridge Co. #51,***2720,INV-202410-SaaS-GL-0008,,False,False,REF-718955,First Continental Bank,***4581,Globex Consulting UK Ltd.,UK,-466203.24
2024-10-15,2024-10-15,Client Receipt - CloudBridge Co. #78,Sales Receipt,SaaS-GL,0.0,10649.3,GBP,CHAPS Credit,CloudBridge Co. #78,***5656,INV-202410-SaaS-GL-0021,,False,False,REF-727644,First Continental Bank,***1054,Globex Consulting UK Ltd.,UK,-455553.94
2024-10-15,2024-10-15,Client Receipt - CloudBridge Co. #4,Sales Receipt,SaaS-GL,0.0,12291.75,GBP,Faster Payments Credit,CloudBridge Co. #4,***2996,INV-202410-SaaS-GL-0015,,False,False,REF-956123,First Continental Bank,***2558,Globex Consulting UK Ltd.,UK,-443262.19
2024-10-16,2024-10-16,Supplier Payment - ExpertNet Subcontractors #9,Supplier Payment,PS-GL,4158.76,0.0,GBP,CHAPS,ExpertNet Subcontractors #9,***6210,,PO-202410-PS-GL-0001,False,False,REF-124785,First Continental Bank,***4164,Globex Consulting UK Ltd.,UK,-447420.95
2024-10-16,2024-10-16,Supplier Payment - Stelliform Parts BV #31,Supplier Payment,CEM-EMEA,53908.98,0.0,GBP,CHAPS,Stelliform Parts BV #31,***5110,,PO-202410-CEM-EMEA-0009,False,False,REF-621044,First Continental Bank,***2010,Globex Consulting UK Ltd.,UK,-501329.93
2024-10-16,2024-10-16,Client Receipt - CloudBridge Co. #4,Sales Receipt,SaaS-GL,0.0,1937.64,GBP,Faster Payments Credit,CloudBridge Co. #4,***1811,INV-202410-SaaS-GL-0001,,False,False,REF-409806,First Continental Bank,***9534,Globex Consulting UK Ltd.,UK,-499392.29
2024-10-16,2024-10-16,Client Receipt - Novatek Components Ltd #1,Sales Receipt,CEM-EMEA,0.0,4510.05,GBP,Faster Payments Credit,Novatek Components Ltd #1,***1567,INV-202410-CEM-EMEA-0012,,False,False,REF-504244,First Continental Bank,***1863,Globex Consulting UK Ltd.,UK,-494882.24
2024-10-16,2024-10-16,Client Receipt - Vertex Advisory Client #26,Sales Receipt,PS-GL,0.0,5003.09,GBP,CHAPS Credit,Vertex Advisory Client #26,***5832,INV-202410-PS-GL-0004,,False,False,REF-333993,First Continental Bank,***4836,Globex Consulting UK Ltd.,UK,-489879.15
2024-10-16,2024-10-16,Client Receipt - Vertex Advisory Client #10,Sales Receipt,PS-GL,0.0,8481.0,GBP,Faster Payments Credit,Vertex Advisory Client #10,***6130,INV-202410-PS-GL-0008,,False,False,REF-958337,First Continental Bank,***5065,Globex Consulting UK Ltd.,UK,-481398.15
2024-10-17,2024-10-17,Supplier Payment - ExpertNet Subcontractors #1,Supplier Payment,PS-GL,3844.26,0.0,GBP,Faster Payments,ExpertNet Subcontractors #1,***2569,,PO-202410-PS-GL-0007,False,False,REF-445736,First Continental Bank,***2622,Globex Consulting UK Ltd.,UK,-485242.41
2024-10-17,2024-10-17,Client Receipt - Novatek Components Ltd #7,Sales Receipt,CEM-EMEA,0.0,26977.4,GBP,CHAPS Credit,Novatek Components Ltd #7,***3291,INV-202410-CEM-EMEA-0013,,False,False,REF-724664,First Continental Bank,***9358,Globex Consulting UK Ltd.,UK,-458265.01
2024-10-17,2024-10-17,Client Receipt - Vertex Advisory Client #23,Sales Receipt,PS-GL,0.0,28608.92,GBP,Faster Payments Credit,Vertex Advisory Client #23,***9138,INV-202410-PS-GL-0006,,False,False,REF-318591,First Continental Bank,***3860,Globex Consulting UK Ltd.,UK,-429656.09
2024-10-17,2024-10-17,Client Receipt - Vertex Advisory Client #10,Sales Receipt,PS-GL,0.0,37403.05,GBP,Faster Payments Credit,Vertex Advisory Client #10,***3255,INV-202410-PS-GL-0003,,False,False,REF-159083,First Continental Bank,***8359,Globex Consulting UK Ltd.,UK,-392253.04
2024-10-17,2024-10-17,Client Receipt - Aurora Electronics GmbH #6,Sales Receipt,CEM-EMEA,0.0,70012.25,GBP,Faster Payments Credit,Aurora Electronics GmbH #6,***3377,INV-202410-CEM-EMEA-0010,,False,False,REF-407367,First Continental Bank,***4982,Globex Consulting UK Ltd.,UK,-322240.79
2024-10-18,2024-10-18,Supplier Payment - CodeCraft Contractors #5,Supplier Payment,SaaS-GL,8323.34,0.0,GBP,Faster Payments,CodeCraft Contractors #5,***1967,,PO-202410-SaaS-GL-0006,False,False,REF-148644,First Continental Bank,***3182,Globex Consulting UK Ltd.,UK,-330564.13
2024-10-19,2024-10-19,Supplier Payment - HyperCloud Infra #3,Supplier Payment,SaaS-GL,1715.83,0.0,GBP,CHAPS,HyperCloud Infra #3,***9245,,PO-202410-SaaS-GL-0007,False,False,REF-262096,First Continental Bank,***9631,Globex Consulting UK Ltd.,UK,-332279.96
2024-10-19,2024-10-19,VAT/GST Remittance - HMRC UK,Tax Payment,ALL,44886.77,0.0,GBP,Faster Payments,HMRC UK,***8631,,,False,False,REF-953158,First Continental Bank,***1226,Globex Consulting UK Ltd.,UK,-377166.73
2024-10-19,2024-10-19,Client Receipt - Novatek Components Ltd #4,Sales Receipt,CEM-EMEA,0.0,4046.47,GBP,Faster Payments Credit,Novatek Components Ltd #4,***2554,INV-202410-CEM-EMEA-0001,,False,False,REF-388658,First Continental Bank,***6284,Globex Consulting UK Ltd.,UK,-373120.26
2024-10-19,2024-10-19,Client Receipt - Novatek Components Ltd #5,Sales Receipt,CEM-EMEA,0.0,5943.58,GBP,Faster Payments Credit,Novatek Components Ltd #5,***7538,INV-202410-CEM-EMEA-0017,,False,False,REF-445260,First Continental Bank,***6767,Globex Consulting UK Ltd.,UK,-367176.68
2024-10-19,2024-10-19,Client Receipt - CloudBridge Co. #72,Sales Receipt,SaaS-GL,0.0,7317.9,GBP,Faster Payments Credit,CloudBridge Co. #72,***7759,INV-202410-SaaS-GL-0012,,False,False,REF-601309,First Continental Bank,***6227,Globex Consulting UK Ltd.,UK,-359858.78
2024-10-19,2024-10-19,Client Receipt - CloudBridge Co. #7,Sales Receipt,SaaS-GL,0.0,18669.03,GBP,CHAPS Credit,CloudBridge Co. #7,***4991,INV-202410-SaaS-GL-0011,,False,False,REF-656540,First Continental Bank,***7348,Globex Consulting UK Ltd.,UK,-341189.75
2024-10-21,2024-10-21,Supplier Payment - ExpertNet Subcontractors #8,Supplier Payment,PS-GL,3490.12,0.0,GBP,Faster Payments,ExpertNet Subcontractors #8,***2412,,PO-202410-PS-GL-0006,False,False,REF-116262,First Continental Bank,***2963,Globex Consulting UK Ltd.,UK,-344679.87
2024-10-21,2024-10-21,Client Receipt - CloudBridge Co. #40,Sales Receipt,SaaS-GL,0.0,2945.48,GBP,CHAPS Credit,CloudBridge Co. #40,***5950,INV-202410-SaaS-GL-0006,,False,False,REF-294475,First Continental Bank,***3422,Globex Consulting UK Ltd.,UK,-341734.39
2024-10-23,2024-10-23,Supplier Payment - Stelliform Parts BV #20,Supplier Payment,CEM-EMEA,1027.14,0.0,GBP,CHAPS,Stelliform Parts BV #20,***6236,,PO-202410-CEM-EMEA-0002,False,False,REF-933941,First Continental Bank,***2631,Globex Consulting UK Ltd.,UK,-342761.53
2024-10-23,2024-10-23,Supplier Payment - HyperCloud Infra #10,Supplier Payment,SaaS-GL,9747.87,0.0,GBP,Faster Payments,HyperCloud Infra #10,***9831,,PO-202410-SaaS-GL-0002,False,False,REF-396305,First Continental Bank,***2116,Globex Consulting UK Ltd.,UK,-352509.4
2024-10-23,2024-10-23,Supplier Payment - Stelliform Parts BV #16,Supplier Payment,CEM-EMEA,40685.38,0.0,GBP,Faster Payments,Stelliform Parts BV #16,***1317,,PO-202410-CEM-EMEA-0001,False,False,REF-575253,First Continental Bank,***9619,Globex Consulting UK Ltd.,UK,-393194.78
2024-10-23,2024-10-23,Client Receipt - Aurora Electronics GmbH #18,Sales Receipt,CEM-EMEA,0.0,271.31,GBP,Faster Payments Credit,Aurora Electronics GmbH #18,***6822,INV-202410-CEM-EMEA-0003,,False,False,REF-317332,First Continental Bank,***8374,Globex Consulting UK Ltd.,UK,-392923.47
2024-10-23,2024-10-23,Client Receipt - Novatek Components Ltd #4,Sales Receipt,CEM-EMEA,0.0,9441.29,GBP,Faster Payments Credit,Novatek Components Ltd #4,***1248,INV-202410-CEM-EMEA-0016,,False,False,REF-938309,First Continental Bank,***9708,Globex Consulting UK Ltd.,UK,-383482.18
2024-10-24,2024-10-24,Supplier Payment - CodeCraft Contractors #8,Supplier Payment,SaaS-GL,1147.2,0.0,GBP,Faster Payments,CodeCraft Contractors #8,***1981,,PO-202410-SaaS-GL-0008,False,False,REF-793222,First Continental Bank,***7307,Globex Consulting UK Ltd.,UK,-384629.38
2024-10-24,2024-10-24,Supplier Payment - CodeCraft Contractors #4,Supplier Payment,SaaS-GL,9425.32,0.0,GBP,CHAPS,CodeCraft Contractors #4,***2312,,PO-202410-SaaS-GL-0001,False,False,REF-391368,First Continental Bank,***6924,Globex Consulting UK Ltd.,UK,-394054.7
2024-10-24,2024-10-24,Client Receipt - Vertex Advisory Client #32,Sales Receipt,PS-GL,0.0,5896.1,GBP,CHAPS Credit,Vertex Advisory Client #32,***7053,INV-202410-PS-GL-0002,,False,False,REF-842984,First Continental Bank,***5970,Globex Consulting UK Ltd.,UK,-388158.6
2024-10-24,2024-10-24,Client Receipt - CloudBridge Co. #13,Sales Receipt,SaaS-GL,0.0,9270.32,GBP,Faster Payments Credit,CloudBridge Co. #13,***9513,INV-202410-SaaS-GL-0016,,False,False,REF-574665,First Continental Bank,***4328,Globex Consulting UK Ltd.,UK,-378888.28
2024-10-25,2024-10-25,Client Receipt - Novatek Components Ltd #5,Sales Receipt,CEM-EMEA,0.0,2850.03,GBP,CHAPS Credit,Novatek Components Ltd #5,***9533,INV-202410-CEM-EMEA-0005,,False,False,REF-808551,First Continental Bank,***8354,Globex Consulting UK Ltd.,UK,-376038.25
2024-10-26,2024-10-26,Intercompany Settlement - Globex EMEA Manufacturing Ltd.,Intercompany Transfer,ALL,591719.0,0.0,GBP,Internal Transfer,Globex EMEA Manufacturing Ltd.,***5796,,,True,True,REF-622618,First Continental Bank,***9539,Globex Consulting UK Ltd.,UK,-967757.25
2024-10-26,2024-10-26,Client Receipt - CloudBridge Co. #2,Sales Receipt,SaaS-GL,0.0,32558.52,GBP,CHAPS Credit,CloudBridge Co. #2,***7897,INV-202410-SaaS-GL-0013,,False,False,REF-462039,First Continental Bank,***5516,Globex Consulting UK Ltd.,UK,-935198.73
2024-10-27,2024-10-27,Payroll - GlobalPay Services Ltd,Payroll,ALL,56597.37,0.0,GBP,CHAPS,GlobalPay Services Ltd,***7739,,,False,False,REF-617578,First Continental Bank,***1570,Globex Consulting UK Ltd.,UK,-991796.1
2024-10-27,2024-10-27,Payroll - GlobalPay Services Ltd,Payroll,ALL,56597.37,0.0,GBP,Faster Payments,GlobalPay Services Ltd,***9737,,,False,False,REF-995718,First Continental Bank,***2389,Globex Consulting UK Ltd.,UK,-1048393.47
2024-10-27,2024-10-27,Client Receipt - CloudBridge Co. #43,Sales Receipt,SaaS-GL,0.0,3972.04,GBP,CHAPS Credit,CloudBridge Co. #43,***6894,INV-202410-SaaS-GL-0003,,False,False,REF-987107,First Continental Bank,***5426,Globex Consulting UK Ltd.,UK,-1044421.43
2024-10-28,2024-10-28,Supplier Payment - Stelliform Parts BV #5,Supplier Payment,CEM-EMEA,549.8,0.0,GBP,Faster Payments,Stelliform Parts BV #5,***2943,,PO-202410-CEM-EMEA-0003,False,False,REF-432758,First Continental Bank,***4379,Globex Consulting UK Ltd.,UK,-1044971.23
2024-10-28,2024-10-28,Supplier Payment - ExpertNet Subcontractors #2,Supplier Payment,PS-GL,897.87,0.0,GBP,CHAPS,ExpertNet Subcontractors #2,***9690,,PO-202410-PS-GL-0003,False,False,REF-960173,First Continental Bank,***8749,Globex Consulting UK Ltd.,UK,-1045869.1
2024-10-28,2024-10-28,Supplier Payment - ExpertNet Subcontractors #5,Supplier Payment,PS-GL,3626.29,0.0,GBP,Faster Payments,ExpertNet Subcontractors #5,***4101,,PO-202410-PS-GL-0002,False,False,REF-985397,First Continental Bank,***6924,Globex Consulting UK Ltd.,UK,-1049495.39
2024-10-28,2024-10-28,Corporate Tax Estimate,Tax Payment,ALL,31512.24,0.0,GBP,SWIFT MT103,HMRC UK,***8603,,,False,False,REF-571281,First Continental Bank,***3287,Globex Consulting UK Ltd.,UK,-1081007.63
2024-10-29,2024-10-29,Client Receipt - Novatek Components Ltd #2,Sales Receipt,CEM-EMEA,0.0,20133.33,GBP,CHAPS Credit,Novatek Components Ltd #2,***6469,INV-202410-CEM-EMEA-0015,,False,False,REF-798148,First Continental Bank,***3375,Globex Consulting UK Ltd.,UK,-1060874.3
2024-10-29,2024-10-29,Client Receipt - CloudBridge Co. #35,Sales Receipt,SaaS-GL,0.0,21133.87,GBP,CHAPS Credit,CloudBridge Co. #35,***2409,INV-202410-SaaS-GL-0014,,False,False,REF-639363,First Continental Bank,***6336,Globex Consulting UK Ltd.,UK,-1039740.43
2024-10-30,2024-10-30,Marketing - Aurelia Media #6,Marketing,ALL,16399.21,0.0,GBP,CHAPS,Aurelia Media #6,***6820,,,False,False,REF-334530,First Continental Bank,***5285,Globex Consulting UK Ltd.,UK,-1056139.64
2024-10-30,2024-10-30,Interest Earned,Interest Income,ALL,0.0,12274.91,GBP,Faster Payments Credit,First Continental Bank,***8277,,,False,False,REF-367598,First Continental Bank,***4354,Globex Consulting UK Ltd.,UK,-1043864.73
2024-10-31,2024-10-31,Merchant Processing Fees,Bank/Merchant Fees,ALL,1438.68,0.0,GBP,Faster Payments,First Continental Bank,***7849,,,False,False,REF-780428,First Continental Bank,***2146,Globex Consulting UK Ltd.,UK,-1045303.41
2024-10-31,2024-10-31,Client Receipt - CloudBridge Co. #70,Sales Receipt,SaaS-GL,0.0,12993.8,GBP,Faster Payments Credit,CloudBridge Co. #70,***2447,INV-202410-SaaS-GL-0005,,False,False,REF-421989,First Continental Bank,***8825,Globex Consulting UK Ltd.,UK,-1032309.61
2024-10-31,2024-10-31,Client Receipt - Vertex Advisory Client #50,Sales Receipt,PS-GL,0.0,19016.89,GBP,CHAPS Credit,Vertex Advisory Client #50,***6012,INV-202410-PS-GL-0010,,False,False,REF-146142,First Continental Bank,***2873,Globex Consulting UK Ltd.,UK,-1013292.72
2024-11-01,2024-11-01,Merchant Processing Fees,Bank/Merchant Fees,ALL,327.2,0.0,GBP,Faster Payments,First Continental Bank,***9638,,,False,False,REF-218683,First Continental Bank,***2434,Globex Consulting UK Ltd.,UK,-1013619.92
2024-11-01,2024-11-01,Account Maintenance Fee,Bank/Merchant Fees,ALL,2500.0,0.0,GBP,CHAPS,First Continental Bank,***5713,,,False,False,REF-235064,First Continental Bank,***5293,Globex Consulting UK Ltd.,UK,-1016119.92
2024-11-01,2024-11-01,Supplier Payment - ExpertNet Subcontractors #15,Supplier Payment,PS-GL,6935.82,0.0,GBP,CHAPS,ExpertNet Subcontractors #15,***7888,,PO-202411-PS-GL-0010,False,False,REF-250433,First Continental Bank,***1780,Globex Consulting UK Ltd.,UK,-1023055.74
2024-11-01,2024-11-01,Client Receipt - CloudBridge Co. #6,Sales Receipt,SaaS-GL,0.0,2105.36,GBP,CHAPS Credit,CloudBridge Co. #6,***4908,INV-202411-SaaS-GL-0015,,False,False,REF-627516,First Continental Bank,***1988,Globex Consulting UK Ltd.,UK,-1020950.38
2024-11-01,2024-11-01,Client Receipt - CloudBridge Co. #28,Sales Receipt,SaaS-GL,0.0,5074.85,GBP,Faster Payments Credit,CloudBridge Co. #28,***5974,INV-202411-SaaS-GL-0021,,False,False,REF-796089,First Continental Bank,***1812,Globex Consulting UK Ltd.,UK,-1015875.53
2024-11-01,2024-11-01,Client Receipt - Vertex Advisory Client #25,Sales Receipt,PS-GL,0.0,14467.02,GBP,Faster Payments Credit,Vertex Advisory Client #25,***4422,INV-202411-PS-GL-0007,,False,False,REF-288647,First Continental Bank,***1372,Globex Consulting UK Ltd.,UK,-1001408.51
2024-11-01,2024-11-01,Client Receipt - Aurora Electronics GmbH #15,Sales Receipt,CEM-EMEA,0.0,53088.2,GBP,CHAPS Credit,Aurora Electronics GmbH #15,***5827,INV-202411-CEM-EMEA-0017,,False,False,REF-459072,First Continental Bank,***3343,Globex Consulting UK Ltd.,UK,-948320.31
2024-11-02,2024-11-02,Client Receipt - CloudBridge Co. #27,Sales Receipt,SaaS-GL,0.0,511.43,GBP,Faster Payments Credit,CloudBridge Co. #27,***1364,INV-202411-SaaS-GL-0031,,False,False,REF-595684,First Continental Bank,***8935,Globex Consulting UK Ltd.,UK,-947808.88
2024-11-05,2024-11-05,Supplier Payment - HyperCloud Infra #14,Supplier Payment,SaaS-GL,1805.55,0.0,GBP,Faster Payments,HyperCloud Infra #14,***7660,,PO-202411-SaaS-GL-0002,False,False,REF-742904,First Continental Bank,***9954,Globex Consulting UK Ltd.,UK,-949614.43
2024-11-05,2024-11-05,Client Receipt - CloudBridge Co. #19,Sales Receipt,SaaS-GL,0.0,1797.15,GBP,Faster Payments Credit,CloudBridge Co. #19,***5654,INV-202411-SaaS-GL-0005,,False,False,REF-142232,First Continental Bank,***3576,Globex Consulting UK Ltd.,UK,-947817.28
2024-11-05,2024-11-05,Client Receipt - CloudBridge Co. #8,Sales Receipt,SaaS-GL,0.0,9439.4,GBP,Faster Payments Credit,CloudBridge Co. #8,***8399,INV-202411-SaaS-GL-0001,,False,False,REF-904108,First Continental Bank,***2111,Globex Consulting UK Ltd.,UK,-938377.88
2024-11-05,2024-11-05,Client Receipt - Vertex Advisory Client #28,Sales Receipt,PS-GL,0.0,15847.62,GBP,CHAPS Credit,Vertex Advisory Client #28,***9378,INV-202411-PS-GL-0002,,False,False,REF-115415,First Continental Bank,***8945,Globex Consulting UK Ltd.,UK,-922530.26
2024-11-05,2024-11-05,Client Receipt - Novatek Components Ltd #1,Sales Receipt,CEM-EMEA,0.0,31223.61,GBP,CHAPS Credit,Novatek Components Ltd #1,***7404,INV-202411-CEM-EMEA-0001,,False,False,REF-604005,First Continental Bank,***2083,Globex Consulting UK Ltd.,UK,-891306.65
2024-11-06,2024-11-06,Merchant Processing Fees,Bank/Merchant Fees,ALL,2161.79,0.0,GBP,Faster Payments,First Continental Bank,***8380,,,False,False,REF-853268,First Continental Bank,***9781,Globex Consulting UK Ltd.,UK,-893468.44
2024-11-06,2024-11-06,Supplier Payment - ExpertNet Subcontractors #10,Supplier Payment,PS-GL,3090.54,0.0,GBP,Faster Payments,ExpertNet Subcontractors #10,***9471,,PO-202411-PS-GL-0003,False,False,REF-924393,First Continental Bank,***5008,Globex Consulting UK Ltd.,UK,-896558.98
2024-11-06,2024-11-06,Supplier Payment - Stelliform Parts BV #6,Supplier Payment,CEM-EMEA,6837.52,0.0,GBP,Faster Payments,Stelliform Parts BV #6,***5263,,PO-202411-CEM-EMEA-0010,False,False,REF-707147,First Continental Bank,***8113,Globex Consulting UK Ltd.,UK,-903396.5
2024-11-06,2024-11-06,Marketing - Aurelia Media #7,Marketing,ALL,15688.02,0.0,GBP,CHAPS,Aurelia Media #7,***4479,,,False,False,REF-139106,First Continental Bank,***2523,Globex Consulting UK Ltd.,UK,-919084.52
2024-11-06,2024-11-06,Supplier Payment - Stelliform Parts BV #9,Supplier Payment,CEM-EMEA,40595.18,0.0,GBP,CHAPS,Stelliform Parts BV #9,***3235,,PO-202411-CEM-EMEA-0008,False,False,REF-508900,First Continental Bank,***1259,Globex Consulting UK Ltd.,UK,-959679.7
2024-11-06,2024-11-06,Client Receipt - CloudBridge Co. #70,Sales Receipt,SaaS-GL,0.0,11013.05,GBP,Faster Payments Credit,CloudBridge Co. #70,***6426,INV-202411-SaaS-GL-0003,,False,False,REF-456084,First Continental Bank,***8518,Globex Consulting UK Ltd.,UK,-948666.65
2024-11-07,2024-11-07,Supplier Payment - ExpertNet Subcontractors #16,Supplier Payment,PS-GL,4398.02,0.0,GBP,Faster Payments,ExpertNet Subcontractors #16,***6265,,PO-202411-PS-GL-0007,False,False,REF-110755,First Continental Bank,***8666,Globex Consulting UK Ltd.,UK,-953064.67
2024-11-07,2024-11-07,Client Receipt - CloudBridge Co. #73,Sales Receipt,SaaS-GL,0.0,15979.03,GBP,Faster Payments Credit,CloudBridge Co. #73,***7425,INV-202411-SaaS-GL-0017,,False,False,REF-683190,First Continental Bank,***3646,Globex Consulting UK Ltd.,UK,-937085.64
2024-11-08,2024-11-08,Client Receipt - CloudBridge Co. #57,Sales Receipt,SaaS-GL,0.0,5918.04,GBP,CHAPS Credit,CloudBridge Co. #57,***7845,INV-202411-SaaS-GL-0025,,False,False,REF-961632,First Continental Bank,***8811,Globex Consulting UK Ltd.,UK,-931167.6
2024-11-08,2024-11-08,Client Receipt - CloudBridge Co. #38,Sales Receipt,SaaS-GL,0.0,32463.99,GBP,CHAPS Credit,CloudBridge Co. #38,***8879,INV-202411-SaaS-GL-0026,,False,False,REF-755274,First Continental Bank,***3046,Globex Consulting UK Ltd.,UK,-898703.61
2024-11-09,2024-11-09,Client Receipt - Aurora Electronics GmbH #7,Sales Receipt,CEM-EMEA,0.0,10176.09,GBP,CHAPS Credit,Aurora Electronics GmbH #7,***4559,INV-202411-CEM-EMEA-0006,,False,False,REF-956003,First Continental Bank,***3790,Globex Consulting UK Ltd.,UK,-888527.52
2024-11-09,2024-11-09,Client Receipt - Vertex Advisory Client #13,Sales Receipt,PS-GL,0.0,27439.8,GBP,Faster Payments Credit,Vertex Advisory Client #13,***2078,INV-202411-PS-GL-0010,,False,False,REF-457184,First Continental Bank,***6342,Globex Consulting UK Ltd.,UK,-861087.72
2024-11-10,2024-11-10,Supplier Payment - Stelliform Parts BV #16,Supplier Payment,CEM-EMEA,2348.14,0.0,GBP,Faster Payments,Stelliform Parts BV #16,***6552,,PO-202411-CEM-EMEA-0011,False,False,REF-200425,First Continental Bank,***8115,Globex Consulting UK Ltd.,UK,-863435.86
2024-11-10,2024-11-10,Client Receipt - Novatek Components Ltd #3,Sales Receipt,CEM-EMEA,0.0,2469.81,GBP,Faster Payments Credit,Novatek Components Ltd #3,***5436,INV-202411-CEM-EMEA-0014,,False,False,REF-406022,First Continental Bank,***8474,Globex Consulting UK Ltd.,UK,-860966.05
2024-11-11,2024-11-11,Client Receipt - CloudBridge Co. #24,Sales Receipt,SaaS-GL,0.0,3542.38,GBP,Faster Payments Credit,CloudBridge Co. #24,***4033,INV-202411-SaaS-GL-0030,,False,False,REF-777135,First Continental Bank,***2158,Globex Consulting UK Ltd.,UK,-857423.67
2024-11-11,2024-11-11,Client Receipt - Aurora Electronics GmbH #11,Sales Receipt,CEM-EMEA,0.0,3799.23,GBP,CHAPS Credit,Aurora Electronics GmbH #11,***1461,INV-202411-CEM-EMEA-0013,,False,False,REF-656997,First Continental Bank,***5464,Globex Consulting UK Ltd.,UK,-853624.44
2024-11-12,2024-11-12,Supplier Payment - CodeCraft Contractors #6,Supplier Payment,SaaS-GL,1807.3,0.0,GBP,Faster Payments,CodeCraft Contractors #6,***1323,,PO-202411-SaaS-GL-0006,False,False,REF-855535,First Continental Bank,***4878,Globex Consulting UK Ltd.,UK,-855431.74
2024-11-12,2024-11-12,Marketing - Aurelia Media #5,Marketing,ALL,4747.2,0.0,GBP,CHAPS,Aurelia Media #5,***7565,,,False,False,REF-124231,First Continental Bank,***9984,Globex Consulting UK Ltd.,UK,-860178.94
2024-11-12,2024-11-12,Northshore Power,Rent & Utilities,ALL,6341.39,0.0,GBP,Faster Payments,Northshore Power,***4949,,,False,False,REF-642947,First Continental Bank,***1214,Globex Consulting UK Ltd.,UK,-866520.33
2024-11-12,2024-11-12,Supplier Payment - CodeCraft Contractors #8,Supplier Payment,SaaS-GL,14358.78,0.0,GBP,CHAPS,CodeCraft Contractors #8,***5945,,PO-202411-SaaS-GL-0008,False,False,REF-651901,First Continental Bank,***9509,Globex Consulting UK Ltd.,UK,-880879.11
2024-11-12,2024-11-12,Intercompany Settlement - Globex APAC Logistics Pte. Ltd.,Intercompany Transfer,ALL,681218.0,0.0,GBP,Internal Transfer,Globex APAC Logistics Pte. Ltd.,***9747,,,True,True,REF-436567,First Continental Bank,***8239,Globex Consulting UK Ltd.,UK,-1562097.11
2024-11-12,2024-11-12,Client Receipt - CloudBridge Co. #29,Sales Receipt,SaaS-GL,0.0,10532.01,GBP,CHAPS Credit,CloudBridge Co. #29,***9687,INV-202411-SaaS-GL-0023,,False,False,REF-425414,First Continental Bank,***8681,Globex Consulting UK Ltd.,UK,-1551565.1
2024-11-12,2024-11-12,Client Receipt - CloudBridge Co. #28,Sales Receipt,SaaS-GL,0.0,12263.08,GBP,Faster Payments Credit,CloudBridge Co. #28,***3743,INV-202411-SaaS-GL-0011,,False,False,REF-596529,First Continental Bank,***3076,Globex Consulting UK Ltd.,UK,-1539302.02
2024-11-12,2024-11-12,Client Receipt - Novatek Components Ltd #2,Sales Receipt,CEM-EMEA,0.0,28311.94,GBP,Faster Payments Credit,Novatek Components Ltd #2,***8265,INV-202411-CEM-EMEA-0002,,False,False,REF-462086,First Continental Bank,***3200,Globex Consulting UK Ltd.,UK,-1510990.08
2024-11-13,2024-11-13,Supplier Payment - HyperCloud Infra #19,Supplier Payment,SaaS-GL,2004.79,0.0,GBP,Faster Payments,HyperCloud Infra #19,***5612,,PO-202411-SaaS-GL-0007,False,False,REF-532342,First Continental Bank,***4471,Globex Consulting UK Ltd.,UK,-1512994.87
2024-11-13,2024-11-13,Supplier Payment - CodeCraft Contractors #1,Supplier Payment,SaaS-GL,3472.02,0.0,GBP,CHAPS,CodeCraft Contractors #1,***4559,,PO-202411-SaaS-GL-0001,False,False,REF-800152,First Continental Bank,***7517,Globex Consulting UK Ltd.,UK,-1516466.89
2024-11-13,2024-11-13,Client Receipt - CloudBridge Co. #74,Sales Receipt,SaaS-GL,0.0,789.43,GBP,Faster Payments Credit,CloudBridge Co. #74,***9728,INV-202411-SaaS-GL-0007,,False,False,REF-633035,First Continental Bank,***5875,Globex Consulting UK Ltd.,UK,-1515677.46
2024-11-13,2024-11-13,Client Receipt - Novatek Components Ltd #9,Sales Receipt,CEM-EMEA,0.0,1625.74,GBP,Faster Payments Credit,Novatek Components Ltd #9,***3088,INV-202411-CEM-EMEA-0008,,False,False,REF-101738,First Continental Bank,***6837,Globex Consulting UK Ltd.,UK,-1514051.72
2024-11-13,2024-11-13,Client Receipt - CloudBridge Co. #35,Sales Receipt,SaaS-GL,0.0,8505.55,GBP,CHAPS Credit,CloudBridge Co. #35,***1851,INV-202411-SaaS-GL-0013,,False,False,REF-580768,First Continental Bank,***6845,Globex Consulting UK Ltd.,UK,-1505546.17
2024-11-13,2024-11-13,Client Receipt - Aurora Electronics GmbH #18,Sales Receipt,CEM-EMEA,0.0,14843.91,GBP,CHAPS Credit,Aurora Electronics GmbH #18,***4010,INV-202411-CEM-EMEA-0018,,False,False,REF-141766,First Continental Bank,***7403,Globex Consulting UK Ltd.,UK,-1490702.26
2024-11-13,2024-11-13,Client Receipt - CloudBridge Co. #28,Sales Receipt,SaaS-GL,0.0,17293.14,GBP,CHAPS Credit,CloudBridge Co. #28,***5916,INV-202411-SaaS-GL-0024,,False,False,REF-446344,First Continental Bank,***3477,Globex Consulting UK Ltd.,UK,-1473409.12
2024-11-13,2024-11-13,Client Receipt - Aurora Electronics GmbH #10,Sales Receipt,CEM-EMEA,0.0,23898.98,GBP,Faster Payments Credit,Aurora Electronics GmbH #10,***8099,INV-202411-CEM-EMEA-0011,,False,False,REF-396587,First Continental Bank,***1182,Globex Consulting UK Ltd.,UK,-1449510.14
2024-11-13,2024-11-13,Client Receipt - CloudBridge Co. #63,Sales Receipt,SaaS-GL,0.0,26852.41,GBP,CHAPS Credit,CloudBridge Co. #63,***8212,INV-202411-SaaS-GL-0012,,False,False,REF-534688,First Continental Bank,***5517,Globex Consulting UK Ltd.,UK,-1422657.73
2024-11-14,2024-11-14,Supplier Payment - ExpertNet Subcontractors #8,Supplier Payment,PS-GL,830.24,0.0,GBP,CHAPS,ExpertNet Subcontractors #8,***5902,,PO-202411-PS-GL-0002,False,False,REF-925645,First Continental Bank,***4669,Globex Consulting UK Ltd.,UK,-1423487.97
2024-11-14,2024-11-14,Supplier Payment - EuroFab Assembly #1,Supplier Payment,CEM-EMEA,4671.03,0.0,GBP,Faster Payments,EuroFab Assembly #1,***8686,,PO-202411-CEM-EMEA-0005,False,False,REF-132588,First Continental Bank,***6931,Globex Consulting UK Ltd.,UK,-1428159.0
2024-11-14,2024-11-14,Supplier Payment - EuroFab Assembly #16,Supplier Payment,CEM-EMEA,18954.02,0.0,GBP,CHAPS,EuroFab Assembly #16,***3997,,PO-202411-CEM-EMEA-0002,False,False,REF-438230,First Continental Bank,***9033,Globex Consulting UK Ltd.,UK,-1447113.02
2024-11-14,2024-11-14,Client Receipt - CloudBridge Co. #59,Sales Receipt,SaaS-GL,0.0,3714.29,GBP,CHAPS Credit,CloudBridge Co. #59,***3630,INV-202411-SaaS-GL-0004,,False,False,REF-877183,First Continental Bank,***7981,Globex Consulting UK Ltd.,UK,-1443398.73
2024-11-15,2024-11-15,Supplier Payment - Stelliform Parts BV #22,Supplier Payment,CEM-EMEA,21415.77,0.0,GBP,CHAPS,Stelliform Parts BV #22,***6776,,PO-202411-CEM-EMEA-0009,False,False,REF-896481,First Continental Bank,***6944,Globex Consulting UK Ltd.,UK,-1464814.5
2024-11-15,2024-11-15,Supplier Payment - Stelliform Parts BV #13,Supplier Payment,CEM-EMEA,24045.37,0.0,GBP,Faster Payments,Stelliform Parts BV #13,***2339,,PO-202411-CEM-EMEA-0004,False,False,REF-340839,First Continental Bank,***2084,Globex Consulting UK Ltd.,UK,-1488859.87
2024-11-15,2024-11-15,Supplier Payment - EuroFab Assembly #14,Supplier Payment,CEM-EMEA,54059.25,0.0,GBP,Faster Payments,EuroFab Assembly #14,***2924,,PO-202411-CEM-EMEA-0003,False,False,REF-620758,First Continental Bank,***4951,Globex Consulting UK Ltd.,UK,-1542919.12
2024-11-15,2024-11-15,Client Receipt - CloudBridge Co. #67,Sales Receipt,SaaS-GL,0.0,130.78,GBP,Faster Payments Credit,CloudBridge Co. #67,***7269,INV-202411-SaaS-GL-0029,,False,False,REF-370533,First Continental Bank,***8886,Globex Consulting UK Ltd.,UK,-1542788.34
2024-11-15,2024-11-15,Client Receipt - Aurora Electronics GmbH #9,Sales Receipt,CEM-EMEA,0.0,2558.29,GBP,Faster Payments Credit,Aurora Electronics GmbH #9,***6126,INV-202411-CEM-EMEA-0012,,False,False,REF-109487,First Continental Bank,***5367,Globex Consulting UK Ltd.,UK,-1540230.05
2024-11-15,2024-11-15,Client Receipt - CloudBridge Co. #41,Sales Receipt,SaaS-GL,0.0,7587.95,GBP,CHAPS Credit,CloudBridge Co. #41,***8282,INV-202411-SaaS-GL-0032,,False,False,REF-252690,First Continental Bank,***9815,Globex Consulting UK Ltd.,UK,-1532642.1
2024-11-15,2024-11-15,Client Receipt - Aurora Electronics GmbH #11,Sales Receipt,CEM-EMEA,0.0,10577.18,GBP,Faster Payments Credit,Aurora Electronics GmbH #11,***5002,INV-202411-CEM-EMEA-0009,,False,False,REF-903981,First Continental Bank,***8689,Globex Consulting UK Ltd.,UK,-1522064.92
2024-11-16,2024-11-16,Client Receipt - Aurora Electronics GmbH #2,Sales Receipt,CEM-EMEA,0.0,24682.88,GBP,Faster Payments Credit,Aurora Electronics GmbH #2,***6068,INV-202411-CEM-EMEA-0010,,False,False,REF-992693,First Continental Bank,***9859,Globex Consulting UK Ltd.,UK,-1497382.04
2024-11-17,2024-11-17,Client Receipt - CloudBridge Co. #50,Sales Receipt,SaaS-GL,0.0,16.21,GBP,CHAPS Credit,CloudBridge Co. #50,***6488,INV-202411-SaaS-GL-0028,,False,False,REF-462217,First Continental Bank,***2188,Globex Consulting UK Ltd.,UK,-1497365.83
2024-11-18,2024-11-18,Supplier Payment - ExpertNet Subcontractors #5,Supplier Payment,PS-GL,645.58,0.0,GBP,CHAPS,ExpertNet Subcontractors #5,***2276,,PO-202411-PS-GL-0004,False,False,REF-571774,First Continental Bank,***6942,Globex Consulting UK Ltd.,UK,-1498011.41
2024-11-18,2024-11-18,Supplier Payment - ExpertNet Subcontractors #15,Supplier Payment,PS-GL,3781.15,0.0,GBP,Faster Payments,ExpertNet Subcontractors #15,***7940,,PO-202411-PS-GL-0001,False,False,REF-608648,First Continental Bank,***5539,Globex Consulting UK Ltd.,UK,-1501792.56
2024-11-18,2024-11-18,Client Receipt - CloudBridge Co. #46,Sales Receipt,SaaS-GL,0.0,1456.66,GBP,Faster Payments Credit,CloudBridge Co. #46,***4934,INV-202411-SaaS-GL-0020,,False,False,REF-641050,First Continental Bank,***8841,Globex Consulting UK Ltd.,UK,-1500335.9
2024-11-18,2024-11-18,Client Receipt - CloudBridge Co. #54,Sales Receipt,SaaS-GL,0.0,6973.75,GBP,CHAPS Credit,CloudBridge Co. #54,***9429,INV-202411-SaaS-GL-0010,,False,False,REF-893546,First Continental Bank,***4212,Globex Consulting UK Ltd.,UK,-1493362.15
2024-11-18,2024-11-18,Client Receipt - Vertex Advisory Client #32,Sales Receipt,PS-GL,0.0,14938.82,GBP,CHAPS Credit,Vertex Advisory Client #32,***3808,INV-202411-PS-GL-0008,,False,False,REF-684320,First Continental Bank,***1329,Globex Consulting UK Ltd.,UK,-1478423.33
2024-11-19,2024-11-19,Client Receipt - CloudBridge Co. #9,Sales Receipt,SaaS-GL,0.0,2175.16,GBP,CHAPS Credit,CloudBridge Co. #9,***3136,INV-202411-SaaS-GL-0006,,False,False,REF-926929,First Continental Bank,***5171,Globex Consulting UK Ltd.,UK,-1476248.17
2024-11-20,2024-11-20,Supplier Payment - ExpertNet Subcontractors #7,Supplier Payment,PS-GL,5411.61,0.0,GBP,CHAPS,ExpertNet Subcontractors #7,***4546,,PO-202411-PS-GL-0009,False,False,REF-305701,First Continental Bank,***8012,Globex Consulting UK Ltd.,UK,-1481659.78
2024-11-20,2024-11-20,Supplier Payment - ExpertNet Subcontractors #14,Supplier Payment,PS-GL,6717.62,0.0,GBP,CHAPS,ExpertNet Subcontractors #14,***9303,,PO-202411-PS-GL-0005,False,False,REF-794671,First Continental Bank,***7458,Globex Consulting UK Ltd.,UK,-1488377.4
2024-11-20,2024-11-20,Supplier Payment - CodeCraft Contractors #8,Supplier Payment,SaaS-GL,12986.41,0.0,GBP,CHAPS,CodeCraft Contractors #8,***1658,,PO-202411-SaaS-GL-0004,False,False,REF-819827,First Continental Bank,***8293,Globex Consulting UK Ltd.,UK,-1501363.81
2024-11-20,2024-11-20,Client Receipt - CloudBridge Co. #39,Sales Receipt,SaaS-GL,0.0,3780.04,GBP,Faster Payments Credit,CloudBridge Co. #39,***6453,INV-202411-SaaS-GL-0022,,False,False,REF-868169,First Continental Bank,***4542,Globex Consulting UK Ltd.,UK,-1497583.77
2024-11-20,2024-11-20,Client Receipt - Novatek Components Ltd #12,Sales Receipt,CEM-EMEA,0.0,10995.04,GBP,Faster Payments Credit,Novatek Components Ltd #12,***5471,INV-202411-CEM-EMEA-0003,,False,False,REF-343122,First Continental Bank,***6931,Globex Consulting UK Ltd.,UK,-1486588.73
2024-11-20,2024-11-20,Client Receipt - Vertex Advisory Client #6,Sales Receipt,PS-GL,0.0,15954.28,GBP,Faster Payments Credit,Vertex Advisory Client #6,***3645,INV-202411-PS-GL-0009,,False,False,REF-979194,First Continental Bank,***9164,Globex Consulting UK Ltd.,UK,-1470634.45
2024-11-20,2024-11-20,Client Receipt - CloudBridge Co. #4,Sales Receipt,SaaS-GL,0.0,18673.03,GBP,CHAPS Credit,CloudBridge Co. #4,***3368,INV-202411-SaaS-GL-0014,,False,False,REF-551359,First Continental Bank,***5717,Globex Consulting UK Ltd.,UK,-1451961.42
2024-11-20,2024-11-20,Client Receipt - Novatek Components Ltd #7,Sales Receipt,CEM-EMEA,0.0,69782.56,GBP,CHAPS Credit,Novatek Components Ltd #7,***9757,INV-202411-CEM-EMEA-0015,,False,False,REF-610695,First Continental Bank,***3554,Globex Consulting UK Ltd.,UK,-1382178.86
2024-11-21,2024-11-21,Supplier Payment - EuroFab Assembly #1,Supplier Payment,CEM-EMEA,22119.85,0.0,GBP,CHAPS,EuroFab Assembly #1,***9082,,PO-202411-CEM-EMEA-0001,False,False,REF-913176,First Continental Bank,***9879,Globex Consulting UK Ltd.,UK,-1404298.71
2024-11-21,2024-11-21,Client Receipt - Aurora Electronics GmbH #13,Sales Receipt,CEM-EMEA,0.0,10955.33,GBP,Faster Payments Credit,Aurora Electronics GmbH #13,***1713,INV-202411-CEM-EMEA-0007,,False,False,REF-718388,First Continental Bank,***6394,Globex Consulting UK Ltd.,UK,-1393343.38
2024-11-21,2024-11-21,Client Receipt - Aurora Electronics GmbH #9,Sales Receipt,CEM-EMEA,0.0,22560.24,GBP,Faster Payments Credit,Aurora Electronics GmbH #9,***3143,INV-202411-CEM-EMEA-0005,,False,False,REF-780597,First Continental Bank,***1796,Globex Consulting UK Ltd.,UK,-1370783.14
2024-11-22,2024-11-22,VAT/GST Remittance - HMRC UK,Tax Payment,ALL,49768.4,0.0,GBP,CHAPS,HMRC UK,***4192,,,False,False,REF-172945,First Continental Bank,***5292,Globex Consulting UK Ltd.,UK,-1420551.54
2024-11-22,2024-11-22,Client Receipt - Novatek Components Ltd #9,Sales Receipt,CEM-EMEA,0.0,16102.42,GBP,Faster Payments Credit,Novatek Components Ltd #9,***2708,INV-202411-CEM-EMEA-0004,,False,False,REF-863859,First Continental Bank,***8117,Globex Consulting UK Ltd.,UK,-1404449.12
2024-11-22,2024-11-22,Client Receipt - Aurora Electronics GmbH #13,Sales Receipt,CEM-EMEA,0.0,54835.23,GBP,Faster Payments Credit,Aurora Electronics GmbH #13,***5192,INV-202411-CEM-EMEA-0016,,False,False,REF-376885,First Continental Bank,***8207,Globex Consulting UK Ltd.,UK,-1349613.89
2024-11-25,2024-11-25,Supplier Payment - HyperCloud Infra #8,Supplier Payment,SaaS-GL,5254.76,0.0,GBP,Faster Payments,HyperCloud Infra #8,***1799,,PO-202411-SaaS-GL-0003,False,False,REF-464449,First Continental Bank,***8872,Globex Consulting UK Ltd.,UK,-1354868.65
2024-11-25,2024-11-25,Supplier Payment - ExpertNet Subcontractors #9,Supplier Payment,PS-GL,8231.11,0.0,GBP,Faster Payments,ExpertNet Subcontractors #9,***9252,,PO-202411-PS-GL-0012,False,False,REF-845420,First Continental Bank,***1473,Globex Consulting UK Ltd.,UK,-1363099.76
2024-11-25,2024-11-25,Supplier Payment - EuroFab Assembly #13,Supplier Payment,CEM-EMEA,33628.44,0.0,GBP,CHAPS,EuroFab Assembly #13,***2263,,PO-202411-CEM-EMEA-0006,False,False,REF-487571,First Continental Bank,***1274,Globex Consulting UK Ltd.,UK,-1396728.2
2024-11-25,2024-11-25,Client Receipt - Vertex Advisory Client #34,Sales Receipt,PS-GL,0.0,20442.02,GBP,CHAPS Credit,Vertex Advisory Client #34,***6073,INV-202411-PS-GL-0005,,False,False,REF-507182,First Continental Bank,***2100,Globex Consulting UK Ltd.,UK,-1376286.18
2024-11-25,2024-11-25,Client Receipt - Vertex Advisory Client #22,Sales Receipt,PS-GL,0.0,30877.91,GBP,CHAPS Credit,Vertex Advisory Client #22,***3580,INV-202411-PS-GL-0006,,False,False,REF-523167,First Continental Bank,***9824,Globex Consulting UK Ltd.,UK,-1345408.27
2024-11-26,2024-11-26,Supplier Payment - EuroFab Assembly #1,Supplier Payment,CEM-EMEA,6817.44,0.0,GBP,Faster Payments,EuroFab Assembly #1,***9908,,PO-202411-CEM-EMEA-0007,False,False,REF-295514,First Continental Bank,***5280,Globex Consulting UK Ltd.,UK,-1352225.71
2024-11-26,2024-11-26,Payroll - GlobalPay Services Ltd,Payroll,ALL,65189.26,0.0,GBP,CHAPS,GlobalPay Services Ltd,***6663,,,False,False,REF-768703,First Continental Bank,***1253,Globex Consulting UK Ltd.,UK,-1417414.97
2024-11-26,2024-11-26,"Intercompany Settlement - Globex International Holdings, Inc.",Intercompany Transfer,ALL,487126.0,0.0,GBP,Internal Transfer,"Globex International Holdings, Inc.",***6433,,,True,True,REF-731387,First Continental Bank,***6154,Globex Consulting UK Ltd.,UK,-1904540.97
2024-11-26,2024-11-26,Client Receipt - Vertex Advisory Client #26,Sales Receipt,PS-GL,0.0,4913.49,GBP,Faster Payments Credit,Vertex Advisory Client #26,***6778,INV-202411-PS-GL-0003,,False,False,REF-850744,First Continental Bank,***4288,Globex Consulting UK Ltd.,UK,-1899627.48
2024-11-26,2024-11-26,Client Receipt - Vertex Advisory Client #52,Sales Receipt,PS-GL,0.0,17733.11,GBP,Faster Payments Credit,Vertex Advisory Client #52,***9372,INV-202411-PS-GL-0001,,False,False,REF-182493,First Continental Bank,***7942,Globex Consulting UK Ltd.,UK,-1881894.37
2024-11-27,2024-11-27,Supplier Payment - ExpertNet Subcontractors #4,Supplier Payment,PS-GL,1690.58,0.0,GBP,Faster Payments,ExpertNet Subcontractors #4,***7079,,PO-202411-PS-GL-0008,False,False,REF-868033,First Continental Bank,***8625,Globex Consulting UK Ltd.,UK,-1883584.95
2024-11-27,2024-11-27,Payroll - GlobalPay Services Ltd,Payroll,ALL,65189.26,0.0,GBP,Faster Payments,GlobalPay Services Ltd,***9434,,,False,False,REF-232125,First Continental Bank,***5817,Globex Consulting UK Ltd.,UK,-1948774.21
2024-11-27,2024-11-27,Client Receipt - CloudBridge Co. #69,Sales Receipt,SaaS-GL,0.0,2129.65,GBP,Faster Payments Credit,CloudBridge Co. #69,***3707,INV-202411-SaaS-GL-0009,,False,False,REF-114275,First Continental Bank,***3124,Globex Consulting UK Ltd.,UK,-1946644.56
2024-11-27,2024-11-27,Client Receipt - Vertex Advisory Client #21,Sales Receipt,PS-GL,0.0,5594.51,GBP,Faster Payments Credit,Vertex Advisory Client #21,***1842,INV-202411-PS-GL-0004,,False,False,REF-749219,First Continental Bank,***1477,Globex Consulting UK Ltd.,UK,-1941050.05
2024-11-27,2024-11-27,Client Receipt - CloudBridge Co. #71,Sales Receipt,SaaS-GL,0.0,7347.66,GBP,CHAPS Credit,CloudBridge Co. #71,***6183,INV-202411-SaaS-GL-0002,,False,False,REF-739149,First Continental Bank,***9180,Globex Consulting UK Ltd.,UK,-1933702.39
2024-11-28,2024-11-28,Supplier Payment - ExpertNet Subcontractors #14,Supplier Payment,PS-GL,4210.03,0.0,GBP,Faster Payments,ExpertNet Subcontractors #14,***5642,,PO-202411-PS-GL-0006,False,False,REF-884688,First Continental Bank,***4866,Globex Consulting UK Ltd.,UK,-1937912.42
2024-11-28,2024-11-28,Client Receipt - CloudBridge Co. #3,Sales Receipt,SaaS-GL,0.0,2698.31,GBP,CHAPS Credit,CloudBridge Co. #3,***2050,INV-202411-SaaS-GL-0008,,False,False,REF-948705,First Continental Bank,***9296,Globex Consulting UK Ltd.,UK,-1935214.11
2024-11-28,2024-11-28,Client Receipt - CloudBridge Co. #71,Sales Receipt,SaaS-GL,0.0,4948.61,GBP,Faster Payments Credit,CloudBridge Co. #71,***5767,INV-202411-SaaS-GL-0027,,False,False,REF-586686,First Continental Bank,***8443,Globex Consulting UK Ltd.,UK,-1930265.5
2024-11-28,2024-11-28,Client Receipt - CloudBridge Co. #45,Sales Receipt,SaaS-GL,0.0,8665.79,GBP,Faster Payments Credit,CloudBridge Co. #45,***3408,INV-202411-SaaS-GL-0016,,False,False,REF-238838,First Continental Bank,***1063,Globex Consulting UK Ltd.,UK,-1921599.71
2024-11-29,2024-11-29,Supplier Payment - ExpertNet Subcontractors #9,Supplier Payment,PS-GL,4520.27,0.0,GBP,CHAPS,ExpertNet Subcontractors #9,***4290,,PO-202411-PS-GL-0011,False,False,REF-116179,First Continental Bank,***3335,Globex Consulting UK Ltd.,UK,-1926119.98
2024-11-29,2024-11-29,Supplier Payment - HyperCloud Infra #7,Supplier Payment,SaaS-GL,13819.22,0.0,GBP,Faster Payments,HyperCloud Infra #7,***3107,,PO-202411-SaaS-GL-0005,False,False,REF-119664,First Continental Bank,***7737,Globex Consulting UK Ltd.,UK,-1939939.2
2024-11-29,2024-11-29,Client Receipt - CloudBridge Co. #78,Sales Receipt,SaaS-GL,0.0,1358.5,GBP,Faster Payments Credit,CloudBridge Co. #78,***8139,INV-202411-SaaS-GL-0019,,False,False,REF-727523,First Continental Bank,***6936,Globex Consulting UK Ltd.,UK,-1938580.7
2024-11-29,2024-11-29,Client Receipt - CloudBridge Co. #51,Sales Receipt,SaaS-GL,0.0,16576.18,GBP,CHAPS Credit,CloudBridge Co. #51,***7622,INV-202411-SaaS-GL-0018,,False,False,REF-671717,First Continental Bank,***3721,Globex Consulting UK Ltd.,UK,-1922004.52
2024-11-30,2024-11-30,Interest Earned,Interest Income,ALL,0.0,13074.52,GBP,CHAPS Credit,First Continental Bank,***2452,,,False,False,REF-753381,First Continental Bank,***7959,Globex Consulting UK Ltd.,UK,-1908930.0
2024-12-01,2024-12-01,Account Maintenance Fee,Bank/Merchant Fees,ALL,2500.0,0.0,GBP,CHAPS,First Continental Bank,***4667,,,False,False,REF-582583,First Continental Bank,***4150,Globex Consulting UK Ltd.,UK,-1911430.0
2024-12-01,2024-12-01,Client Receipt - CloudBridge Co. #32,Sales Receipt,SaaS-GL,0.0,6650.16,GBP,CHAPS Credit,CloudBridge Co. #32,***3752,INV-202412-SaaS-GL-0007,,False,False,REF-287827,First Continental Bank,***4090,Globex Consulting UK Ltd.,UK,-1904779.84
2024-12-02,2024-12-02,Client Receipt - CloudBridge Co. #36,Sales Receipt,SaaS-GL,0.0,7277.42,GBP,CHAPS Credit,CloudBridge Co. #36,***4349,INV-202412-SaaS-GL-0024,,False,False,REF-184204,First Continental Bank,***1434,Globex Consulting UK Ltd.,UK,-1897502.42
2024-12-03,2024-12-03,Supplier Payment - ExpertNet Subcontractors #1,Supplier Payment,PS-GL,9859.9,0.0,GBP,Faster Payments,ExpertNet Subcontractors #1,***1155,,PO-202412-PS-GL-0007,False,False,REF-967217,First Continental Bank,***1305,Globex Consulting UK Ltd.,UK,-1907362.32
2024-12-03,2024-12-03,Supplier Payment - ExpertNet Subcontractors #16,Supplier Payment,PS-GL,10012.67,0.0,GBP,CHAPS,ExpertNet Subcontractors #16,***1131,,PO-202412-PS-GL-0002,False,False,REF-215387,First Continental Bank,***6776,Globex Consulting UK Ltd.,UK,-1917374.99
2024-12-03,2024-12-03,Client Receipt - CloudBridge Co. #26,Sales Receipt,SaaS-GL,0.0,1655.31,GBP,CHAPS Credit,CloudBridge Co. #26,***5029,INV-202412-SaaS-GL-0001,,False,False,REF-944944,First Continental Bank,***9690,Globex Consulting UK Ltd.,UK,-1915719.68
2024-12-03,2024-12-03,Client Receipt - CloudBridge Co. #29,Sales Receipt,SaaS-GL,0.0,4447.24,GBP,Faster Payments Credit,CloudBridge Co. #29,***5115,INV-202412-SaaS-GL-0017,,False,False,REF-622713,First Continental Bank,***7429,Globex Consulting UK Ltd.,UK,-1911272.44
2024-12-03,2024-12-03,Client Receipt - CloudBridge Co. #8,Sales Receipt,SaaS-GL,0.0,15392.73,GBP,Faster Payments Credit,CloudBridge Co. #8,***2233,INV-202412-SaaS-GL-0027,,False,False,REF-674032,First Continental Bank,***7727,Globex Consulting UK Ltd.,UK,-1895879.71
2024-12-04,2024-12-04,Client Receipt - CloudBridge Co. #21,Sales Receipt,SaaS-GL,0.0,7249.91,GBP,Faster Payments Credit,CloudBridge Co. #21,***4588,INV-202412-SaaS-GL-0029,,False,False,REF-374787,First Continental Bank,***4220,Globex Consulting UK Ltd.,UK,-1888629.8
2024-12-05,2024-12-05,Supplier Payment - ExpertNet Subcontractors #5,Supplier Payment,PS-GL,4276.34,0.0,GBP,CHAPS,ExpertNet Subcontractors #5,***5703,,PO-202412-PS-GL-0008,False,False,REF-587148,First Continental Bank,***9281,Globex Consulting UK Ltd.,UK,-1892906.14
2024-12-05,2024-12-05,Client Receipt - Vertex Advisory Client #20,Sales Receipt,PS-GL,0.0,15954.28,GBP,CHAPS Credit,Vertex Advisory Client #20,***3941,INV-202412-PS-GL-0001,,False,False,REF-193723,First Continental Bank,***8343,Globex Consulting UK Ltd.,UK,-1876951.86
2024-12-06,2024-12-06,Supplier Payment - HyperCloud Infra #8,Supplier Payment,SaaS-GL,13565.38,0.0,GBP,CHAPS,HyperCloud Infra #8,***8780,,PO-202412-SaaS-GL-0004,False,False,REF-716182,First Continental Bank,***4982,Globex Consulting UK Ltd.,UK,-1890517.24
2024-12-08,2024-12-08,Client Receipt - CloudBridge Co. #61,Sales Receipt,SaaS-GL,0.0,1874.81,GBP,CHAPS Credit,CloudBridge Co. #61,***7801,INV-202412-SaaS-GL-0005,,False,False,REF-290894,First Continental Bank,***6681,Globex Consulting UK Ltd.,UK,-1888642.43
2024-12-09,2024-12-09,Client Receipt - Novatek Components Ltd #11,Sales Receipt,CEM-EMEA,0.0,6713.39,GBP,CHAPS Credit,Novatek Components Ltd #11,***4765,INV-202412-CEM-EMEA-0003,,False,False,REF-822741,First Continental Bank,***5458,Globex Consulting UK Ltd.,UK,-1881929.04
2024-12-10,2024-12-10,Supplier Payment - CodeCraft Contractors #9,Supplier Payment,SaaS-GL,3722.67,0.0,GBP,Faster Payments,CodeCraft Contractors #9,***7538,,PO-202412-SaaS-GL-0001,False,False,REF-151809,First Continental Bank,***3165,Globex Consulting UK Ltd.,UK,-1885651.71
2024-12-10,2024-12-10,Supplier Payment - ExpertNet Subcontractors #7,Supplier Payment,PS-GL,10165.5,0.0,GBP,CHAPS,ExpertNet Subcontractors #7,***9215,,PO-202412-PS-GL-0004,False,False,REF-687862,First Continental Bank,***7933,Globex Consulting UK Ltd.,UK,-1895817.21
2024-12-10,2024-12-10,Supplier Payment - HyperCloud Infra #1,Supplier Payment,SaaS-GL,19522.65,0.0,GBP,CHAPS,HyperCloud Infra #1,***9220,,PO-202412-SaaS-GL-0005,False,False,REF-921989,First Continental Bank,***2285,Globex Consulting UK Ltd.,UK,-1915339.86
2024-12-10,2024-12-10,Client Receipt - CloudBridge Co. #67,Sales Receipt,SaaS-GL,0.0,4150.72,GBP,Faster Payments Credit,CloudBridge Co. #67,***8799,INV-202412-SaaS-GL-0003,,False,False,REF-580840,First Continental Bank,***7736,Globex Consulting UK Ltd.,UK,-1911189.14
2024-12-10,2024-12-10,Client Receipt - CloudBridge Co. #56,Sales Receipt,SaaS-GL,0.0,6092.96,GBP,Faster Payments Credit,CloudBridge Co. #56,***4562,INV-202412-SaaS-GL-0013,,False,False,REF-270009,First Continental Bank,***4485,Globex Consulting UK Ltd.,UK,-1905096.18
2024-12-10,2024-12-10,Client Receipt - CloudBridge Co. #20,Sales Receipt,SaaS-GL,0.0,13466.5,GBP,CHAPS Credit,CloudBridge Co. #20,***5800,INV-202412-SaaS-GL-0009,,False,False,REF-110991,First Continental Bank,***7133,Globex Consulting UK Ltd.,UK,-1891629.68
2024-12-10,2024-12-10,Client Receipt - Vertex Advisory Client #55,Sales Receipt,PS-GL,0.0,25850.29,GBP,Faster Payments Credit,Vertex Advisory Client #55,***9122,INV-202412-PS-GL-0010,,False,False,REF-220093,First Continental Bank,***6336,Globex Consulting UK Ltd.,UK,-1865779.39
2024-12-11,2024-12-11,Marketing - Aurelia Media #6,Marketing,ALL,7086.53,0.0,GBP,Faster Payments,Aurelia Media #6,***4422,,,False,False,REF-344672,First Continental Bank,***1019,Globex Consulting UK Ltd.,UK,-1872865.92
2024-12-11,2024-12-11,Supplier Payment - Stelliform Parts BV #12,Supplier Payment,CEM-EMEA,20080.27,0.0,GBP,Faster Payments,Stelliform Parts BV #12,***7611,,PO-202412-CEM-EMEA-0001,False,False,REF-142611,First Continental Bank,***8021,Globex Consulting UK Ltd.,UK,-1892946.19
2024-12-11,2024-12-11,Client Receipt - CloudBridge Co. #8,Sales Receipt,SaaS-GL,0.0,6784.0,GBP,Faster Payments Credit,CloudBridge Co. #8,***5339,INV-202412-SaaS-GL-0004,,False,False,REF-649913,First Continental Bank,***2990,Globex Consulting UK Ltd.,UK,-1886162.19
2024-12-12,2024-12-12,Supplier Payment - ExpertNet Subcontractors #11,Supplier Payment,PS-GL,1354.15,0.0,GBP,Faster Payments,ExpertNet Subcontractors #11,***5984,,PO-202412-PS-GL-0011,False,False,REF-254399,First Continental Bank,***7731,Globex Consulting UK Ltd.,UK,-1887516.34
2024-12-12,2024-12-12,Intercompany Settlement - Globex Retail NA LLC,Intercompany Transfer,ALL,323800.0,0.0,GBP,Internal Transfer,Globex Retail NA LLC,***5865,,,True,True,REF-602973,First Continental Bank,***5526,Globex Consulting UK Ltd.,UK,-2211316.34
2024-12-12,2024-12-12,Client Receipt - CloudBridge Co. #3,Sales Receipt,SaaS-GL,0.0,2584.45,GBP,Faster Payments Credit,CloudBridge Co. #3,***4215,INV-202412-SaaS-GL-0011,,False,False,REF-465649,First Continental Bank,***4383,Globex Consulting UK Ltd.,UK,-2208731.89
2024-12-12,2024-12-12,Client Receipt - CloudBridge Co. #71,Sales Receipt,SaaS-GL,0.0,7368.97,GBP,CHAPS Credit,CloudBridge Co. #71,***1057,INV-202412-SaaS-GL-0014,,False,False,REF-130291,First Continental Bank,***3189,Globex Consulting UK Ltd.,UK,-2201362.92
2024-12-12,2024-12-12,Client Receipt - CloudBridge Co. #3,Sales Receipt,SaaS-GL,0.0,14174.14,GBP,Faster Payments Credit,CloudBridge Co. #3,***3111,INV-202412-SaaS-GL-0019,,False,False,REF-850025,First Continental Bank,***7595,Globex Consulting UK Ltd.,UK,-2187188.78
2024-12-12,2024-12-12,Client Receipt - CloudBridge Co. #17,Sales Receipt,SaaS-GL,0.0,14494.73,GBP,Faster Payments Credit,CloudBridge Co. #17,***8233,INV-202412-SaaS-GL-0015,,False,False,REF-220480,First Continental Bank,***9350,Globex Consulting UK Ltd.,UK,-2172694.05
2024-12-12,2024-12-12,Client Receipt - CloudBridge Co. #77,Sales Receipt,SaaS-GL,0.0,16739.95,GBP,Faster Payments Credit,CloudBridge Co. #77,***5879,INV-202412-SaaS-GL-0023,,False,False,REF-954518,First Continental Bank,***4330,Globex Consulting UK Ltd.,UK,-2155954.1
2024-12-12,2024-12-12,Client Receipt - Novatek Components Ltd #8,Sales Receipt,CEM-EMEA,0.0,43637.32,GBP,CHAPS Credit,Novatek Components Ltd #8,***9747,INV-202412-CEM-EMEA-0007,,False,False,REF-385362,First Continental Bank,***8120,Globex Consulting UK Ltd.,UK,-2112316.78
2024-12-13,2024-12-13,Supplier Payment - Stelliform Parts BV #18,Supplier Payment,CEM-EMEA,17723.2,0.0,GBP,Faster Payments,Stelliform Parts BV #18,***9100,,PO-202412-CEM-EMEA-0002,False,False,REF-969875,First Continental Bank,***7046,Globex Consulting UK Ltd.,UK,-2130039.98
2024-12-13,2024-12-13,Client Receipt - CloudBridge Co. #47,Sales Receipt,SaaS-GL,0.0,11130.18,GBP,Faster Payments Credit,CloudBridge Co. #47,***6183,INV-202412-SaaS-GL-0018,,False,False,REF-590817,First Continental Bank,***5972,Globex Consulting UK Ltd.,UK,-2118909.8
2024-12-14,2024-12-14,Supplier Payment - ExpertNet Subcontractors #14,Supplier Payment,PS-GL,4782.06,0.0,GBP,CHAPS,ExpertNet Subcontractors #14,***9401,,PO-202412-PS-GL-0012,False,False,REF-459933,First Continental Bank,***2731,Globex Consulting UK Ltd.,UK,-2123691.86
2024-12-14,2024-12-14,Client Receipt - Aurora Electronics GmbH #16,Sales Receipt,CEM-EMEA,0.0,7612.79,GBP,CHAPS Credit,Aurora Electronics GmbH #16,***7346,INV-202412-CEM-EMEA-0009,,False,False,REF-943464,First Continental Bank,***5548,Globex Consulting UK Ltd.,UK,-2116079.07
2024-12-15,2024-12-15,Supplier Payment - HyperCloud Infra #15,Supplier Payment,SaaS-GL,1176.97,0.0,GBP,CHAPS,HyperCloud Infra #15,***3264,,PO-202412-SaaS-GL-0008,False,False,REF-613023,First Continental Bank,***4801,Globex Consulting UK Ltd.,UK,-2117256.04
2024-12-16,2024-12-16,Supplier Payment - HyperCloud Infra #1,Supplier Payment,SaaS-GL,11863.54,0.0,GBP,CHAPS,HyperCloud Infra #1,***5233,,PO-202412-SaaS-GL-0007,False,False,REF-840882,First Continental Bank,***1643,Globex Consulting UK Ltd.,UK,-2129119.58
2024-12-16,2024-12-16,Supplier Payment - Stelliform Parts BV #12,Supplier Payment,CEM-EMEA,23705.53,0.0,GBP,Faster Payments,Stelliform Parts BV #12,***1052,,PO-202412-CEM-EMEA-0004,False,False,REF-429172,First Continental Bank,***2933,Globex Consulting UK Ltd.,UK,-2152825.11
2024-12-16,2024-12-16,Client Receipt - Vertex Advisory Client #28,Sales Receipt,PS-GL,0.0,4518.34,GBP,Faster Payments Credit,Vertex Advisory Client #28,***3420,INV-202412-PS-GL-0008,,False,False,REF-502236,First Continental Bank,***1973,Globex Consulting UK Ltd.,UK,-2148306.77
2024-12-16,2024-12-16,Client Receipt - CloudBridge Co. #17,Sales Receipt,SaaS-GL,0.0,18628.3,GBP,CHAPS Credit,CloudBridge Co. #17,***1304,INV-202412-SaaS-GL-0021,,False,False,REF-392204,First Continental Bank,***5137,Globex Consulting UK Ltd.,UK,-2129678.47
2024-12-16,2024-12-16,Client Receipt - Vertex Advisory Client #25,Sales Receipt,PS-GL,0.0,26182.86,GBP,Faster Payments Credit,Vertex Advisory Client #25,***1271,INV-202412-PS-GL-0009,,False,False,REF-718306,First Continental Bank,***9036,Globex Consulting UK Ltd.,UK,-2103495.61
2024-12-17,2024-12-17,Supplier Payment - Stelliform Parts BV #24,Supplier Payment,CEM-EMEA,17098.94,0.0,GBP,Faster Payments,Stelliform Parts BV #24,***7586,,PO-202412-CEM-EMEA-0008,False,False,REF-860640,First Continental Bank,***5412,Globex Consulting UK Ltd.,UK,-2120594.55
2024-12-17,2024-12-17,Client Receipt - Vertex Advisory Client #39,Sales Receipt,PS-GL,0.0,16741.03,GBP,Faster Payments Credit,Vertex Advisory Client #39,***6996,INV-202412-PS-GL-0005,,False,False,REF-413539,First Continental Bank,***9307,Globex Consulting UK Ltd.,UK,-2103853.52
2024-12-17,2024-12-17,Client Receipt - CloudBridge Co. #15,Sales Receipt,SaaS-GL,0.0,18572.54,GBP,Faster Payments Credit,CloudBridge Co. #15,***4192,INV-202412-SaaS-GL-0026,,False,False,REF-973063,First Continental Bank,***2202,Globex Consulting UK Ltd.,UK,-2085280.98
2024-12-17,2024-12-17,Client Receipt - CloudBridge Co. #70,Sales Receipt,SaaS-GL,0.0,35171.89,GBP,CHAPS Credit,CloudBridge Co. #70,***5422,INV-202412-SaaS-GL-0022,,False,False,REF-599657,First Continental Bank,***3549,Globex Consulting UK Ltd.,UK,-2050109.09
2024-12-17,2024-12-17,Client Receipt - Novatek Components Ltd #14,Sales Receipt,CEM-EMEA,0.0,102637.41,GBP,CHAPS Credit,Novatek Components Ltd #14,***6185,INV-202412-CEM-EMEA-0008,,False,False,REF-766053,First Continental Bank,***4151,Globex Consulting UK Ltd.,UK,-1947471.68
2024-12-18,2024-12-18,Client Receipt - CloudBridge Co. #64,Sales Receipt,SaaS-GL,0.0,5567.85,GBP,CHAPS Credit,CloudBridge Co. #64,***8121,INV-202412-SaaS-GL-0020,,False,False,REF-103535,First Continental Bank,***6211,Globex Consulting UK Ltd.,UK,-1941903.83
2024-12-18,2024-12-18,Client Receipt - CloudBridge Co. #42,Sales Receipt,SaaS-GL,0.0,7352.42,GBP,CHAPS Credit,CloudBridge Co. #42,***7494,INV-202412-SaaS-GL-0008,,False,False,REF-821357,First Continental Bank,***7804,Globex Consulting UK Ltd.,UK,-1934551.41
2024-12-18,2024-12-18,Client Receipt - CloudBridge Co. #32,Sales Receipt,SaaS-GL,0.0,9779.12,GBP,Faster Payments Credit,CloudBridge Co. #32,***6207,INV-202412-SaaS-GL-0028,,False,False,REF-582842,First Continental Bank,***2068,Globex Consulting UK Ltd.,UK,-1924772.29
2024-12-19,2024-12-19,Supplier Payment - ExpertNet Subcontractors #4,Supplier Payment,PS-GL,3040.56,0.0,GBP,Faster Payments,ExpertNet Subcontractors #4,***9944,,PO-202412-PS-GL-0005,False,False,REF-692480,First Continental Bank,***4509,Globex Consulting UK Ltd.,UK,-1927812.85
2024-12-19,2024-12-19,Marketing - Aurelia Media #4,Marketing,ALL,9496.17,0.0,GBP,CHAPS,Aurelia Media #4,***4012,,,False,False,REF-877389,First Continental Bank,***4259,Globex Consulting UK Ltd.,UK,-1937309.02
2024-12-19,2024-12-19,VAT/GST Remittance - HMRC UK,Tax Payment,ALL,56536.22,0.0,GBP,SWIFT MT103,HMRC UK,***9576,,,False,False,REF-261739,First Continental Bank,***3716,Globex Consulting UK Ltd.,UK,-1993845.24
2024-12-19,2024-12-19,Client Receipt - CloudBridge Co. #39,Sales Receipt,SaaS-GL,0.0,16926.32,GBP,Faster Payments Credit,CloudBridge Co. #39,***5595,INV-202412-SaaS-GL-0010,,False,False,REF-359832,First Continental Bank,***9057,Globex Consulting UK Ltd.,UK,-1976918.92
2024-12-19,2024-12-19,Client Receipt - Aurora Electronics GmbH #5,Sales Receipt,CEM-EMEA,0.0,65825.95,GBP,CHAPS Credit,Aurora Electronics GmbH #5,***3696,INV-202412-CEM-EMEA-0010,,False,False,REF-688175,First Continental Bank,***7193,Globex Consulting UK Ltd.,UK,-1911092.97
2024-12-20,2024-12-20,Merchant Processing Fees,Bank/Merchant Fees,ALL,1507.3,0.0,GBP,CHAPS,First Continental Bank,***7188,,,False,False,REF-708890,First Continental Bank,***2955,Globex Consulting UK Ltd.,UK,-1912600.27
2024-12-20,2024-12-20,Client Receipt - CloudBridge Co. #79,Sales Receipt,SaaS-GL,0.0,430.8,GBP,Faster Payments Credit,CloudBridge Co. #79,***5936,INV-202412-SaaS-GL-0016,,False,False,REF-688913,First Continental Bank,***8871,Globex Consulting UK Ltd.,UK,-1912169.47
2024-12-22,2024-12-22,Supplier Payment - CodeCraft Contractors #12,Supplier Payment,SaaS-GL,12070.08,0.0,GBP,Faster Payments,CodeCraft Contractors #12,***7768,,PO-202412-SaaS-GL-0002,False,False,REF-536710,First Continental Bank,***4658,Globex Consulting UK Ltd.,UK,-1924239.55
2024-12-23,2024-12-23,Client Receipt - CloudBridge Co. #52,Sales Receipt,SaaS-GL,0.0,12522.29,GBP,Faster Payments Credit,CloudBridge Co. #52,***5699,INV-202412-SaaS-GL-0006,,False,False,REF-978960,First Continental Bank,***9027,Globex Consulting UK Ltd.,UK,-1911717.26
2024-12-23,2024-12-23,Client Receipt - Vertex Advisory Client #58,Sales Receipt,PS-GL,0.0,28657.85,GBP,Faster Payments Credit,Vertex Advisory Client #58,***4149,INV-202412-PS-GL-0002,,False,False,REF-513082,First Continental Bank,***6311,Globex Consulting UK Ltd.,UK,-1883059.41
2024-12-24,2024-12-24,Supplier Payment - ExpertNet Subcontractors #7,Supplier Payment,PS-GL,2310.34,0.0,GBP,CHAPS,ExpertNet Subcontractors #7,***4673,,PO-202412-PS-GL-0001,False,False,REF-995832,First Continental Bank,***5750,Globex Consulting UK Ltd.,UK,-1885369.75
2024-12-24,2024-12-24,Client Receipt - CloudBridge Co. #47,Sales Receipt,SaaS-GL,0.0,7931.73,GBP,CHAPS Credit,CloudBridge Co. #47,***9559,INV-202412-SaaS-GL-0025,,False,False,REF-618348,First Continental Bank,***4353,Globex Consulting UK Ltd.,UK,-1877438.02
2024-12-24,2024-12-24,Client Receipt - Novatek Components Ltd #12,Sales Receipt,CEM-EMEA,0.0,52837.71,GBP,CHAPS Credit,Novatek Components Ltd #12,***4112,INV-202412-CEM-EMEA-0005,,False,False,REF-445626,First Continental Bank,***8486,Globex Consulting UK Ltd.,UK,-1824600.31
2024-12-25,2024-12-25,Supplier Payment - CodeCraft Contractors #12,Supplier Payment,SaaS-GL,102.78,0.0,GBP,Faster Payments,CodeCraft Contractors #12,***7041,,PO-202412-SaaS-GL-0003,False,False,REF-115448,First Continental Bank,***5350,Globex Consulting UK Ltd.,UK,-1824703.09
2024-12-25,2024-12-25,Supplier Payment - ExpertNet Subcontractors #5,Supplier Payment,PS-GL,114.8,0.0,GBP,CHAPS,ExpertNet Subcontractors #5,***2205,,PO-202412-PS-GL-0006,False,False,REF-244323,First Continental Bank,***2756,Globex Consulting UK Ltd.,UK,-1824817.89
2024-12-25,2024-12-25,Merchant Processing Fees,Bank/Merchant Fees,ALL,1158.43,0.0,GBP,Faster Payments,First Continental Bank,***3078,,,False,False,REF-784001,First Continental Bank,***9827,Globex Consulting UK Ltd.,UK,-1825976.32
2024-12-25,2024-12-25,Client Receipt - CloudBridge Co. #68,Sales Receipt,SaaS-GL,0.0,4355.55,GBP,Faster Payments Credit,CloudBridge Co. #68,***6185,INV-202412-SaaS-GL-0012,,False,False,REF-803819,First Continental Bank,***7555,Globex Consulting UK Ltd.,UK,-1821620.77
2024-12-25,2024-12-25,Client Receipt - Aurora Electronics GmbH #17,Sales Receipt,CEM-EMEA,0.0,38547.01,GBP,CHAPS Credit,Aurora Electronics GmbH #17,***3871,INV-202412-CEM-EMEA-0006,,False,False,REF-182371,First Continental Bank,***3065,Globex Consulting UK Ltd.,UK,-1783073.76
2024-12-25,2024-12-25,Client Receipt - Aurora Electronics GmbH #19,Sales Receipt,CEM-EMEA,0.0,45950.87,GBP,Faster Payments Credit,Aurora Electronics GmbH #19,***8141,INV-202412-CEM-EMEA-0011,,False,False,REF-229222,First Continental Bank,***7971,Globex Consulting UK Ltd.,UK,-1737122.89
2024-12-26,2024-12-26,Supplier Payment - ExpertNet Subcontractors #9,Supplier Payment,PS-GL,2232.64,0.0,GBP,CHAPS,ExpertNet Subcontractors #9,***1682,,PO-202412-PS-GL-0003,False,False,REF-997739,First Continental Bank,***3163,Globex Consulting UK Ltd.,UK,-1739355.53
2024-12-26,2024-12-26,Supplier Payment - Stelliform Parts BV #26,Supplier Payment,CEM-EMEA,6121.08,0.0,GBP,Faster Payments,Stelliform Parts BV #26,***4570,,PO-202412-CEM-EMEA-0006,False,False,REF-168020,First Continental Bank,***1507,Globex Consulting UK Ltd.,UK,-1745476.61
2024-12-26,2024-12-26,Supplier Payment - EuroFab Assembly #6,Supplier Payment,CEM-EMEA,63040.75,0.0,GBP,CHAPS,EuroFab Assembly #6,***9364,,PO-202412-CEM-EMEA-0003,False,False,REF-155961,First Continental Bank,***5618,Globex Consulting UK Ltd.,UK,-1808517.36
2024-12-26,2024-12-26,Payroll - GlobalPay Services Ltd,Payroll,ALL,73348.8,0.0,GBP,CHAPS,GlobalPay Services Ltd,***5256,,,False,False,REF-666424,First Continental Bank,***3644,Globex Consulting UK Ltd.,UK,-1881866.16
2024-12-26,2024-12-26,Intercompany Settlement - Globex APAC Logistics Pte. Ltd.,Intercompany Transfer,ALL,591660.0,0.0,GBP,Internal Transfer,Globex APAC Logistics Pte. Ltd.,***2780,,,True,True,REF-464690,First Continental Bank,***8527,Globex Consulting UK Ltd.,UK,-2473526.16
2024-12-26,2024-12-26,Client Receipt - Vertex Advisory Client #34,Sales Receipt,PS-GL,0.0,2916.06,GBP,Faster Payments Credit,Vertex Advisory Client #34,***8692,INV-202412-PS-GL-0007,,False,False,REF-916223,First Continental Bank,***8512,Globex Consulting UK Ltd.,UK,-2470610.1
2024-12-26,2024-12-26,Client Receipt - CloudBridge Co. #36,Sales Receipt,SaaS-GL,0.0,3817.42,GBP,CHAPS Credit,CloudBridge Co. #36,***1882,INV-202412-SaaS-GL-0002,,False,False,REF-751154,First Continental Bank,***8674,Globex Consulting UK Ltd.,UK,-2466792.68
2024-12-26,2024-12-26,Client Receipt - Vertex Advisory Client #45,Sales Receipt,PS-GL,0.0,11969.97,GBP,CHAPS Credit,Vertex Advisory Client #45,***4684,INV-202412-PS-GL-0003,,False,False,REF-752347,First Continental Bank,***9094,Globex Consulting UK Ltd.,UK,-2454822.71
2024-12-26,2024-12-26,Intercompany Reimbursement - Globex APAC Logistics Pte. Ltd.,Intercompany Transfer,ALL,0.0,236664.0,GBP,Internal Transfer,Globex APAC Logistics Pte. Ltd.,***8452,,,True,True,REF-353896,First Continental Bank,***8437,Globex Consulting UK Ltd.,UK,-2218158.71
2024-12-27,2024-12-27,BluePeak Property Mgmt,Rent & Utilities,ALL,4922.93,0.0,GBP,Faster Payments,BluePeak Property Mgmt,***1035,,,False,False,REF-291039,First Continental Bank,***7313,Globex Consulting UK Ltd.,UK,-2223081.64
2024-12-27,2024-12-27,Client Receipt - Vertex Advisory Client #53,Sales Receipt,PS-GL,0.0,31603.51,GBP,Faster Payments Credit,Vertex Advisory Client #53,***2636,INV-202412-PS-GL-0006,,False,False,REF-223783,First Continental Bank,***8619,Globex Consulting UK Ltd.,UK,-2191478.13
2024-12-27,2024-12-27,Client Receipt - Novatek Components Ltd #14,Sales Receipt,CEM-EMEA,0.0,36738.34,GBP,CHAPS Credit,Novatek Components Ltd #14,***3819,INV-202412-CEM-EMEA-0002,,False,False,REF-335511,First Continental Bank,***5258,Globex Consulting UK Ltd.,UK,-2154739.79
2024-12-28,2024-12-28,BluePeak Property Mgmt,Rent & Utilities,ALL,2201.01,0.0,GBP,Faster Payments,BluePeak Property Mgmt,***6472,,,False,False,REF-461498,First Continental Bank,***8391,Globex Consulting UK Ltd.,UK,-2156940.8
2024-12-28,2024-12-28,Supplier Payment - ExpertNet Subcontractors #1,Supplier Payment,PS-GL,3161.22,0.0,GBP,Faster Payments,ExpertNet Subcontractors #1,***2713,,PO-202412-PS-GL-0009,False,False,REF-937449,First Continental Bank,***2992,Globex Consulting UK Ltd.,UK,-2160102.02
2024-12-28,2024-12-28,Client Receipt - Aurora Electronics GmbH #5,Sales Receipt,CEM-EMEA,0.0,15034.46,GBP,CHAPS Credit,Aurora Electronics GmbH #5,***7423,INV-202412-CEM-EMEA-0004,,False,False,REF-667239,First Continental Bank,***6568,Globex Consulting UK Ltd.,UK,-2145067.56
2024-12-29,2024-12-29,Client Receipt - Vertex Advisory Client #53,Sales Receipt,PS-GL,0.0,23999.42,GBP,Faster Payments Credit,Vertex Advisory Client #53,***6077,INV-202412-PS-GL-0004,,False,False,REF-282895,First Continental Bank,***9997,Globex Consulting UK Ltd.,UK,-2121068.14
2024-12-30,2024-12-30,Supplier Payment - HyperCloud Infra #18,Supplier Payment,SaaS-GL,145.82,0.0,GBP,CHAPS,HyperCloud Infra #18,***1122,,PO-202412-SaaS-GL-0006,False,False,REF-736050,First Continental Bank,***8395,Globex Consulting UK Ltd.,UK,-2121213.96
2024-12-30,2024-12-30,Marketing - Beacon Digital #8,Marketing,ALL,5153.58,0.0,GBP,Faster Payments,Beacon Digital #8,***4442,,,False,False,REF-851017,First Continental Bank,***2100,Globex Consulting UK Ltd.,UK,-2126367.54
2024-12-30,2024-12-30,Supplier Payment - ExpertNet Subcontractors #2,Supplier Payment,PS-GL,5207.9,0.0,GBP,Faster Payments,ExpertNet Subcontractors #2,***8206,,PO-202412-PS-GL-0010,False,False,REF-832231,First Continental Bank,***5679,Globex Consulting UK Ltd.,UK,-2131575.44
2024-12-30,2024-12-30,Payroll - GlobalPay Services Ltd,Payroll,ALL,73348.8,0.0,GBP,Faster Payments,GlobalPay Services Ltd,***9073,,,False,False,REF-980168,First Continental Bank,***7735,Globex Consulting UK Ltd.,UK,-2204924.24
2024-12-30,2024-12-30,Interest Earned,Interest Income,ALL,0.0,12327.45,GBP,Faster Payments Credit,First Continental Bank,***3633,,,False,False,REF-115499,First Continental Bank,***8065,Globex Consulting UK Ltd.,UK,-2192596.79
2024-12-30,2024-12-30,Client Receipt - Novatek Components Ltd #9,Sales Receipt,CEM-EMEA,0.0,24049.84,GBP,CHAPS Credit,Novatek Components Ltd #9,***9080,INV-202412-CEM-EMEA-0001,,False,False,REF-241919,First Continental Bank,***6064,Globex Consulting UK Ltd.,UK,-2168546.95
2024-12-31,2024-12-31,Supplier Payment - EuroFab Assembly #15,Supplier Payment,CEM-EMEA,33164.61,0.0,GBP,CHAPS,EuroFab Assembly #15,***3326,,PO-202412-CEM-EMEA-0005,False,False,REF-612561,First Continental Bank,***5127,Globex Consulting UK Ltd.,UK,-2201711.56
2024-12-31,2024-12-31,Supplier Payment - Stelliform Parts BV #18,Supplier Payment,CEM-EMEA,82816.67,0.0,GBP,Faster Payments,Stelliform Parts BV #18,***2004,,PO-202412-CEM-EMEA-0007,False,False,REF-918504,First Continental Bank,***8051,Globex Consulting UK Ltd.,UK,-2284528.23
2025-01-01,2025-01-01,Account Maintenance Fee,Bank/Merchant Fees,ALL,2500.0,0.0,GBP,CHAPS,First Continental Bank,***1204,,,False,False,REF-876927,First Continental Bank,***4896,Globex Consulting UK Ltd.,UK,-2287028.23
2025-01-01,2025-01-01,Marketing - Aurelia Media #4,Marketing,ALL,3344.44,0.0,GBP,CHAPS,Aurelia Media #4,***2766,,,False,False,REF-553377,First Continental Bank,***3422,Globex Consulting UK Ltd.,UK,-2290372.67
2025-01-01,2025-01-01,Client Receipt - CloudBridge Co. #74,Sales Receipt,SaaS-GL,0.0,3628.29,GBP,CHAPS Credit,CloudBridge Co. #74,***5405,INV-202501-SaaS-GL-0012,,False,False,REF-550986,First Continental Bank,***4692,Globex Consulting UK Ltd.,UK,-2286744.38
2025-01-01,2025-01-01,Client Receipt - Aurora Electronics GmbH #9,Sales Receipt,CEM-EMEA,0.0,4960.65,GBP,Faster Payments Credit,Aurora Electronics GmbH #9,***3304,INV-202501-CEM-EMEA-0013,,False,False,REF-325860,First Continental Bank,***1997,Globex Consulting UK Ltd.,UK,-2281783.73
2025-01-01,2025-01-01,Client Receipt - CloudBridge Co. #60,Sales Receipt,SaaS-GL,0.0,6802.72,GBP,Faster Payments Credit,CloudBridge Co. #60,***7108,INV-202501-SaaS-GL-0029,,False,False,REF-963065,First Continental Bank,***7137,Globex Consulting UK Ltd.,UK,-2274981.01
2025-01-01,2025-01-01,Client Receipt - CloudBridge Co. #75,Sales Receipt,SaaS-GL,0.0,7112.77,GBP,CHAPS Credit,CloudBridge Co. #75,***9824,INV-202501-SaaS-GL-0004,,False,False,REF-492825,First Continental Bank,***5516,Globex Consulting UK Ltd.,UK,-2267868.24
2025-01-01,2025-01-01,Client Receipt - CloudBridge Co. #72,Sales Receipt,SaaS-GL,0.0,7323.14,GBP,CHAPS Credit,CloudBridge Co. #72,***1780,INV-202501-SaaS-GL-0013,,False,False,REF-776189,First Continental Bank,***6587,Globex Consulting UK Ltd.,UK,-2260545.1
2025-01-02,2025-01-02,Supplier Payment - ExpertNet Subcontractors #3,Supplier Payment,PS-GL,7235.66,0.0,GBP,Faster Payments,ExpertNet Subcontractors #3,***2204,,PO-202501-PS-GL-0006,False,False,REF-125953,First Continental Bank,***3219,Globex Consulting UK Ltd.,UK,-2267780.76
2025-01-02,2025-01-02,Supplier Payment - EuroFab Assembly #10,Supplier Payment,CEM-EMEA,29090.49,0.0,GBP,CHAPS,EuroFab Assembly #10,***2097,,PO-202501-CEM-EMEA-0006,False,False,REF-197717,First Continental Bank,***6417,Globex Consulting UK Ltd.,UK,-2296871.25
2025-01-02,2025-01-02,Client Receipt - Vertex Advisory Client #2,Sales Receipt,PS-GL,0.0,4416.95,GBP,CHAPS Credit,Vertex Advisory Client #2,***1033,INV-202501-PS-GL-0005,,False,False,REF-903830,First Continental Bank,***2363,Globex Consulting UK Ltd.,UK,-2292454.3
2025-01-03,2025-01-03,Supplier Payment - ExpertNet Subcontractors #8,Supplier Payment,PS-GL,1224.06,0.0,GBP,CHAPS,ExpertNet Subcontractors #8,***5781,,PO-202501-PS-GL-0007,False,False,REF-794936,First Continental Bank,***9694,Globex Consulting UK Ltd.,UK,-2293678.36
2025-01-03,2025-01-03,Supplier Payment - ExpertNet Subcontractors #5,Supplier Payment,PS-GL,1338.57,0.0,GBP,CHAPS,ExpertNet Subcontractors #5,***5488,,PO-202501-PS-GL-0002,False,False,REF-797559,First Continental Bank,***3282,Globex Consulting UK Ltd.,UK,-2295016.93
2025-01-03,2025-01-03,Supplier Payment - Stelliform Parts BV #30,Supplier Payment,CEM-EMEA,69048.64,0.0,GBP,Faster Payments,Stelliform Parts BV #30,***1548,,PO-202501-CEM-EMEA-0007,False,False,REF-925683,First Continental Bank,***9093,Globex Consulting UK Ltd.,UK,-2364065.57
2025-01-03,2025-01-03,Client Receipt - CloudBridge Co. #63,Sales Receipt,SaaS-GL,0.0,9977.4,GBP,Faster Payments Credit,CloudBridge Co. #63,***5120,INV-202501-SaaS-GL-0008,,False,False,REF-880034,First Continental Bank,***6364,Globex Consulting UK Ltd.,UK,-2354088.17
2025-01-05,2025-01-05,Client Receipt - Novatek Components Ltd #2,Sales Receipt,CEM-EMEA,0.0,817.43,GBP,Faster Payments Credit,Novatek Components Ltd #2,***6998,INV-202501-CEM-EMEA-0007,,False,False,REF-866974,First Continental Bank,***9381,Globex Consulting UK Ltd.,UK,-2353270.74
2025-01-06,2025-01-06,Supplier Payment - EuroFab Assembly #22,Supplier Payment,CEM-EMEA,8369.67,0.0,GBP,Faster Payments,EuroFab Assembly #22,***1790,,PO-202501-CEM-EMEA-0009,False,False,REF-257355,First Continental Bank,***1483,Globex Consulting UK Ltd.,UK,-2361640.41
2025-01-06,2025-01-06,Client Receipt - Aurora Electronics GmbH #12,Sales Receipt,CEM-EMEA,0.0,37.97,GBP,CHAPS Credit,Aurora Electronics GmbH #12,***9916,INV-202501-CEM-EMEA-0018,,False,False,REF-123680,First Continental Bank,***5492,Globex Consulting UK Ltd.,UK,-2361602.44
2025-01-06,2025-01-06,Client Receipt - Aurora Electronics GmbH #4,Sales Receipt,CEM-EMEA,0.0,15327.26,GBP,Faster Payments Credit,Aurora Electronics GmbH #4,***1887,INV-202501-CEM-EMEA-0004,,False,False,REF-125725,First Continental Bank,***2864,Globex Consulting UK Ltd.,UK,-2346275.18
2025-01-07,2025-01-07,Supplier Payment - ExpertNet Subcontractors #5,Supplier Payment,PS-GL,2545.54,0.0,GBP,Faster Payments,ExpertNet Subcontractors #5,***5211,,PO-202501-PS-GL-0003,False,False,REF-129064,First Continental Bank,***6329,Globex Consulting UK Ltd.,UK,-2348820.72
2025-01-07,2025-01-07,Client Receipt - Novatek Components Ltd #2,Sales Receipt,CEM-EMEA,0.0,11718.77,GBP,CHAPS Credit,Novatek Components Ltd #2,***1336,INV-202501-CEM-EMEA-0003,,False,False,REF-639141,First Continental Bank,***5026,Globex Consulting UK Ltd.,UK,-2337101.95
2025-01-07,2025-01-07,Client Receipt - Aurora Electronics GmbH #2,Sales Receipt,CEM-EMEA,0.0,50298.84,GBP,Faster Payments Credit,Aurora Electronics GmbH #2,***5666,INV-202501-CEM-EMEA-0017,,False,False,REF-259331,First Continental Bank,***7391,Globex Consulting UK Ltd.,UK,-2286803.11
2025-01-08,2025-01-08,Supplier Payment - ExpertNet Subcontractors #6,Supplier Payment,PS-GL,4506.47,0.0,GBP,Faster Payments,ExpertNet Subcontractors #6,***3522,,PO-202501-PS-GL-0001,False,False,REF-651585,First Continental Bank,***5806,Globex Consulting UK Ltd.,UK,-2291309.58
2025-01-08,2025-01-08,Supplier Payment - EuroFab Assembly #18,Supplier Payment,CEM-EMEA,7088.01,0.0,GBP,Faster Payments,EuroFab Assembly #18,***9505,,PO-202501-CEM-EMEA-0001,False,False,REF-467803,First Continental Bank,***2552,Globex Consulting UK Ltd.,UK,-2298397.59
2025-01-08,2025-01-08,Client Receipt - CloudBridge Co. #5,Sales Receipt,SaaS-GL,0.0,875.05,GBP,CHAPS Credit,CloudBridge Co. #5,***8894,INV-202501-SaaS-GL-0022,,False,False,REF-360313,First Continental Bank,***6003,Globex Consulting UK Ltd.,UK,-2297522.54
2025-01-08,2025-01-08,Client Receipt - Vertex Advisory Client #6,Sales Receipt,PS-GL,0.0,4892.17,GBP,CHAPS Credit,Vertex Advisory Client #6,***5293,INV-202501-PS-GL-0007,,False,False,REF-505487,First Continental Bank,***7654,Globex Consulting UK Ltd.,UK,-2292630.37
2025-01-08,2025-01-08,Client Receipt - Aurora Electronics GmbH #6,Sales Receipt,CEM-EMEA,0.0,6944.49,GBP,CHAPS Credit,Aurora Electronics GmbH #6,***7236,INV-202501-CEM-EMEA-0008,,False,False,REF-944663,First Continental Bank,***7730,Globex Consulting UK Ltd.,UK,-2285685.88
2025-01-08,2025-01-08,Client Receipt - Novatek Components Ltd #10,Sales Receipt,CEM-EMEA,0.0,22448.01,GBP,Faster Payments Credit,Novatek Components Ltd #10,***4154,INV-202501-CEM-EMEA-0014,,False,False,REF-782355,First Continental Bank,***7011,Globex Consulting UK Ltd.,UK,-2263237.87
2025-01-09,2025-01-09,Supplier Payment - Stelliform Parts BV #27,Supplier Payment,CEM-EMEA,2076.88,0.0,GBP,CHAPS,Stelliform Parts BV #27,***2685,,PO-202501-CEM-EMEA-0005,False,False,REF-746228,First Continental Bank,***5926,Globex Consulting UK Ltd.,UK,-2265314.75
2025-01-09,2025-01-09,Supplier Payment - HyperCloud Infra #2,Supplier Payment,SaaS-GL,6268.41,0.0,GBP,CHAPS,HyperCloud Infra #2,***8377,,PO-202501-SaaS-GL-0002,False,False,REF-452470,First Continental Bank,***2914,Globex Consulting UK Ltd.,UK,-2271583.16
2025-01-12,2025-01-12,Supplier Payment - HyperCloud Infra #6,Supplier Payment,SaaS-GL,7716.84,0.0,GBP,CHAPS,HyperCloud Infra #6,***9602,,PO-202501-SaaS-GL-0003,False,False,REF-429045,First Continental Bank,***2945,Globex Consulting UK Ltd.,UK,-2279300.0
2025-01-12,2025-01-12,Intercompany Settlement - Globex Retail NA LLC,Intercompany Transfer,ALL,460810.0,0.0,GBP,Internal Transfer,Globex Retail NA LLC,***3161,,,True,True,REF-551534,First Continental Bank,***4229,Globex Consulting UK Ltd.,UK,-2740110.0
2025-01-12,2025-01-12,Client Receipt - Vertex Advisory Client #31,Sales Receipt,PS-GL,0.0,2708.44,GBP,Faster Payments Credit,Vertex Advisory Client #31,***2266,INV-202501-PS-GL-0008,,False,False,REF-963287,First Continental Bank,***6768,Globex Consulting UK Ltd.,UK,-2737401.56
2025-01-14,2025-01-14,Supplier Payment - EuroFab Assembly #13,Supplier Payment,CEM-EMEA,2982.31,0.0,GBP,CHAPS,EuroFab Assembly #13,***5555,,PO-202501-CEM-EMEA-0010,False,False,REF-619873,First Continental Bank,***3755,Globex Consulting UK Ltd.,UK,-2740383.87
2025-01-14,2025-01-14,Client Receipt - CloudBridge Co. #26,Sales Receipt,SaaS-GL,0.0,15156.59,GBP,Faster Payments Credit,CloudBridge Co. #26,***3198,INV-202501-SaaS-GL-0017,,False,False,REF-360158,First Continental Bank,***7892,Globex Consulting UK Ltd.,UK,-2725227.28
2025-01-15,2025-01-15,Supplier Payment - Stelliform Parts BV #11,Supplier Payment,CEM-EMEA,2591.14,0.0,GBP,Faster Payments,Stelliform Parts BV #11,***5860,,PO-202501-CEM-EMEA-0004,False,False,REF-738587,First Continental Bank,***5713,Globex Consulting UK Ltd.,UK,-2727818.42
2025-01-15,2025-01-15,Marketing - Beacon Digital #7,Marketing,ALL,4320.9,0.0,GBP,Faster Payments,Beacon Digital #7,***1036,,,False,False,REF-883325,First Continental Bank,***4386,Globex Consulting UK Ltd.,UK,-2732139.32
2025-01-15,2025-01-15,Client Receipt - CloudBridge Co. #30,Sales Receipt,SaaS-GL,0.0,3108.28,GBP,Faster Payments Credit,CloudBridge Co. #30,***6062,INV-202501-SaaS-GL-0018,,False,False,REF-465123,First Continental Bank,***6414,Globex Consulting UK Ltd.,UK,-2729031.04
2025-01-16,2025-01-16,Supplier Payment - ExpertNet Subcontractors #8,Supplier Payment,PS-GL,9135.14,0.0,GBP,CHAPS,ExpertNet Subcontractors #8,***7018,,PO-202501-PS-GL-0004,False,False,REF-433328,First Continental Bank,***6362,Globex Consulting UK Ltd.,UK,-2738166.18
2025-01-16,2025-01-16,Client Receipt - Novatek Components Ltd #8,Sales Receipt,CEM-EMEA,0.0,2617.92,GBP,CHAPS Credit,Novatek Components Ltd #8,***5070,INV-202501-CEM-EMEA-0010,,False,False,REF-497676,First Continental Bank,***7832,Globex Consulting UK Ltd.,UK,-2735548.26
2025-01-16,2025-01-16,Client Receipt - Aurora Electronics GmbH #5,Sales Receipt,CEM-EMEA,0.0,10203.43,GBP,Faster Payments Credit,Aurora Electronics GmbH #5,***3928,INV-202501-CEM-EMEA-0002,,False,False,REF-338359,First Continental Bank,***4140,Globex Consulting UK Ltd.,UK,-2725344.83
2025-01-17,2025-01-17,Client Receipt - CloudBridge Co. #6,Sales Receipt,SaaS-GL,0.0,989.48,GBP,Faster Payments Credit,CloudBridge Co. #6,***3073,INV-202501-SaaS-GL-0020,,False,False,REF-115918,First Continental Bank,***4013,Globex Consulting UK Ltd.,UK,-2724355.35
2025-01-17,2025-01-17,Client Receipt - CloudBridge Co. #50,Sales Receipt,SaaS-GL,0.0,1616.03,GBP,CHAPS Credit,CloudBridge Co. #50,***6671,INV-202501-SaaS-GL-0026,,False,False,REF-647414,First Continental Bank,***7771,Globex Consulting UK Ltd.,UK,-2722739.32
2025-01-17,2025-01-17,Client Receipt - CloudBridge Co. #71,Sales Receipt,SaaS-GL,0.0,4961.98,GBP,CHAPS Credit,CloudBridge Co. #71,***6165,INV-202501-SaaS-GL-0023,,False,False,REF-671384,First Continental Bank,***8946,Globex Consulting UK Ltd.,UK,-2717777.34
2025-01-17,2025-01-17,Client Receipt - CloudBridge Co. #10,Sales Receipt,SaaS-GL,0.0,8371.89,GBP,Faster Payments Credit,CloudBridge Co. #10,***7015,INV-202501-SaaS-GL-0016,,False,False,REF-133778,First Continental Bank,***8532,Globex Consulting UK Ltd.,UK,-2709405.45
2025-01-17,2025-01-17,Client Receipt - Vertex Advisory Client #39,Sales Receipt,PS-GL,0.0,23364.05,GBP,Faster Payments Credit,Vertex Advisory Client #39,***2546,INV-202501-PS-GL-0001,,False,False,REF-926407,First Continental Bank,***9395,Globex Consulting UK Ltd.,UK,-2686041.4
2025-01-19,2025-01-19,VAT/GST Remittance - HMRC UK,Tax Payment,ALL,27278.92,0.0,GBP,SWIFT MT103,HMRC UK,***6700,,,False,False,REF-319642,First Continental Bank,***3572,Globex Consulting UK Ltd.,UK,-2713320.32
2025-01-20,2025-01-20,Merchant Processing Fees,Bank/Merchant Fees,ALL,528.81,0.0,GBP,CHAPS,First Continental Bank,***5806,,,False,False,REF-637566,First Continental Bank,***4557,Globex Consulting UK Ltd.,UK,-2713849.13
2025-01-20,2025-01-20,Supplier Payment - CodeCraft Contractors #2,Supplier Payment,SaaS-GL,746.29,0.0,GBP,Faster Payments,CodeCraft Contractors #2,***4890,,PO-202501-SaaS-GL-0008,False,False,REF-361756,First Continental Bank,***6544,Globex Consulting UK Ltd.,UK,-2714595.42
2025-01-20,2025-01-20,Supplier Payment - EuroFab Assembly #18,Supplier Payment,CEM-EMEA,3227.81,0.0,GBP,Faster Payments,EuroFab Assembly #18,***9724,,PO-202501-CEM-EMEA-0002,False,False,REF-982393,First Continental Bank,***6881,Globex Consulting UK Ltd.,UK,-2717823.23
2025-01-20,2025-01-20,Client Receipt - Vertex Advisory Client #43,Sales Receipt,PS-GL,0.0,10882.24,GBP,Faster Payments Credit,Vertex Advisory Client #43,***5875,INV-202501-PS-GL-0006,,False,False,REF-826833,First Continental Bank,***2593,Globex Consulting UK Ltd.,UK,-2706940.99
2025-01-21,2025-01-21,Supplier Payment - EuroFab Assembly #23,Supplier Payment,CEM-EMEA,5227.29,0.0,GBP,Faster Payments,EuroFab Assembly #23,***2971,,PO-202501-CEM-EMEA-0003,False,False,REF-811873,First Continental Bank,***8648,Globex Consulting UK Ltd.,UK,-2712168.28
2025-01-21,2025-01-21,Client Receipt - CloudBridge Co. #2,Sales Receipt,SaaS-GL,0.0,1923.05,GBP,CHAPS Credit,CloudBridge Co. #2,***4348,INV-202501-SaaS-GL-0021,,False,False,REF-586319,First Continental Bank,***6666,Globex Consulting UK Ltd.,UK,-2710245.23
2025-01-21,2025-01-21,Client Receipt - Novatek Components Ltd #12,Sales Receipt,CEM-EMEA,0.0,12833.92,GBP,Faster Payments Credit,Novatek Components Ltd #12,***4194,INV-202501-CEM-EMEA-0005,,False,False,REF-578044,First Continental Bank,***6808,Globex Consulting UK Ltd.,UK,-2697411.31
2025-01-21,2025-01-21,Client Receipt - Novatek Components Ltd #13,Sales Receipt,CEM-EMEA,0.0,41813.96,GBP,Faster Payments Credit,Novatek Components Ltd #13,***5896,INV-202501-CEM-EMEA-0012,,False,False,REF-327373,First Continental Bank,***6801,Globex Consulting UK Ltd.,UK,-2655597.35
2025-01-22,2025-01-22,Client Receipt - Novatek Components Ltd #10,Sales Receipt,CEM-EMEA,0.0,332.52,GBP,CHAPS Credit,Novatek Components Ltd #10,***9999,INV-202501-CEM-EMEA-0011,,False,False,REF-418745,First Continental Bank,***8751,Globex Consulting UK Ltd.,UK,-2655264.83
2025-01-22,2025-01-22,Client Receipt - CloudBridge Co. #28,Sales Receipt,SaaS-GL,0.0,1684.35,GBP,CHAPS Credit,CloudBridge Co. #28,***5510,INV-202501-SaaS-GL-0009,,False,False,REF-686132,First Continental Bank,***4402,Globex Consulting UK Ltd.,UK,-2653580.48
2025-01-22,2025-01-22,Client Receipt - Aurora Electronics GmbH #5,Sales Receipt,CEM-EMEA,0.0,4545.15,GBP,CHAPS Credit,Aurora Electronics GmbH #5,***4695,INV-202501-CEM-EMEA-0009,,False,False,REF-591242,First Continental Bank,***3526,Globex Consulting UK Ltd.,UK,-2649035.33
2025-01-22,2025-01-22,Client Receipt - CloudBridge Co. #5,Sales Receipt,SaaS-GL,0.0,6811.03,GBP,CHAPS Credit,CloudBridge Co. #5,***7575,INV-202501-SaaS-GL-0010,,False,False,REF-935724,First Continental Bank,***6512,Globex Consulting UK Ltd.,UK,-2642224.3
2025-01-22,2025-01-22,Client Receipt - CloudBridge Co. #56,Sales Receipt,SaaS-GL,0.0,8218.28,GBP,Faster Payments Credit,CloudBridge Co. #56,***5437,INV-202501-SaaS-GL-0001,,False,False,REF-536977,First Continental Bank,***1068,Globex Consulting UK Ltd.,UK,-2634006.02
2025-01-22,2025-01-22,Client Receipt - Novatek Components Ltd #8,Sales Receipt,CEM-EMEA,0.0,9606.19,GBP,Faster Payments Credit,Novatek Components Ltd #8,***2638,INV-202501-CEM-EMEA-0001,,False,False,REF-131440,First Continental Bank,***7518,Globex Consulting UK Ltd.,UK,-2624399.83
2025-01-22,2025-01-22,Client Receipt - CloudBridge Co. #31,Sales Receipt,SaaS-GL,0.0,9606.49,GBP,Faster Payments Credit,CloudBridge Co. #31,***9787,INV-202501-SaaS-GL-0002,,False,False,REF-610254,First Continental Bank,***6662,Globex Consulting UK Ltd.,UK,-2614793.34
2025-01-22,2025-01-22,Client Receipt - Vertex Advisory Client #38,Sales Receipt,PS-GL,0.0,14431.86,GBP,Faster Payments Credit,Vertex Advisory Client #38,***2879,INV-202501-PS-GL-0003,,False,False,REF-307972,First Continental Bank,***2674,Globex Consulting UK Ltd.,UK,-2600361.48
2025-01-22,2025-01-22,Client Receipt - Vertex Advisory Client #56,Sales Receipt,PS-GL,0.0,32278.24,GBP,CHAPS Credit,Vertex Advisory Client #56,***7440,INV-202501-PS-GL-0004,,False,False,REF-955719,First Continental Bank,***9840,Globex Consulting UK Ltd.,UK,-2568083.24
2025-01-23,2025-01-23,Supplier Payment - HyperCloud Infra #14,Supplier Payment,SaaS-GL,398.14,0.0,GBP,CHAPS,HyperCloud Infra #14,***6191,,PO-202501-SaaS-GL-0006,False,False,REF-513288,First Continental Bank,***3061,Globex Consulting UK Ltd.,UK,-2568481.38
2025-01-23,2025-01-23,Supplier Payment - EuroFab Assembly #16,Supplier Payment,CEM-EMEA,2173.29,0.0,GBP,Faster Payments,EuroFab Assembly #16,***3108,,PO-202501-CEM-EMEA-0008,False,False,REF-700663,First Continental Bank,***3036,Globex Consulting UK Ltd.,UK,-2570654.67
2025-01-23,2025-01-23,Client Receipt - CloudBridge Co. #55,Sales Receipt,SaaS-GL,0.0,1516.14,GBP,Faster Payments Credit,CloudBridge Co. #55,***4961,INV-202501-SaaS-GL-0005,,False,False,REF-171707,First Continental Bank,***9765,Globex Consulting UK Ltd.,UK,-2569138.53
2025-01-23,2025-01-23,Client Receipt - CloudBridge Co. #64,Sales Receipt,SaaS-GL,0.0,2356.98,GBP,Faster Payments Credit,CloudBridge Co. #64,***1016,INV-202501-SaaS-GL-0014,,False,False,REF-995825,First Continental Bank,***4066,Globex Consulting UK Ltd.,UK,-2566781.55
2025-01-23,2025-01-23,Client Receipt - CloudBridge Co. #75,Sales Receipt,SaaS-GL,0.0,3085.72,GBP,Faster Payments Credit,CloudBridge Co. #75,***9606,INV-202501-SaaS-GL-0007,,False,False,REF-270251,First Continental Bank,***8401,Globex Consulting UK Ltd.,UK,-2563695.83
2025-01-24,2025-01-24,BluePeak Property Mgmt,Rent & Utilities,ALL,3697.27,0.0,GBP,CHAPS,BluePeak Property Mgmt,***8479,,,False,False,REF-481867,First Continental Bank,***8775,Globex Consulting UK Ltd.,UK,-2567393.1
2025-01-24,2025-01-24,Client Receipt - CloudBridge Co. #9,Sales Receipt,SaaS-GL,0.0,8926.09,GBP,Faster Payments Credit,CloudBridge Co. #9,***2084,INV-202501-SaaS-GL-0006,,False,False,REF-140222,First Continental Bank,***7049,Globex Consulting UK Ltd.,UK,-2558467.01
2025-01-26,2025-01-26,Intercompany Settlement - Globex APAC Logistics Pte. Ltd.,Intercompany Transfer,ALL,156505.0,0.0,GBP,Internal Transfer,Globex APAC Logistics Pte. Ltd.,***4601,,,True,True,REF-523442,First Continental Bank,***1804,Globex Consulting UK Ltd.,UK,-2714972.01
2025-01-26,2025-01-26,Client Receipt - CloudBridge Co. #55,Sales Receipt,SaaS-GL,0.0,2544.7,GBP,Faster Payments Credit,CloudBridge Co. #55,***1306,INV-202501-SaaS-GL-0019,,False,False,REF-130109,First Continental Bank,***2473,Globex Consulting UK Ltd.,UK,-2712427.31
2025-01-26,2025-01-26,Client Receipt - Aurora Electronics GmbH #7,Sales Receipt,CEM-EMEA,0.0,12824.86,GBP,CHAPS Credit,Aurora Electronics GmbH #7,***5488,INV-202501-CEM-EMEA-0006,,False,False,REF-519895,First Continental Bank,***4591,Globex Consulting UK Ltd.,UK,-2699602.45
2025-01-27,2025-01-27,Merchant Processing Fees,Bank/Merchant Fees,ALL,869.54,0.0,GBP,CHAPS,First Continental Bank,***2407,,,False,False,REF-234562,First Continental Bank,***5346,Globex Consulting UK Ltd.,UK,-2700471.99
2025-01-27,2025-01-27,Supplier Payment - ExpertNet Subcontractors #16,Supplier Payment,PS-GL,1372.6,0.0,GBP,Faster Payments,ExpertNet Subcontractors #16,***6250,,PO-202501-PS-GL-0005,False,False,REF-583148,First Continental Bank,***9199,Globex Consulting UK Ltd.,UK,-2701844.59
2025-01-27,2025-01-27,Client Receipt - CloudBridge Co. #6,Sales Receipt,SaaS-GL,0.0,186.93,GBP,CHAPS Credit,CloudBridge Co. #6,***9581,INV-202501-SaaS-GL-0027,,False,False,REF-922834,First Continental Bank,***2545,Globex Consulting UK Ltd.,UK,-2701657.66
2025-01-27,2025-01-27,Client Receipt - CloudBridge Co. #38,Sales Receipt,SaaS-GL,0.0,6093.48,GBP,Faster Payments Credit,CloudBridge Co. #38,***7904,INV-202501-SaaS-GL-0028,,False,False,REF-187702,First Continental Bank,***5765,Globex Consulting UK Ltd.,UK,-2695564.18
2025-01-27,2025-01-27,Client Receipt - CloudBridge Co. #54,Sales Receipt,SaaS-GL,0.0,6135.99,GBP,CHAPS Credit,CloudBridge Co. #54,***4034,INV-202501-SaaS-GL-0015,,False,False,REF-539764,First Continental Bank,***7878,Globex Consulting UK Ltd.,UK,-2689428.19
2025-01-27,2025-01-27,Client Receipt - Novatek Components Ltd #10,Sales Receipt,CEM-EMEA,0.0,7358.35,GBP,Faster Payments Credit,Novatek Components Ltd #10,***4900,INV-202501-CEM-EMEA-0015,,False,False,REF-784109,First Continental Bank,***3522,Globex Consulting UK Ltd.,UK,-2682069.84
2025-01-28,2025-01-28,Supplier Payment - CodeCraft Contractors #9,Supplier Payment,SaaS-GL,6446.45,0.0,GBP,CHAPS,CodeCraft Contractors #9,***9715,,PO-202501-SaaS-GL-0001,False,False,REF-467137,First Continental Bank,***6024,Globex Consulting UK Ltd.,UK,-2688516.29
2025-01-28,2025-01-28,Corporate Tax Estimate,Tax Payment,ALL,20130.92,0.0,GBP,CHAPS,HMRC UK,***7569,,,False,False,REF-874703,First Continental Bank,***6362,Globex Consulting UK Ltd.,UK,-2708647.21
2025-01-28,2025-01-28,Payroll - GlobalPay Services Ltd,Payroll,ALL,36174.04,0.0,GBP,Faster Payments,GlobalPay Services Ltd,***1184,,,False,False,REF-442242,First Continental Bank,***2840,Globex Consulting UK Ltd.,UK,-2744821.25
2025-01-28,2025-01-28,Client Receipt - CloudBridge Co. #57,Sales Receipt,SaaS-GL,0.0,9296.7,GBP,CHAPS Credit,CloudBridge Co. #57,***2600,INV-202501-SaaS-GL-0025,,False,False,REF-276288,First Continental Bank,***2889,Globex Consulting UK Ltd.,UK,-2735524.55
2025-01-29,2025-01-29,Supplier Payment - CodeCraft Contractors #12,Supplier Payment,SaaS-GL,1502.56,0.0,GBP,Faster Payments,CodeCraft Contractors #12,***6307,,PO-202501-SaaS-GL-0007,False,False,REF-937728,First Continental Bank,***1234,Globex Consulting UK Ltd.,UK,-2737027.11
2025-01-29,2025-01-29,Supplier Payment - HyperCloud Infra #5,Supplier Payment,SaaS-GL,3927.5,0.0,GBP,Faster Payments,HyperCloud Infra #5,***9458,,PO-202501-SaaS-GL-0004,False,False,REF-760478,First Continental Bank,***7421,Globex Consulting UK Ltd.,UK,-2740954.61
2025-01-29,2025-01-29,Payroll - GlobalPay Services Ltd,Payroll,ALL,36174.04,0.0,GBP,CHAPS,GlobalPay Services Ltd,***3279,,,False,False,REF-512608,First Continental Bank,***3672,Globex Consulting UK Ltd.,UK,-2777128.65
2025-01-29,2025-01-29,Client Receipt - CloudBridge Co. #49,Sales Receipt,SaaS-GL,0.0,3.92,GBP,Faster Payments Credit,CloudBridge Co. #49,***9044,INV-202501-SaaS-GL-0003,,False,False,REF-210699,First Continental Bank,***1508,Globex Consulting UK Ltd.,UK,-2777124.73
2025-01-29,2025-01-29,Client Receipt - Vertex Advisory Client #21,Sales Receipt,PS-GL,0.0,1222.85,GBP,Faster Payments Credit,Vertex Advisory Client #21,***3177,INV-202501-PS-GL-0002,,False,False,REF-211612,First Continental Bank,***8958,Globex Consulting UK Ltd.,UK,-2775901.88
2025-01-30,2025-01-30,Marketing - Aurelia Media #3,Marketing,ALL,3989.62,0.0,GBP,Faster Payments,Aurelia Media #3,***9377,,,False,False,REF-853720,First Continental Bank,***5118,Globex Consulting UK Ltd.,UK,-2779891.5
2025-01-30,2025-01-30,Client Receipt - Aurora Electronics GmbH #15,Sales Receipt,CEM-EMEA,0.0,5102.82,GBP,Faster Payments Credit,Aurora Electronics GmbH #15,***6337,INV-202501-CEM-EMEA-0016,,False,False,REF-136632,First Continental Bank,***1114,Globex Consulting UK Ltd.,UK,-2774788.68
2025-01-30,2025-01-30,Interest Earned,Interest Income,ALL,0.0,9616.08,GBP,CHAPS Credit,First Continental Bank,***6617,,,False,False,REF-651315,First Continental Bank,***5505,Globex Consulting UK Ltd.,UK,-2765172.6
2025-01-31,2025-01-31,Supplier Payment - ExpertNet Subcontractors #12,Supplier Payment,PS-GL,901.0,0.0,GBP,CHAPS,ExpertNet Subcontractors #12,***9459,,PO-202501-PS-GL-0008,False,False,REF-894208,First Continental Bank,***2669,Globex Consulting UK Ltd.,UK,-2766073.6
2025-01-31,2025-01-31,Supplier Payment - CodeCraft Contractors #2,Supplier Payment,SaaS-GL,4078.76,0.0,GBP,CHAPS,CodeCraft Contractors #2,***8884,,PO-202501-SaaS-GL-0005,False,False,REF-681181,First Continental Bank,***4844,Globex Consulting UK Ltd.,UK,-2770152.36
2025-01-31,2025-01-31,Client Receipt - CloudBridge Co. #71,Sales Receipt,SaaS-GL,0.0,848.22,GBP,CHAPS Credit,CloudBridge Co. #71,***5969,INV-202501-SaaS-GL-0024,,False,False,REF-709992,First Continental Bank,***6624,Globex Consulting UK Ltd.,UK,-2769304.14
2025-01-31,2025-01-31,Client Receipt - CloudBridge Co. #57,Sales Receipt,SaaS-GL,0.0,2133.52,GBP,CHAPS Credit,CloudBridge Co. #57,***2348,INV-202501-SaaS-GL-0011,,False,False,REF-788168,First Continental Bank,***9521,Globex Consulting UK Ltd.,UK,-2767170.62
2025-02-01,2025-02-01,Account Maintenance Fee,Bank/Merchant Fees,ALL,2500.0,0.0,GBP,Faster Payments,First Continental Bank,***8679,,,False,False,REF-821776,First Continental Bank,***4763,Globex Consulting UK Ltd.,UK,-2769670.62
2025-02-01,2025-02-01,Client Receipt - CloudBridge Co. #73,Sales Receipt,SaaS-GL,0.0,1615.51,GBP,CHAPS Credit,CloudBridge Co. #73,***2014,INV-202502-SaaS-GL-0002,,False,False,REF-105778,First Continental Bank,***6061,Globex Consulting UK Ltd.,UK,-2768055.11
2025-02-03,2025-02-03,Supplier Payment - HyperCloud Infra #19,Supplier Payment,SaaS-GL,4834.91,0.0,GBP,CHAPS,HyperCloud Infra #19,***7227,,PO-202502-SaaS-GL-0003,False,False,REF-396859,First Continental Bank,***4871,Globex Consulting UK Ltd.,UK,-2772890.02
2025-02-03,2025-02-03,Supplier Payment - EuroFab Assembly #12,Supplier Payment,CEM-EMEA,27363.87,0.0,GBP,CHAPS,EuroFab Assembly #12,***3294,,PO-202502-CEM-EMEA-0003,False,False,REF-748431,First Continental Bank,***2143,Globex Consulting UK Ltd.,UK,-2800253.89
2025-02-03,2025-02-03,Supplier Payment - EuroFab Assembly #24,Supplier Payment,CEM-EMEA,34559.98,0.0,GBP,Faster Payments,EuroFab Assembly #24,***5194,,PO-202502-CEM-EMEA-0008,False,False,REF-566084,First Continental Bank,***2045,Globex Consulting UK Ltd.,UK,-2834813.87
2025-02-03,2025-02-03,Client Receipt - Vertex Advisory Client #36,Sales Receipt,PS-GL,0.0,2387.68,GBP,Faster Payments Credit,Vertex Advisory Client #36,***6346,INV-202502-PS-GL-0005,,False,False,REF-598157,First Continental Bank,***4051,Globex Consulting UK Ltd.,UK,-2832426.19
2025-02-03,2025-02-03,Client Receipt - Aurora Electronics GmbH #13,Sales Receipt,CEM-EMEA,0.0,10275.2,GBP,Faster Payments Credit,Aurora Electronics GmbH #13,***1829,INV-202502-CEM-EMEA-0002,,False,False,REF-322502,First Continental Bank,***5439,Globex Consulting UK Ltd.,UK,-2822150.99
2025-02-04,2025-02-04,Supplier Payment - ExpertNet Subcontractors #15,Supplier Payment,PS-GL,364.65,0.0,GBP,CHAPS,ExpertNet Subcontractors #15,***7476,,PO-202502-PS-GL-0008,False,False,REF-386015,First Continental Bank,***8962,Globex Consulting UK Ltd.,UK,-2822515.64
2025-02-05,2025-02-05,BluePeak Property Mgmt,Rent & Utilities,ALL,2393.75,0.0,GBP,CHAPS,BluePeak Property Mgmt,***7744,,,False,False,REF-685292,First Continental Bank,***1853,Globex Consulting UK Ltd.,UK,-2824909.39
2025-02-05,2025-02-05,Supplier Payment - EuroFab Assembly #1,Supplier Payment,CEM-EMEA,19587.74,0.0,GBP,CHAPS,EuroFab Assembly #1,***9946,,PO-202502-CEM-EMEA-0006,False,False,REF-136417,First Continental Bank,***5058,Globex Consulting UK Ltd.,UK,-2844497.13
2025-02-05,2025-02-05,Client Receipt - CloudBridge Co. #29,Sales Receipt,SaaS-GL,0.0,5039.22,GBP,Faster Payments Credit,CloudBridge Co. #29,***6248,INV-202502-SaaS-GL-0024,,False,False,REF-592328,First Continental Bank,***1023,Globex Consulting UK Ltd.,UK,-2839457.91
2025-02-05,2025-02-05,Client Receipt - CloudBridge Co. #22,Sales Receipt,SaaS-GL,0.0,21712.6,GBP,CHAPS Credit,CloudBridge Co. #22,***7025,INV-202502-SaaS-GL-0010,,False,False,REF-309525,First Continental Bank,***8479,Globex Consulting UK Ltd.,UK,-2817745.31
2025-02-06,2025-02-06,Supplier Payment - ExpertNet Subcontractors #11,Supplier Payment,PS-GL,591.8,0.0,GBP,Faster Payments,ExpertNet Subcontractors #11,***7663,,PO-202502-PS-GL-0009,False,False,REF-908447,First Continental Bank,***3847,Globex Consulting UK Ltd.,UK,-2818337.11
2025-02-06,2025-02-06,Supplier Payment - Stelliform Parts BV #14,Supplier Payment,CEM-EMEA,1206.6,0.0,GBP,Faster Payments,Stelliform Parts BV #14,***4889,,PO-202502-CEM-EMEA-0002,False,False,REF-858832,First Continental Bank,***3210,Globex Consulting UK Ltd.,UK,-2819543.71
2025-02-06,2025-02-06,Client Receipt - CloudBridge Co. #64,Sales Receipt,SaaS-GL,0.0,4668.14,GBP,Faster Payments Credit,CloudBridge Co. #64,***9784,INV-202502-SaaS-GL-0001,,False,False,REF-850536,First Continental Bank,***3929,Globex Consulting UK Ltd.,UK,-2814875.57
2025-02-06,2025-02-06,Client Receipt - Novatek Components Ltd #8,Sales Receipt,CEM-EMEA,0.0,8708.38,GBP,Faster Payments Credit,Novatek Components Ltd #8,***9186,INV-202502-CEM-EMEA-0001,,False,False,REF-144466,First Continental Bank,***6350,Globex Consulting UK Ltd.,UK,-2806167.19
2025-02-07,2025-02-07,Supplier Payment - ExpertNet Subcontractors #9,Supplier Payment,PS-GL,1711.13,0.0,GBP,CHAPS,ExpertNet Subcontractors #9,***4066,,PO-202502-PS-GL-0002,False,False,REF-470178,First Continental Bank,***5456,Globex Consulting UK Ltd.,UK,-2807878.32
2025-02-07,2025-02-07,Supplier Payment - ExpertNet Subcontractors #8,Supplier Payment,PS-GL,5039.46,0.0,GBP,CHAPS,ExpertNet Subcontractors #8,***6329,,PO-202502-PS-GL-0006,False,False,REF-523841,First Continental Bank,***8564,Globex Consulting UK Ltd.,UK,-2812917.78
2025-02-07,2025-02-07,Client Receipt - Novatek Components Ltd #3,Sales Receipt,CEM-EMEA,0.0,21765.49,GBP,CHAPS Credit,Novatek Components Ltd #3,***3893,INV-202502-CEM-EMEA-0011,,False,False,REF-385977,First Continental Bank,***9245,Globex Consulting UK Ltd.,UK,-2791152.29
2025-02-08,2025-02-08,Client Receipt - CloudBridge Co. #66,Sales Receipt,SaaS-GL,0.0,4849.47,GBP,CHAPS Credit,CloudBridge Co. #66,***7771,INV-202502-SaaS-GL-0006,,False,False,REF-803434,First Continental Bank,***4821,Globex Consulting UK Ltd.,UK,-2786302.82
2025-02-09,2025-02-09,Merchant Processing Fees,Bank/Merchant Fees,ALL,189.24,0.0,GBP,Faster Payments,First Continental Bank,***2108,,,False,False,REF-759356,First Continental Bank,***2610,Globex Consulting UK Ltd.,UK,-2786492.06
2025-02-09,2025-02-09,Client Receipt - CloudBridge Co. #30,Sales Receipt,SaaS-GL,0.0,9018.88,GBP,CHAPS Credit,CloudBridge Co. #30,***9707,INV-202502-SaaS-GL-0026,,False,False,REF-188945,First Continental Bank,***6961,Globex Consulting UK Ltd.,UK,-2777473.18
2025-02-09,2025-02-09,Client Receipt - CloudBridge Co. #21,Sales Receipt,SaaS-GL,0.0,10392.19,GBP,Faster Payments Credit,CloudBridge Co. #21,***8871,INV-202502-SaaS-GL-0007,,False,False,REF-858875,First Continental Bank,***9447,Globex Consulting UK Ltd.,UK,-2767080.99
2025-02-09,2025-02-09,Client Receipt - Aurora Electronics GmbH #9,Sales Receipt,CEM-EMEA,0.0,17682.27,GBP,Faster Payments Credit,Aurora Electronics GmbH #9,***9156,INV-202502-CEM-EMEA-0010,,False,False,REF-396042,First Continental Bank,***5096,Globex Consulting UK Ltd.,UK,-2749398.72
2025-02-09,2025-02-09,Client Receipt - Vertex Advisory Client #25,Sales Receipt,PS-GL,0.0,30447.0,GBP,CHAPS Credit,Vertex Advisory Client #25,***7463,INV-202502-PS-GL-0006,,False,False,REF-392858,First Continental Bank,***1712,Globex Consulting UK Ltd.,UK,-2718951.72
2025-02-10,2025-02-10,Supplier Payment - CodeCraft Contractors #9,Supplier Payment,SaaS-GL,1823.59,0.0,GBP,CHAPS,CodeCraft Contractors #9,***3048,,PO-202502-SaaS-GL-0007,False,False,REF-320745,First Continental Bank,***1319,Globex Consulting UK Ltd.,UK,-2720775.31
2025-02-10,2025-02-10,BluePeak Property Mgmt,Rent & Utilities,ALL,1983.72,0.0,GBP,Faster Payments,BluePeak Property Mgmt,***5958,,,False,False,REF-269834,First Continental Bank,***9513,Globex Consulting UK Ltd.,UK,-2722759.03
2025-02-10,2025-02-10,Supplier Payment - ExpertNet Subcontractors #10,Supplier Payment,PS-GL,2739.48,0.0,GBP,Faster Payments,ExpertNet Subcontractors #10,***4008,,PO-202502-PS-GL-0010,False,False,REF-885904,First Continental Bank,***9898,Globex Consulting UK Ltd.,UK,-2725498.51
2025-02-10,2025-02-10,Supplier Payment - ExpertNet Subcontractors #2,Supplier Payment,PS-GL,3415.47,0.0,GBP,Faster Payments,ExpertNet Subcontractors #2,***4363,,PO-202502-PS-GL-0005,False,False,REF-281270,First Continental Bank,***4373,Globex Consulting UK Ltd.,UK,-2728913.98
2025-02-10,2025-02-10,Supplier Payment - HyperCloud Infra #19,Supplier Payment,SaaS-GL,8222.73,0.0,GBP,Faster Payments,HyperCloud Infra #19,***2569,,PO-202502-SaaS-GL-0006,False,False,REF-654546,First Continental Bank,***7702,Globex Consulting UK Ltd.,UK,-2737136.71
2025-02-10,2025-02-10,Client Receipt - CloudBridge Co. #73,Sales Receipt,SaaS-GL,0.0,16736.64,GBP,CHAPS Credit,CloudBridge Co. #73,***6061,INV-202502-SaaS-GL-0008,,False,False,REF-379709,First Continental Bank,***2879,Globex Consulting UK Ltd.,UK,-2720400.07
2025-02-11,2025-02-11,Supplier Payment - CodeCraft Contractors #1,Supplier Payment,SaaS-GL,2541.68,0.0,GBP,Faster Payments,CodeCraft Contractors #1,***6185,,PO-202502-SaaS-GL-0004,False,False,REF-310241,First Continental Bank,***3576,Globex Consulting UK Ltd.,UK,-2722941.75
2025-02-11,2025-02-11,Marketing - Aurelia Media #4,Marketing,ALL,14376.75,0.0,GBP,CHAPS,Aurelia Media #4,***2922,,,False,False,REF-622470,First Continental Bank,***5287,Globex Consulting UK Ltd.,UK,-2737318.5
2025-02-11,2025-02-11,Supplier Payment - EuroFab Assembly #6,Supplier Payment,CEM-EMEA,36202.34,0.0,GBP,CHAPS,EuroFab Assembly #6,***3160,,PO-202502-CEM-EMEA-0005,False,False,REF-544559,First Continental Bank,***6989,Globex Consulting UK Ltd.,UK,-2773520.84
2025-02-11,2025-02-11,Client Receipt - Aurora Electronics GmbH #1,Sales Receipt,CEM-EMEA,0.0,1116.18,GBP,Faster Payments Credit,Aurora Electronics GmbH #1,***6476,INV-202502-CEM-EMEA-0018,,False,False,REF-882859,First Continental Bank,***9181,Globex Consulting UK Ltd.,UK,-2772404.66
2025-02-11,2025-02-11,Client Receipt - CloudBridge Co. #65,Sales Receipt,SaaS-GL,0.0,5998.08,GBP,CHAPS Credit,CloudBridge Co. #65,***4205,INV-202502-SaaS-GL-0003,,False,False,REF-735346,First Continental Bank,***9396,Globex Consulting UK Ltd.,UK,-2766406.58
2025-02-11,2025-02-11,Client Receipt - CloudBridge Co. #49,Sales Receipt,SaaS-GL,0.0,9895.28,GBP,CHAPS Credit,CloudBridge Co. #49,***1271,INV-202502-SaaS-GL-0020,,False,False,REF-778666,First Continental Bank,***4076,Globex Consulting UK Ltd.,UK,-2756511.3
2025-02-11,2025-02-11,Client Receipt - Vertex Advisory Client #34,Sales Receipt,PS-GL,0.0,21476.83,GBP,Faster Payments Credit,Vertex Advisory Client #34,***7024,INV-202502-PS-GL-0004,,False,False,REF-494346,First Continental Bank,***9597,Globex Consulting UK Ltd.,UK,-2735034.47
2025-02-12,2025-02-12,Supplier Payment - ExpertNet Subcontractors #18,Supplier Payment,PS-GL,5873.66,0.0,GBP,CHAPS,ExpertNet Subcontractors #18,***6747,,PO-202502-PS-GL-0001,False,False,REF-999624,First Continental Bank,***2226,Globex Consulting UK Ltd.,UK,-2740908.13
2025-02-12,2025-02-12,Intercompany Settlement - Globex Retail NA LLC,Intercompany Transfer,ALL,465959.0,0.0,GBP,Internal Transfer,Globex Retail NA LLC,***1564,,,True,True,REF-433732,First Continental Bank,***3019,Globex Consulting UK Ltd.,UK,-3206867.13
2025-02-12,2025-02-12,Client Receipt - CloudBridge Co. #64,Sales Receipt,SaaS-GL,0.0,4051.4,GBP,Faster Payments Credit,CloudBridge Co. #64,***8683,INV-202502-SaaS-GL-0025,,False,False,REF-991683,First Continental Bank,***9632,Globex Consulting UK Ltd.,UK,-3202815.73
2025-02-12,2025-02-12,Intercompany Reimbursement - Globex Retail NA LLC,Intercompany Transfer,ALL,0.0,186383.6,GBP,Internal Transfer,Globex Retail NA LLC,***8143,,,True,True,REF-635041,First Continental Bank,***6422,Globex Consulting UK Ltd.,UK,-3016432.13
2025-02-13,2025-02-13,Supplier Payment - Stelliform Parts BV #24,Supplier Payment,CEM-EMEA,24450.74,0.0,GBP,Faster Payments,Stelliform Parts BV #24,***9867,,PO-202502-CEM-EMEA-0007,False,False,REF-693189,First Continental Bank,***6649,Globex Consulting UK Ltd.,UK,-3040882.87
2025-02-13,2025-02-13,Client Receipt - CloudBridge Co. #70,Sales Receipt,SaaS-GL,0.0,4288.18,GBP,CHAPS Credit,CloudBridge Co. #70,***1608,INV-202502-SaaS-GL-0009,,False,False,REF-129695,First Continental Bank,***1144,Globex Consulting UK Ltd.,UK,-3036594.69
2025-02-13,2025-02-13,Client Receipt - CloudBridge Co. #62,Sales Receipt,SaaS-GL,0.0,15377.22,GBP,CHAPS Credit,CloudBridge Co. #62,***6037,INV-202502-SaaS-GL-0021,,False,False,REF-111628,First Continental Bank,***6839,Globex Consulting UK Ltd.,UK,-3021217.47
2025-02-13,2025-02-13,Client Receipt - Aurora Electronics GmbH #15,Sales Receipt,CEM-EMEA,0.0,16537.34,GBP,CHAPS Credit,Aurora Electronics GmbH #15,***3188,INV-202502-CEM-EMEA-0006,,False,False,REF-977882,First Continental Bank,***8998,Globex Consulting UK Ltd.,UK,-3004680.13
2025-02-13,2025-02-13,Client Receipt - Aurora Electronics GmbH #3,Sales Receipt,CEM-EMEA,0.0,27180.44,GBP,Faster Payments Credit,Aurora Electronics GmbH #3,***1423,INV-202502-CEM-EMEA-0005,,False,False,REF-679477,First Continental Bank,***7734,Globex Consulting UK Ltd.,UK,-2977499.69
2025-02-14,2025-02-14,Client Receipt - CloudBridge Co. #69,Sales Receipt,SaaS-GL,0.0,2369.57,GBP,CHAPS Credit,CloudBridge Co. #69,***2978,INV-202502-SaaS-GL-0027,,False,False,REF-737902,First Continental Bank,***6614,Globex Consulting UK Ltd.,UK,-2975130.12
2025-02-14,2025-02-14,Client Receipt - CloudBridge Co. #37,Sales Receipt,SaaS-GL,0.0,4675.65,GBP,Faster Payments Credit,CloudBridge Co. #37,***6765,INV-202502-SaaS-GL-0019,,False,False,REF-790214,First Continental Bank,***4732,Globex Consulting UK Ltd.,UK,-2970454.47
2025-02-14,2025-02-14,Client Receipt - Novatek Components Ltd #5,Sales Receipt,CEM-EMEA,0.0,6249.68,GBP,CHAPS Credit,Novatek Components Ltd #5,***7505,INV-202502-CEM-EMEA-0007,,False,False,REF-760395,First Continental Bank,***9571,Globex Consulting UK Ltd.,UK,-2964204.79
2025-02-16,2025-02-16,Client Receipt - Vertex Advisory Client #24,Sales Receipt,PS-GL,0.0,10311.04,GBP,CHAPS Credit,Vertex Advisory Client #24,***7409,INV-202502-PS-GL-0009,,False,False,REF-555510,First Continental Bank,***4443,Globex Consulting UK Ltd.,UK,-2953893.75
2025-02-17,2025-02-17,Supplier Payment - ExpertNet Subcontractors #10,Supplier Payment,PS-GL,3552.14,0.0,GBP,CHAPS,ExpertNet Subcontractors #10,***5362,,PO-202502-PS-GL-0007,False,False,REF-877096,First Continental Bank,***8692,Globex Consulting UK Ltd.,UK,-2957445.89
2025-02-17,2025-02-17,Supplier Payment - EuroFab Assembly #6,Supplier Payment,CEM-EMEA,4863.1,0.0,GBP,CHAPS,EuroFab Assembly #6,***9077,,PO-202502-CEM-EMEA-0009,False,False,REF-275498,First Continental Bank,***6402,Globex Consulting UK Ltd.,UK,-2962308.99
2025-02-17,2025-02-17,Supplier Payment - ExpertNet Subcontractors #4,Supplier Payment,PS-GL,7649.6,0.0,GBP,Faster Payments,ExpertNet Subcontractors #4,***2505,,PO-202502-PS-GL-0004,False,False,REF-211020,First Continental Bank,***5066,Globex Consulting UK Ltd.,UK,-2969958.59
2025-02-17,2025-02-17,Supplier Payment - Stelliform Parts BV #24,Supplier Payment,CEM-EMEA,8250.95,0.0,GBP,Faster Payments,Stelliform Parts BV #24,***5458,,PO-202502-CEM-EMEA-0001,False,False,REF-197679,First Continental Bank,***9582,Globex Consulting UK Ltd.,UK,-2978209.54
2025-02-18,2025-02-18,Supplier Payment - EuroFab Assembly #2,Supplier Payment,CEM-EMEA,3649.25,0.0,GBP,Faster Payments,EuroFab Assembly #2,***6387,,PO-202502-CEM-EMEA-0004,False,False,REF-480988,First Continental Bank,***8860,Globex Consulting UK Ltd.,UK,-2981858.79
2025-02-18,2025-02-18,Client Receipt - CloudBridge Co. #76,Sales Receipt,SaaS-GL,0.0,1898.39,GBP,CHAPS Credit,CloudBridge Co. #76,***6518,INV-202502-SaaS-GL-0014,,False,False,REF-512435,First Continental Bank,***5105,Globex Consulting UK Ltd.,UK,-2979960.4
2025-02-18,2025-02-18,Client Receipt - CloudBridge Co. #70,Sales Receipt,SaaS-GL,0.0,2990.16,GBP,Faster Payments Credit,CloudBridge Co. #70,***8497,INV-202502-SaaS-GL-0018,,False,False,REF-636850,First Continental Bank,***9441,Globex Consulting UK Ltd.,UK,-2976970.24
2025-02-19,2025-02-19,Supplier Payment - HyperCloud Infra #15,Supplier Payment,SaaS-GL,582.51,0.0,GBP,CHAPS,HyperCloud Infra #15,***2029,,PO-202502-SaaS-GL-0001,False,False,REF-964989,First Continental Bank,***7620,Globex Consulting UK Ltd.,UK,-2977552.75
2025-02-19,2025-02-19,Merchant Processing Fees,Bank/Merchant Fees,ALL,1451.37,0.0,GBP,CHAPS,First Continental Bank,***5172,,,False,False,REF-873498,First Continental Bank,***8167,Globex Consulting UK Ltd.,UK,-2979004.12
2025-02-19,2025-02-19,Supplier Payment - ExpertNet Subcontractors #6,Supplier Payment,PS-GL,1998.06,0.0,GBP,CHAPS,ExpertNet Subcontractors #6,***3887,,PO-202502-PS-GL-0003,False,False,REF-548377,First Continental Bank,***8843,Globex Consulting UK Ltd.,UK,-2981002.18
2025-02-19,2025-02-19,Supplier Payment - CodeCraft Contractors #14,Supplier Payment,SaaS-GL,9456.54,0.0,GBP,Faster Payments,CodeCraft Contractors #14,***8376,,PO-202502-SaaS-GL-0008,False,False,REF-735429,First Continental Bank,***7122,Globex Consulting UK Ltd.,UK,-2990458.72
2025-02-19,2025-02-19,VAT/GST Remittance - HMRC UK,Tax Payment,ALL,33173.48,0.0,GBP,SWIFT MT103,HMRC UK,***7853,,,False,False,REF-491127,First Continental Bank,***5131,Globex Consulting UK Ltd.,UK,-3023632.2
2025-02-19,2025-02-19,Client Receipt - CloudBridge Co. #30,Sales Receipt,SaaS-GL,0.0,488.87,GBP,CHAPS Credit,CloudBridge Co. #30,***3307,INV-202502-SaaS-GL-0022,,False,False,REF-609369,First Continental Bank,***2439,Globex Consulting UK Ltd.,UK,-3023143.33
2025-02-19,2025-02-19,Client Receipt - Aurora Electronics GmbH #17,Sales Receipt,CEM-EMEA,0.0,11914.83,GBP,Faster Payments Credit,Aurora Electronics GmbH #17,***6937,INV-202502-CEM-EMEA-0017,,False,False,REF-298576,First Continental Bank,***9854,Globex Consulting UK Ltd.,UK,-3011228.5
2025-02-19,2025-02-19,Client Receipt - CloudBridge Co. #37,Sales Receipt,SaaS-GL,0.0,12021.62,GBP,Faster Payments Credit,CloudBridge Co. #37,***7626,INV-202502-SaaS-GL-0004,,False,False,REF-249233,First Continental Bank,***2056,Globex Consulting UK Ltd.,UK,-2999206.88
2025-02-19,2025-02-19,Client Receipt - Novatek Components Ltd #5,Sales Receipt,CEM-EMEA,0.0,21419.03,GBP,Faster Payments Credit,Novatek Components Ltd #5,***9783,INV-202502-CEM-EMEA-0004,,False,False,REF-987345,First Continental Bank,***6922,Globex Consulting UK Ltd.,UK,-2977787.85
2025-02-20,2025-02-20,Supplier Payment - ExpertNet Subcontractors #16,Supplier Payment,PS-GL,1214.14,0.0,GBP,CHAPS,ExpertNet Subcontractors #16,***8129,,PO-202502-PS-GL-0011,False,False,REF-509431,First Continental Bank,***4152,Globex Consulting UK Ltd.,UK,-2979001.99
2025-02-20,2025-02-20,Supplier Payment - HyperCloud Infra #15,Supplier Payment,SaaS-GL,1734.18,0.0,GBP,Faster Payments,HyperCloud Infra #15,***6939,,PO-202502-SaaS-GL-0009,False,False,REF-782503,First Continental Bank,***8422,Globex Consulting UK Ltd.,UK,-2980736.17
2025-02-20,2025-02-20,Client Receipt - Vertex Advisory Client #26,Sales Receipt,PS-GL,0.0,8846.06,GBP,Faster Payments Credit,Vertex Advisory Client #26,***3123,INV-202502-PS-GL-0001,,False,False,REF-149720,First Continental Bank,***7285,Globex Consulting UK Ltd.,UK,-2971890.11
2025-02-21,2025-02-21,Client Receipt - CloudBridge Co. #23,Sales Receipt,SaaS-GL,0.0,3390.42,GBP,Faster Payments Credit,CloudBridge Co. #23,***2890,INV-202502-SaaS-GL-0012,,False,False,REF-510049,First Continental Bank,***9206,Globex Consulting UK Ltd.,UK,-2968499.69
2025-02-22,2025-02-22,Client Receipt - Novatek Components Ltd #8,Sales Receipt,CEM-EMEA,0.0,18294.6,GBP,Faster Payments Credit,Novatek Components Ltd #8,***9171,INV-202502-CEM-EMEA-0014,,False,False,REF-743327,First Continental Bank,***5335,Globex Consulting UK Ltd.,UK,-2950205.09
2025-02-23,2025-02-23,Client Receipt - CloudBridge Co. #8,Sales Receipt,SaaS-GL,0.0,458.61,GBP,CHAPS Credit,CloudBridge Co. #8,***3235,INV-202502-SaaS-GL-0005,,False,False,REF-554314,First Continental Bank,***9862,Globex Consulting UK Ltd.,UK,-2949746.48
2025-02-23,2025-02-23,Client Receipt - Novatek Components Ltd #12,Sales Receipt,CEM-EMEA,0.0,7781.66,GBP,CHAPS Credit,Novatek Components Ltd #12,***1473,INV-202502-CEM-EMEA-0012,,False,False,REF-468842,First Continental Bank,***1810,Globex Consulting UK Ltd.,UK,-2941964.82
2025-02-24,2025-02-24,Client Receipt - CloudBridge Co. #52,Sales Receipt,SaaS-GL,0.0,1768.31,GBP,CHAPS Credit,CloudBridge Co. #52,***4690,INV-202502-SaaS-GL-0011,,False,False,REF-111581,First Continental Bank,***6660,Globex Consulting UK Ltd.,UK,-2940196.51
2025-02-24,2025-02-24,Client Receipt - Vertex Advisory Client #30,Sales Receipt,PS-GL,0.0,13772.11,GBP,CHAPS Credit,Vertex Advisory Client #30,***4853,INV-202502-PS-GL-0008,,False,False,REF-414653,First Continental Bank,***3833,Globex Consulting UK Ltd.,UK,-2926424.4
2025-02-25,2025-02-25,Marketing - Aurelia Media #4,Marketing,ALL,5.66,0.0,GBP,Faster Payments,Aurelia Media #4,***3328,,,False,False,REF-515644,First Continental Bank,***6387,Globex Consulting UK Ltd.,UK,-2926430.06
2025-02-25,2025-02-25,Supplier Payment - CodeCraft Contractors #3,Supplier Payment,SaaS-GL,3710.05,0.0,GBP,Faster Payments,CodeCraft Contractors #3,***8229,,PO-202502-SaaS-GL-0005,False,False,REF-241909,First Continental Bank,***4866,Globex Consulting UK Ltd.,UK,-2930140.11
2025-02-25,2025-02-25,Supplier Payment - HyperCloud Infra #3,Supplier Payment,SaaS-GL,4839.82,0.0,GBP,Faster Payments,HyperCloud Infra #3,***1292,,PO-202502-SaaS-GL-0002,False,False,REF-769427,First Continental Bank,***3400,Globex Consulting UK Ltd.,UK,-2934979.93
2025-02-25,2025-02-25,Client Receipt - Aurora Electronics GmbH #8,Sales Receipt,CEM-EMEA,0.0,2190.26,GBP,Faster Payments Credit,Aurora Electronics GmbH #8,***9717,INV-202502-CEM-EMEA-0016,,False,False,REF-752567,First Continental Bank,***4719,Globex Consulting UK Ltd.,UK,-2932789.67
2025-02-25,2025-02-25,Client Receipt - CloudBridge Co. #21,Sales Receipt,SaaS-GL,0.0,13629.78,GBP,Faster Payments Credit,CloudBridge Co. #21,***5547,INV-202502-SaaS-GL-0015,,False,False,REF-659695,First Continental Bank,***1692,Globex Consulting UK Ltd.,UK,-2919159.89
2025-02-25,2025-02-25,Client Receipt - Vertex Advisory Client #15,Sales Receipt,PS-GL,0.0,14904.79,GBP,CHAPS Credit,Vertex Advisory Client #15,***1480,INV-202502-PS-GL-0003,,False,False,REF-890879,First Continental Bank,***2830,Globex Consulting UK Ltd.,UK,-2904255.1
2025-02-25,2025-02-25,Client Receipt - Aurora Electronics GmbH #9,Sales Receipt,CEM-EMEA,0.0,15668.98,GBP,CHAPS Credit,Aurora Electronics GmbH #9,***9370,INV-202502-CEM-EMEA-0008,,False,False,REF-964755,First Continental Bank,***7471,Globex Consulting UK Ltd.,UK,-2888586.12
2025-02-25,2025-02-25,Client Receipt - Aurora Electronics GmbH #8,Sales Receipt,CEM-EMEA,0.0,29570.5,GBP,Faster Payments Credit,Aurora Electronics GmbH #8,***7431,INV-202502-CEM-EMEA-0015,,False,False,REF-779535,First Continental Bank,***1439,Globex Consulting UK Ltd.,UK,-2859015.62
2025-02-26,2025-02-26,Intercompany Settlement - Globex APAC Logistics Pte. Ltd.,Intercompany Transfer,ALL,799677.0,0.0,GBP,Internal Transfer,Globex APAC Logistics Pte. Ltd.,***3814,,,True,True,REF-515108,First Continental Bank,***2432,Globex Consulting UK Ltd.,UK,-3658692.62
2025-02-26,2025-02-26,Client Receipt - CloudBridge Co. #2,Sales Receipt,SaaS-GL,0.0,282.67,GBP,Faster Payments Credit,CloudBridge Co. #2,***8939,INV-202502-SaaS-GL-0013,,False,False,REF-715717,First Continental Bank,***2057,Globex Consulting UK Ltd.,UK,-3658409.95
2025-02-26,2025-02-26,Client Receipt - Vertex Advisory Client #43,Sales Receipt,PS-GL,0.0,5281.57,GBP,Faster Payments Credit,Vertex Advisory Client #43,***2135,INV-202502-PS-GL-0002,,False,False,REF-561402,First Continental Bank,***5966,Globex Consulting UK Ltd.,UK,-3653128.38
2025-02-26,2025-02-26,Client Receipt - Aurora Electronics GmbH #3,Sales Receipt,CEM-EMEA,0.0,6979.44,GBP,Faster Payments Credit,Aurora Electronics GmbH #3,***4060,INV-202502-CEM-EMEA-0003,,False,False,REF-445866,First Continental Bank,***3913,Globex Consulting UK Ltd.,UK,-3646148.94
2025-02-26,2025-02-26,Client Receipt - Novatek Components Ltd #9,Sales Receipt,CEM-EMEA,0.0,23565.84,GBP,CHAPS Credit,Novatek Components Ltd #9,***1501,INV-202502-CEM-EMEA-0013,,False,False,REF-617982,First Continental Bank,***2652,Globex Consulting UK Ltd.,UK,-3622583.1
2025-02-27,2025-02-27,Payroll - GlobalPay Services Ltd,Payroll,ALL,44132.21,0.0,GBP,Faster Payments,GlobalPay Services Ltd,***2761,,,False,False,REF-121125,First Continental Bank,***8558,Globex Consulting UK Ltd.,UK,-3666715.31
2025-02-27,2025-02-27,Client Receipt - CloudBridge Co. #25,Sales Receipt,SaaS-GL,0.0,881.99,GBP,Faster Payments Credit,CloudBridge Co. #25,***4040,INV-202502-SaaS-GL-0016,,False,False,REF-590193,First Continental Bank,***6406,Globex Consulting UK Ltd.,UK,-3665833.32
2025-02-27,2025-02-27,Client Receipt - CloudBridge Co. #17,Sales Receipt,SaaS-GL,0.0,4971.4,GBP,Faster Payments Credit,CloudBridge Co. #17,***2535,INV-202502-SaaS-GL-0023,,False,False,REF-252853,First Continental Bank,***8283,Globex Consulting UK Ltd.,UK,-3660861.92
2025-02-27,2025-02-27,Client Receipt - Vertex Advisory Client #1,Sales Receipt,PS-GL,0.0,6954.75,GBP,CHAPS Credit,Vertex Advisory Client #1,***3986,INV-202502-PS-GL-0007,,False,False,REF-532150,First Continental Bank,***6655,Globex Consulting UK Ltd.,UK,-3653907.17
2025-02-27,2025-02-27,Client Receipt - CloudBridge Co. #72,Sales Receipt,SaaS-GL,0.0,8102.5,GBP,Faster Payments Credit,CloudBridge Co. #72,***4767,INV-202502-SaaS-GL-0017,,False,False,REF-348296,First Continental Bank,***7234,Globex Consulting UK Ltd.,UK,-3645804.67
2025-02-28,2025-02-28,Supplier Payment - ExpertNet Subcontractors #1,Supplier Payment,PS-GL,164.96,0.0,GBP,CHAPS,ExpertNet Subcontractors #1,***5201,,PO-202502-PS-GL-0012,False,False,REF-607707,First Continental Bank,***5166,Globex Consulting UK Ltd.,UK,-3645969.63
2025-02-28,2025-02-28,Payroll - GlobalPay Services Ltd,Payroll,ALL,44132.21,0.0,GBP,CHAPS,GlobalPay Services Ltd,***3493,,,False,False,REF-692167,First Continental Bank,***3936,Globex Consulting UK Ltd.,UK,-3690101.84
2025-02-28,2025-02-28,Interest Earned,Interest Income,ALL,0.0,9717.95,GBP,CHAPS Credit,First Continental Bank,***3088,,,False,False,REF-249409,First Continental Bank,***4466,Globex Consulting UK Ltd.,UK,-3680383.89
2025-02-28,2025-02-28,Client Receipt - Novatek Components Ltd #1,Sales Receipt,CEM-EMEA,0.0,19990.82,GBP,Faster Payments Credit,Novatek Components Ltd #1,***7742,INV-202502-CEM-EMEA-0009,,False,False,REF-185370,First Continental Bank,***1476,Globex Consulting UK Ltd.,UK,-3660393.07
2025-03-01,2025-03-01,BluePeak Property Mgmt,Rent & Utilities,ALL,2061.69,0.0,GBP,CHAPS,BluePeak Property Mgmt,***6526,,,False,False,REF-358623,First Continental Bank,***5467,Globex Consulting UK Ltd.,UK,-3662454.76
2025-03-01,2025-03-01,Account Maintenance Fee,Bank/Merchant Fees,ALL,2500.0,0.0,GBP,Faster Payments,First Continental Bank,***6065,,,False,False,REF-505094,First Continental Bank,***4384,Globex Consulting UK Ltd.,UK,-3664954.76
2025-03-01,2025-03-01,Supplier Payment - HyperCloud Infra #18,Supplier Payment,SaaS-GL,7834.24,0.0,GBP,CHAPS,HyperCloud Infra #18,***2513,,PO-202503-SaaS-GL-0003,False,False,REF-498959,First Continental Bank,***4708,Globex Consulting UK Ltd.,UK,-3672789.0
2025-03-02,2025-03-02,Client Receipt - CloudBridge Co. #71,Sales Receipt,SaaS-GL,0.0,11741.11,GBP,CHAPS Credit,CloudBridge Co. #71,***8648,INV-202503-SaaS-GL-0024,,False,False,REF-848899,First Continental Bank,***4164,Globex Consulting UK Ltd.,UK,-3661047.89
2025-03-04,2025-03-04,Supplier Payment - HyperCloud Infra #11,Supplier Payment,SaaS-GL,2562.54,0.0,GBP,Faster Payments,HyperCloud Infra #11,***7873,,PO-202503-SaaS-GL-0002,False,False,REF-199694,First Continental Bank,***3851,Globex Consulting UK Ltd.,UK,-3663610.43
2025-03-04,2025-03-04,Supplier Payment - ExpertNet Subcontractors #11,Supplier Payment,PS-GL,3761.38,0.0,GBP,Faster Payments,ExpertNet Subcontractors #11,***2775,,PO-202503-PS-GL-0010,False,False,REF-130418,First Continental Bank,***9098,Globex Consulting UK Ltd.,UK,-3667371.81
2025-03-04,2025-03-04,Supplier Payment - ExpertNet Subcontractors #19,Supplier Payment,PS-GL,5920.53,0.0,GBP,CHAPS,ExpertNet Subcontractors #19,***1611,,PO-202503-PS-GL-0006,False,False,REF-965390,First Continental Bank,***1106,Globex Consulting UK Ltd.,UK,-3673292.34
2025-03-04,2025-03-04,Supplier Payment - EuroFab Assembly #11,Supplier Payment,CEM-EMEA,15451.41,0.0,GBP,CHAPS,EuroFab Assembly #11,***9352,,PO-202503-CEM-EMEA-0005,False,False,REF-112877,First Continental Bank,***7520,Globex Consulting UK Ltd.,UK,-3688743.75
2025-03-04,2025-03-04,Client Receipt - CloudBridge Co. #56,Sales Receipt,SaaS-GL,0.0,2465.57,GBP,CHAPS Credit,CloudBridge Co. #56,***2203,INV-202503-SaaS-GL-0004,,False,False,REF-487670,First Continental Bank,***9451,Globex Consulting UK Ltd.,UK,-3686278.18
2025-03-04,2025-03-04,Client Receipt - CloudBridge Co. #63,Sales Receipt,SaaS-GL,0.0,4768.6,GBP,Faster Payments Credit,CloudBridge Co. #63,***9918,INV-202503-SaaS-GL-0008,,False,False,REF-845512,First Continental Bank,***6391,Globex Consulting UK Ltd.,UK,-3681509.58
2025-03-04,2025-03-04,Client Receipt - CloudBridge Co. #79,Sales Receipt,SaaS-GL,0.0,6262.61,GBP,Faster Payments Credit,CloudBridge Co. #79,***2246,INV-202503-SaaS-GL-0022,,False,False,REF-958811,First Continental Bank,***6101,Globex Consulting UK Ltd.,UK,-3675246.97
2025-03-04,2025-03-04,Client Receipt - CloudBridge Co. #30,Sales Receipt,SaaS-GL,0.0,8687.99,GBP,Faster Payments Credit,CloudBridge Co. #30,***6065,INV-202503-SaaS-GL-0017,,False,False,REF-130767,First Continental Bank,***9944,Globex Consulting UK Ltd.,UK,-3666558.98
2025-03-05,2025-03-05,Merchant Processing Fees,Bank/Merchant Fees,ALL,1550.06,0.0,GBP,CHAPS,First Continental Bank,***4032,,,False,False,REF-771963,First Continental Bank,***4044,Globex Consulting UK Ltd.,UK,-3668109.04
2025-03-05,2025-03-05,Supplier Payment - ExpertNet Subcontractors #19,Supplier Payment,PS-GL,7089.76,0.0,GBP,Faster Payments,ExpertNet Subcontractors #19,***5575,,PO-202503-PS-GL-0002,False,False,REF-347797,First Continental Bank,***3871,Globex Consulting UK Ltd.,UK,-3675198.8
2025-03-05,2025-03-05,Client Receipt - Novatek Components Ltd #6,Sales Receipt,CEM-EMEA,0.0,24830.28,GBP,Faster Payments Credit,Novatek Components Ltd #6,***7576,INV-202503-CEM-EMEA-0002,,False,False,REF-906745,First Continental Bank,***1111,Globex Consulting UK Ltd.,UK,-3650368.52
2025-03-05,2025-03-05,Client Receipt - Vertex Advisory Client #1,Sales Receipt,PS-GL,0.0,34717.12,GBP,CHAPS Credit,Vertex Advisory Client #1,***6011,INV-202503-PS-GL-0006,,False,False,REF-954966,First Continental Bank,***6823,Globex Consulting UK Ltd.,UK,-3615651.4
2025-03-10,2025-03-10,Supplier Payment - Stelliform Parts BV #30,Supplier Payment,CEM-EMEA,6939.62,0.0,GBP,CHAPS,Stelliform Parts BV #30,***7324,,PO-202503-CEM-EMEA-0008,False,False,REF-574207,First Continental Bank,***5348,Globex Consulting UK Ltd.,UK,-3622591.02
2025-03-10,2025-03-10,Client Receipt - Novatek Components Ltd #11,Sales Receipt,CEM-EMEA,0.0,1613.91,GBP,CHAPS Credit,Novatek Components Ltd #11,***9494,INV-202503-CEM-EMEA-0008,,False,False,REF-828878,First Continental Bank,***8292,Globex Consulting UK Ltd.,UK,-3620977.11
2025-03-11,2025-03-11,Supplier Payment - CodeCraft Contractors #3,Supplier Payment,SaaS-GL,680.46,0.0,GBP,Faster Payments,CodeCraft Contractors #3,***3426,,PO-202503-SaaS-GL-0006,False,False,REF-717488,First Continental Bank,***4699,Globex Consulting UK Ltd.,UK,-3621657.57
2025-03-11,2025-03-11,Supplier Payment - ExpertNet Subcontractors #14,Supplier Payment,PS-GL,4835.39,0.0,GBP,CHAPS,ExpertNet Subcontractors #14,***8981,,PO-202503-PS-GL-0009,False,False,REF-832107,First Continental Bank,***2629,Globex Consulting UK Ltd.,UK,-3626492.96
2025-03-11,2025-03-11,Client Receipt - Aurora Electronics GmbH #13,Sales Receipt,CEM-EMEA,0.0,6000.02,GBP,Faster Payments Credit,Aurora Electronics GmbH #13,***8730,INV-202503-CEM-EMEA-0009,,False,False,REF-897597,First Continental Bank,***5846,Globex Consulting UK Ltd.,UK,-3620492.94
2025-03-11,2025-03-11,Client Receipt - Aurora Electronics GmbH #13,Sales Receipt,CEM-EMEA,0.0,9517.26,GBP,Faster Payments Credit,Aurora Electronics GmbH #13,***2850,INV-202503-CEM-EMEA-0007,,False,False,REF-195451,First Continental Bank,***3794,Globex Consulting UK Ltd.,UK,-3610975.68
2025-03-11,2025-03-11,Client Receipt - Novatek Components Ltd #10,Sales Receipt,CEM-EMEA,0.0,20910.78,GBP,CHAPS Credit,Novatek Components Ltd #10,***9037,INV-202503-CEM-EMEA-0003,,False,False,REF-868155,First Continental Bank,***4011,Globex Consulting UK Ltd.,UK,-3590064.9
2025-03-11,2025-03-11,Client Receipt - Vertex Advisory Client #38,Sales Receipt,PS-GL,0.0,33619.85,GBP,CHAPS Credit,Vertex Advisory Client #38,***7735,INV-202503-PS-GL-0001,,False,False,REF-140684,First Continental Bank,***8670,Globex Consulting UK Ltd.,UK,-3556445.05
2025-03-12,2025-03-12,Supplier Payment - ExpertNet Subcontractors #7,Supplier Payment,PS-GL,298.44,0.0,GBP,Faster Payments,ExpertNet Subcontractors #7,***6554,,PO-202503-PS-GL-0011,False,False,REF-462078,First Continental Bank,***5568,Globex Consulting UK Ltd.,UK,-3556743.49
2025-03-12,2025-03-12,Supplier Payment - ExpertNet Subcontractors #7,Supplier Payment,PS-GL,3045.84,0.0,GBP,Faster Payments,ExpertNet Subcontractors #7,***7915,,PO-202503-PS-GL-0007,False,False,REF-540599,First Continental Bank,***7967,Globex Consulting UK Ltd.,UK,-3559789.33
2025-03-12,2025-03-12,Supplier Payment - Stelliform Parts BV #22,Supplier Payment,CEM-EMEA,10645.72,0.0,GBP,Faster Payments,Stelliform Parts BV #22,***8476,,PO-202503-CEM-EMEA-0001,False,False,REF-101243,First Continental Bank,***9062,Globex Consulting UK Ltd.,UK,-3570435.05
2025-03-12,2025-03-12,"Intercompany Settlement - Globex International Holdings, Inc.",Intercompany Transfer,ALL,752662.0,0.0,GBP,Internal Transfer,"Globex International Holdings, Inc.",***2411,,,True,True,REF-333150,First Continental Bank,***1123,Globex Consulting UK Ltd.,UK,-4323097.05
2025-03-12,2025-03-12,Client Receipt - CloudBridge Co. #58,Sales Receipt,SaaS-GL,0.0,2890.04,GBP,CHAPS Credit,CloudBridge Co. #58,***9008,INV-202503-SaaS-GL-0002,,False,False,REF-699464,First Continental Bank,***3355,Globex Consulting UK Ltd.,UK,-4320207.01
2025-03-12,2025-03-12,Client Receipt - CloudBridge Co. #37,Sales Receipt,SaaS-GL,0.0,3271.44,GBP,CHAPS Credit,CloudBridge Co. #37,***9391,INV-202503-SaaS-GL-0006,,False,False,REF-224361,First Continental Bank,***7139,Globex Consulting UK Ltd.,UK,-4316935.57
2025-03-12,2025-03-12,Client Receipt - CloudBridge Co. #8,Sales Receipt,SaaS-GL,0.0,5411.3,GBP,Faster Payments Credit,CloudBridge Co. #8,***7917,INV-202503-SaaS-GL-0009,,False,False,REF-936440,First Continental Bank,***8571,Globex Consulting UK Ltd.,UK,-4311524.27
2025-03-12,2025-03-12,Client Receipt - Vertex Advisory Client #4,Sales Receipt,PS-GL,0.0,5792.87,GBP,Faster Payments Credit,Vertex Advisory Client #4,***7263,INV-202503-PS-GL-0004,,False,False,REF-472098,First Continental Bank,***3517,Globex Consulting UK Ltd.,UK,-4305731.4
2025-03-12,2025-03-12,Client Receipt - CloudBridge Co. #47,Sales Receipt,SaaS-GL,0.0,17755.53,GBP,Faster Payments Credit,CloudBridge Co. #47,***8984,INV-202503-SaaS-GL-0003,,False,False,REF-732714,First Continental Bank,***8739,Globex Consulting UK Ltd.,UK,-4287975.87
2025-03-13,2025-03-13,Supplier Payment - ExpertNet Subcontractors #17,Supplier Payment,PS-GL,2076.43,0.0,GBP,Faster Payments,ExpertNet Subcontractors #17,***7004,,PO-202503-PS-GL-0008,False,False,REF-638022,First Continental Bank,***4055,Globex Consulting UK Ltd.,UK,-4290052.3
2025-03-13,2025-03-13,Supplier Payment - EuroFab Assembly #24,Supplier Payment,CEM-EMEA,21305.27,0.0,GBP,Faster Payments,EuroFab Assembly #24,***6253,,PO-202503-CEM-EMEA-0003,False,False,REF-292236,First Continental Bank,***9261,Globex Consulting UK Ltd.,UK,-4311357.57
2025-03-13,2025-03-13,Client Receipt - Vertex Advisory Client #59,Sales Receipt,PS-GL,0.0,4312.37,GBP,CHAPS Credit,Vertex Advisory Client #59,***7899,INV-202503-PS-GL-0008,,False,False,REF-193020,First Continental Bank,***7874,Globex Consulting UK Ltd.,UK,-4307045.2
2025-03-13,2025-03-13,Client Receipt - CloudBridge Co. #68,Sales Receipt,SaaS-GL,0.0,5730.11,GBP,Faster Payments Credit,CloudBridge Co. #68,***6831,INV-202503-SaaS-GL-0014,,False,False,REF-333000,First Continental Bank,***2889,Globex Consulting UK Ltd.,UK,-4301315.09
2025-03-13,2025-03-13,Client Receipt - Aurora Electronics GmbH #15,Sales Receipt,CEM-EMEA,0.0,6012.65,GBP,Faster Payments Credit,Aurora Electronics GmbH #15,***4382,INV-202503-CEM-EMEA-0016,,False,False,REF-472307,First Continental Bank,***5597,Globex Consulting UK Ltd.,UK,-4295302.44
2025-03-13,2025-03-13,Client Receipt - CloudBridge Co. #69,Sales Receipt,SaaS-GL,0.0,7015.26,GBP,CHAPS Credit,CloudBridge Co. #69,***6910,INV-202503-SaaS-GL-0027,,False,False,REF-495032,First Continental Bank,***9411,Globex Consulting UK Ltd.,UK,-4288287.18
2025-03-13,2025-03-13,Client Receipt - CloudBridge Co. #14,Sales Receipt,SaaS-GL,0.0,8446.29,GBP,Faster Payments Credit,CloudBridge Co. #14,***7223,INV-202503-SaaS-GL-0023,,False,False,REF-923870,First Continental Bank,***8741,Globex Consulting UK Ltd.,UK,-4279840.89
2025-03-14,2025-03-14,Client Receipt - Novatek Components Ltd #7,Sales Receipt,CEM-EMEA,0.0,2621.74,GBP,Faster Payments Credit,Novatek Components Ltd #7,***7823,INV-202503-CEM-EMEA-0012,,False,False,REF-684323,First Continental Bank,***9238,Globex Consulting UK Ltd.,UK,-4277219.15
2025-03-14,2025-03-14,Client Receipt - Vertex Advisory Client #2,Sales Receipt,PS-GL,0.0,5992.21,GBP,Faster Payments Credit,Vertex Advisory Client #2,***3011,INV-202503-PS-GL-0005,,False,False,REF-177724,First Continental Bank,***7183,Globex Consulting UK Ltd.,UK,-4271226.94
2025-03-14,2025-03-14,Client Receipt - CloudBridge Co. #63,Sales Receipt,SaaS-GL,0.0,8394.91,GBP,Faster Payments Credit,CloudBridge Co. #63,***1290,INV-202503-SaaS-GL-0001,,False,False,REF-772508,First Continental Bank,***5369,Globex Consulting UK Ltd.,UK,-4262832.03
2025-03-14,2025-03-14,Client Receipt - CloudBridge Co. #51,Sales Receipt,SaaS-GL,0.0,8806.38,GBP,CHAPS Credit,CloudBridge Co. #51,***6201,INV-202503-SaaS-GL-0007,,False,False,REF-932103,First Continental Bank,***1803,Globex Consulting UK Ltd.,UK,-4254025.65
2025-03-15,2025-03-15,Marketing - Beacon Digital #1,Marketing,ALL,990.31,0.0,GBP,CHAPS,Beacon Digital #1,***2440,,,False,False,REF-613636,First Continental Bank,***2214,Globex Consulting UK Ltd.,UK,-4255015.96
2025-03-16,2025-03-16,Client Receipt - Aurora Electronics GmbH #9,Sales Receipt,CEM-EMEA,0.0,3779.76,GBP,CHAPS Credit,Aurora Electronics GmbH #9,***2076,INV-202503-CEM-EMEA-0004,,False,False,REF-386553,First Continental Bank,***4448,Globex Consulting UK Ltd.,UK,-4251236.2
2025-03-17,2025-03-17,Merchant Processing Fees,Bank/Merchant Fees,ALL,281.1,0.0,GBP,CHAPS,First Continental Bank,***6510,,,False,False,REF-504494,First Continental Bank,***4817,Globex Consulting UK Ltd.,UK,-4251517.3
2025-03-17,2025-03-17,Supplier Payment - Stelliform Parts BV #10,Supplier Payment,CEM-EMEA,55052.63,0.0,GBP,CHAPS,Stelliform Parts BV #10,***4421,,PO-202503-CEM-EMEA-0007,False,False,REF-737579,First Continental Bank,***8254,Globex Consulting UK Ltd.,UK,-4306569.93
2025-03-17,2025-03-17,Client Receipt - CloudBridge Co. #3,Sales Receipt,SaaS-GL,0.0,3770.62,GBP,CHAPS Credit,CloudBridge Co. #3,***4810,INV-202503-SaaS-GL-0012,,False,False,REF-920604,First Continental Bank,***6392,Globex Consulting UK Ltd.,UK,-4302799.31
2025-03-18,2025-03-18,Supplier Payment - ExpertNet Subcontractors #13,Supplier Payment,PS-GL,1293.88,0.0,GBP,Faster Payments,ExpertNet Subcontractors #13,***2170,,PO-202503-PS-GL-0001,False,False,REF-731469,First Continental Bank,***1869,Globex Consulting UK Ltd.,UK,-4304093.19
2025-03-18,2025-03-18,Supplier Payment - CodeCraft Contractors #11,Supplier Payment,SaaS-GL,4872.96,0.0,GBP,Faster Payments,CodeCraft Contractors #11,***1960,,PO-202503-SaaS-GL-0008,False,False,REF-671664,First Continental Bank,***7385,Globex Consulting UK Ltd.,UK,-4308966.15
2025-03-18,2025-03-18,Marketing - Aurelia Media #1,Marketing,ALL,12324.79,0.0,GBP,Faster Payments,Aurelia Media #1,***7011,,,False,False,REF-498208,First Continental Bank,***6516,Globex Consulting UK Ltd.,UK,-4321290.94
2025-03-18,2025-03-18,Client Receipt - CloudBridge Co. #60,Sales Receipt,SaaS-GL,0.0,12338.28,GBP,CHAPS Credit,CloudBridge Co. #60,***3545,INV-202503-SaaS-GL-0015,,False,False,REF-766215,First Continental Bank,***9233,Globex Consulting UK Ltd.,UK,-4308952.66
2025-03-19,2025-03-19,Supplier Payment - ExpertNet Subcontractors #6,Supplier Payment,PS-GL,1226.05,0.0,GBP,Faster Payments,ExpertNet Subcontractors #6,***2223,,PO-202503-PS-GL-0012,False,False,REF-458968,First Continental Bank,***8043,Globex Consulting UK Ltd.,UK,-4310178.71
2025-03-19,2025-03-19,Supplier Payment - CodeCraft Contractors #9,Supplier Payment,SaaS-GL,2015.09,0.0,GBP,CHAPS,CodeCraft Contractors #9,***8140,,PO-202503-SaaS-GL-0007,False,False,REF-651371,First Continental Bank,***3662,Globex Consulting UK Ltd.,UK,-4312193.8
2025-03-19,2025-03-19,Client Receipt - CloudBridge Co. #65,Sales Receipt,SaaS-GL,0.0,3269.9,GBP,CHAPS Credit,CloudBridge Co. #65,***9847,INV-202503-SaaS-GL-0013,,False,False,REF-734427,First Continental Bank,***2814,Globex Consulting UK Ltd.,UK,-4308923.9
2025-03-19,2025-03-19,Client Receipt - CloudBridge Co. #34,Sales Receipt,SaaS-GL,0.0,8214.55,GBP,CHAPS Credit,CloudBridge Co. #34,***2343,INV-202503-SaaS-GL-0025,,False,False,REF-447606,First Continental Bank,***5406,Globex Consulting UK Ltd.,UK,-4300709.35
2025-03-20,2025-03-20,Supplier Payment - EuroFab Assembly #3,Supplier Payment,CEM-EMEA,5231.2,0.0,GBP,CHAPS,EuroFab Assembly #3,***9849,,PO-202503-CEM-EMEA-0006,False,False,REF-138959,First Continental Bank,***9632,Globex Consulting UK Ltd.,UK,-4305940.55
2025-03-20,2025-03-20,VAT/GST Remittance - HMRC UK,Tax Payment,ALL,36598.11,0.0,GBP,SWIFT MT103,HMRC UK,***5050,,,False,False,REF-712914,First Continental Bank,***5663,Globex Consulting UK Ltd.,UK,-4342538.66
2025-03-20,2025-03-20,Client Receipt - Aurora Electronics GmbH #13,Sales Receipt,CEM-EMEA,0.0,4537.15,GBP,CHAPS Credit,Aurora Electronics GmbH #13,***3046,INV-202503-CEM-EMEA-0005,,False,False,REF-884879,First Continental Bank,***1990,Globex Consulting UK Ltd.,UK,-4338001.51
2025-03-20,2025-03-20,Client Receipt - CloudBridge Co. #51,Sales Receipt,SaaS-GL,0.0,4761.07,GBP,CHAPS Credit,CloudBridge Co. #51,***8149,INV-202503-SaaS-GL-0021,,False,False,REF-132119,First Continental Bank,***9872,Globex Consulting UK Ltd.,UK,-4333240.44
2025-03-21,2025-03-21,Supplier Payment - HyperCloud Infra #1,Supplier Payment,SaaS-GL,15489.84,0.0,GBP,Faster Payments,HyperCloud Infra #1,***7614,,PO-202503-SaaS-GL-0001,False,False,REF-762992,First Continental Bank,***2914,Globex Consulting UK Ltd.,UK,-4348730.28
2025-03-21,2025-03-21,Client Receipt - Vertex Advisory Client #9,Sales Receipt,PS-GL,0.0,18138.94,GBP,CHAPS Credit,Vertex Advisory Client #9,***1407,INV-202503-PS-GL-0003,,False,False,REF-858914,First Continental Bank,***1289,Globex Consulting UK Ltd.,UK,-4330591.34
2025-03-21,2025-03-21,Client Receipt - Aurora Electronics GmbH #10,Sales Receipt,CEM-EMEA,0.0,67059.12,GBP,Faster Payments Credit,Aurora Electronics GmbH #10,***9323,INV-202503-CEM-EMEA-0006,,False,False,REF-934758,First Continental Bank,***6543,Globex Consulting UK Ltd.,UK,-4263532.22
2025-03-22,2025-03-22,Client Receipt - CloudBridge Co. #4,Sales Receipt,SaaS-GL,0.0,4130.72,GBP,CHAPS Credit,CloudBridge Co. #4,***6795,INV-202503-SaaS-GL-0026,,False,False,REF-481723,First Continental Bank,***5104,Globex Consulting UK Ltd.,UK,-4259401.5
2025-03-22,2025-03-22,Client Receipt - CloudBridge Co. #37,Sales Receipt,SaaS-GL,0.0,4751.21,GBP,CHAPS Credit,CloudBridge Co. #37,***4286,INV-202503-SaaS-GL-0028,,False,False,REF-265639,First Continental Bank,***3359,Globex Consulting UK Ltd.,UK,-4254650.29
2025-03-23,2025-03-23,Supplier Payment - HyperCloud Infra #15,Supplier Payment,SaaS-GL,1516.02,0.0,GBP,Faster Payments,HyperCloud Infra #15,***1125,,PO-202503-SaaS-GL-0004,False,False,REF-135456,First Continental Bank,***5481,Globex Consulting UK Ltd.,UK,-4256166.31
2025-03-23,2025-03-23,Client Receipt - Aurora Electronics GmbH #12,Sales Receipt,CEM-EMEA,0.0,6571.17,GBP,Faster Payments Credit,Aurora Electronics GmbH #12,***2641,INV-202503-CEM-EMEA-0015,,False,False,REF-833009,First Continental Bank,***2087,Globex Consulting UK Ltd.,UK,-4249595.14
2025-03-23,2025-03-23,Client Receipt - Novatek Components Ltd #13,Sales Receipt,CEM-EMEA,0.0,35745.65,GBP,CHAPS Credit,Novatek Components Ltd #13,***7291,INV-202503-CEM-EMEA-0011,,False,False,REF-556515,First Continental Bank,***3880,Globex Consulting UK Ltd.,UK,-4213849.49
2025-03-24,2025-03-24,Marketing - Beacon Digital #9,Marketing,ALL,1931.71,0.0,GBP,Faster Payments,Beacon Digital #9,***3999,,,False,False,REF-172952,First Continental Bank,***7232,Globex Consulting UK Ltd.,UK,-4215781.2
2025-03-24,2025-03-24,Client Receipt - CloudBridge Co. #27,Sales Receipt,SaaS-GL,0.0,295.3,GBP,Faster Payments Credit,CloudBridge Co. #27,***3079,INV-202503-SaaS-GL-0019,,False,False,REF-215325,First Continental Bank,***7473,Globex Consulting UK Ltd.,UK,-4215485.9
2025-03-24,2025-03-24,Client Receipt - Vertex Advisory Client #37,Sales Receipt,PS-GL,0.0,8928.92,GBP,Faster Payments Credit,Vertex Advisory Client #37,***1386,INV-202503-PS-GL-0007,,False,False,REF-236189,First Continental Bank,***3050,Globex Consulting UK Ltd.,UK,-4206556.98
2025-03-24,2025-03-24,Client Receipt - CloudBridge Co. #57,Sales Receipt,SaaS-GL,0.0,15760.75,GBP,Faster Payments Credit,CloudBridge Co. #57,***9831,INV-202503-SaaS-GL-0018,,False,False,REF-438549,First Continental Bank,***6083,Globex Consulting UK Ltd.,UK,-4190796.23
2025-03-25,2025-03-25,Supplier Payment - HyperCloud Infra #9,Supplier Payment,SaaS-GL,525.97,0.0,GBP,CHAPS,HyperCloud Infra #9,***7138,,PO-202503-SaaS-GL-0005,False,False,REF-760640,First Continental Bank,***7766,Globex Consulting UK Ltd.,UK,-4191322.2
2025-03-25,2025-03-25,Supplier Payment - ExpertNet Subcontractors #16,Supplier Payment,PS-GL,4828.56,0.0,GBP,CHAPS,ExpertNet Subcontractors #16,***9285,,PO-202503-PS-GL-0003,False,False,REF-506261,First Continental Bank,***5761,Globex Consulting UK Ltd.,UK,-4196150.76
2025-03-25,2025-03-25,Client Receipt - CloudBridge Co. #22,Sales Receipt,SaaS-GL,0.0,8980.39,GBP,Faster Payments Credit,CloudBridge Co. #22,***5047,INV-202503-SaaS-GL-0011,,False,False,REF-530014,First Continental Bank,***6846,Globex Consulting UK Ltd.,UK,-4187170.37
2025-03-26,2025-03-26,Supplier Payment - ExpertNet Subcontractors #13,Supplier Payment,PS-GL,1190.94,0.0,GBP,CHAPS,ExpertNet Subcontractors #13,***6271,,PO-202503-PS-GL-0005,False,False,REF-848315,First Continental Bank,***2197,Globex Consulting UK Ltd.,UK,-4188361.31
2025-03-26,2025-03-26,Supplier Payment - ExpertNet Subcontractors #13,Supplier Payment,PS-GL,2784.36,0.0,GBP,Faster Payments,ExpertNet Subcontractors #13,***7318,,PO-202503-PS-GL-0004,False,False,REF-830622,First Continental Bank,***5513,Globex Consulting UK Ltd.,UK,-4191145.67
2025-03-26,2025-03-26,Supplier Payment - HyperCloud Infra #11,Supplier Payment,SaaS-GL,5219.09,0.0,GBP,Faster Payments,HyperCloud Infra #11,***6832,,PO-202503-SaaS-GL-0009,False,False,REF-653503,First Continental Bank,***3650,Globex Consulting UK Ltd.,UK,-4196364.76
2025-03-26,2025-03-26,Payroll - GlobalPay Services Ltd,Payroll,ALL,49494.7,0.0,GBP,CHAPS,GlobalPay Services Ltd,***9691,,,False,False,REF-457816,First Continental Bank,***5845,Globex Consulting UK Ltd.,UK,-4245859.46
2025-03-26,2025-03-26,Intercompany Settlement - Globex Retail NA LLC,Intercompany Transfer,ALL,608722.0,0.0,GBP,Internal Transfer,Globex Retail NA LLC,***5517,,,True,True,REF-709798,First Continental Bank,***8301,Globex Consulting UK Ltd.,UK,-4854581.46
2025-03-26,2025-03-26,Client Receipt - Aurora Electronics GmbH #2,Sales Receipt,CEM-EMEA,0.0,4840.16,GBP,CHAPS Credit,Aurora Electronics GmbH #2,***4655,INV-202503-CEM-EMEA-0014,,False,False,REF-286803,First Continental Bank,***9379,Globex Consulting UK Ltd.,UK,-4849741.3
2025-03-26,2025-03-26,Client Receipt - CloudBridge Co. #16,Sales Receipt,SaaS-GL,0.0,6533.4,GBP,Faster Payments Credit,CloudBridge Co. #16,***8114,INV-202503-SaaS-GL-0010,,False,False,REF-236196,First Continental Bank,***5715,Globex Consulting UK Ltd.,UK,-4843207.9
2025-03-26,2025-03-26,Client Receipt - Novatek Components Ltd #10,Sales Receipt,CEM-EMEA,0.0,62408.0,GBP,Faster Payments Credit,Novatek Components Ltd #10,***5875,INV-202503-CEM-EMEA-0001,,False,False,REF-581861,First Continental Bank,***7189,Globex Consulting UK Ltd.,UK,-4780799.9
2025-03-27,2025-03-27,Supplier Payment - HyperCloud Infra #4,Supplier Payment,SaaS-GL,1470.5,0.0,GBP,Faster Payments,HyperCloud Infra #4,***9800,,PO-202503-SaaS-GL-0010,False,False,REF-667575,First Continental Bank,***5122,Globex Consulting UK Ltd.,UK,-4782270.4
2025-03-27,2025-03-27,Supplier Payment - EuroFab Assembly #9,Supplier Payment,CEM-EMEA,39254.81,0.0,GBP,CHAPS,EuroFab Assembly #9,***8395,,PO-202503-CEM-EMEA-0004,False,False,REF-519410,First Continental Bank,***1596,Globex Consulting UK Ltd.,UK,-4821525.21
2025-03-27,2025-03-27,Client Receipt - CloudBridge Co. #20,Sales Receipt,SaaS-GL,0.0,2921.33,GBP,CHAPS Credit,CloudBridge Co. #20,***3705,INV-202503-SaaS-GL-0005,,False,False,REF-311482,First Continental Bank,***7210,Globex Consulting UK Ltd.,UK,-4818603.88
2025-03-27,2025-03-27,Client Receipt - CloudBridge Co. #23,Sales Receipt,SaaS-GL,0.0,11131.1,GBP,Faster Payments Credit,CloudBridge Co. #23,***6254,INV-202503-SaaS-GL-0016,,False,False,REF-716156,First Continental Bank,***2042,Globex Consulting UK Ltd.,UK,-4807472.78
2025-03-27,2025-03-27,Client Receipt - Vertex Advisory Client #29,Sales Receipt,PS-GL,0.0,16336.24,GBP,Faster Payments Credit,Vertex Advisory Client #29,***2483,INV-202503-PS-GL-0002,,False,False,REF-187193,First Continental Bank,***6514,Globex Consulting UK Ltd.,UK,-4791136.54
2025-03-27,2025-03-27,Client Receipt - Aurora Electronics GmbH #17,Sales Receipt,CEM-EMEA,0.0,34676.27,GBP,Faster Payments Credit,Aurora Electronics GmbH #17,***2646,INV-202503-CEM-EMEA-0010,,False,False,REF-480254,First Continental Bank,***4091,Globex Consulting UK Ltd.,UK,-4756460.27
2025-03-28,2025-03-28,Client Receipt - Novatek Components Ltd #3,Sales Receipt,CEM-EMEA,0.0,7165.96,GBP,CHAPS Credit,Novatek Components Ltd #3,***8950,INV-202503-CEM-EMEA-0013,,False,False,REF-712998,First Continental Bank,***2873,Globex Consulting UK Ltd.,UK,-4749294.31
2025-03-29,2025-03-29,Alphagrid Utilities,Rent & Utilities,ALL,2935.5,0.0,GBP,Faster Payments,Alphagrid Utilities,***4498,,,False,False,REF-760381,First Continental Bank,***2271,Globex Consulting UK Ltd.,UK,-4752229.81
2025-03-29,2025-03-29,Payroll - GlobalPay Services Ltd,Payroll,ALL,49494.7,0.0,GBP,CHAPS,GlobalPay Services Ltd,***5854,,,False,False,REF-828131,First Continental Bank,***9277,Globex Consulting UK Ltd.,UK,-4801724.51
2025-03-30,2025-03-30,Client Receipt - CloudBridge Co. #71,Sales Receipt,SaaS-GL,0.0,3252.02,GBP,CHAPS Credit,CloudBridge Co. #71,***1476,INV-202503-SaaS-GL-0020,,False,False,REF-345434,First Continental Bank,***8637,Globex Consulting UK Ltd.,UK,-4798472.49
2025-03-30,2025-03-30,Interest Earned,Interest Income,ALL,0.0,10435.65,GBP,Faster Payments Credit,First Continental Bank,***6306,,,False,False,REF-394927,First Continental Bank,***8123,Globex Consulting UK Ltd.,UK,-4788036.84
2025-03-31,2025-03-31,Supplier Payment - Stelliform Parts BV #5,Supplier Payment,CEM-EMEA,25093.27,0.0,GBP,Faster Payments,Stelliform Parts BV #5,***6630,,PO-202503-CEM-EMEA-0002,False,False,REF-753094,First Continental Bank,***8618,Globex Consulting UK Ltd.,UK,-4813130.11
2025-04-01,2025-04-01,Account Maintenance Fee,Bank/Merchant Fees,ALL,2500.0,0.0,GBP,Faster Payments,First Continental Bank,***9769,,,False,False,REF-160123,First Continental Bank,***8065,Globex Consulting UK Ltd.,UK,-4815630.11
2025-04-01,2025-04-01,Supplier Payment - Stelliform Parts BV #28,Supplier Payment,CEM-EMEA,4307.09,0.0,GBP,CHAPS,Stelliform Parts BV #28,***2540,,PO-202504-CEM-EMEA-0005,False,False,REF-154714,First Continental Bank,***8259,Globex Consulting UK Ltd.,UK,-4819937.2
2025-04-01,2025-04-01,Client Receipt - Vertex Advisory Client #22,Sales Receipt,PS-GL,0.0,1549.22,GBP,Faster Payments Credit,Vertex Advisory Client #22,***4433,INV-202504-PS-GL-0006,,False,False,REF-880209,First Continental Bank,***3123,Globex Consulting UK Ltd.,UK,-4818387.98
2025-04-01,2025-04-01,Client Receipt - CloudBridge Co. #66,Sales Receipt,SaaS-GL,0.0,8477.89,GBP,Faster Payments Credit,CloudBridge Co. #66,***7578,INV-202504-SaaS-GL-0019,,False,False,REF-575122,First Continental Bank,***4451,Globex Consulting UK Ltd.,UK,-4809910.09
2025-04-01,2025-04-01,Client Receipt - CloudBridge Co. #18,Sales Receipt,SaaS-GL,0.0,11193.2,GBP,Faster Payments Credit,CloudBridge Co. #18,***5683,INV-202504-SaaS-GL-0021,,False,False,REF-192461,First Continental Bank,***4836,Globex Consulting UK Ltd.,UK,-4798716.89
2025-04-01,2025-04-01,Client Receipt - CloudBridge Co. #11,Sales Receipt,SaaS-GL,0.0,21755.31,GBP,CHAPS Credit,CloudBridge Co. #11,***7855,INV-202504-SaaS-GL-0023,,False,False,REF-666387,First Continental Bank,***3076,Globex Consulting UK Ltd.,UK,-4776961.58
2025-04-02,2025-04-02,Supplier Payment - ExpertNet Subcontractors #17,Supplier Payment,PS-GL,2456.59,0.0,GBP,Faster Payments,ExpertNet Subcontractors #17,***8063,,PO-202504-PS-GL-0007,False,False,REF-326854,First Continental Bank,***8018,Globex Consulting UK Ltd.,UK,-4779418.17
2025-04-02,2025-04-02,Supplier Payment - ExpertNet Subcontractors #19,Supplier Payment,PS-GL,2981.8,0.0,GBP,Faster Payments,ExpertNet Subcontractors #19,***1829,,PO-202504-PS-GL-0002,False,False,REF-349724,First Continental Bank,***7398,Globex Consulting UK Ltd.,UK,-4782399.97
2025-04-02,2025-04-02,Supplier Payment - Stelliform Parts BV #24,Supplier Payment,CEM-EMEA,3610.34,0.0,GBP,CHAPS,Stelliform Parts BV #24,***5817,,PO-202504-CEM-EMEA-0007,False,False,REF-841395,First Continental Bank,***1167,Globex Consulting UK Ltd.,UK,-4786010.31
2025-04-02,2025-04-02,Client Receipt - CloudBridge Co. #58,Sales Receipt,SaaS-GL,0.0,3649.6,GBP,CHAPS Credit,CloudBridge Co. #58,***7419,INV-202504-SaaS-GL-0002,,False,False,REF-447325,First Continental Bank,***4122,Globex Consulting UK Ltd.,UK,-4782360.71
2025-04-02,2025-04-02,Client Receipt - CloudBridge Co. #54,Sales Receipt,SaaS-GL,0.0,10492.27,GBP,CHAPS Credit,CloudBridge Co. #54,***9206,INV-202504-SaaS-GL-0014,,False,False,REF-769102,First Continental Bank,***5327,Globex Consulting UK Ltd.,UK,-4771868.44
2025-04-02,2025-04-02,Client Receipt - Novatek Components Ltd #7,Sales Receipt,CEM-EMEA,0.0,38082.92,GBP,Faster Payments Credit,Novatek Components Ltd #7,***2661,INV-202504-CEM-EMEA-0005,,False,False,REF-439493,First Continental Bank,***4164,Globex Consulting UK Ltd.,UK,-4733785.52
2025-04-03,2025-04-03,Supplier Payment - ExpertNet Subcontractors #17,Supplier Payment,PS-GL,2449.43,0.0,GBP,CHAPS,ExpertNet Subcontractors #17,***2740,,PO-202504-PS-GL-0003,False,False,REF-631962,First Continental Bank,***3807,Globex Consulting UK Ltd.,UK,-4736234.95
2025-04-03,2025-04-03,Supplier Payment - CodeCraft Contractors #4,Supplier Payment,SaaS-GL,6448.19,0.0,GBP,Faster Payments,CodeCraft Contractors #4,***7370,,PO-202504-SaaS-GL-0004,False,False,REF-487949,First Continental Bank,***7598,Globex Consulting UK Ltd.,UK,-4742683.14
2025-04-03,2025-04-03,Client Receipt - Novatek Components Ltd #14,Sales Receipt,CEM-EMEA,0.0,1867.13,GBP,CHAPS Credit,Novatek Components Ltd #14,***6481,INV-202504-CEM-EMEA-0012,,False,False,REF-775667,First Continental Bank,***1367,Globex Consulting UK Ltd.,UK,-4740816.01
2025-04-03,2025-04-03,Client Receipt - Aurora Electronics GmbH #18,Sales Receipt,CEM-EMEA,0.0,2319.59,GBP,CHAPS Credit,Aurora Electronics GmbH #18,***1546,INV-202504-CEM-EMEA-0008,,False,False,REF-859411,First Continental Bank,***1125,Globex Consulting UK Ltd.,UK,-4738496.42
2025-04-03,2025-04-03,Client Receipt - CloudBridge Co. #71,Sales Receipt,SaaS-GL,0.0,4819.07,GBP,Faster Payments Credit,CloudBridge Co. #71,***8232,INV-202504-SaaS-GL-0015,,False,False,REF-434162,First Continental Bank,***2301,Globex Consulting UK Ltd.,UK,-4733677.35
2025-04-03,2025-04-03,Client Receipt - CloudBridge Co. #2,Sales Receipt,SaaS-GL,0.0,15454.34,GBP,Faster Payments Credit,CloudBridge Co. #2,***4912,INV-202504-SaaS-GL-0020,,False,False,REF-382763,First Continental Bank,***3955,Globex Consulting UK Ltd.,UK,-4718223.01
2025-04-03,2025-04-03,Client Receipt - Vertex Advisory Client #48,Sales Receipt,PS-GL,0.0,27013.93,GBP,CHAPS Credit,Vertex Advisory Client #48,***9891,INV-202504-PS-GL-0009,,False,False,REF-293875,First Continental Bank,***3446,Globex Consulting UK Ltd.,UK,-4691209.08
2025-04-04,2025-04-04,Client Receipt - Aurora Electronics GmbH #9,Sales Receipt,CEM-EMEA,0.0,21766.63,GBP,CHAPS Credit,Aurora Electronics GmbH #9,***3895,INV-202504-CEM-EMEA-0003,,False,False,REF-693865,First Continental Bank,***6752,Globex Consulting UK Ltd.,UK,-4669442.45
2025-04-04,2025-04-04,Client Receipt - Aurora Electronics GmbH #12,Sales Receipt,CEM-EMEA,0.0,32116.09,GBP,CHAPS Credit,Aurora Electronics GmbH #12,***1449,INV-202504-CEM-EMEA-0013,,False,False,REF-582913,First Continental Bank,***4657,Globex Consulting UK Ltd.,UK,-4637326.36
2025-04-05,2025-04-05,Client Receipt - CloudBridge Co. #44,Sales Receipt,SaaS-GL,0.0,4714.33,GBP,Faster Payments Credit,CloudBridge Co. #44,***5970,INV-202504-SaaS-GL-0003,,False,False,REF-409723,First Continental Bank,***4143,Globex Consulting UK Ltd.,UK,-4632612.03
2025-04-06,2025-04-06,Supplier Payment - ExpertNet Subcontractors #4,Supplier Payment,PS-GL,2266.61,0.0,GBP,CHAPS,ExpertNet Subcontractors #4,***4195,,PO-202504-PS-GL-0006,False,False,REF-810645,First Continental Bank,***1613,Globex Consulting UK Ltd.,UK,-4634878.64
2025-04-07,2025-04-07,Supplier Payment - ExpertNet Subcontractors #4,Supplier Payment,PS-GL,2822.16,0.0,GBP,CHAPS,ExpertNet Subcontractors #4,***8600,,PO-202504-PS-GL-0009,False,False,REF-118578,First Continental Bank,***1151,Globex Consulting UK Ltd.,UK,-4637700.8
2025-04-07,2025-04-07,Client Receipt - Vertex Advisory Client #14,Sales Receipt,PS-GL,0.0,2412.34,GBP,CHAPS Credit,Vertex Advisory Client #14,***7119,INV-202504-PS-GL-0002,,False,False,REF-114908,First Continental Bank,***4490,Globex Consulting UK Ltd.,UK,-4635288.46
2025-04-07,2025-04-07,Client Receipt - Novatek Components Ltd #6,Sales Receipt,CEM-EMEA,0.0,20449.1,GBP,Faster Payments Credit,Novatek Components Ltd #6,***9413,INV-202504-CEM-EMEA-0009,,False,False,REF-102850,First Continental Bank,***3961,Globex Consulting UK Ltd.,UK,-4614839.36
2025-04-07,2025-04-07,Client Receipt - Vertex Advisory Client #3,Sales Receipt,PS-GL,0.0,57554.0,GBP,Faster Payments Credit,Vertex Advisory Client #3,***4094,INV-202504-PS-GL-0008,,False,False,REF-594872,First Continental Bank,***6280,Globex Consulting UK Ltd.,UK,-4557285.36
2025-04-08,2025-04-08,Supplier Payment - HyperCloud Infra #10,Supplier Payment,SaaS-GL,5601.29,0.0,GBP,Faster Payments,HyperCloud Infra #10,***5346,,PO-202504-SaaS-GL-0009,False,False,REF-516284,First Continental Bank,***9190,Globex Consulting UK Ltd.,UK,-4562886.65
2025-04-08,2025-04-08,Client Receipt - Novatek Components Ltd #14,Sales Receipt,CEM-EMEA,0.0,6285.24,GBP,Faster Payments Credit,Novatek Components Ltd #14,***9223,INV-202504-CEM-EMEA-0007,,False,False,REF-131081,First Continental Bank,***3326,Globex Consulting UK Ltd.,UK,-4556601.41
2025-04-09,2025-04-09,Merchant Processing Fees,Bank/Merchant Fees,ALL,794.13,0.0,GBP,CHAPS,First Continental Bank,***3893,,,False,False,REF-455659,First Continental Bank,***4928,Globex Consulting UK Ltd.,UK,-4557395.54
2025-04-09,2025-04-09,Supplier Payment - ExpertNet Subcontractors #10,Supplier Payment,PS-GL,4440.59,0.0,GBP,CHAPS,ExpertNet Subcontractors #10,***3144,,PO-202504-PS-GL-0008,False,False,REF-626022,First Continental Bank,***8758,Globex Consulting UK Ltd.,UK,-4561836.13
2025-04-09,2025-04-09,Supplier Payment - EuroFab Assembly #4,Supplier Payment,CEM-EMEA,10420.88,0.0,GBP,Faster Payments,EuroFab Assembly #4,***8212,,PO-202504-CEM-EMEA-0009,False,False,REF-623342,First Continental Bank,***7366,Globex Consulting UK Ltd.,UK,-4572257.01
2025-04-09,2025-04-09,Supplier Payment - Stelliform Parts BV #10,Supplier Payment,CEM-EMEA,17846.31,0.0,GBP,Faster Payments,Stelliform Parts BV #10,***3914,,PO-202504-CEM-EMEA-0010,False,False,REF-688770,First Continental Bank,***1450,Globex Consulting UK Ltd.,UK,-4590103.32
2025-04-09,2025-04-09,Client Receipt - Vertex Advisory Client #35,Sales Receipt,PS-GL,0.0,2726.85,GBP,Faster Payments Credit,Vertex Advisory Client #35,***2926,INV-202504-PS-GL-0005,,False,False,REF-899085,First Continental Bank,***1993,Globex Consulting UK Ltd.,UK,-4587376.47
2025-04-09,2025-04-09,Client Receipt - Vertex Advisory Client #56,Sales Receipt,PS-GL,0.0,4743.2,GBP,CHAPS Credit,Vertex Advisory Client #56,***9572,INV-202504-PS-GL-0004,,False,False,REF-678310,First Continental Bank,***5183,Globex Consulting UK Ltd.,UK,-4582633.27
2025-04-09,2025-04-09,Client Receipt - CloudBridge Co. #33,Sales Receipt,SaaS-GL,0.0,7006.86,GBP,Faster Payments Credit,CloudBridge Co. #33,***3417,INV-202504-SaaS-GL-0006,,False,False,REF-139105,First Continental Bank,***3045,Globex Consulting UK Ltd.,UK,-4575626.41
2025-04-09,2025-04-09,Client Receipt - CloudBridge Co. #28,Sales Receipt,SaaS-GL,0.0,11755.11,GBP,Faster Payments Credit,CloudBridge Co. #28,***4766,INV-202504-SaaS-GL-0011,,False,False,REF-319157,First Continental Bank,***9575,Globex Consulting UK Ltd.,UK,-4563871.3
2025-04-09,2025-04-09,Client Receipt - Aurora Electronics GmbH #8,Sales Receipt,CEM-EMEA,0.0,38973.89,GBP,CHAPS Credit,Aurora Electronics GmbH #8,***2092,INV-202504-CEM-EMEA-0010,,False,False,REF-669924,First Continental Bank,***4352,Globex Consulting UK Ltd.,UK,-4524897.41
2025-04-10,2025-04-10,Client Receipt - CloudBridge Co. #8,Sales Receipt,SaaS-GL,0.0,1687.12,GBP,Faster Payments Credit,CloudBridge Co. #8,***8259,INV-202504-SaaS-GL-0001,,False,False,REF-557656,First Continental Bank,***5642,Globex Consulting UK Ltd.,UK,-4523210.29
2025-04-10,2025-04-10,Client Receipt - Aurora Electronics GmbH #3,Sales Receipt,CEM-EMEA,0.0,15631.29,GBP,Faster Payments Credit,Aurora Electronics GmbH #3,***3466,INV-202504-CEM-EMEA-0015,,False,False,REF-123229,First Continental Bank,***2048,Globex Consulting UK Ltd.,UK,-4507579.0
2025-04-12,2025-04-12,Intercompany Settlement - Globex EMEA Manufacturing Ltd.,Intercompany Transfer,ALL,167712.0,0.0,GBP,Internal Transfer,Globex EMEA Manufacturing Ltd.,***5905,,,True,True,REF-433795,First Continental Bank,***3048,Globex Consulting UK Ltd.,UK,-4675291.0
2025-04-14,2025-04-14,Supplier Payment - EuroFab Assembly #8,Supplier Payment,CEM-EMEA,8438.92,0.0,GBP,Faster Payments,EuroFab Assembly #8,***3541,,PO-202504-CEM-EMEA-0001,False,False,REF-793137,First Continental Bank,***7373,Globex Consulting UK Ltd.,UK,-4683729.92
2025-04-14,2025-04-14,Client Receipt - CloudBridge Co. #27,Sales Receipt,SaaS-GL,0.0,896.42,GBP,CHAPS Credit,CloudBridge Co. #27,***5102,INV-202504-SaaS-GL-0004,,False,False,REF-358617,First Continental Bank,***2043,Globex Consulting UK Ltd.,UK,-4682833.5
2025-04-14,2025-04-14,Client Receipt - Vertex Advisory Client #57,Sales Receipt,PS-GL,0.0,3238.18,GBP,Faster Payments Credit,Vertex Advisory Client #57,***7821,INV-202504-PS-GL-0007,,False,False,REF-832340,First Continental Bank,***6676,Globex Consulting UK Ltd.,UK,-4679595.32
2025-04-15,2025-04-15,Supplier Payment - ExpertNet Subcontractors #17,Supplier Payment,PS-GL,574.44,0.0,GBP,CHAPS,ExpertNet Subcontractors #17,***9202,,PO-202504-PS-GL-0011,False,False,REF-126296,First Continental Bank,***3557,Globex Consulting UK Ltd.,UK,-4680169.76
2025-04-15,2025-04-15,Supplier Payment - HyperCloud Infra #16,Supplier Payment,SaaS-GL,725.31,0.0,GBP,CHAPS,HyperCloud Infra #16,***9720,,PO-202504-SaaS-GL-0005,False,False,REF-415743,First Continental Bank,***6760,Globex Consulting UK Ltd.,UK,-4680895.07
2025-04-15,2025-04-15,Merchant Processing Fees,Bank/Merchant Fees,ALL,1180.08,0.0,GBP,Faster Payments,First Continental Bank,***2890,,,False,False,REF-237162,First Continental Bank,***8375,Globex Consulting UK Ltd.,UK,-4682075.15
2025-04-15,2025-04-15,Client Receipt - CloudBridge Co. #24,Sales Receipt,SaaS-GL,0.0,578.01,GBP,CHAPS Credit,CloudBridge Co. #24,***1336,INV-202504-SaaS-GL-0017,,False,False,REF-498893,First Continental Bank,***2328,Globex Consulting UK Ltd.,UK,-4681497.14
2025-04-15,2025-04-15,Client Receipt - Novatek Components Ltd #10,Sales Receipt,CEM-EMEA,0.0,3218.36,GBP,Faster Payments Credit,Novatek Components Ltd #10,***8534,INV-202504-CEM-EMEA-0002,,False,False,REF-782317,First Continental Bank,***7430,Globex Consulting UK Ltd.,UK,-4678278.78
2025-04-15,2025-04-15,Client Receipt - Novatek Components Ltd #2,Sales Receipt,CEM-EMEA,0.0,39282.39,GBP,CHAPS Credit,Novatek Components Ltd #2,***5907,INV-202504-CEM-EMEA-0004,,False,False,REF-331194,First Continental Bank,***8234,Globex Consulting UK Ltd.,UK,-4638996.39
2025-04-16,2025-04-16,Client Receipt - CloudBridge Co. #65,Sales Receipt,SaaS-GL,0.0,10071.62,GBP,Faster Payments Credit,CloudBridge Co. #65,***8802,INV-202504-SaaS-GL-0022,,False,False,REF-530004,First Continental Bank,***8472,Globex Consulting UK Ltd.,UK,-4628924.77
2025-04-16,2025-04-16,Client Receipt - CloudBridge Co. #28,Sales Receipt,SaaS-GL,0.0,14107.67,GBP,CHAPS Credit,CloudBridge Co. #28,***6476,INV-202504-SaaS-GL-0013,,False,False,REF-197590,First Continental Bank,***8013,Globex Consulting UK Ltd.,UK,-4614817.1
2025-04-16,2025-04-16,Client Receipt - Vertex Advisory Client #4,Sales Receipt,PS-GL,0.0,15808.6,GBP,CHAPS Credit,Vertex Advisory Client #4,***6395,INV-202504-PS-GL-0010,,False,False,REF-919647,First Continental Bank,***3743,Globex Consulting UK Ltd.,UK,-4599008.5
2025-04-17,2025-04-17,Supplier Payment - Stelliform Parts BV #5,Supplier Payment,CEM-EMEA,42042.36,0.0,GBP,CHAPS,Stelliform Parts BV #5,***6358,,PO-202504-CEM-EMEA-0002,False,False,REF-314125,First Continental Bank,***7179,Globex Consulting UK Ltd.,UK,-4641050.86
2025-04-17,2025-04-17,Client Receipt - Novatek Components Ltd #7,Sales Receipt,CEM-EMEA,0.0,32269.99,GBP,Faster Payments Credit,Novatek Components Ltd #7,***9293,INV-202504-CEM-EMEA-0014,,False,False,REF-444945,First Continental Bank,***8348,Globex Consulting UK Ltd.,UK,-4608780.87
2025-04-18,2025-04-18,Client Receipt - CloudBridge Co. #20,Sales Receipt,SaaS-GL,0.0,3666.18,GBP,CHAPS Credit,CloudBridge Co. #20,***7741,INV-202504-SaaS-GL-0024,,False,False,REF-437306,First Continental Bank,***5136,Globex Consulting UK Ltd.,UK,-4605114.69
2025-04-20,2025-04-20,Client Receipt - CloudBridge Co. #19,Sales Receipt,SaaS-GL,0.0,1815.33,GBP,CHAPS Credit,CloudBridge Co. #19,***9468,INV-202504-SaaS-GL-0007,,False,False,REF-586838,First Continental Bank,***2002,Globex Consulting UK Ltd.,UK,-4603299.36
2025-04-21,2025-04-21,Supplier Payment - ExpertNet Subcontractors #17,Supplier Payment,PS-GL,1788.0,0.0,GBP,CHAPS,ExpertNet Subcontractors #17,***2436,,PO-202504-PS-GL-0005,False,False,REF-829785,First Continental Bank,***9943,Globex Consulting UK Ltd.,UK,-4605087.36
2025-04-21,2025-04-21,Supplier Payment - Stelliform Parts BV #32,Supplier Payment,CEM-EMEA,52127.7,0.0,GBP,Faster Payments,Stelliform Parts BV #32,***1722,,PO-202504-CEM-EMEA-0006,False,False,REF-457129,First Continental Bank,***4714,Globex Consulting UK Ltd.,UK,-4657215.06
2025-04-22,2025-04-22,Northshore Power,Rent & Utilities,ALL,4503.45,0.0,GBP,CHAPS,Northshore Power,***3875,,,False,False,REF-326311,First Continental Bank,***7137,Globex Consulting UK Ltd.,UK,-4661718.51
2025-04-22,2025-04-22,Marketing - Aurelia Media #8,Marketing,ALL,4845.24,0.0,GBP,CHAPS,Aurelia Media #8,***1283,,,False,False,REF-553630,First Continental Bank,***7740,Globex Consulting UK Ltd.,UK,-4666563.75
2025-04-22,2025-04-22,Supplier Payment - HyperCloud Infra #15,Supplier Payment,SaaS-GL,6761.76,0.0,GBP,Faster Payments,HyperCloud Infra #15,***9057,,PO-202504-SaaS-GL-0003,False,False,REF-399735,First Continental Bank,***9592,Globex Consulting UK Ltd.,UK,-4673325.51
2025-04-22,2025-04-22,VAT/GST Remittance - HMRC UK,Tax Payment,ALL,41169.02,0.0,GBP,CHAPS,HMRC UK,***1295,,,False,False,REF-416431,First Continental Bank,***2634,Globex Consulting UK Ltd.,UK,-4714494.53
2025-04-22,2025-04-22,Client Receipt - CloudBridge Co. #17,Sales Receipt,SaaS-GL,0.0,4584.16,GBP,Faster Payments Credit,CloudBridge Co. #17,***6169,INV-202504-SaaS-GL-0012,,False,False,REF-583291,First Continental Bank,***9092,Globex Consulting UK Ltd.,UK,-4709910.37
2025-04-22,2025-04-22,Client Receipt - Vertex Advisory Client #10,Sales Receipt,PS-GL,0.0,17473.36,GBP,Faster Payments Credit,Vertex Advisory Client #10,***4204,INV-202504-PS-GL-0003,,False,False,REF-636024,First Continental Bank,***9845,Globex Consulting UK Ltd.,UK,-4692437.01
2025-04-23,2025-04-23,Supplier Payment - ExpertNet Subcontractors #2,Supplier Payment,PS-GL,1574.28,0.0,GBP,CHAPS,ExpertNet Subcontractors #2,***3244,,PO-202504-PS-GL-0004,False,False,REF-492941,First Continental Bank,***1189,Globex Consulting UK Ltd.,UK,-4694011.29
2025-04-23,2025-04-23,Supplier Payment - CodeCraft Contractors #13,Supplier Payment,SaaS-GL,13311.16,0.0,GBP,Faster Payments,CodeCraft Contractors #13,***7408,,PO-202504-SaaS-GL-0001,False,False,REF-933959,First Continental Bank,***6242,Globex Consulting UK Ltd.,UK,-4707322.45
2025-04-23,2025-04-23,Supplier Payment - EuroFab Assembly #16,Supplier Payment,CEM-EMEA,23404.19,0.0,GBP,Faster Payments,EuroFab Assembly #16,***1915,,PO-202504-CEM-EMEA-0004,False,False,REF-163879,First Continental Bank,***5768,Globex Consulting UK Ltd.,UK,-4730726.64
2025-04-23,2025-04-23,Client Receipt - CloudBridge Co. #30,Sales Receipt,SaaS-GL,0.0,4715.93,GBP,CHAPS Credit,CloudBridge Co. #30,***3184,INV-202504-SaaS-GL-0009,,False,False,REF-460428,First Continental Bank,***5442,Globex Consulting UK Ltd.,UK,-4726010.71
2025-04-24,2025-04-24,Supplier Payment - HyperCloud Infra #14,Supplier Payment,SaaS-GL,1093.37,0.0,GBP,CHAPS,HyperCloud Infra #14,***3480,,PO-202504-SaaS-GL-0007,False,False,REF-913134,First Continental Bank,***8369,Globex Consulting UK Ltd.,UK,-4727104.08
2025-04-24,2025-04-24,Supplier Payment - Stelliform Parts BV #11,Supplier Payment,CEM-EMEA,13474.77,0.0,GBP,Faster Payments,Stelliform Parts BV #11,***6776,,PO-202504-CEM-EMEA-0011,False,False,REF-539744,First Continental Bank,***1633,Globex Consulting UK Ltd.,UK,-4740578.85
2025-04-24,2025-04-24,Client Receipt - Novatek Components Ltd #2,Sales Receipt,CEM-EMEA,0.0,5937.83,GBP,Faster Payments Credit,Novatek Components Ltd #2,***7997,INV-202504-CEM-EMEA-0001,,False,False,REF-322930,First Continental Bank,***5832,Globex Consulting UK Ltd.,UK,-4734641.02
2025-04-25,2025-04-25,Supplier Payment - ExpertNet Subcontractors #1,Supplier Payment,PS-GL,2544.23,0.0,GBP,Faster Payments,ExpertNet Subcontractors #1,***8515,,PO-202504-PS-GL-0010,False,False,REF-618944,First Continental Bank,***5878,Globex Consulting UK Ltd.,UK,-4737185.25
2025-04-25,2025-04-25,Supplier Payment - Stelliform Parts BV #12,Supplier Payment,CEM-EMEA,6342.29,0.0,GBP,CHAPS,Stelliform Parts BV #12,***4089,,PO-202504-CEM-EMEA-0003,False,False,REF-908647,First Continental Bank,***7806,Globex Consulting UK Ltd.,UK,-4743527.54
2025-04-26,2025-04-26,BluePeak Property Mgmt,Rent & Utilities,ALL,682.58,0.0,GBP,CHAPS,BluePeak Property Mgmt,***1078,,,False,False,REF-274990,First Continental Bank,***7275,Globex Consulting UK Ltd.,UK,-4744210.12
2025-04-26,2025-04-26,Marketing - Aurelia Media #7,Marketing,ALL,11666.99,0.0,GBP,Faster Payments,Aurelia Media #7,***2035,,,False,False,REF-621130,First Continental Bank,***4919,Globex Consulting UK Ltd.,UK,-4755877.11
2025-04-26,2025-04-26,Payroll - GlobalPay Services Ltd,Payroll,ALL,51535.33,0.0,GBP,Faster Payments,GlobalPay Services Ltd,***6106,,,False,False,REF-821093,First Continental Bank,***9520,Globex Consulting UK Ltd.,UK,-4807412.44
2025-04-26,2025-04-26,"Intercompany Settlement - Globex International Holdings, Inc.",Intercompany Transfer,ALL,686153.0,0.0,GBP,Internal Transfer,"Globex International Holdings, Inc.",***5644,,,True,True,REF-593099,First Continental Bank,***4989,Globex Consulting UK Ltd.,UK,-5493565.44
2025-04-26,2025-04-26,Client Receipt - CloudBridge Co. #2,Sales Receipt,SaaS-GL,0.0,6372.32,GBP,Faster Payments Credit,CloudBridge Co. #2,***4940,INV-202504-SaaS-GL-0005,,False,False,REF-515508,First Continental Bank,***3989,Globex Consulting UK Ltd.,UK,-5487193.12
2025-04-26,2025-04-26,"Intercompany Reimbursement - Globex International Holdings, Inc.",Intercompany Transfer,ALL,0.0,274461.2,GBP,Internal Transfer,"Globex International Holdings, Inc.",***8699,,,True,True,REF-388820,First Continental Bank,***1182,Globex Consulting UK Ltd.,UK,-5212731.92
2025-04-27,2025-04-27,Supplier Payment - ExpertNet Subcontractors #10,Supplier Payment,PS-GL,16471.93,0.0,GBP,CHAPS,ExpertNet Subcontractors #10,***6417,,PO-202504-PS-GL-0001,False,False,REF-592059,First Continental Bank,***2513,Globex Consulting UK Ltd.,UK,-5229203.85
2025-04-27,2025-04-27,Payroll - GlobalPay Services Ltd,Payroll,ALL,51535.33,0.0,GBP,CHAPS,GlobalPay Services Ltd,***2462,,,False,False,REF-470709,First Continental Bank,***8868,Globex Consulting UK Ltd.,UK,-5280739.18
2025-04-27,2025-04-27,Client Receipt - CloudBridge Co. #68,Sales Receipt,SaaS-GL,0.0,8746.12,GBP,Faster Payments Credit,CloudBridge Co. #68,***2512,INV-202504-SaaS-GL-0010,,False,False,REF-101118,First Continental Bank,***3167,Globex Consulting UK Ltd.,UK,-5271993.06
2025-04-27,2025-04-27,Client Receipt - CloudBridge Co. #64,Sales Receipt,SaaS-GL,0.0,11340.93,GBP,CHAPS Credit,CloudBridge Co. #64,***8336,INV-202504-SaaS-GL-0008,,False,False,REF-466912,First Continental Bank,***5421,Globex Consulting UK Ltd.,UK,-5260652.13
2025-04-28,2025-04-28,Supplier Payment - CodeCraft Contractors #10,Supplier Payment,SaaS-GL,5152.58,0.0,GBP,Faster Payments,CodeCraft Contractors #10,***6990,,PO-202504-SaaS-GL-0010,False,False,REF-120468,First Continental Bank,***4674,Globex Consulting UK Ltd.,UK,-5265804.71
2025-04-28,2025-04-28,Corporate Tax Estimate,Tax Payment,ALL,29533.8,0.0,GBP,Faster Payments,HMRC UK,***3098,,,False,False,REF-146807,First Continental Bank,***3793,Globex Consulting UK Ltd.,UK,-5295338.51
2025-04-28,2025-04-28,Client Receipt - CloudBridge Co. #76,Sales Receipt,SaaS-GL,0.0,3192.39,GBP,CHAPS Credit,CloudBridge Co. #76,***5799,INV-202504-SaaS-GL-0025,,False,False,REF-494751,First Continental Bank,***1980,Globex Consulting UK Ltd.,UK,-5292146.12
2025-04-29,2025-04-29,Supplier Payment - HyperCloud Infra #17,Supplier Payment,SaaS-GL,2064.76,0.0,GBP,CHAPS,HyperCloud Infra #17,***6218,,PO-202504-SaaS-GL-0008,False,False,REF-786968,First Continental Bank,***4818,Globex Consulting UK Ltd.,UK,-5294210.88
2025-04-29,2025-04-29,Supplier Payment - CodeCraft Contractors #3,Supplier Payment,SaaS-GL,2639.89,0.0,GBP,Faster Payments,CodeCraft Contractors #3,***7883,,PO-202504-SaaS-GL-0002,False,False,REF-251139,First Continental Bank,***3432,Globex Consulting UK Ltd.,UK,-5296850.77
2025-04-29,2025-04-29,Supplier Payment - Stelliform Parts BV #5,Supplier Payment,CEM-EMEA,6378.76,0.0,GBP,Faster Payments,Stelliform Parts BV #5,***5649,,PO-202504-CEM-EMEA-0008,False,False,REF-600275,First Continental Bank,***5969,Globex Consulting UK Ltd.,UK,-5303229.53
2025-04-29,2025-04-29,Client Receipt - Novatek Components Ltd #14,Sales Receipt,CEM-EMEA,0.0,266.23,GBP,Faster Payments Credit,Novatek Components Ltd #14,***9482,INV-202504-CEM-EMEA-0006,,False,False,REF-824292,First Continental Bank,***4553,Globex Consulting UK Ltd.,UK,-5302963.3
2025-04-29,2025-04-29,Client Receipt - Vertex Advisory Client #54,Sales Receipt,PS-GL,0.0,2047.18,GBP,CHAPS Credit,Vertex Advisory Client #54,***7872,INV-202504-PS-GL-0001,,False,False,REF-552252,First Continental Bank,***6222,Globex Consulting UK Ltd.,UK,-5300916.12
2025-04-29,2025-04-29,Client Receipt - CloudBridge Co. #25,Sales Receipt,SaaS-GL,0.0,17492.27,GBP,CHAPS Credit,CloudBridge Co. #25,***7176,INV-202504-SaaS-GL-0018,,False,False,REF-751910,First Continental Bank,***2591,Globex Consulting UK Ltd.,UK,-5283423.85
2025-04-29,2025-04-29,Client Receipt - Novatek Components Ltd #1,Sales Receipt,CEM-EMEA,0.0,55522.67,GBP,Faster Payments Credit,Novatek Components Ltd #1,***8847,INV-202504-CEM-EMEA-0011,,False,False,REF-407332,First Continental Bank,***7233,Globex Consulting UK Ltd.,UK,-5227901.18
2025-04-30,2025-04-30,Supplier Payment - CodeCraft Contractors #5,Supplier Payment,SaaS-GL,608.75,0.0,GBP,Faster Payments,CodeCraft Contractors #5,***1911,,PO-202504-SaaS-GL-0006,False,False,REF-199346,First Continental Bank,***2720,Globex Consulting UK Ltd.,UK,-5228509.93
2025-04-30,2025-04-30,Interest Earned,Interest Income,ALL,0.0,11231.64,GBP,Faster Payments Credit,First Continental Bank,***4101,,,False,False,REF-649817,First Continental Bank,***3162,Globex Consulting UK Ltd.,UK,-5217278.29
2025-04-30,2025-04-30,Client Receipt - CloudBridge Co. #28,Sales Receipt,SaaS-GL,0.0,13265.84,GBP,Faster Payments Credit,CloudBridge Co. #28,***4883,INV-202504-SaaS-GL-0016,,False,False,REF-525307,First Continental Bank,***6974,Globex Consulting UK Ltd.,UK,-5204012.45
2025-05-01,2025-05-01,Account Maintenance Fee,Bank/Merchant Fees,ALL,2500.0,0.0,GBP,Faster Payments,First Continental Bank,***6560,,,False,False,REF-754402,First Continental Bank,***7695,Globex Consulting UK Ltd.,UK,-5206512.45
2025-05-01,2025-05-01,Supplier Payment - HyperCloud Infra #15,Supplier Payment,SaaS-GL,3644.66,0.0,GBP,Faster Payments,HyperCloud Infra #15,***2663,,PO-202505-SaaS-GL-0006,False,False,REF-437374,First Continental Bank,***9279,Globex Consulting UK Ltd.,UK,-5210157.11
2025-05-01,2025-05-01,Client Receipt - CloudBridge Co. #25,Sales Receipt,SaaS-GL,0.0,794.65,GBP,CHAPS Credit,CloudBridge Co. #25,***3455,INV-202505-SaaS-GL-0033,,False,False,REF-957027,First Continental Bank,***6080,Globex Consulting UK Ltd.,UK,-5209362.46
2025-05-01,2025-05-01,Client Receipt - Novatek Components Ltd #5,Sales Receipt,CEM-EMEA,0.0,2034.63,GBP,CHAPS Credit,Novatek Components Ltd #5,***8426,INV-202505-CEM-EMEA-0001,,False,False,REF-790097,First Continental Bank,***2081,Globex Consulting UK Ltd.,UK,-5207327.83
2025-05-01,2025-05-01,Client Receipt - CloudBridge Co. #74,Sales Receipt,SaaS-GL,0.0,4733.05,GBP,CHAPS Credit,CloudBridge Co. #74,***1465,INV-202505-SaaS-GL-0025,,False,False,REF-380587,First Continental Bank,***1089,Globex Consulting UK Ltd.,UK,-5202594.78
2025-05-01,2025-05-01,Client Receipt - Vertex Advisory Client #28,Sales Receipt,PS-GL,0.0,11932.16,GBP,CHAPS Credit,Vertex Advisory Client #28,***2075,INV-202505-PS-GL-0004,,False,False,REF-474515,First Continental Bank,***5096,Globex Consulting UK Ltd.,UK,-5190662.62
2025-05-02,2025-05-02,Supplier Payment - CodeCraft Contractors #10,Supplier Payment,SaaS-GL,2801.07,0.0,GBP,Faster Payments,CodeCraft Contractors #10,***7936,,PO-202505-SaaS-GL-0008,False,False,REF-460306,First Continental Bank,***2306,Globex Consulting UK Ltd.,UK,-5193463.69
2025-05-02,2025-05-02,Supplier Payment - HyperCloud Infra #2,Supplier Payment,SaaS-GL,4012.82,0.0,GBP,Faster Payments,HyperCloud Infra #2,***1502,,PO-202505-SaaS-GL-0005,False,False,REF-477011,First Continental Bank,***3569,Globex Consulting UK Ltd.,UK,-5197476.51
2025-05-02,2025-05-02,Supplier Payment - ExpertNet Subcontractors #1,Supplier Payment,PS-GL,20139.52,0.0,GBP,CHAPS,ExpertNet Subcontractors #1,***4742,,PO-202505-PS-GL-0005,False,False,REF-542218,First Continental Bank,***2667,Globex Consulting UK Ltd.,UK,-5217616.03
2025-05-02,2025-05-02,Client Receipt - CloudBridge Co. #12,Sales Receipt,SaaS-GL,0.0,756.18,GBP,CHAPS Credit,CloudBridge Co. #12,***6582,INV-202505-SaaS-GL-0018,,False,False,REF-843706,First Continental Bank,***6963,Globex Consulting UK Ltd.,UK,-5216859.85
2025-05-02,2025-05-02,Client Receipt - CloudBridge Co. #9,Sales Receipt,SaaS-GL,0.0,1994.6,GBP,Faster Payments Credit,CloudBridge Co. #9,***1786,INV-202505-SaaS-GL-0008,,False,False,REF-971114,First Continental Bank,***1272,Globex Consulting UK Ltd.,UK,-5214865.25
2025-05-02,2025-05-02,Client Receipt - CloudBridge Co. #64,Sales Receipt,SaaS-GL,0.0,13132.25,GBP,Faster Payments Credit,CloudBridge Co. #64,***9293,INV-202505-SaaS-GL-0003,,False,False,REF-794071,First Continental Bank,***9127,Globex Consulting UK Ltd.,UK,-5201733.0
2025-05-02,2025-05-02,Client Receipt - Aurora Electronics GmbH #17,Sales Receipt,CEM-EMEA,0.0,14119.68,GBP,Faster Payments Credit,Aurora Electronics GmbH #17,***3497,INV-202505-CEM-EMEA-0002,,False,False,REF-450840,First Continental Bank,***8116,Globex Consulting UK Ltd.,UK,-5187613.32
2025-05-03,2025-05-03,Client Receipt - CloudBridge Co. #7,Sales Receipt,SaaS-GL,0.0,1731.24,GBP,Faster Payments Credit,CloudBridge Co. #7,***6172,INV-202505-SaaS-GL-0022,,False,False,REF-818339,First Continental Bank,***2602,Globex Consulting UK Ltd.,UK,-5185882.08
2025-05-03,2025-05-03,Client Receipt - Vertex Advisory Client #58,Sales Receipt,PS-GL,0.0,14974.54,GBP,CHAPS Credit,Vertex Advisory Client #58,***4230,INV-202505-PS-GL-0002,,False,False,REF-329709,First Continental Bank,***1605,Globex Consulting UK Ltd.,UK,-5170907.54
2025-05-05,2025-05-05,Metro Water & Waste,Rent & Utilities,ALL,5366.42,0.0,GBP,Faster Payments,Metro Water & Waste,***9151,,,False,False,REF-269857,First Continental Bank,***3068,Globex Consulting UK Ltd.,UK,-5176273.96
2025-05-05,2025-05-05,Client Receipt - CloudBridge Co. #13,Sales Receipt,SaaS-GL,0.0,9359.45,GBP,Faster Payments Credit,CloudBridge Co. #13,***5289,INV-202505-SaaS-GL-0029,,False,False,REF-535972,First Continental Bank,***9620,Globex Consulting UK Ltd.,UK,-5166914.51
2025-05-05,2025-05-05,Client Receipt - CloudBridge Co. #46,Sales Receipt,SaaS-GL,0.0,17236.08,GBP,CHAPS Credit,CloudBridge Co. #46,***3056,INV-202505-SaaS-GL-0006,,False,False,REF-869189,First Continental Bank,***3493,Globex Consulting UK Ltd.,UK,-5149678.43
2025-05-06,2025-05-06,Client Receipt - CloudBridge Co. #14,Sales Receipt,SaaS-GL,0.0,517.04,GBP,CHAPS Credit,CloudBridge Co. #14,***8815,INV-202505-SaaS-GL-0012,,False,False,REF-220412,First Continental Bank,***4760,Globex Consulting UK Ltd.,UK,-5149161.39
2025-05-06,2025-05-06,Client Receipt - Vertex Advisory Client #22,Sales Receipt,PS-GL,0.0,5252.11,GBP,CHAPS Credit,Vertex Advisory Client #22,***1462,INV-202505-PS-GL-0007,,False,False,REF-328495,First Continental Bank,***4183,Globex Consulting UK Ltd.,UK,-5143909.28
2025-05-07,2025-05-07,Supplier Payment - HyperCloud Infra #2,Supplier Payment,SaaS-GL,3159.76,0.0,GBP,CHAPS,HyperCloud Infra #2,***5943,,PO-202505-SaaS-GL-0004,False,False,REF-602292,First Continental Bank,***1222,Globex Consulting UK Ltd.,UK,-5147069.04
2025-05-07,2025-05-07,Supplier Payment - Stelliform Parts BV #25,Supplier Payment,CEM-EMEA,9676.59,0.0,GBP,Faster Payments,Stelliform Parts BV #25,***1222,,PO-202505-CEM-EMEA-0002,False,False,REF-396545,First Continental Bank,***8138,Globex Consulting UK Ltd.,UK,-5156745.63
2025-05-07,2025-05-07,Supplier Payment - ExpertNet Subcontractors #2,Supplier Payment,PS-GL,10847.21,0.0,GBP,CHAPS,ExpertNet Subcontractors #2,***6639,,PO-202505-PS-GL-0003,False,False,REF-675605,First Continental Bank,***8221,Globex Consulting UK Ltd.,UK,-5167592.84
2025-05-07,2025-05-07,Client Receipt - CloudBridge Co. #58,Sales Receipt,SaaS-GL,0.0,9328.41,GBP,CHAPS Credit,CloudBridge Co. #58,***7272,INV-202505-SaaS-GL-0020,,False,False,REF-547125,First Continental Bank,***2317,Globex Consulting UK Ltd.,UK,-5158264.43
2025-05-08,2025-05-08,Marketing - Beacon Digital #1,Marketing,ALL,2079.68,0.0,GBP,Faster Payments,Beacon Digital #1,***7502,,,False,False,REF-497260,First Continental Bank,***3219,Globex Consulting UK Ltd.,UK,-5160344.11
2025-05-08,2025-05-08,Client Receipt - CloudBridge Co. #66,Sales Receipt,SaaS-GL,0.0,722.01,GBP,Faster Payments Credit,CloudBridge Co. #66,***8084,INV-202505-SaaS-GL-0010,,False,False,REF-122921,First Continental Bank,***7811,Globex Consulting UK Ltd.,UK,-5159622.1
2025-05-08,2025-05-08,Client Receipt - CloudBridge Co. #44,Sales Receipt,SaaS-GL,0.0,4356.81,GBP,CHAPS Credit,CloudBridge Co. #44,***5226,INV-202505-SaaS-GL-0004,,False,False,REF-949815,First Continental Bank,***5337,Globex Consulting UK Ltd.,UK,-5155265.29
2025-05-08,2025-05-08,Client Receipt - Aurora Electronics GmbH #8,Sales Receipt,CEM-EMEA,0.0,9146.17,GBP,Faster Payments Credit,Aurora Electronics GmbH #8,***4414,INV-202505-CEM-EMEA-0004,,False,False,REF-389073,First Continental Bank,***9686,Globex Consulting UK Ltd.,UK,-5146119.12
2025-05-08,2025-05-08,Client Receipt - CloudBridge Co. #79,Sales Receipt,SaaS-GL,0.0,18317.48,GBP,CHAPS Credit,CloudBridge Co. #79,***1864,INV-202505-SaaS-GL-0023,,False,False,REF-752230,First Continental Bank,***2796,Globex Consulting UK Ltd.,UK,-5127801.64
2025-05-09,2025-05-09,Supplier Payment - ExpertNet Subcontractors #3,Supplier Payment,PS-GL,272.77,0.0,GBP,CHAPS,ExpertNet Subcontractors #3,***4723,,PO-202505-PS-GL-0004,False,False,REF-922412,First Continental Bank,***6709,Globex Consulting UK Ltd.,UK,-5128074.41
2025-05-09,2025-05-09,Merchant Processing Fees,Bank/Merchant Fees,ALL,1734.08,0.0,GBP,Faster Payments,First Continental Bank,***3521,,,False,False,REF-894358,First Continental Bank,***4747,Globex Consulting UK Ltd.,UK,-5129808.49
2025-05-09,2025-05-09,Supplier Payment - Stelliform Parts BV #17,Supplier Payment,CEM-EMEA,19146.6,0.0,GBP,Faster Payments,Stelliform Parts BV #17,***3800,,PO-202505-CEM-EMEA-0007,False,False,REF-283444,First Continental Bank,***3902,Globex Consulting UK Ltd.,UK,-5148955.09
2025-05-10,2025-05-10,Client Receipt - CloudBridge Co. #12,Sales Receipt,SaaS-GL,0.0,15156.06,GBP,Faster Payments Credit,CloudBridge Co. #12,***7880,INV-202505-SaaS-GL-0024,,False,False,REF-608324,First Continental Bank,***2797,Globex Consulting UK Ltd.,UK,-5133799.03
2025-05-11,2025-05-11,Supplier Payment - Stelliform Parts BV #6,Supplier Payment,CEM-EMEA,29910.04,0.0,GBP,Faster Payments,Stelliform Parts BV #6,***1973,,PO-202505-CEM-EMEA-0008,False,False,REF-290517,First Continental Bank,***3323,Globex Consulting UK Ltd.,UK,-5163709.07
2025-05-11,2025-05-11,Client Receipt - CloudBridge Co. #58,Sales Receipt,SaaS-GL,0.0,9606.13,GBP,Faster Payments Credit,CloudBridge Co. #58,***4547,INV-202505-SaaS-GL-0001,,False,False,REF-968443,First Continental Bank,***7729,Globex Consulting UK Ltd.,UK,-5154102.94
2025-05-11,2025-05-11,Client Receipt - Vertex Advisory Client #7,Sales Receipt,PS-GL,0.0,27382.8,GBP,Faster Payments Credit,Vertex Advisory Client #7,***4198,INV-202505-PS-GL-0006,,False,False,REF-957069,First Continental Bank,***9530,Globex Consulting UK Ltd.,UK,-5126720.14
2025-05-12,2025-05-12,"Intercompany Settlement - Globex International Holdings, Inc.",Intercompany Transfer,ALL,732003.0,0.0,GBP,Internal Transfer,"Globex International Holdings, Inc.",***6873,,,True,True,REF-388407,First Continental Bank,***5785,Globex Consulting UK Ltd.,UK,-5858723.14
2025-05-12,2025-05-12,Client Receipt - CloudBridge Co. #54,Sales Receipt,SaaS-GL,0.0,1372.14,GBP,Faster Payments Credit,CloudBridge Co. #54,***1733,INV-202505-SaaS-GL-0031,,False,False,REF-368526,First Continental Bank,***6350,Globex Consulting UK Ltd.,UK,-5857351.0
2025-05-12,2025-05-12,Client Receipt - Vertex Advisory Client #3,Sales Receipt,PS-GL,0.0,13105.99,GBP,CHAPS Credit,Vertex Advisory Client #3,***8423,INV-202505-PS-GL-0008,,False,False,REF-582457,First Continental Bank,***7496,Globex Consulting UK Ltd.,UK,-5844245.01
2025-05-13,2025-05-13,Marketing - Aurelia Media #7,Marketing,ALL,3978.36,0.0,GBP,CHAPS,Aurelia Media #7,***1637,,,False,False,REF-767068,First Continental Bank,***3784,Globex Consulting UK Ltd.,UK,-5848223.37
2025-05-13,2025-05-13,Client Receipt - Novatek Components Ltd #11,Sales Receipt,CEM-EMEA,0.0,4460.99,GBP,Faster Payments Credit,Novatek Components Ltd #11,***6147,INV-202505-CEM-EMEA-0009,,False,False,REF-789334,First Continental Bank,***6149,Globex Consulting UK Ltd.,UK,-5843762.38
2025-05-13,2025-05-13,Client Receipt - CloudBridge Co. #65,Sales Receipt,SaaS-GL,0.0,8974.82,GBP,Faster Payments Credit,CloudBridge Co. #65,***8812,INV-202505-SaaS-GL-0007,,False,False,REF-189786,First Continental Bank,***9931,Globex Consulting UK Ltd.,UK,-5834787.56
2025-05-13,2025-05-13,Client Receipt - Aurora Electronics GmbH #8,Sales Receipt,CEM-EMEA,0.0,19661.16,GBP,CHAPS Credit,Aurora Electronics GmbH #8,***4660,INV-202505-CEM-EMEA-0005,,False,False,REF-847367,First Continental Bank,***6401,Globex Consulting UK Ltd.,UK,-5815126.4
2025-05-14,2025-05-14,Supplier Payment - CodeCraft Contractors #1,Supplier Payment,SaaS-GL,3862.88,0.0,GBP,CHAPS,CodeCraft Contractors #1,***8210,,PO-202505-SaaS-GL-0001,False,False,REF-298009,First Continental Bank,***3368,Globex Consulting UK Ltd.,UK,-5818989.28
2025-05-14,2025-05-14,Marketing - Aurelia Media #7,Marketing,ALL,10816.25,0.0,GBP,Faster Payments,Aurelia Media #7,***4115,,,False,False,REF-311025,First Continental Bank,***7597,Globex Consulting UK Ltd.,UK,-5829805.53
2025-05-14,2025-05-14,Supplier Payment - Stelliform Parts BV #33,Supplier Payment,CEM-EMEA,56988.21,0.0,GBP,CHAPS,Stelliform Parts BV #33,***1247,,PO-202505-CEM-EMEA-0006,False,False,REF-438826,First Continental Bank,***8837,Globex Consulting UK Ltd.,UK,-5886793.74
2025-05-14,2025-05-14,Client Receipt - CloudBridge Co. #69,Sales Receipt,SaaS-GL,0.0,1138.63,GBP,Faster Payments Credit,CloudBridge Co. #69,***1642,INV-202505-SaaS-GL-0015,,False,False,REF-239414,First Continental Bank,***9601,Globex Consulting UK Ltd.,UK,-5885655.11
2025-05-14,2025-05-14,Client Receipt - CloudBridge Co. #55,Sales Receipt,SaaS-GL,0.0,7351.98,GBP,Faster Payments Credit,CloudBridge Co. #55,***1257,INV-202505-SaaS-GL-0017,,False,False,REF-885126,First Continental Bank,***3208,Globex Consulting UK Ltd.,UK,-5878303.13
2025-05-14,2025-05-14,Client Receipt - Aurora Electronics GmbH #9,Sales Receipt,CEM-EMEA,0.0,67848.09,GBP,Faster Payments Credit,Aurora Electronics GmbH #9,***9491,INV-202505-CEM-EMEA-0012,,False,False,REF-356535,First Continental Bank,***3698,Globex Consulting UK Ltd.,UK,-5810455.04
2025-05-15,2025-05-15,Alphagrid Utilities,Rent & Utilities,ALL,64.96,0.0,GBP,Faster Payments,Alphagrid Utilities,***8678,,,False,False,REF-465893,First Continental Bank,***2848,Globex Consulting UK Ltd.,UK,-5810520.0
2025-05-15,2025-05-15,Supplier Payment - HyperCloud Infra #10,Supplier Payment,SaaS-GL,4892.15,0.0,GBP,Faster Payments,HyperCloud Infra #10,***9049,,PO-202505-SaaS-GL-0010,False,False,REF-810700,First Continental Bank,***5167,Globex Consulting UK Ltd.,UK,-5815412.15
2025-05-15,2025-05-15,Client Receipt - CloudBridge Co. #14,Sales Receipt,SaaS-GL,0.0,1136.2,GBP,CHAPS Credit,CloudBridge Co. #14,***1012,INV-202505-SaaS-GL-0002,,False,False,REF-228131,First Continental Bank,***1754,Globex Consulting UK Ltd.,UK,-5814275.95
2025-05-15,2025-05-15,Client Receipt - CloudBridge Co. #21,Sales Receipt,SaaS-GL,0.0,2053.78,GBP,Faster Payments Credit,CloudBridge Co. #21,***7831,INV-202505-SaaS-GL-0009,,False,False,REF-964449,First Continental Bank,***8796,Globex Consulting UK Ltd.,UK,-5812222.17
2025-05-15,2025-05-15,Client Receipt - Novatek Components Ltd #10,Sales Receipt,CEM-EMEA,0.0,33135.31,GBP,Faster Payments Credit,Novatek Components Ltd #10,***1018,INV-202505-CEM-EMEA-0007,,False,False,REF-921044,First Continental Bank,***1881,Globex Consulting UK Ltd.,UK,-5779086.86
2025-05-16,2025-05-16,Supplier Payment - CodeCraft Contractors #10,Supplier Payment,SaaS-GL,10804.27,0.0,GBP,Faster Payments,CodeCraft Contractors #10,***4941,,PO-202505-SaaS-GL-0007,False,False,REF-603570,First Continental Bank,***1764,Globex Consulting UK Ltd.,UK,-5789891.13
2025-05-16,2025-05-16,Client Receipt - Vertex Advisory Client #36,Sales Receipt,PS-GL,0.0,284.19,GBP,CHAPS Credit,Vertex Advisory Client #36,***6598,INV-202505-PS-GL-0010,,False,False,REF-494007,First Continental Bank,***1143,Globex Consulting UK Ltd.,UK,-5789606.94
2025-05-16,2025-05-16,Client Receipt - Aurora Electronics GmbH #10,Sales Receipt,CEM-EMEA,0.0,29923.49,GBP,CHAPS Credit,Aurora Electronics GmbH #10,***9640,INV-202505-CEM-EMEA-0013,,False,False,REF-616133,First Continental Bank,***4365,Globex Consulting UK Ltd.,UK,-5759683.45
2025-05-19,2025-05-19,Client Receipt - CloudBridge Co. #52,Sales Receipt,SaaS-GL,0.0,1833.84,GBP,CHAPS Credit,CloudBridge Co. #52,***7556,INV-202505-SaaS-GL-0032,,False,False,REF-942643,First Continental Bank,***3395,Globex Consulting UK Ltd.,UK,-5757849.61
2025-05-19,2025-05-19,Client Receipt - CloudBridge Co. #31,Sales Receipt,SaaS-GL,0.0,3925.86,GBP,Faster Payments Credit,CloudBridge Co. #31,***6120,INV-202505-SaaS-GL-0030,,False,False,REF-863616,First Continental Bank,***6762,Globex Consulting UK Ltd.,UK,-5753923.75
2025-05-19,2025-05-19,Client Receipt - Vertex Advisory Client #17,Sales Receipt,PS-GL,0.0,28026.78,GBP,CHAPS Credit,Vertex Advisory Client #17,***8967,INV-202505-PS-GL-0001,,False,False,REF-286966,First Continental Bank,***8293,Globex Consulting UK Ltd.,UK,-5725896.97
2025-05-19,2025-05-19,Client Receipt - Novatek Components Ltd #6,Sales Receipt,CEM-EMEA,0.0,55439.66,GBP,CHAPS Credit,Novatek Components Ltd #6,***7531,INV-202505-CEM-EMEA-0003,,False,False,REF-177037,First Continental Bank,***4939,Globex Consulting UK Ltd.,UK,-5670457.31
2025-05-20,2025-05-20,VAT/GST Remittance - HMRC UK,Tax Payment,ALL,40118.77,0.0,GBP,CHAPS,HMRC UK,***5957,,,False,False,REF-107955,First Continental Bank,***4867,Globex Consulting UK Ltd.,UK,-5710576.08
2025-05-20,2025-05-20,Client Receipt - CloudBridge Co. #50,Sales Receipt,SaaS-GL,0.0,8216.54,GBP,CHAPS Credit,CloudBridge Co. #50,***6122,INV-202505-SaaS-GL-0019,,False,False,REF-909653,First Continental Bank,***1160,Globex Consulting UK Ltd.,UK,-5702359.54
2025-05-21,2025-05-21,Supplier Payment - ExpertNet Subcontractors #15,Supplier Payment,PS-GL,551.16,0.0,GBP,Faster Payments,ExpertNet Subcontractors #15,***5591,,PO-202505-PS-GL-0002,False,False,REF-398990,First Continental Bank,***9572,Globex Consulting UK Ltd.,UK,-5702910.7
2025-05-21,2025-05-21,Supplier Payment - ExpertNet Subcontractors #16,Supplier Payment,PS-GL,688.75,0.0,GBP,CHAPS,ExpertNet Subcontractors #16,***2688,,PO-202505-PS-GL-0008,False,False,REF-129470,First Continental Bank,***8551,Globex Consulting UK Ltd.,UK,-5703599.45
2025-05-21,2025-05-21,Supplier Payment - ExpertNet Subcontractors #16,Supplier Payment,PS-GL,2578.85,0.0,GBP,CHAPS,ExpertNet Subcontractors #16,***2183,,PO-202505-PS-GL-0001,False,False,REF-601197,First Continental Bank,***9349,Globex Consulting UK Ltd.,UK,-5706178.3
2025-05-21,2025-05-21,Client Receipt - Aurora Electronics GmbH #16,Sales Receipt,CEM-EMEA,0.0,2378.79,GBP,Faster Payments Credit,Aurora Electronics GmbH #16,***6303,INV-202505-CEM-EMEA-0010,,False,False,REF-341353,First Continental Bank,***2887,Globex Consulting UK Ltd.,UK,-5703799.51
2025-05-21,2025-05-21,Client Receipt - CloudBridge Co. #48,Sales Receipt,SaaS-GL,0.0,14183.91,GBP,Faster Payments Credit,CloudBridge Co. #48,***8560,INV-202505-SaaS-GL-0013,,False,False,REF-869752,First Continental Bank,***3467,Globex Consulting UK Ltd.,UK,-5689615.6
2025-05-21,2025-05-21,Client Receipt - Aurora Electronics GmbH #16,Sales Receipt,CEM-EMEA,0.0,37382.47,GBP,Faster Payments Credit,Aurora Electronics GmbH #16,***3168,INV-202505-CEM-EMEA-0006,,False,False,REF-627928,First Continental Bank,***4044,Globex Consulting UK Ltd.,UK,-5652233.13
2025-05-22,2025-05-22,Client Receipt - CloudBridge Co. #28,Sales Receipt,SaaS-GL,0.0,924.23,GBP,Faster Payments Credit,CloudBridge Co. #28,***4638,INV-202505-SaaS-GL-0034,,False,False,REF-867236,First Continental Bank,***7894,Globex Consulting UK Ltd.,UK,-5651308.9
2025-05-22,2025-05-22,Client Receipt - CloudBridge Co. #4,Sales Receipt,SaaS-GL,0.0,3563.56,GBP,Faster Payments Credit,CloudBridge Co. #4,***9885,INV-202505-SaaS-GL-0026,,False,False,REF-849788,First Continental Bank,***3070,Globex Consulting UK Ltd.,UK,-5647745.34
2025-05-23,2025-05-23,Supplier Payment - EuroFab Assembly #1,Supplier Payment,CEM-EMEA,11582.85,0.0,GBP,CHAPS,EuroFab Assembly #1,***4369,,PO-202505-CEM-EMEA-0004,False,False,REF-206713,First Continental Bank,***1065,Globex Consulting UK Ltd.,UK,-5659328.19
2025-05-23,2025-05-23,Client Receipt - CloudBridge Co. #75,Sales Receipt,SaaS-GL,0.0,13518.34,GBP,Faster Payments Credit,CloudBridge Co. #75,***9310,INV-202505-SaaS-GL-0028,,False,False,REF-828522,First Continental Bank,***8091,Globex Consulting UK Ltd.,UK,-5645809.85
2025-05-23,2025-05-23,Client Receipt - Novatek Components Ltd #14,Sales Receipt,CEM-EMEA,0.0,15546.69,GBP,Faster Payments Credit,Novatek Components Ltd #14,***4328,INV-202505-CEM-EMEA-0008,,False,False,REF-355888,First Continental Bank,***9582,Globex Consulting UK Ltd.,UK,-5630263.16
2025-05-23,2025-05-23,Client Receipt - Novatek Components Ltd #12,Sales Receipt,CEM-EMEA,0.0,23313.28,GBP,Faster Payments Credit,Novatek Components Ltd #12,***6589,INV-202505-CEM-EMEA-0011,,False,False,REF-153372,First Continental Bank,***7340,Globex Consulting UK Ltd.,UK,-5606949.88
2025-05-25,2025-05-25,Client Receipt - CloudBridge Co. #53,Sales Receipt,SaaS-GL,0.0,938.42,GBP,Faster Payments Credit,CloudBridge Co. #53,***5040,INV-202505-SaaS-GL-0011,,False,False,REF-258634,First Continental Bank,***3308,Globex Consulting UK Ltd.,UK,-5606011.46
2025-05-25,2025-05-25,Client Receipt - CloudBridge Co. #48,Sales Receipt,SaaS-GL,0.0,8503.21,GBP,CHAPS Credit,CloudBridge Co. #48,***3824,INV-202505-SaaS-GL-0005,,False,False,REF-491392,First Continental Bank,***8702,Globex Consulting UK Ltd.,UK,-5597508.25
2025-05-26,2025-05-26,Merchant Processing Fees,Bank/Merchant Fees,ALL,313.45,0.0,GBP,Faster Payments,First Continental Bank,***4983,,,False,False,REF-963207,First Continental Bank,***4952,Globex Consulting UK Ltd.,UK,-5597821.7
2025-05-26,2025-05-26,Intercompany Settlement - Globex Retail NA LLC,Intercompany Transfer,ALL,615099.0,0.0,GBP,Internal Transfer,Globex Retail NA LLC,***7757,,,True,True,REF-419844,First Continental Bank,***3641,Globex Consulting UK Ltd.,UK,-6212920.7
2025-05-26,2025-05-26,Client Receipt - CloudBridge Co. #11,Sales Receipt,SaaS-GL,0.0,6891.61,GBP,CHAPS Credit,CloudBridge Co. #11,***1329,INV-202505-SaaS-GL-0035,,False,False,REF-959776,First Continental Bank,***9440,Globex Consulting UK Ltd.,UK,-6206029.09
2025-05-26,2025-05-26,Intercompany Reimbursement - Globex Retail NA LLC,Intercompany Transfer,ALL,0.0,246039.6,GBP,Internal Transfer,Globex Retail NA LLC,***5007,,,True,True,REF-148513,First Continental Bank,***9637,Globex Consulting UK Ltd.,UK,-5959989.49
2025-05-27,2025-05-27,Supplier Payment - CodeCraft Contractors #3,Supplier Payment,SaaS-GL,1423.23,0.0,GBP,CHAPS,CodeCraft Contractors #3,***1093,,PO-202505-SaaS-GL-0003,False,False,REF-697669,First Continental Bank,***7261,Globex Consulting UK Ltd.,UK,-5961412.72
2025-05-27,2025-05-27,Supplier Payment - ExpertNet Subcontractors #17,Supplier Payment,PS-GL,2826.93,0.0,GBP,CHAPS,ExpertNet Subcontractors #17,***4695,,PO-202505-PS-GL-0007,False,False,REF-454833,First Continental Bank,***6954,Globex Consulting UK Ltd.,UK,-5964239.65
2025-05-27,2025-05-27,Supplier Payment - Stelliform Parts BV #21,Supplier Payment,CEM-EMEA,51178.05,0.0,GBP,Faster Payments,Stelliform Parts BV #21,***4303,,PO-202505-CEM-EMEA-0003,False,False,REF-611213,First Continental Bank,***1871,Globex Consulting UK Ltd.,UK,-6015417.7
2025-05-27,2025-05-27,Client Receipt - CloudBridge Co. #25,Sales Receipt,SaaS-GL,0.0,9303.52,GBP,Faster Payments Credit,CloudBridge Co. #25,***9757,INV-202505-SaaS-GL-0021,,False,False,REF-551937,First Continental Bank,***7677,Globex Consulting UK Ltd.,UK,-6006114.18
2025-05-27,2025-05-27,Client Receipt - Vertex Advisory Client #51,Sales Receipt,PS-GL,0.0,10351.64,GBP,CHAPS Credit,Vertex Advisory Client #51,***1023,INV-202505-PS-GL-0005,,False,False,REF-872666,First Continental Bank,***2008,Globex Consulting UK Ltd.,UK,-5995762.54
2025-05-27,2025-05-27,Client Receipt - Vertex Advisory Client #22,Sales Receipt,PS-GL,0.0,11443.23,GBP,Faster Payments Credit,Vertex Advisory Client #22,***4434,INV-202505-PS-GL-0009,,False,False,REF-320683,First Continental Bank,***5119,Globex Consulting UK Ltd.,UK,-5984319.31
2025-05-28,2025-05-28,Supplier Payment - EuroFab Assembly #22,Supplier Payment,CEM-EMEA,8324.41,0.0,GBP,Faster Payments,EuroFab Assembly #22,***9211,,PO-202505-CEM-EMEA-0005,False,False,REF-667343,First Continental Bank,***1541,Globex Consulting UK Ltd.,UK,-5992643.72
2025-05-28,2025-05-28,Payroll - GlobalPay Services Ltd,Payroll,ALL,109531.47,0.0,GBP,Faster Payments,GlobalPay Services Ltd,***6280,,,False,False,REF-643081,First Continental Bank,***7984,Globex Consulting UK Ltd.,UK,-6102175.19
2025-05-28,2025-05-28,Client Receipt - CloudBridge Co. #59,Sales Receipt,SaaS-GL,0.0,4380.62,GBP,Faster Payments Credit,CloudBridge Co. #59,***2942,INV-202505-SaaS-GL-0027,,False,False,REF-973110,First Continental Bank,***8894,Globex Consulting UK Ltd.,UK,-6097794.57
2025-05-28,2025-05-28,Client Receipt - CloudBridge Co. #67,Sales Receipt,SaaS-GL,0.0,4632.15,GBP,Faster Payments Credit,CloudBridge Co. #67,***4180,INV-202505-SaaS-GL-0016,,False,False,REF-523507,First Continental Bank,***9930,Globex Consulting UK Ltd.,UK,-6093162.42
2025-05-29,2025-05-29,Supplier Payment - CodeCraft Contractors #11,Supplier Payment,SaaS-GL,3489.0,0.0,GBP,Faster Payments,CodeCraft Contractors #11,***6552,,PO-202505-SaaS-GL-0002,False,False,REF-127125,First Continental Bank,***7646,Globex Consulting UK Ltd.,UK,-6096651.42
2025-05-29,2025-05-29,Client Receipt - CloudBridge Co. #15,Sales Receipt,SaaS-GL,0.0,1358.01,GBP,CHAPS Credit,CloudBridge Co. #15,***9873,INV-202505-SaaS-GL-0014,,False,False,REF-932638,First Continental Bank,***3675,Globex Consulting UK Ltd.,UK,-6095293.41
2025-05-29,2025-05-29,Client Receipt - Vertex Advisory Client #28,Sales Receipt,PS-GL,0.0,7732.76,GBP,Faster Payments Credit,Vertex Advisory Client #28,***5420,INV-202505-PS-GL-0003,,False,False,REF-745865,First Continental Bank,***6382,Globex Consulting UK Ltd.,UK,-6087560.65
2025-05-29,2025-05-29,Client Receipt - Vertex Advisory Client #49,Sales Receipt,PS-GL,0.0,10809.01,GBP,Faster Payments Credit,Vertex Advisory Client #49,***7933,INV-202505-PS-GL-0011,,False,False,REF-834086,First Continental Bank,***4260,Globex Consulting UK Ltd.,UK,-6076751.64
2025-05-29,2025-05-29,Client Receipt - Novatek Components Ltd #12,Sales Receipt,CEM-EMEA,0.0,15298.4,GBP,Faster Payments Credit,Novatek Components Ltd #12,***5556,INV-202505-CEM-EMEA-0014,,False,False,REF-507388,First Continental Bank,***8046,Globex Consulting UK Ltd.,UK,-6061453.24
2025-05-30,2025-05-30,Supplier Payment - ExpertNet Subcontractors #8,Supplier Payment,PS-GL,4483.37,0.0,GBP,Faster Payments,ExpertNet Subcontractors #8,***9527,,PO-202505-PS-GL-0006,False,False,REF-559018,First Continental Bank,***6719,Globex Consulting UK Ltd.,UK,-6065936.61
2025-05-30,2025-05-30,Supplier Payment - CodeCraft Contractors #13,Supplier Payment,SaaS-GL,8537.58,0.0,GBP,Faster Payments,CodeCraft Contractors #13,***1544,,PO-202505-SaaS-GL-0009,False,False,REF-259221,First Continental Bank,***3132,Globex Consulting UK Ltd.,UK,-6074474.19
2025-05-30,2025-05-30,Supplier Payment - Stelliform Parts BV #34,Supplier Payment,CEM-EMEA,11006.54,0.0,GBP,Faster Payments,Stelliform Parts BV #34,***2311,,PO-202505-CEM-EMEA-0001,False,False,REF-405537,First Continental Bank,***3163,Globex Consulting UK Ltd.,UK,-6085480.73
2025-05-30,2025-05-30,Interest Earned,Interest Income,ALL,0.0,12233.45,GBP,Faster Payments Credit,First Continental Bank,***5779,,,False,False,REF-724361,First Continental Bank,***9521,Globex Consulting UK Ltd.,UK,-6073247.28
2025-06-01,2025-06-01,Account Maintenance Fee,Bank/Merchant Fees,ALL,2500.0,0.0,GBP,Faster Payments,First Continental Bank,***2518,,,False,False,REF-299547,First Continental Bank,***5118,Globex Consulting UK Ltd.,UK,-6075747.28
2025-06-02,2025-06-02,Supplier Payment - EuroFab Assembly #19,Supplier Payment,CEM-EMEA,40486.16,0.0,GBP,Faster Payments,EuroFab Assembly #19,***3315,,PO-202506-CEM-EMEA-0003,False,False,REF-492587,First Continental Bank,***8356,Globex Consulting UK Ltd.,UK,-6116233.44
2025-06-02,2025-06-02,Client Receipt - CloudBridge Co. #43,Sales Receipt,SaaS-GL,0.0,13341.51,GBP,Faster Payments Credit,CloudBridge Co. #43,***4928,INV-202506-SaaS-GL-0014,,False,False,REF-264035,First Continental Bank,***3514,Globex Consulting UK Ltd.,UK,-6102891.93
2025-06-03,2025-06-03,Supplier Payment - ExpertNet Subcontractors #19,Supplier Payment,PS-GL,4098.3,0.0,GBP,Faster Payments,ExpertNet Subcontractors #19,***7893,,PO-202506-PS-GL-0005,False,False,REF-542229,First Continental Bank,***2931,Globex Consulting UK Ltd.,UK,-6106990.23
2025-06-03,2025-06-03,Supplier Payment - ExpertNet Subcontractors #18,Supplier Payment,PS-GL,5695.55,0.0,GBP,CHAPS,ExpertNet Subcontractors #18,***9529,,PO-202506-PS-GL-0001,False,False,REF-273485,First Continental Bank,***4953,Globex Consulting UK Ltd.,UK,-6112685.78
2025-06-05,2025-06-05,Supplier Payment - HyperCloud Infra #10,Supplier Payment,SaaS-GL,5128.06,0.0,GBP,CHAPS,HyperCloud Infra #10,***3380,,PO-202506-SaaS-GL-0004,False,False,REF-235181,First Continental Bank,***9383,Globex Consulting UK Ltd.,UK,-6117813.84
2025-06-05,2025-06-05,Supplier Payment - EuroFab Assembly #12,Supplier Payment,CEM-EMEA,64737.83,0.0,GBP,Faster Payments,EuroFab Assembly #12,***2664,,PO-202506-CEM-EMEA-0001,False,False,REF-528731,First Continental Bank,***2426,Globex Consulting UK Ltd.,UK,-6182551.67
2025-06-05,2025-06-05,Client Receipt - CloudBridge Co. #38,Sales Receipt,SaaS-GL,0.0,1967.14,GBP,Faster Payments Credit,CloudBridge Co. #38,***2329,INV-202506-SaaS-GL-0013,,False,False,REF-276368,First Continental Bank,***5257,Globex Consulting UK Ltd.,UK,-6180584.53
2025-06-05,2025-06-05,Client Receipt - Vertex Advisory Client #7,Sales Receipt,PS-GL,0.0,2561.43,GBP,Faster Payments Credit,Vertex Advisory Client #7,***2714,INV-202506-PS-GL-0007,,False,False,REF-879513,First Continental Bank,***1503,Globex Consulting UK Ltd.,UK,-6178023.1
2025-06-05,2025-06-05,Client Receipt - Aurora Electronics GmbH #11,Sales Receipt,CEM-EMEA,0.0,10078.83,GBP,Faster Payments Credit,Aurora Electronics GmbH #11,***8999,INV-202506-CEM-EMEA-0003,,False,False,REF-463639,First Continental Bank,***3523,Globex Consulting UK Ltd.,UK,-6167944.27
2025-06-05,2025-06-05,Client Receipt - Vertex Advisory Client #15,Sales Receipt,PS-GL,0.0,17142.85,GBP,CHAPS Credit,Vertex Advisory Client #15,***6171,INV-202506-PS-GL-0006,,False,False,REF-812235,First Continental Bank,***5505,Globex Consulting UK Ltd.,UK,-6150801.42
2025-06-06,2025-06-06,Client Receipt - Vertex Advisory Client #41,Sales Receipt,PS-GL,0.0,15414.51,GBP,Faster Payments Credit,Vertex Advisory Client #41,***5250,INV-202506-PS-GL-0003,,False,False,REF-636281,First Continental Bank,***4987,Globex Consulting UK Ltd.,UK,-6135386.91
2025-06-07,2025-06-07,Supplier Payment - ExpertNet Subcontractors #13,Supplier Payment,PS-GL,4309.7,0.0,GBP,Faster Payments,ExpertNet Subcontractors #13,***7797,,PO-202506-PS-GL-0010,False,False,REF-972619,First Continental Bank,***9815,Globex Consulting UK Ltd.,UK,-6139696.61
2025-06-07,2025-06-07,Supplier Payment - HyperCloud Infra #18,Supplier Payment,SaaS-GL,5058.51,0.0,GBP,Faster Payments,HyperCloud Infra #18,***3020,,PO-202506-SaaS-GL-0007,False,False,REF-662945,First Continental Bank,***5295,Globex Consulting UK Ltd.,UK,-6144755.12
2025-06-07,2025-06-07,Client Receipt - CloudBridge Co. #10,Sales Receipt,SaaS-GL,0.0,14004.05,GBP,Faster Payments Credit,CloudBridge Co. #10,***5515,INV-202506-SaaS-GL-0005,,False,False,REF-126447,First Continental Bank,***2234,Globex Consulting UK Ltd.,UK,-6130751.07
2025-06-09,2025-06-09,Client Receipt - Aurora Electronics GmbH #14,Sales Receipt,CEM-EMEA,0.0,10935.06,GBP,Faster Payments Credit,Aurora Electronics GmbH #14,***6073,INV-202506-CEM-EMEA-0006,,False,False,REF-985445,First Continental Bank,***5438,Globex Consulting UK Ltd.,UK,-6119816.01
2025-06-10,2025-06-10,Supplier Payment - CodeCraft Contractors #2,Supplier Payment,SaaS-GL,1397.12,0.0,GBP,Faster Payments,CodeCraft Contractors #2,***4819,,PO-202506-SaaS-GL-0002,False,False,REF-294556,First Continental Bank,***1671,Globex Consulting UK Ltd.,UK,-6121213.13
2025-06-10,2025-06-10,Marketing - Beacon Digital #9,Marketing,ALL,15725.5,0.0,GBP,CHAPS,Beacon Digital #9,***7738,,,False,False,REF-388933,First Continental Bank,***9934,Globex Consulting UK Ltd.,UK,-6136938.63
2025-06-10,2025-06-10,Client Receipt - Novatek Components Ltd #7,Sales Receipt,CEM-EMEA,0.0,33238.74,GBP,Faster Payments Credit,Novatek Components Ltd #7,***3699,INV-202506-CEM-EMEA-0005,,False,False,REF-157037,First Continental Bank,***8799,Globex Consulting UK Ltd.,UK,-6103699.89
2025-06-11,2025-06-11,Supplier Payment - ExpertNet Subcontractors #1,Supplier Payment,PS-GL,305.07,0.0,GBP,Faster Payments,ExpertNet Subcontractors #1,***3191,,PO-202506-PS-GL-0009,False,False,REF-688113,First Continental Bank,***4111,Globex Consulting UK Ltd.,UK,-6104004.96
2025-06-11,2025-06-11,Supplier Payment - EuroFab Assembly #16,Supplier Payment,CEM-EMEA,1026.68,0.0,GBP,Faster Payments,EuroFab Assembly #16,***5472,,PO-202506-CEM-EMEA-0007,False,False,REF-715485,First Continental Bank,***3251,Globex Consulting UK Ltd.,UK,-6105031.64
2025-06-11,2025-06-11,Client Receipt - Novatek Components Ltd #1,Sales Receipt,CEM-EMEA,0.0,1762.04,GBP,Faster Payments Credit,Novatek Components Ltd #1,***6096,INV-202506-CEM-EMEA-0007,,False,False,REF-836324,First Continental Bank,***5144,Globex Consulting UK Ltd.,UK,-6103269.6
2025-06-11,2025-06-11,Client Receipt - CloudBridge Co. #42,Sales Receipt,SaaS-GL,0.0,6862.75,GBP,CHAPS Credit,CloudBridge Co. #42,***1075,INV-202506-SaaS-GL-0011,,False,False,REF-198972,First Continental Bank,***8155,Globex Consulting UK Ltd.,UK,-6096406.85
2025-06-11,2025-06-11,Client Receipt - Aurora Electronics GmbH #14,Sales Receipt,CEM-EMEA,0.0,39424.62,GBP,Faster Payments Credit,Aurora Electronics GmbH #14,***7772,INV-202506-CEM-EMEA-0001,,False,False,REF-938436,First Continental Bank,***2887,Globex Consulting UK Ltd.,UK,-6056982.23
2025-06-12,2025-06-12,Merchant Processing Fees,Bank/Merchant Fees,ALL,962.97,0.0,GBP,Faster Payments,First Continental Bank,***8210,,,False,False,REF-323452,First Continental Bank,***5763,Globex Consulting UK Ltd.,UK,-6057945.2
2025-06-12,2025-06-12,Supplier Payment - ExpertNet Subcontractors #19,Supplier Payment,PS-GL,11947.96,0.0,GBP,Faster Payments,ExpertNet Subcontractors #19,***2876,,PO-202506-PS-GL-0008,False,False,REF-998419,First Continental Bank,***6151,Globex Consulting UK Ltd.,UK,-6069893.16
2025-06-12,2025-06-12,"Intercompany Settlement - Globex International Holdings, Inc.",Intercompany Transfer,ALL,536616.0,0.0,GBP,Internal Transfer,"Globex International Holdings, Inc.",***8032,,,True,True,REF-229461,First Continental Bank,***8781,Globex Consulting UK Ltd.,UK,-6606509.16
2025-06-12,2025-06-12,Client Receipt - CloudBridge Co. #9,Sales Receipt,SaaS-GL,0.0,7226.37,GBP,CHAPS Credit,CloudBridge Co. #9,***3224,INV-202506-SaaS-GL-0019,,False,False,REF-152438,First Continental Bank,***1468,Globex Consulting UK Ltd.,UK,-6599282.79
2025-06-12,2025-06-12,Client Receipt - Vertex Advisory Client #8,Sales Receipt,PS-GL,0.0,16544.57,GBP,CHAPS Credit,Vertex Advisory Client #8,***8664,INV-202506-PS-GL-0011,,False,False,REF-860547,First Continental Bank,***8504,Globex Consulting UK Ltd.,UK,-6582738.22
2025-06-13,2025-06-13,Supplier Payment - CodeCraft Contractors #12,Supplier Payment,SaaS-GL,737.74,0.0,GBP,Faster Payments,CodeCraft Contractors #12,***7312,,PO-202506-SaaS-GL-0001,False,False,REF-466562,First Continental Bank,***8141,Globex Consulting UK Ltd.,UK,-6583475.96
2025-06-13,2025-06-13,Supplier Payment - EuroFab Assembly #3,Supplier Payment,CEM-EMEA,31083.09,0.0,GBP,CHAPS,EuroFab Assembly #3,***3195,,PO-202506-CEM-EMEA-0004,False,False,REF-827564,First Continental Bank,***5971,Globex Consulting UK Ltd.,UK,-6614559.05
2025-06-14,2025-06-14,Supplier Payment - ExpertNet Subcontractors #16,Supplier Payment,PS-GL,1194.82,0.0,GBP,Faster Payments,ExpertNet Subcontractors #16,***6022,,PO-202506-PS-GL-0004,False,False,REF-688083,First Continental Bank,***4738,Globex Consulting UK Ltd.,UK,-6615753.87
2025-06-16,2025-06-16,Client Receipt - Novatek Components Ltd #2,Sales Receipt,CEM-EMEA,0.0,9753.02,GBP,CHAPS Credit,Novatek Components Ltd #2,***8236,INV-202506-CEM-EMEA-0008,,False,False,REF-451272,First Continental Bank,***7448,Globex Consulting UK Ltd.,UK,-6606000.85
2025-06-17,2025-06-17,Merchant Processing Fees,Bank/Merchant Fees,ALL,1044.52,0.0,GBP,CHAPS,First Continental Bank,***3959,,,False,False,REF-796617,First Continental Bank,***4521,Globex Consulting UK Ltd.,UK,-6607045.37
2025-06-17,2025-06-17,Client Receipt - Novatek Components Ltd #10,Sales Receipt,CEM-EMEA,0.0,25581.59,GBP,CHAPS Credit,Novatek Components Ltd #10,***2722,INV-202506-CEM-EMEA-0009,,False,False,REF-391606,First Continental Bank,***5498,Globex Consulting UK Ltd.,UK,-6581463.78
2025-06-17,2025-06-17,Client Receipt - Vertex Advisory Client #48,Sales Receipt,PS-GL,0.0,27008.5,GBP,Faster Payments Credit,Vertex Advisory Client #48,***5031,INV-202506-PS-GL-0002,,False,False,REF-817021,First Continental Bank,***9972,Globex Consulting UK Ltd.,UK,-6554455.28
2025-06-18,2025-06-18,Marketing - Aurelia Media #4,Marketing,ALL,982.83,0.0,GBP,Faster Payments,Aurelia Media #4,***5109,,,False,False,REF-157653,First Continental Bank,***4875,Globex Consulting UK Ltd.,UK,-6555438.11
2025-06-18,2025-06-18,Supplier Payment - ExpertNet Subcontractors #19,Supplier Payment,PS-GL,1557.63,0.0,GBP,Faster Payments,ExpertNet Subcontractors #19,***7084,,PO-202506-PS-GL-0006,False,False,REF-923526,First Continental Bank,***9014,Globex Consulting UK Ltd.,UK,-6556995.74
2025-06-18,2025-06-18,Client Receipt - CloudBridge Co. #72,Sales Receipt,SaaS-GL,0.0,4223.66,GBP,Faster Payments Credit,CloudBridge Co. #72,***7108,INV-202506-SaaS-GL-0004,,False,False,REF-124784,First Continental Bank,***5814,Globex Consulting UK Ltd.,UK,-6552772.08
2025-06-18,2025-06-18,Client Receipt - Vertex Advisory Client #11,Sales Receipt,PS-GL,0.0,6808.08,GBP,Faster Payments Credit,Vertex Advisory Client #11,***5579,INV-202506-PS-GL-0004,,False,False,REF-316098,First Continental Bank,***1335,Globex Consulting UK Ltd.,UK,-6545964.0
2025-06-18,2025-06-18,Client Receipt - CloudBridge Co. #71,Sales Receipt,SaaS-GL,0.0,12977.48,GBP,Faster Payments Credit,CloudBridge Co. #71,***7178,INV-202506-SaaS-GL-0020,,False,False,REF-867291,First Continental Bank,***8631,Globex Consulting UK Ltd.,UK,-6532986.52
2025-06-18,2025-06-18,Client Receipt - Novatek Components Ltd #5,Sales Receipt,CEM-EMEA,0.0,86915.83,GBP,Faster Payments Credit,Novatek Components Ltd #5,***2162,INV-202506-CEM-EMEA-0010,,False,False,REF-927263,First Continental Bank,***5162,Globex Consulting UK Ltd.,UK,-6446070.69
2025-06-19,2025-06-19,Client Receipt - CloudBridge Co. #59,Sales Receipt,SaaS-GL,0.0,1252.12,GBP,Faster Payments Credit,CloudBridge Co. #59,***4333,INV-202506-SaaS-GL-0021,,False,False,REF-352561,First Continental Bank,***4270,Globex Consulting UK Ltd.,UK,-6444818.57
2025-06-19,2025-06-19,Client Receipt - Novatek Components Ltd #14,Sales Receipt,CEM-EMEA,0.0,46417.47,GBP,Faster Payments Credit,Novatek Components Ltd #14,***6619,INV-202506-CEM-EMEA-0011,,False,False,REF-480632,First Continental Bank,***7250,Globex Consulting UK Ltd.,UK,-6398401.1
2025-06-20,2025-06-20,Alphagrid Utilities,Rent & Utilities,ALL,2593.86,0.0,GBP,Faster Payments,Alphagrid Utilities,***3968,,,False,False,REF-722921,First Continental Bank,***7822,Globex Consulting UK Ltd.,UK,-6400994.96
2025-06-20,2025-06-20,Client Receipt - CloudBridge Co. #78,Sales Receipt,SaaS-GL,0.0,1152.09,GBP,Faster Payments Credit,CloudBridge Co. #78,***3966,INV-202506-SaaS-GL-0006,,False,False,REF-588050,First Continental Bank,***6655,Globex Consulting UK Ltd.,UK,-6399842.87
2025-06-21,2025-06-21,VAT/GST Remittance - HMRC UK,Tax Payment,ALL,41618.54,0.0,GBP,Faster Payments,HMRC UK,***8697,,,False,False,REF-718202,First Continental Bank,***3652,Globex Consulting UK Ltd.,UK,-6441461.41
2025-06-22,2025-06-22,Supplier Payment - ExpertNet Subcontractors #16,Supplier Payment,PS-GL,1177.24,0.0,GBP,Faster Payments,ExpertNet Subcontractors #16,***1628,,PO-202506-PS-GL-0002,False,False,REF-512860,First Continental Bank,***4765,Globex Consulting UK Ltd.,UK,-6442638.65
2025-06-22,2025-06-22,Supplier Payment - CodeCraft Contractors #8,Supplier Payment,SaaS-GL,18578.87,0.0,GBP,Faster Payments,CodeCraft Contractors #8,***2476,,PO-202506-SaaS-GL-0006,False,False,REF-682988,First Continental Bank,***5659,Globex Consulting UK Ltd.,UK,-6461217.52
2025-06-22,2025-06-22,Client Receipt - CloudBridge Co. #23,Sales Receipt,SaaS-GL,0.0,7091.74,GBP,CHAPS Credit,CloudBridge Co. #23,***5335,INV-202506-SaaS-GL-0018,,False,False,REF-562943,First Continental Bank,***9485,Globex Consulting UK Ltd.,UK,-6454125.78
2025-06-23,2025-06-23,Client Receipt - Aurora Electronics GmbH #15,Sales Receipt,CEM-EMEA,0.0,4030.16,GBP,Faster Payments Credit,Aurora Electronics GmbH #15,***4389,INV-202506-CEM-EMEA-0004,,False,False,REF-150037,First Continental Bank,***9984,Globex Consulting UK Ltd.,UK,-6450095.62
2025-06-23,2025-06-23,Client Receipt - CloudBridge Co. #2,Sales Receipt,SaaS-GL,0.0,8060.15,GBP,CHAPS Credit,CloudBridge Co. #2,***1314,INV-202506-SaaS-GL-0012,,False,False,REF-926931,First Continental Bank,***5935,Globex Consulting UK Ltd.,UK,-6442035.47
2025-06-23,2025-06-23,Client Receipt - CloudBridge Co. #63,Sales Receipt,SaaS-GL,0.0,16483.91,GBP,Faster Payments Credit,CloudBridge Co. #63,***6194,INV-202506-SaaS-GL-0007,,False,False,REF-262516,First Continental Bank,***9197,Globex Consulting UK Ltd.,UK,-6425551.56
2025-06-24,2025-06-24,Supplier Payment - ExpertNet Subcontractors #8,Supplier Payment,PS-GL,578.93,0.0,GBP,Faster Payments,ExpertNet Subcontractors #8,***5925,,PO-202506-PS-GL-0007,False,False,REF-488078,First Continental Bank,***6033,Globex Consulting UK Ltd.,UK,-6426130.49
2025-06-24,2025-06-24,Supplier Payment - Stelliform Parts BV #33,Supplier Payment,CEM-EMEA,28963.7,0.0,GBP,CHAPS,Stelliform Parts BV #33,***9404,,PO-202506-CEM-EMEA-0002,False,False,REF-835980,First Continental Bank,***1408,Globex Consulting UK Ltd.,UK,-6455094.19
2025-06-24,2025-06-24,Client Receipt - CloudBridge Co. #1,Sales Receipt,SaaS-GL,0.0,18030.2,GBP,CHAPS Credit,CloudBridge Co. #1,***7867,INV-202506-SaaS-GL-0009,,False,False,REF-216496,First Continental Bank,***5223,Globex Consulting UK Ltd.,UK,-6437063.99
2025-06-25,2025-06-25,BluePeak Property Mgmt,Rent & Utilities,ALL,2885.79,0.0,GBP,Faster Payments,BluePeak Property Mgmt,***9738,,,False,False,REF-746435,First Continental Bank,***7949,Globex Consulting UK Ltd.,UK,-6439949.78
2025-06-25,2025-06-25,Client Receipt - Vertex Advisory Client #13,Sales Receipt,PS-GL,0.0,2480.93,GBP,CHAPS Credit,Vertex Advisory Client #13,***9526,INV-202506-PS-GL-0005,,False,False,REF-658694,First Continental Bank,***6374,Globex Consulting UK Ltd.,UK,-6437468.85
2025-06-26,2025-06-26,Supplier Payment - Stelliform Parts BV #8,Supplier Payment,CEM-EMEA,11746.19,0.0,GBP,CHAPS,Stelliform Parts BV #8,***3682,,PO-202506-CEM-EMEA-0005,False,False,REF-378950,First Continental Bank,***7332,Globex Consulting UK Ltd.,UK,-6449215.04
2025-06-26,2025-06-26,Intercompany Settlement - Globex APAC Logistics Pte. Ltd.,Intercompany Transfer,ALL,847862.0,0.0,GBP,Internal Transfer,Globex APAC Logistics Pte. Ltd.,***7888,,,True,True,REF-133023,First Continental Bank,***1348,Globex Consulting UK Ltd.,UK,-7297077.04
2025-06-26,2025-06-26,Client Receipt - Vertex Advisory Client #9,Sales Receipt,PS-GL,0.0,5976.34,GBP,CHAPS Credit,Vertex Advisory Client #9,***4837,INV-202506-PS-GL-0001,,False,False,REF-766245,First Continental Bank,***2757,Globex Consulting UK Ltd.,UK,-7291100.7
2025-06-26,2025-06-26,Client Receipt - CloudBridge Co. #52,Sales Receipt,SaaS-GL,0.0,11248.23,GBP,CHAPS Credit,CloudBridge Co. #52,***1282,INV-202506-SaaS-GL-0001,,False,False,REF-375482,First Continental Bank,***1762,Globex Consulting UK Ltd.,UK,-7279852.47
2025-06-26,2025-06-26,Client Receipt - Vertex Advisory Client #19,Sales Receipt,PS-GL,0.0,18545.71,GBP,CHAPS Credit,Vertex Advisory Client #19,***9475,INV-202506-PS-GL-0010,,False,False,REF-206558,First Continental Bank,***1517,Globex Consulting UK Ltd.,UK,-7261306.76
2025-06-26,2025-06-26,Client Receipt - Aurora Electronics GmbH #16,Sales Receipt,CEM-EMEA,0.0,35232.44,GBP,Faster Payments Credit,Aurora Electronics GmbH #16,***8700,INV-202506-CEM-EMEA-0002,,False,False,REF-893224,First Continental Bank,***8885,Globex Consulting UK Ltd.,UK,-7226074.32
2025-06-27,2025-06-27,Supplier Payment - ExpertNet Subcontractors #10,Supplier Payment,PS-GL,1769.32,0.0,GBP,Faster Payments,ExpertNet Subcontractors #10,***6041,,PO-202506-PS-GL-0011,False,False,REF-801016,First Continental Bank,***8476,Globex Consulting UK Ltd.,UK,-7227843.64
2025-06-27,2025-06-27,Supplier Payment - HyperCloud Infra #12,Supplier Payment,SaaS-GL,7048.92,0.0,GBP,CHAPS,HyperCloud Infra #12,***2548,,PO-202506-SaaS-GL-0003,False,False,REF-782560,First Continental Bank,***4774,Globex Consulting UK Ltd.,UK,-7234892.56
2025-06-27,2025-06-27,Client Receipt - CloudBridge Co. #58,Sales Receipt,SaaS-GL,0.0,2649.01,GBP,CHAPS Credit,CloudBridge Co. #58,***4633,INV-202506-SaaS-GL-0010,,False,False,REF-131088,First Continental Bank,***8898,Globex Consulting UK Ltd.,UK,-7232243.55
2025-06-27,2025-06-27,Client Receipt - Vertex Advisory Client #12,Sales Receipt,PS-GL,0.0,14847.95,GBP,CHAPS Credit,Vertex Advisory Client #12,***2047,INV-202506-PS-GL-0009,,False,False,REF-173997,First Continental Bank,***4035,Globex Consulting UK Ltd.,UK,-7217395.6
2025-06-27,2025-06-27,Client Receipt - CloudBridge Co. #2,Sales Receipt,SaaS-GL,0.0,24287.36,GBP,Faster Payments Credit,CloudBridge Co. #2,***9738,INV-202506-SaaS-GL-0016,,False,False,REF-838093,First Continental Bank,***1986,Globex Consulting UK Ltd.,UK,-7193108.24
2025-06-28,2025-06-28,Supplier Payment - ExpertNet Subcontractors #2,Supplier Payment,PS-GL,9754.04,0.0,GBP,Faster Payments,ExpertNet Subcontractors #2,***9902,,PO-202506-PS-GL-0003,False,False,REF-931193,First Continental Bank,***4618,Globex Consulting UK Ltd.,UK,-7202862.28
2025-06-28,2025-06-28,Supplier Payment - Stelliform Parts BV #4,Supplier Payment,CEM-EMEA,16464.6,0.0,GBP,CHAPS,Stelliform Parts BV #4,***2495,,PO-202506-CEM-EMEA-0008,False,False,REF-102834,First Continental Bank,***4171,Globex Consulting UK Ltd.,UK,-7219326.88
2025-06-28,2025-06-28,Client Receipt - CloudBridge Co. #76,Sales Receipt,SaaS-GL,0.0,8033.1,GBP,CHAPS Credit,CloudBridge Co. #76,***2504,INV-202506-SaaS-GL-0003,,False,False,REF-706206,First Continental Bank,***7338,Globex Consulting UK Ltd.,UK,-7211293.78
2025-06-29,2025-06-29,Payroll - GlobalPay Services Ltd,Payroll,ALL,109099.65,0.0,GBP,Faster Payments,GlobalPay Services Ltd,***9703,,,False,False,REF-666880,First Continental Bank,***5538,Globex Consulting UK Ltd.,UK,-7320393.43
2025-06-29,2025-06-29,Client Receipt - CloudBridge Co. #75,Sales Receipt,SaaS-GL,0.0,3849.28,GBP,CHAPS Credit,CloudBridge Co. #75,***2055,INV-202506-SaaS-GL-0002,,False,False,REF-763054,First Continental Bank,***6057,Globex Consulting UK Ltd.,UK,-7316544.15
2025-06-29,2025-06-29,Client Receipt - CloudBridge Co. #16,Sales Receipt,SaaS-GL,0.0,9625.98,GBP,Faster Payments Credit,CloudBridge Co. #16,***6865,INV-202506-SaaS-GL-0017,,False,False,REF-146214,First Continental Bank,***7009,Globex Consulting UK Ltd.,UK,-7306918.17
2025-06-29,2025-06-29,Client Receipt - CloudBridge Co. #11,Sales Receipt,SaaS-GL,0.0,22152.66,GBP,CHAPS Credit,CloudBridge Co. #11,***6211,INV-202506-SaaS-GL-0015,,False,False,REF-531685,First Continental Bank,***8878,Globex Consulting UK Ltd.,UK,-7284765.51
2025-06-30,2025-06-30,Supplier Payment - CodeCraft Contractors #12,Supplier Payment,SaaS-GL,393.2,0.0,GBP,Faster Payments,CodeCraft Contractors #12,***3768,,PO-202506-SaaS-GL-0005,False,False,REF-203646,First Continental Bank,***9995,Globex Consulting UK Ltd.,UK,-7285158.71
2025-06-30,2025-06-30,Supplier Payment - Stelliform Parts BV #33,Supplier Payment,CEM-EMEA,3305.04,0.0,GBP,CHAPS,Stelliform Parts BV #33,***3867,,PO-202506-CEM-EMEA-0006,False,False,REF-718884,First Continental Bank,***2022,Globex Consulting UK Ltd.,UK,-7288463.75
2025-06-30,2025-06-30,Supplier Payment - HyperCloud Infra #1,Supplier Payment,SaaS-GL,8285.0,0.0,GBP,Faster Payments,HyperCloud Infra #1,***3498,,PO-202506-SaaS-GL-0008,False,False,REF-208030,First Continental Bank,***7104,Globex Consulting UK Ltd.,UK,-7296748.75
2025-06-30,2025-06-30,Client Receipt - CloudBridge Co. #3,Sales Receipt,SaaS-GL,0.0,6854.94,GBP,Faster Payments Credit,CloudBridge Co. #3,***6293,INV-202506-SaaS-GL-0008,,False,False,REF-674121,First Continental Bank,***5094,Globex Consulting UK Ltd.,UK,-7289893.81
2025-06-30,2025-06-30,Client Receipt - CloudBridge Co. #47,Sales Receipt,SaaS-GL,0.0,10569.08,GBP,CHAPS Credit,CloudBridge Co. #47,***7546,INV-202506-SaaS-GL-0022,,False,False,REF-816147,First Continental Bank,***4472,Globex Consulting UK Ltd.,UK,-7279324.73
2025-06-30,2025-06-30,Interest Earned,Interest Income,ALL,0.0,11376.91,GBP,CHAPS Credit,First Continental Bank,***4635,,,False,False,REF-653247,First Continental Bank,***3923,Globex Consulting UK Ltd.,UK,-7267947.82
2025-06-30,2025-06-30,Client Receipt - Vertex Advisory Client #59,Sales Receipt,PS-GL,0.0,13964.34,GBP,Faster Payments Credit,Vertex Advisory Client #59,***9403,INV-202506-PS-GL-0008,,False,False,REF-328658,First Continental Bank,***1248,Globex Consulting UK Ltd.,UK,-7253983.48
2025-06-30,2025-06-30,Client Receipt - Aurora Electronics GmbH #16,Sales Receipt,CEM-EMEA,0.0,26319.01,GBP,CHAPS Credit,Aurora Electronics GmbH #16,***5546,INV-202506-CEM-EMEA-0012,,False,False,REF-444464,First Continental Bank,***1744,Globex Consulting UK Ltd.,UK,-7227664.47
2025-07-01,2025-07-01,Supplier Payment - EuroFab Assembly #11,Supplier Payment,CEM-EMEA,1077.78,0.0,GBP,Faster Payments,EuroFab Assembly #11,***7382,,PO-202507-CEM-EMEA-0003,False,False,REF-738912,First Continental Bank,***7327,Globex Consulting UK Ltd.,UK,-7228742.25
2025-07-01,2025-07-01,Account Maintenance Fee,Bank/Merchant Fees,ALL,2500.0,0.0,GBP,Faster Payments,First Continental Bank,***8553,,,False,False,REF-614506,First Continental Bank,***4749,Globex Consulting UK Ltd.,UK,-7231242.25
2025-07-01,2025-07-01,Supplier Payment - CodeCraft Contractors #1,Supplier Payment,SaaS-GL,5893.64,0.0,GBP,Faster Payments,CodeCraft Contractors #1,***9550,,PO-202507-SaaS-GL-0002,False,False,REF-947021,First Continental Bank,***2765,Globex Consulting UK Ltd.,UK,-7237135.89
2025-07-01,2025-07-01,Client Receipt - Vertex Advisory Client #19,Sales Receipt,PS-GL,0.0,25518.7,GBP,Faster Payments Credit,Vertex Advisory Client #19,***9136,INV-202507-PS-GL-0006,,False,False,REF-236838,First Continental Bank,***1927,Globex Consulting UK Ltd.,UK,-7211617.19
2025-07-01,2025-07-01,Client Receipt - Aurora Electronics GmbH #3,Sales Receipt,CEM-EMEA,0.0,48709.14,GBP,Faster Payments Credit,Aurora Electronics GmbH #3,***8339,INV-202507-CEM-EMEA-0012,,False,False,REF-665170,First Continental Bank,***7827,Globex Consulting UK Ltd.,UK,-7162908.05
2025-07-02,2025-07-02,Supplier Payment - ExpertNet Subcontractors #11,Supplier Payment,PS-GL,2097.6,0.0,GBP,CHAPS,ExpertNet Subcontractors #11,***4236,,PO-202507-PS-GL-0009,False,False,REF-614626,First Continental Bank,***4992,Globex Consulting UK Ltd.,UK,-7165005.65
2025-07-02,2025-07-02,Client Receipt - CloudBridge Co. #57,Sales Receipt,SaaS-GL,0.0,2003.68,GBP,Faster Payments Credit,CloudBridge Co. #57,***9998,INV-202507-SaaS-GL-0002,,False,False,REF-574914,First Continental Bank,***8744,Globex Consulting UK Ltd.,UK,-7163001.97
2025-07-02,2025-07-02,Client Receipt - CloudBridge Co. #69,Sales Receipt,SaaS-GL,0.0,10912.47,GBP,Faster Payments Credit,CloudBridge Co. #69,***5558,INV-202507-SaaS-GL-0007,,False,False,REF-956333,First Continental Bank,***6494,Globex Consulting UK Ltd.,UK,-7152089.5
2025-07-03,2025-07-03,Merchant Processing Fees,Bank/Merchant Fees,ALL,467.99,0.0,GBP,Faster Payments,First Continental Bank,***7786,,,False,False,REF-396256,First Continental Bank,***5811,Globex Consulting UK Ltd.,UK,-7152557.49
2025-07-03,2025-07-03,Supplier Payment - HyperCloud Infra #15,Supplier Payment,SaaS-GL,2515.95,0.0,GBP,Faster Payments,HyperCloud Infra #15,***7707,,PO-202507-SaaS-GL-0008,False,False,REF-975417,First Continental Bank,***6171,Globex Consulting UK Ltd.,UK,-7155073.44
2025-07-03,2025-07-03,Marketing - Aurelia Media #10,Marketing,ALL,2913.26,0.0,GBP,Faster Payments,Aurelia Media #10,***5998,,,False,False,REF-406098,First Continental Bank,***3998,Globex Consulting UK Ltd.,UK,-7157986.7
2025-07-03,2025-07-03,Client Receipt - CloudBridge Co. #15,Sales Receipt,SaaS-GL,0.0,9533.45,GBP,CHAPS Credit,CloudBridge Co. #15,***4519,INV-202507-SaaS-GL-0013,,False,False,REF-688030,First Continental Bank,***5797,Globex Consulting UK Ltd.,UK,-7148453.25
2025-07-03,2025-07-03,Client Receipt - Vertex Advisory Client #41,Sales Receipt,PS-GL,0.0,15463.27,GBP,Faster Payments Credit,Vertex Advisory Client #41,***3946,INV-202507-PS-GL-0003,,False,False,REF-557239,First Continental Bank,***3348,Globex Consulting UK Ltd.,UK,-7132989.98
2025-07-03,2025-07-03,Client Receipt - Aurora Electronics GmbH #7,Sales Receipt,CEM-EMEA,0.0,77097.27,GBP,CHAPS Credit,Aurora Electronics GmbH #7,***3385,INV-202507-CEM-EMEA-0007,,False,False,REF-247443,First Continental Bank,***3808,Globex Consulting UK Ltd.,UK,-7055892.71
2025-07-05,2025-07-05,Supplier Payment - ExpertNet Subcontractors #19,Supplier Payment,PS-GL,6974.78,0.0,GBP,Faster Payments,ExpertNet Subcontractors #19,***3034,,PO-202507-PS-GL-0007,False,False,REF-579755,First Continental Bank,***5237,Globex Consulting UK Ltd.,UK,-7062867.49
2025-07-05,2025-07-05,Client Receipt - CloudBridge Co. #55,Sales Receipt,SaaS-GL,0.0,4148.71,GBP,Faster Payments Credit,CloudBridge Co. #55,***4469,INV-202507-SaaS-GL-0022,,False,False,REF-727387,First Continental Bank,***2920,Globex Consulting UK Ltd.,UK,-7058718.78
2025-07-05,2025-07-05,Client Receipt - Vertex Advisory Client #55,Sales Receipt,PS-GL,0.0,13386.88,GBP,Faster Payments Credit,Vertex Advisory Client #55,***9947,INV-202507-PS-GL-0002,,False,False,REF-765104,First Continental Bank,***4820,Globex Consulting UK Ltd.,UK,-7045331.9
2025-07-05,2025-07-05,Client Receipt - CloudBridge Co. #1,Sales Receipt,SaaS-GL,0.0,14451.74,GBP,Faster Payments Credit,CloudBridge Co. #1,***7885,INV-202507-SaaS-GL-0016,,False,False,REF-687549,First Continental Bank,***2012,Globex Consulting UK Ltd.,UK,-7030880.16
2025-07-06,2025-07-06,Client Receipt - Novatek Components Ltd #6,Sales Receipt,CEM-EMEA,0.0,4397.27,GBP,Faster Payments Credit,Novatek Components Ltd #6,***3874,INV-202507-CEM-EMEA-0008,,False,False,REF-954574,First Continental Bank,***8175,Globex Consulting UK Ltd.,UK,-7026482.89
2025-07-07,2025-07-07,Merchant Processing Fees,Bank/Merchant Fees,ALL,1498.97,0.0,GBP,CHAPS,First Continental Bank,***3018,,,False,False,REF-369809,First Continental Bank,***2713,Globex Consulting UK Ltd.,UK,-7027981.86
2025-07-07,2025-07-07,Supplier Payment - HyperCloud Infra #18,Supplier Payment,SaaS-GL,17267.42,0.0,GBP,CHAPS,HyperCloud Infra #18,***9273,,PO-202507-SaaS-GL-0004,False,False,REF-642944,First Continental Bank,***3146,Globex Consulting UK Ltd.,UK,-7045249.28
2025-07-07,2025-07-07,Client Receipt - Vertex Advisory Client #27,Sales Receipt,PS-GL,0.0,3419.8,GBP,CHAPS Credit,Vertex Advisory Client #27,***4971,INV-202507-PS-GL-0005,,False,False,REF-368066,First Continental Bank,***7402,Globex Consulting UK Ltd.,UK,-7041829.48
2025-07-08,2025-07-08,Supplier Payment - HyperCloud Infra #15,Supplier Payment,SaaS-GL,3173.57,0.0,GBP,CHAPS,HyperCloud Infra #15,***2065,,PO-202507-SaaS-GL-0010,False,False,REF-406556,First Continental Bank,***1367,Globex Consulting UK Ltd.,UK,-7045003.05
2025-07-08,2025-07-08,Client Receipt - Vertex Advisory Client #23,Sales Receipt,PS-GL,0.0,15261.84,GBP,CHAPS Credit,Vertex Advisory Client #23,***5233,INV-202507-PS-GL-0004,,False,False,REF-305401,First Continental Bank,***1717,Globex Consulting UK Ltd.,UK,-7029741.21
2025-07-09,2025-07-09,Supplier Payment - ExpertNet Subcontractors #3,Supplier Payment,PS-GL,1952.89,0.0,GBP,CHAPS,ExpertNet Subcontractors #3,***1992,,PO-202507-PS-GL-0010,False,False,REF-268745,First Continental Bank,***4739,Globex Consulting UK Ltd.,UK,-7031694.1
2025-07-09,2025-07-09,Supplier Payment - Stelliform Parts BV #2,Supplier Payment,CEM-EMEA,3363.19,0.0,GBP,CHAPS,Stelliform Parts BV #2,***7570,,PO-202507-CEM-EMEA-0007,False,False,REF-372812,First Continental Bank,***4933,Globex Consulting UK Ltd.,UK,-7035057.29
2025-07-09,2025-07-09,Supplier Payment - Stelliform Parts BV #7,Supplier Payment,CEM-EMEA,11082.97,0.0,GBP,CHAPS,Stelliform Parts BV #7,***1183,,PO-202507-CEM-EMEA-0001,False,False,REF-635601,First Continental Bank,***6163,Globex Consulting UK Ltd.,UK,-7046140.26
2025-07-09,2025-07-09,Client Receipt - Aurora Electronics GmbH #14,Sales Receipt,CEM-EMEA,0.0,1389.81,GBP,Faster Payments Credit,Aurora Electronics GmbH #14,***6489,INV-202507-CEM-EMEA-0003,,False,False,REF-459301,First Continental Bank,***1247,Globex Consulting UK Ltd.,UK,-7044750.45
2025-07-09,2025-07-09,Client Receipt - Vertex Advisory Client #25,Sales Receipt,PS-GL,0.0,34870.81,GBP,CHAPS Credit,Vertex Advisory Client #25,***9280,INV-202507-PS-GL-0007,,False,False,REF-529947,First Continental Bank,***9224,Globex Consulting UK Ltd.,UK,-7009879.64
2025-07-10,2025-07-10,Alphagrid Utilities,Rent & Utilities,ALL,2887.84,0.0,GBP,CHAPS,Alphagrid Utilities,***1534,,,False,False,REF-290498,First Continental Bank,***2182,Globex Consulting UK Ltd.,UK,-7012767.48
2025-07-10,2025-07-10,Client Receipt - CloudBridge Co. #61,Sales Receipt,SaaS-GL,0.0,1288.43,GBP,CHAPS Credit,CloudBridge Co. #61,***3439,INV-202507-SaaS-GL-0015,,False,False,REF-228426,First Continental Bank,***3085,Globex Consulting UK Ltd.,UK,-7011479.05
2025-07-10,2025-07-10,Client Receipt - CloudBridge Co. #71,Sales Receipt,SaaS-GL,0.0,10469.5,GBP,CHAPS Credit,CloudBridge Co. #71,***9790,INV-202507-SaaS-GL-0005,,False,False,REF-723739,First Continental Bank,***9062,Globex Consulting UK Ltd.,UK,-7001009.55
2025-07-10,2025-07-10,Client Receipt - Aurora Electronics GmbH #14,Sales Receipt,CEM-EMEA,0.0,11782.09,GBP,CHAPS Credit,Aurora Electronics GmbH #14,***3377,INV-202507-CEM-EMEA-0005,,False,False,REF-210389,First Continental Bank,***8183,Globex Consulting UK Ltd.,UK,-6989227.46
2025-07-10,2025-07-10,Client Receipt - CloudBridge Co. #16,Sales Receipt,SaaS-GL,0.0,17069.84,GBP,CHAPS Credit,CloudBridge Co. #16,***5023,INV-202507-SaaS-GL-0004,,False,False,REF-909099,First Continental Bank,***1857,Globex Consulting UK Ltd.,UK,-6972157.62
2025-07-10,2025-07-10,Client Receipt - CloudBridge Co. #22,Sales Receipt,SaaS-GL,0.0,21589.52,GBP,Faster Payments Credit,CloudBridge Co. #22,***3605,INV-202507-SaaS-GL-0010,,False,False,REF-104536,First Continental Bank,***7207,Globex Consulting UK Ltd.,UK,-6950568.1
2025-07-11,2025-07-11,Supplier Payment - ExpertNet Subcontractors #15,Supplier Payment,PS-GL,714.9,0.0,GBP,Faster Payments,ExpertNet Subcontractors #15,***5096,,PO-202507-PS-GL-0006,False,False,REF-486053,First Continental Bank,***3810,Globex Consulting UK Ltd.,UK,-6951283.0
2025-07-11,2025-07-11,Supplier Payment - CodeCraft Contractors #9,Supplier Payment,SaaS-GL,2067.86,0.0,GBP,CHAPS,CodeCraft Contractors #9,***7773,,PO-202507-SaaS-GL-0005,False,False,REF-443878,First Continental Bank,***7839,Globex Consulting UK Ltd.,UK,-6953350.86
2025-07-12,2025-07-12,Intercompany Settlement - Globex Retail NA LLC,Intercompany Transfer,ALL,150556.0,0.0,GBP,Internal Transfer,Globex Retail NA LLC,***2298,,,True,True,REF-633198,First Continental Bank,***9062,Globex Consulting UK Ltd.,UK,-7103906.86
2025-07-12,2025-07-12,Client Receipt - Novatek Components Ltd #10,Sales Receipt,CEM-EMEA,0.0,6773.08,GBP,Faster Payments Credit,Novatek Components Ltd #10,***5544,INV-202507-CEM-EMEA-0006,,False,False,REF-971743,First Continental Bank,***4108,Globex Consulting UK Ltd.,UK,-7097133.78
2025-07-12,2025-07-12,Client Receipt - Aurora Electronics GmbH #10,Sales Receipt,CEM-EMEA,0.0,28728.93,GBP,Faster Payments Credit,Aurora Electronics GmbH #10,***8443,INV-202507-CEM-EMEA-0010,,False,False,REF-978967,First Continental Bank,***1455,Globex Consulting UK Ltd.,UK,-7068404.85
2025-07-12,2025-07-12,Intercompany Reimbursement - Globex Retail NA LLC,Intercompany Transfer,ALL,0.0,60222.4,GBP,Internal Transfer,Globex Retail NA LLC,***3278,,,True,True,REF-285903,First Continental Bank,***8404,Globex Consulting UK Ltd.,UK,-7008182.45
2025-07-14,2025-07-14,Supplier Payment - HyperCloud Infra #9,Supplier Payment,SaaS-GL,111.96,0.0,GBP,CHAPS,HyperCloud Infra #9,***8300,,PO-202507-SaaS-GL-0001,False,False,REF-954296,First Continental Bank,***2414,Globex Consulting UK Ltd.,UK,-7008294.41
2025-07-15,2025-07-15,Supplier Payment - CodeCraft Contractors #8,Supplier Payment,SaaS-GL,4337.34,0.0,GBP,Faster Payments,CodeCraft Contractors #8,***9435,,PO-202507-SaaS-GL-0003,False,False,REF-109919,First Continental Bank,***2999,Globex Consulting UK Ltd.,UK,-7012631.75
2025-07-15,2025-07-15,Client Receipt - CloudBridge Co. #57,Sales Receipt,SaaS-GL,0.0,9999.07,GBP,CHAPS Credit,CloudBridge Co. #57,***6722,INV-202507-SaaS-GL-0008,,False,False,REF-785311,First Continental Bank,***9427,Globex Consulting UK Ltd.,UK,-7002632.68
2025-07-16,2025-07-16,Supplier Payment - ExpertNet Subcontractors #13,Supplier Payment,PS-GL,1047.32,0.0,GBP,CHAPS,ExpertNet Subcontractors #13,***3116,,PO-202507-PS-GL-0004,False,False,REF-831463,First Continental Bank,***4075,Globex Consulting UK Ltd.,UK,-7003680.0
2025-07-16,2025-07-16,Supplier Payment - ExpertNet Subcontractors #6,Supplier Payment,PS-GL,3824.73,0.0,GBP,CHAPS,ExpertNet Subcontractors #6,***7223,,PO-202507-PS-GL-0003,False,False,REF-800879,First Continental Bank,***5384,Globex Consulting UK Ltd.,UK,-7007504.73
2025-07-16,2025-07-16,Supplier Payment - Stelliform Parts BV #30,Supplier Payment,CEM-EMEA,14499.35,0.0,GBP,CHAPS,Stelliform Parts BV #30,***9116,,PO-202507-CEM-EMEA-0010,False,False,REF-211030,First Continental Bank,***9538,Globex Consulting UK Ltd.,UK,-7022004.08
2025-07-16,2025-07-16,Client Receipt - CloudBridge Co. #28,Sales Receipt,SaaS-GL,0.0,1300.26,GBP,Faster Payments Credit,CloudBridge Co. #28,***7584,INV-202507-SaaS-GL-0009,,False,False,REF-528247,First Continental Bank,***9951,Globex Consulting UK Ltd.,UK,-7020703.82
2025-07-16,2025-07-16,Client Receipt - CloudBridge Co. #28,Sales Receipt,SaaS-GL,0.0,3831.45,GBP,Faster Payments Credit,CloudBridge Co. #28,***1443,INV-202507-SaaS-GL-0023,,False,False,REF-164481,First Continental Bank,***9306,Globex Consulting UK Ltd.,UK,-7016872.37
2025-07-16,2025-07-16,Client Receipt - CloudBridge Co. #58,Sales Receipt,SaaS-GL,0.0,11588.98,GBP,CHAPS Credit,CloudBridge Co. #58,***3471,INV-202507-SaaS-GL-0019,,False,False,REF-894376,First Continental Bank,***9169,Globex Consulting UK Ltd.,UK,-7005283.39
2025-07-17,2025-07-17,BluePeak Property Mgmt,Rent & Utilities,ALL,2251.14,0.0,GBP,Faster Payments,BluePeak Property Mgmt,***8867,,,False,False,REF-779733,First Continental Bank,***1180,Globex Consulting UK Ltd.,UK,-7007534.53
2025-07-17,2025-07-17,Supplier Payment - ExpertNet Subcontractors #7,Supplier Payment,PS-GL,9444.0,0.0,GBP,Faster Payments,ExpertNet Subcontractors #7,***1199,,PO-202507-PS-GL-0005,False,False,REF-340608,First Continental Bank,***6236,Globex Consulting UK Ltd.,UK,-7016978.53
2025-07-18,2025-07-18,Client Receipt - Novatek Components Ltd #12,Sales Receipt,CEM-EMEA,0.0,15476.2,GBP,Faster Payments Credit,Novatek Components Ltd #12,***8754,INV-202507-CEM-EMEA-0009,,False,False,REF-899035,First Continental Bank,***7346,Globex Consulting UK Ltd.,UK,-7001502.33
2025-07-19,2025-07-19,Client Receipt - CloudBridge Co. #71,Sales Receipt,SaaS-GL,0.0,6983.59,GBP,CHAPS Credit,CloudBridge Co. #71,***3336,INV-202507-SaaS-GL-0014,,False,False,REF-721477,First Continental Bank,***7835,Globex Consulting UK Ltd.,UK,-6994518.74
2025-07-19,2025-07-19,Client Receipt - CloudBridge Co. #30,Sales Receipt,SaaS-GL,0.0,8476.88,GBP,CHAPS Credit,CloudBridge Co. #30,***1778,INV-202507-SaaS-GL-0003,,False,False,REF-495696,First Continental Bank,***6414,Globex Consulting UK Ltd.,UK,-6986041.86
2025-07-20,2025-07-20,Supplier Payment - CodeCraft Contractors #12,Supplier Payment,SaaS-GL,2253.76,0.0,GBP,CHAPS,CodeCraft Contractors #12,***6039,,PO-202507-SaaS-GL-0007,False,False,REF-566866,First Continental Bank,***2569,Globex Consulting UK Ltd.,UK,-6988295.62
2025-07-20,2025-07-20,Client Receipt - Aurora Electronics GmbH #15,Sales Receipt,CEM-EMEA,0.0,35738.11,GBP,Faster Payments Credit,Aurora Electronics GmbH #15,***3938,INV-202507-CEM-EMEA-0011,,False,False,REF-739318,First Continental Bank,***7778,Globex Consulting UK Ltd.,UK,-6952557.51
2025-07-21,2025-07-21,Supplier Payment - CodeCraft Contractors #11,Supplier Payment,SaaS-GL,1238.88,0.0,GBP,CHAPS,CodeCraft Contractors #11,***6344,,PO-202507-SaaS-GL-0009,False,False,REF-916226,First Continental Bank,***8484,Globex Consulting UK Ltd.,UK,-6953796.39
2025-07-21,2025-07-21,Supplier Payment - ExpertNet Subcontractors #18,Supplier Payment,PS-GL,3119.56,0.0,GBP,CHAPS,ExpertNet Subcontractors #18,***7809,,PO-202507-PS-GL-0002,False,False,REF-870482,First Continental Bank,***4190,Globex Consulting UK Ltd.,UK,-6956915.95
2025-07-21,2025-07-21,Supplier Payment - Stelliform Parts BV #9,Supplier Payment,CEM-EMEA,51660.75,0.0,GBP,Faster Payments,Stelliform Parts BV #9,***8493,,PO-202507-CEM-EMEA-0011,False,False,REF-257514,First Continental Bank,***6792,Globex Consulting UK Ltd.,UK,-7008576.7
2025-07-21,2025-07-21,Client Receipt - Aurora Electronics GmbH #9,Sales Receipt,CEM-EMEA,0.0,6782.07,GBP,Faster Payments Credit,Aurora Electronics GmbH #9,***4362,INV-202507-CEM-EMEA-0002,,False,False,REF-546261,First Continental Bank,***6767,Globex Consulting UK Ltd.,UK,-7001794.63
2025-07-21,2025-07-21,Client Receipt - CloudBridge Co. #22,Sales Receipt,SaaS-GL,0.0,9430.9,GBP,Faster Payments Credit,CloudBridge Co. #22,***8516,INV-202507-SaaS-GL-0012,,False,False,REF-340674,First Continental Bank,***6769,Globex Consulting UK Ltd.,UK,-6992363.73
2025-07-22,2025-07-22,Supplier Payment - HyperCloud Infra #2,Supplier Payment,SaaS-GL,5546.68,0.0,GBP,CHAPS,HyperCloud Infra #2,***9305,,PO-202507-SaaS-GL-0006,False,False,REF-152490,First Continental Bank,***4238,Globex Consulting UK Ltd.,UK,-6997910.41
2025-07-22,2025-07-22,VAT/GST Remittance - HMRC UK,Tax Payment,ALL,38823.71,0.0,GBP,SWIFT MT103,HMRC UK,***9474,,,False,False,REF-900276,First Continental Bank,***7720,Globex Consulting UK Ltd.,UK,-7036734.12
2025-07-23,2025-07-23,Client Receipt - CloudBridge Co. #17,Sales Receipt,SaaS-GL,0.0,11564.43,GBP,CHAPS Credit,CloudBridge Co. #17,***2119,INV-202507-SaaS-GL-0018,,False,False,REF-941427,First Continental Bank,***4655,Globex Consulting UK Ltd.,UK,-7025169.69
2025-07-23,2025-07-23,Client Receipt - Vertex Advisory Client #29,Sales Receipt,PS-GL,0.0,12179.13,GBP,Faster Payments Credit,Vertex Advisory Client #29,***6484,INV-202507-PS-GL-0001,,False,False,REF-362232,First Continental Bank,***8689,Globex Consulting UK Ltd.,UK,-7012990.56
2025-07-23,2025-07-23,Client Receipt - CloudBridge Co. #42,Sales Receipt,SaaS-GL,0.0,20744.94,GBP,Faster Payments Credit,CloudBridge Co. #42,***4414,INV-202507-SaaS-GL-0006,,False,False,REF-257684,First Continental Bank,***1215,Globex Consulting UK Ltd.,UK,-6992245.62
2025-07-24,2025-07-24,Supplier Payment - EuroFab Assembly #12,Supplier Payment,CEM-EMEA,1091.32,0.0,GBP,CHAPS,EuroFab Assembly #12,***2482,,PO-202507-CEM-EMEA-0006,False,False,REF-515958,First Continental Bank,***1999,Globex Consulting UK Ltd.,UK,-6993336.94
2025-07-24,2025-07-24,Supplier Payment - Stelliform Parts BV #27,Supplier Payment,CEM-EMEA,25599.57,0.0,GBP,Faster Payments,Stelliform Parts BV #27,***8255,,PO-202507-CEM-EMEA-0002,False,False,REF-377314,First Continental Bank,***7395,Globex Consulting UK Ltd.,UK,-7018936.51
2025-07-24,2025-07-24,Client Receipt - Vertex Advisory Client #5,Sales Receipt,PS-GL,0.0,14466.43,GBP,Faster Payments Credit,Vertex Advisory Client #5,***7621,INV-202507-PS-GL-0008,,False,False,REF-842921,First Continental Bank,***5756,Globex Consulting UK Ltd.,UK,-7004470.08
2025-07-25,2025-07-25,Marketing - Aurelia Media #6,Marketing,ALL,12692.73,0.0,GBP,Faster Payments,Aurelia Media #6,***6503,,,False,False,REF-466963,First Continental Bank,***5001,Globex Consulting UK Ltd.,UK,-7017162.81
2025-07-25,2025-07-25,Client Receipt - CloudBridge Co. #37,Sales Receipt,SaaS-GL,0.0,5050.87,GBP,CHAPS Credit,CloudBridge Co. #37,***1889,INV-202507-SaaS-GL-0020,,False,False,REF-879329,First Continental Bank,***4452,Globex Consulting UK Ltd.,UK,-7012111.94
2025-07-26,2025-07-26,Supplier Payment - EuroFab Assembly #24,Supplier Payment,CEM-EMEA,14622.51,0.0,GBP,Faster Payments,EuroFab Assembly #24,***1399,,PO-202507-CEM-EMEA-0004,False,False,REF-321009,First Continental Bank,***9269,Globex Consulting UK Ltd.,UK,-7026734.45
2025-07-26,2025-07-26,Intercompany Settlement - Globex APAC Logistics Pte. Ltd.,Intercompany Transfer,ALL,796387.0,0.0,GBP,Internal Transfer,Globex APAC Logistics Pte. Ltd.,***5261,,,True,True,REF-454342,First Continental Bank,***4294,Globex Consulting UK Ltd.,UK,-7823121.45
2025-07-27,2025-07-27,Supplier Payment - ExpertNet Subcontractors #18,Supplier Payment,PS-GL,3424.87,0.0,GBP,CHAPS,ExpertNet Subcontractors #18,***5377,,PO-202507-PS-GL-0001,False,False,REF-667666,First Continental Bank,***4719,Globex Consulting UK Ltd.,UK,-7826546.32
2025-07-27,2025-07-27,Payroll - GlobalPay Services Ltd,Payroll,ALL,105158.01,0.0,GBP,Faster Payments,GlobalPay Services Ltd,***5043,,,False,False,REF-521926,First Continental Bank,***4767,Globex Consulting UK Ltd.,UK,-7931704.33
2025-07-28,2025-07-28,Corporate Tax Estimate,Tax Payment,ALL,29014.72,0.0,GBP,Faster Payments,HMRC UK,***8201,,,False,False,REF-914995,First Continental Bank,***2674,Globex Consulting UK Ltd.,UK,-7960719.05
2025-07-28,2025-07-28,Client Receipt - Aurora Electronics GmbH #12,Sales Receipt,CEM-EMEA,0.0,1827.07,GBP,CHAPS Credit,Aurora Electronics GmbH #12,***2337,INV-202507-CEM-EMEA-0014,,False,False,REF-288053,First Continental Bank,***2003,Globex Consulting UK Ltd.,UK,-7958891.98
2025-07-28,2025-07-28,Client Receipt - CloudBridge Co. #57,Sales Receipt,SaaS-GL,0.0,3956.32,GBP,Faster Payments Credit,CloudBridge Co. #57,***6301,INV-202507-SaaS-GL-0021,,False,False,REF-407243,First Continental Bank,***1410,Globex Consulting UK Ltd.,UK,-7954935.66
2025-07-28,2025-07-28,Client Receipt - Novatek Components Ltd #9,Sales Receipt,CEM-EMEA,0.0,6357.29,GBP,CHAPS Credit,Novatek Components Ltd #9,***8298,INV-202507-CEM-EMEA-0013,,False,False,REF-910704,First Continental Bank,***9253,Globex Consulting UK Ltd.,UK,-7948578.37
2025-07-28,2025-07-28,Client Receipt - CloudBridge Co. #63,Sales Receipt,SaaS-GL,0.0,6777.03,GBP,CHAPS Credit,CloudBridge Co. #63,***2911,INV-202507-SaaS-GL-0001,,False,False,REF-774052,First Continental Bank,***1735,Globex Consulting UK Ltd.,UK,-7941801.34
2025-07-28,2025-07-28,Client Receipt - Novatek Components Ltd #10,Sales Receipt,CEM-EMEA,0.0,42611.74,GBP,CHAPS Credit,Novatek Components Ltd #10,***4939,INV-202507-CEM-EMEA-0004,,False,False,REF-251066,First Continental Bank,***9235,Globex Consulting UK Ltd.,UK,-7899189.6
2025-07-29,2025-07-29,Supplier Payment - EuroFab Assembly #20,Supplier Payment,CEM-EMEA,9012.91,0.0,GBP,CHAPS,EuroFab Assembly #20,***3223,,PO-202507-CEM-EMEA-0008,False,False,REF-917442,First Continental Bank,***1673,Globex Consulting UK Ltd.,UK,-7908202.51
2025-07-29,2025-07-29,Client Receipt - CloudBridge Co. #3,Sales Receipt,SaaS-GL,0.0,5661.52,GBP,Faster Payments Credit,CloudBridge Co. #3,***4044,INV-202507-SaaS-GL-0011,,False,False,REF-720636,First Continental Bank,***3035,Globex Consulting UK Ltd.,UK,-7902540.99
2025-07-30,2025-07-30,Supplier Payment - Stelliform Parts BV #27,Supplier Payment,CEM-EMEA,2312.18,0.0,GBP,Faster Payments,Stelliform Parts BV #27,***2816,,PO-202507-CEM-EMEA-0009,False,False,REF-930974,First Continental Bank,***3039,Globex Consulting UK Ltd.,UK,-7904853.17
2025-07-30,2025-07-30,Supplier Payment - EuroFab Assembly #18,Supplier Payment,CEM-EMEA,54071.08,0.0,GBP,Faster Payments,EuroFab Assembly #18,***7349,,PO-202507-CEM-EMEA-0005,False,False,REF-738130,First Continental Bank,***1874,Globex Consulting UK Ltd.,UK,-7958924.25
2025-07-30,2025-07-30,Interest Earned,Interest Income,ALL,0.0,10579.36,GBP,CHAPS Credit,First Continental Bank,***4892,,,False,False,REF-564073,First Continental Bank,***3332,Globex Consulting UK Ltd.,UK,-7948344.89
2025-07-30,2025-07-30,Client Receipt - Novatek Components Ltd #8,Sales Receipt,CEM-EMEA,0.0,26319.28,GBP,CHAPS Credit,Novatek Components Ltd #8,***5856,INV-202507-CEM-EMEA-0001,,False,False,REF-155785,First Continental Bank,***2594,Globex Consulting UK Ltd.,UK,-7922025.61
2025-07-31,2025-07-31,Supplier Payment - ExpertNet Subcontractors #16,Supplier Payment,PS-GL,7769.41,0.0,GBP,CHAPS,ExpertNet Subcontractors #16,***2117,,PO-202507-PS-GL-0008,False,False,REF-610020,First Continental Bank,***4333,Globex Consulting UK Ltd.,UK,-7929795.02
2025-07-31,2025-07-31,Client Receipt - CloudBridge Co. #52,Sales Receipt,SaaS-GL,0.0,5016.71,GBP,Faster Payments Credit,CloudBridge Co. #52,***2098,INV-202507-SaaS-GL-0017,,False,False,REF-983470,First Continental Bank,***9128,Globex Consulting UK Ltd.,UK,-7924778.31
2025-08-01,2025-08-01,Account Maintenance Fee,Bank/Merchant Fees,ALL,2500.0,0.0,GBP,Faster Payments,First Continental Bank,***4062,,,False,False,REF-421493,First Continental Bank,***2874,Globex Consulting UK Ltd.,UK,-7927278.31
2025-08-01,2025-08-01,Client Receipt - CloudBridge Co. #25,Sales Receipt,SaaS-GL,0.0,6443.48,GBP,Faster Payments Credit,CloudBridge Co. #25,***1104,INV-202508-SaaS-GL-0010,,False,False,REF-142490,First Continental Bank,***4321,Globex Consulting UK Ltd.,UK,-7920834.83
2025-08-02,2025-08-02,Client Receipt - Vertex Advisory Client #19,Sales Receipt,PS-GL,0.0,75010.27,GBP,Faster Payments Credit,Vertex Advisory Client #19,***4842,INV-202508-PS-GL-0005,,False,False,REF-469663,First Continental Bank,***9151,Globex Consulting UK Ltd.,UK,-7845824.56
2025-08-04,2025-08-04,Client Receipt - Vertex Advisory Client #7,Sales Receipt,PS-GL,0.0,12.01,GBP,CHAPS Credit,Vertex Advisory Client #7,***1654,INV-202508-PS-GL-0006,,False,False,REF-700822,First Continental Bank,***6323,Globex Consulting UK Ltd.,UK,-7845812.55
2025-08-04,2025-08-04,Client Receipt - CloudBridge Co. #62,Sales Receipt,SaaS-GL,0.0,2862.89,GBP,CHAPS Credit,CloudBridge Co. #62,***7915,INV-202508-SaaS-GL-0018,,False,False,REF-443086,First Continental Bank,***7438,Globex Consulting UK Ltd.,UK,-7842949.66
2025-08-04,2025-08-04,Client Receipt - CloudBridge Co. #13,Sales Receipt,SaaS-GL,0.0,12973.7,GBP,CHAPS Credit,CloudBridge Co. #13,***9987,INV-202508-SaaS-GL-0024,,False,False,REF-882257,First Continental Bank,***6131,Globex Consulting UK Ltd.,UK,-7829975.96
2025-08-05,2025-08-05,Supplier Payment - ExpertNet Subcontractors #4,Supplier Payment,PS-GL,913.86,0.0,GBP,CHAPS,ExpertNet Subcontractors #4,***7779,,PO-202508-PS-GL-0006,False,False,REF-594425,First Continental Bank,***8279,Globex Consulting UK Ltd.,UK,-7830889.82
2025-08-05,2025-08-05,Supplier Payment - Stelliform Parts BV #4,Supplier Payment,CEM-EMEA,30418.73,0.0,GBP,Faster Payments,Stelliform Parts BV #4,***7431,,PO-202508-CEM-EMEA-0010,False,False,REF-470643,First Continental Bank,***9385,Globex Consulting UK Ltd.,UK,-7861308.55
2025-08-05,2025-08-05,Client Receipt - Vertex Advisory Client #33,Sales Receipt,PS-GL,0.0,7176.57,GBP,CHAPS Credit,Vertex Advisory Client #33,***8707,INV-202508-PS-GL-0002,,False,False,REF-227880,First Continental Bank,***7240,Globex Consulting UK Ltd.,UK,-7854131.98
2025-08-06,2025-08-06,Supplier Payment - ExpertNet Subcontractors #19,Supplier Payment,PS-GL,1766.72,0.0,GBP,Faster Payments,ExpertNet Subcontractors #19,***5219,,PO-202508-PS-GL-0004,False,False,REF-836806,First Continental Bank,***1761,Globex Consulting UK Ltd.,UK,-7855898.7
2025-08-06,2025-08-06,Marketing - Aurelia Media #8,Marketing,ALL,3177.45,0.0,GBP,CHAPS,Aurelia Media #8,***6131,,,False,False,REF-887209,First Continental Bank,***3179,Globex Consulting UK Ltd.,UK,-7859076.15
2025-08-06,2025-08-06,Supplier Payment - HyperCloud Infra #9,Supplier Payment,SaaS-GL,6120.26,0.0,GBP,CHAPS,HyperCloud Infra #9,***1751,,PO-202508-SaaS-GL-0002,False,False,REF-268073,First Continental Bank,***8020,Globex Consulting UK Ltd.,UK,-7865196.41
2025-08-06,2025-08-06,Client Receipt - CloudBridge Co. #51,Sales Receipt,SaaS-GL,0.0,1899.39,GBP,Faster Payments Credit,CloudBridge Co. #51,***6310,INV-202508-SaaS-GL-0021,,False,False,REF-550161,First Continental Bank,***8067,Globex Consulting UK Ltd.,UK,-7863297.02
2025-08-06,2025-08-06,Client Receipt - CloudBridge Co. #16,Sales Receipt,SaaS-GL,0.0,10403.71,GBP,CHAPS Credit,CloudBridge Co. #16,***6135,INV-202508-SaaS-GL-0011,,False,False,REF-123704,First Continental Bank,***5281,Globex Consulting UK Ltd.,UK,-7852893.31
2025-08-06,2025-08-06,Client Receipt - Novatek Components Ltd #2,Sales Receipt,CEM-EMEA,0.0,39866.14,GBP,Faster Payments Credit,Novatek Components Ltd #2,***5034,INV-202508-CEM-EMEA-0011,,False,False,REF-384457,First Continental Bank,***7399,Globex Consulting UK Ltd.,UK,-7813027.17
2025-08-07,2025-08-07,Supplier Payment - ExpertNet Subcontractors #1,Supplier Payment,PS-GL,574.29,0.0,GBP,CHAPS,ExpertNet Subcontractors #1,***6719,,PO-202508-PS-GL-0009,False,False,REF-960763,First Continental Bank,***4420,Globex Consulting UK Ltd.,UK,-7813601.46
2025-08-07,2025-08-07,Supplier Payment - Stelliform Parts BV #1,Supplier Payment,CEM-EMEA,766.75,0.0,GBP,CHAPS,Stelliform Parts BV #1,***5002,,PO-202508-CEM-EMEA-0007,False,False,REF-343793,First Continental Bank,***8705,Globex Consulting UK Ltd.,UK,-7814368.21
2025-08-07,2025-08-07,Client Receipt - Aurora Electronics GmbH #16,Sales Receipt,CEM-EMEA,0.0,13430.98,GBP,Faster Payments Credit,Aurora Electronics GmbH #16,***9256,INV-202508-CEM-EMEA-0013,,False,False,REF-569179,First Continental Bank,***3377,Globex Consulting UK Ltd.,UK,-7800937.23
2025-08-08,2025-08-08,Supplier Payment - ExpertNet Subcontractors #8,Supplier Payment,PS-GL,4585.36,0.0,GBP,CHAPS,ExpertNet Subcontractors #8,***9587,,PO-202508-PS-GL-0008,False,False,REF-369355,First Continental Bank,***1096,Globex Consulting UK Ltd.,UK,-7805522.59
2025-08-08,2025-08-08,Supplier Payment - Stelliform Parts BV #5,Supplier Payment,CEM-EMEA,12258.18,0.0,GBP,CHAPS,Stelliform Parts BV #5,***1395,,PO-202508-CEM-EMEA-0004,False,False,REF-886104,First Continental Bank,***9658,Globex Consulting UK Ltd.,UK,-7817780.77
2025-08-08,2025-08-08,Supplier Payment - EuroFab Assembly #3,Supplier Payment,CEM-EMEA,66609.2,0.0,GBP,CHAPS,EuroFab Assembly #3,***9521,,PO-202508-CEM-EMEA-0008,False,False,REF-285956,First Continental Bank,***6331,Globex Consulting UK Ltd.,UK,-7884389.97
2025-08-08,2025-08-08,Client Receipt - Vertex Advisory Client #11,Sales Receipt,PS-GL,0.0,2078.12,GBP,CHAPS Credit,Vertex Advisory Client #11,***7029,INV-202508-PS-GL-0003,,False,False,REF-975596,First Continental Bank,***1244,Globex Consulting UK Ltd.,UK,-7882311.85
2025-08-08,2025-08-08,Client Receipt - Aurora Electronics GmbH #18,Sales Receipt,CEM-EMEA,0.0,2717.06,GBP,CHAPS Credit,Aurora Electronics GmbH #18,***1478,INV-202508-CEM-EMEA-0012,,False,False,REF-802265,First Continental Bank,***9588,Globex Consulting UK Ltd.,UK,-7879594.79
2025-08-08,2025-08-08,Client Receipt - Novatek Components Ltd #5,Sales Receipt,CEM-EMEA,0.0,22018.31,GBP,Faster Payments Credit,Novatek Components Ltd #5,***3461,INV-202508-CEM-EMEA-0007,,False,False,REF-245439,First Continental Bank,***9911,Globex Consulting UK Ltd.,UK,-7857576.48
2025-08-09,2025-08-09,Merchant Processing Fees,Bank/Merchant Fees,ALL,1474.51,0.0,GBP,CHAPS,First Continental Bank,***3926,,,False,False,REF-246426,First Continental Bank,***2757,Globex Consulting UK Ltd.,UK,-7859050.99
2025-08-09,2025-08-09,Supplier Payment - ExpertNet Subcontractors #12,Supplier Payment,PS-GL,13107.53,0.0,GBP,Faster Payments,ExpertNet Subcontractors #12,***8191,,PO-202508-PS-GL-0012,False,False,REF-669798,First Continental Bank,***7882,Globex Consulting UK Ltd.,UK,-7872158.52
2025-08-11,2025-08-11,Supplier Payment - CodeCraft Contractors #5,Supplier Payment,SaaS-GL,185.27,0.0,GBP,Faster Payments,CodeCraft Contractors #5,***3340,,PO-202508-SaaS-GL-0006,False,False,REF-808697,First Continental Bank,***2759,Globex Consulting UK Ltd.,UK,-7872343.79
2025-08-12,2025-08-12,Supplier Payment - ExpertNet Subcontractors #1,Supplier Payment,PS-GL,4735.01,0.0,GBP,CHAPS,ExpertNet Subcontractors #1,***3701,,PO-202508-PS-GL-0005,False,False,REF-689173,First Continental Bank,***1007,Globex Consulting UK Ltd.,UK,-7877078.8
2025-08-12,2025-08-12,"Intercompany Settlement - Globex International Holdings, Inc.",Intercompany Transfer,ALL,550998.0,0.0,GBP,Internal Transfer,"Globex International Holdings, Inc.",***7616,,,True,True,REF-935719,First Continental Bank,***6992,Globex Consulting UK Ltd.,UK,-8428076.8
2025-08-12,2025-08-12,Client Receipt - CloudBridge Co. #10,Sales Receipt,SaaS-GL,0.0,203.14,GBP,Faster Payments Credit,CloudBridge Co. #10,***9905,INV-202508-SaaS-GL-0004,,False,False,REF-847613,First Continental Bank,***6302,Globex Consulting UK Ltd.,UK,-8427873.66
2025-08-12,2025-08-12,Client Receipt - Vertex Advisory Client #32,Sales Receipt,PS-GL,0.0,9411.48,GBP,Faster Payments Credit,Vertex Advisory Client #32,***1398,INV-202508-PS-GL-0007,,False,False,REF-318848,First Continental Bank,***6418,Globex Consulting UK Ltd.,UK,-8418462.18
2025-08-12,2025-08-12,Client Receipt - CloudBridge Co. #47,Sales Receipt,SaaS-GL,0.0,16006.78,GBP,Faster Payments Credit,CloudBridge Co. #47,***4457,INV-202508-SaaS-GL-0015,,False,False,REF-794974,First Continental Bank,***8186,Globex Consulting UK Ltd.,UK,-8402455.4
2025-08-12,2025-08-12,Client Receipt - Aurora Electronics GmbH #17,Sales Receipt,CEM-EMEA,0.0,20498.92,GBP,Faster Payments Credit,Aurora Electronics GmbH #17,***6749,INV-202508-CEM-EMEA-0002,,False,False,REF-311417,First Continental Bank,***6699,Globex Consulting UK Ltd.,UK,-8381956.48
2025-08-13,2025-08-13,Merchant Processing Fees,Bank/Merchant Fees,ALL,395.42,0.0,GBP,CHAPS,First Continental Bank,***4025,,,False,False,REF-148012,First Continental Bank,***4871,Globex Consulting UK Ltd.,UK,-8382351.9
2025-08-13,2025-08-13,Supplier Payment - ExpertNet Subcontractors #8,Supplier Payment,PS-GL,3669.87,0.0,GBP,Faster Payments,ExpertNet Subcontractors #8,***9565,,PO-202508-PS-GL-0001,False,False,REF-774269,First Continental Bank,***8299,Globex Consulting UK Ltd.,UK,-8386021.77
2025-08-13,2025-08-13,Supplier Payment - HyperCloud Infra #8,Supplier Payment,SaaS-GL,8204.92,0.0,GBP,Faster Payments,HyperCloud Infra #8,***7495,,PO-202508-SaaS-GL-0003,False,False,REF-271179,First Continental Bank,***1452,Globex Consulting UK Ltd.,UK,-8394226.69
2025-08-13,2025-08-13,Supplier Payment - EuroFab Assembly #19,Supplier Payment,CEM-EMEA,13402.4,0.0,GBP,Faster Payments,EuroFab Assembly #19,***7526,,PO-202508-CEM-EMEA-0002,False,False,REF-985821,First Continental Bank,***9180,Globex Consulting UK Ltd.,UK,-8407629.09
2025-08-13,2025-08-13,Client Receipt - CloudBridge Co. #68,Sales Receipt,SaaS-GL,0.0,1124.69,GBP,CHAPS Credit,CloudBridge Co. #68,***2506,INV-202508-SaaS-GL-0022,,False,False,REF-215598,First Continental Bank,***3358,Globex Consulting UK Ltd.,UK,-8406504.4
2025-08-13,2025-08-13,Client Receipt - CloudBridge Co. #11,Sales Receipt,SaaS-GL,0.0,2160.37,GBP,CHAPS Credit,CloudBridge Co. #11,***3867,INV-202508-SaaS-GL-0019,,False,False,REF-774274,First Continental Bank,***7543,Globex Consulting UK Ltd.,UK,-8404344.03
2025-08-13,2025-08-13,Client Receipt - CloudBridge Co. #29,Sales Receipt,SaaS-GL,0.0,9880.21,GBP,Faster Payments Credit,CloudBridge Co. #29,***5228,INV-202508-SaaS-GL-0014,,False,False,REF-592429,First Continental Bank,***7596,Globex Consulting UK Ltd.,UK,-8394463.82
2025-08-13,2025-08-13,Client Receipt - CloudBridge Co. #22,Sales Receipt,SaaS-GL,0.0,13322.12,GBP,CHAPS Credit,CloudBridge Co. #22,***4697,INV-202508-SaaS-GL-0006,,False,False,REF-899617,First Continental Bank,***2175,Globex Consulting UK Ltd.,UK,-8381141.7
2025-08-14,2025-08-14,Client Receipt - Novatek Components Ltd #5,Sales Receipt,CEM-EMEA,0.0,17253.71,GBP,Faster Payments Credit,Novatek Components Ltd #5,***7244,INV-202508-CEM-EMEA-0014,,False,False,REF-372241,First Continental Bank,***5084,Globex Consulting UK Ltd.,UK,-8363887.99
2025-08-15,2025-08-15,Supplier Payment - Stelliform Parts BV #11,Supplier Payment,CEM-EMEA,2371.71,0.0,GBP,Faster Payments,Stelliform Parts BV #11,***4782,,PO-202508-CEM-EMEA-0003,False,False,REF-793737,First Continental Bank,***9113,Globex Consulting UK Ltd.,UK,-8366259.7
2025-08-15,2025-08-15,Supplier Payment - HyperCloud Infra #7,Supplier Payment,SaaS-GL,6667.93,0.0,GBP,Faster Payments,HyperCloud Infra #7,***9240,,PO-202508-SaaS-GL-0007,False,False,REF-958771,First Continental Bank,***6271,Globex Consulting UK Ltd.,UK,-8372927.63
2025-08-16,2025-08-16,Alphagrid Utilities,Rent & Utilities,ALL,4922.41,0.0,GBP,CHAPS,Alphagrid Utilities,***9290,,,False,False,REF-957957,First Continental Bank,***5742,Globex Consulting UK Ltd.,UK,-8377850.04
2025-08-16,2025-08-16,Client Receipt - Aurora Electronics GmbH #2,Sales Receipt,CEM-EMEA,0.0,14387.09,GBP,CHAPS Credit,Aurora Electronics GmbH #2,***4179,INV-202508-CEM-EMEA-0009,,False,False,REF-337237,First Continental Bank,***5399,Globex Consulting UK Ltd.,UK,-8363462.95
2025-08-17,2025-08-17,Supplier Payment - EuroFab Assembly #6,Supplier Payment,CEM-EMEA,5191.88,0.0,GBP,CHAPS,EuroFab Assembly #6,***3579,,PO-202508-CEM-EMEA-0006,False,False,REF-817441,First Continental Bank,***8252,Globex Consulting UK Ltd.,UK,-8368654.83
2025-08-18,2025-08-18,Supplier Payment - ExpertNet Subcontractors #9,Supplier Payment,PS-GL,1596.46,0.0,GBP,Faster Payments,ExpertNet Subcontractors #9,***6659,,PO-202508-PS-GL-0003,False,False,REF-659285,First Continental Bank,***6094,Globex Consulting UK Ltd.,UK,-8370251.29
2025-08-18,2025-08-18,Supplier Payment - HyperCloud Infra #18,Supplier Payment,SaaS-GL,6932.44,0.0,GBP,Faster Payments,HyperCloud Infra #18,***1520,,PO-202508-SaaS-GL-0004,False,False,REF-740162,First Continental Bank,***2138,Globex Consulting UK Ltd.,UK,-8377183.73
2025-08-18,2025-08-18,Client Receipt - CloudBridge Co. #48,Sales Receipt,SaaS-GL,0.0,6819.36,GBP,CHAPS Credit,CloudBridge Co. #48,***3005,INV-202508-SaaS-GL-0008,,False,False,REF-191134,First Continental Bank,***2078,Globex Consulting UK Ltd.,UK,-8370364.37
2025-08-19,2025-08-19,Supplier Payment - HyperCloud Infra #7,Supplier Payment,SaaS-GL,2049.96,0.0,GBP,Faster Payments,HyperCloud Infra #7,***6155,,PO-202508-SaaS-GL-0001,False,False,REF-784206,First Continental Bank,***1497,Globex Consulting UK Ltd.,UK,-8372414.33
2025-08-19,2025-08-19,Supplier Payment - HyperCloud Infra #16,Supplier Payment,SaaS-GL,5188.68,0.0,GBP,Faster Payments,HyperCloud Infra #16,***1402,,PO-202508-SaaS-GL-0008,False,False,REF-456583,First Continental Bank,***3056,Globex Consulting UK Ltd.,UK,-8377603.01
2025-08-19,2025-08-19,Client Receipt - CloudBridge Co. #30,Sales Receipt,SaaS-GL,0.0,2139.21,GBP,CHAPS Credit,CloudBridge Co. #30,***3640,INV-202508-SaaS-GL-0009,,False,False,REF-915462,First Continental Bank,***5900,Globex Consulting UK Ltd.,UK,-8375463.8
2025-08-19,2025-08-19,Client Receipt - Novatek Components Ltd #7,Sales Receipt,CEM-EMEA,0.0,4066.97,GBP,Faster Payments Credit,Novatek Components Ltd #7,***6230,INV-202508-CEM-EMEA-0008,,False,False,REF-456753,First Continental Bank,***4735,Globex Consulting UK Ltd.,UK,-8371396.83
2025-08-19,2025-08-19,Client Receipt - CloudBridge Co. #43,Sales Receipt,SaaS-GL,0.0,24325.7,GBP,Faster Payments Credit,CloudBridge Co. #43,***7077,INV-202508-SaaS-GL-0020,,False,False,REF-777806,First Continental Bank,***6876,Globex Consulting UK Ltd.,UK,-8347071.13
2025-08-19,2025-08-19,Client Receipt - CloudBridge Co. #3,Sales Receipt,SaaS-GL,0.0,24922.34,GBP,CHAPS Credit,CloudBridge Co. #3,***4283,INV-202508-SaaS-GL-0005,,False,False,REF-566048,First Continental Bank,***1052,Globex Consulting UK Ltd.,UK,-8322148.79
2025-08-20,2025-08-20,Supplier Payment - ExpertNet Subcontractors #14,Supplier Payment,PS-GL,3294.79,0.0,GBP,Faster Payments,ExpertNet Subcontractors #14,***1388,,PO-202508-PS-GL-0011,False,False,REF-419822,First Continental Bank,***3404,Globex Consulting UK Ltd.,UK,-8325443.58
2025-08-20,2025-08-20,Supplier Payment - EuroFab Assembly #1,Supplier Payment,CEM-EMEA,9587.28,0.0,GBP,Faster Payments,EuroFab Assembly #1,***7503,,PO-202508-CEM-EMEA-0009,False,False,REF-429939,First Continental Bank,***2041,Globex Consulting UK Ltd.,UK,-8335030.86
2025-08-20,2025-08-20,Client Receipt - Aurora Electronics GmbH #17,Sales Receipt,CEM-EMEA,0.0,54639.44,GBP,Faster Payments Credit,Aurora Electronics GmbH #17,***8543,INV-202508-CEM-EMEA-0006,,False,False,REF-130823,First Continental Bank,***9041,Globex Consulting UK Ltd.,UK,-8280391.42
2025-08-21,2025-08-21,Supplier Payment - Stelliform Parts BV #25,Supplier Payment,CEM-EMEA,33645.76,0.0,GBP,CHAPS,Stelliform Parts BV #25,***4530,,PO-202508-CEM-EMEA-0005,False,False,REF-200783,First Continental Bank,***6741,Globex Consulting UK Ltd.,UK,-8314037.18
2025-08-21,2025-08-21,VAT/GST Remittance - HMRC UK,Tax Payment,ALL,37838.98,0.0,GBP,Faster Payments,HMRC UK,***7878,,,False,False,REF-548806,First Continental Bank,***9748,Globex Consulting UK Ltd.,UK,-8351876.16
2025-08-21,2025-08-21,Client Receipt - Vertex Advisory Client #33,Sales Receipt,PS-GL,0.0,5232.43,GBP,CHAPS Credit,Vertex Advisory Client #33,***8542,INV-202508-PS-GL-0004,,False,False,REF-496920,First Continental Bank,***8315,Globex Consulting UK Ltd.,UK,-8346643.73
2025-08-21,2025-08-21,Client Receipt - CloudBridge Co. #61,Sales Receipt,SaaS-GL,0.0,6667.19,GBP,CHAPS Credit,CloudBridge Co. #61,***5112,INV-202508-SaaS-GL-0003,,False,False,REF-894603,First Continental Bank,***9833,Globex Consulting UK Ltd.,UK,-8339976.54
2025-08-21,2025-08-21,Client Receipt - Aurora Electronics GmbH #17,Sales Receipt,CEM-EMEA,0.0,32591.56,GBP,CHAPS Credit,Aurora Electronics GmbH #17,***6291,INV-202508-CEM-EMEA-0010,,False,False,REF-372765,First Continental Bank,***1434,Globex Consulting UK Ltd.,UK,-8307384.98
2025-08-22,2025-08-22,Client Receipt - Aurora Electronics GmbH #18,Sales Receipt,CEM-EMEA,0.0,129.4,GBP,CHAPS Credit,Aurora Electronics GmbH #18,***6986,INV-202508-CEM-EMEA-0005,,False,False,REF-457810,First Continental Bank,***4804,Globex Consulting UK Ltd.,UK,-8307255.58
2025-08-22,2025-08-22,Client Receipt - CloudBridge Co. #59,Sales Receipt,SaaS-GL,0.0,456.0,GBP,CHAPS Credit,CloudBridge Co. #59,***5344,INV-202508-SaaS-GL-0007,,False,False,REF-800461,First Continental Bank,***2109,Globex Consulting UK Ltd.,UK,-8306799.58
2025-08-23,2025-08-23,Marketing - Beacon Digital #4,Marketing,ALL,12753.93,0.0,GBP,Faster Payments,Beacon Digital #4,***1022,,,False,False,REF-750179,First Continental Bank,***1475,Globex Consulting UK Ltd.,UK,-8319553.51
2025-08-24,2025-08-24,Client Receipt - Aurora Electronics GmbH #12,Sales Receipt,CEM-EMEA,0.0,37949.4,GBP,CHAPS Credit,Aurora Electronics GmbH #12,***3735,INV-202508-CEM-EMEA-0004,,False,False,REF-479446,First Continental Bank,***6766,Globex Consulting UK Ltd.,UK,-8281604.11
2025-08-25,2025-08-25,Client Receipt - CloudBridge Co. #29,Sales Receipt,SaaS-GL,0.0,2927.56,GBP,CHAPS Credit,CloudBridge Co. #29,***4636,INV-202508-SaaS-GL-0016,,False,False,REF-699345,First Continental Bank,***2114,Globex Consulting UK Ltd.,UK,-8278676.55
2025-08-26,2025-08-26,Supplier Payment - ExpertNet Subcontractors #14,Supplier Payment,PS-GL,3257.28,0.0,GBP,Faster Payments,ExpertNet Subcontractors #14,***2221,,PO-202508-PS-GL-0010,False,False,REF-563908,First Continental Bank,***1564,Globex Consulting UK Ltd.,UK,-8281933.83
2025-08-26,2025-08-26,Supplier Payment - CodeCraft Contractors #2,Supplier Payment,SaaS-GL,6837.25,0.0,GBP,CHAPS,CodeCraft Contractors #2,***9701,,PO-202508-SaaS-GL-0005,False,False,REF-630875,First Continental Bank,***3534,Globex Consulting UK Ltd.,UK,-8288771.08
2025-08-26,2025-08-26,Intercompany Settlement - Globex Retail NA LLC,Intercompany Transfer,ALL,637724.0,0.0,GBP,Internal Transfer,Globex Retail NA LLC,***1620,,,True,True,REF-305366,First Continental Bank,***8419,Globex Consulting UK Ltd.,UK,-8926495.08
2025-08-26,2025-08-26,Client Receipt - CloudBridge Co. #31,Sales Receipt,SaaS-GL,0.0,15840.38,GBP,Faster Payments Credit,CloudBridge Co. #31,***4759,INV-202508-SaaS-GL-0012,,False,False,REF-323497,First Continental Bank,***5705,Globex Consulting UK Ltd.,UK,-8910654.7
2025-08-27,2025-08-27,Client Receipt - CloudBridge Co. #49,Sales Receipt,SaaS-GL,0.0,1692.49,GBP,CHAPS Credit,CloudBridge Co. #49,***6604,INV-202508-SaaS-GL-0023,,False,False,REF-404834,First Continental Bank,***7222,Globex Consulting UK Ltd.,UK,-8908962.21
2025-08-27,2025-08-27,Client Receipt - Vertex Advisory Client #6,Sales Receipt,PS-GL,0.0,2755.79,GBP,CHAPS Credit,Vertex Advisory Client #6,***9917,INV-202508-PS-GL-0001,,False,False,REF-729249,First Continental Bank,***1836,Globex Consulting UK Ltd.,UK,-8906206.42
2025-08-27,2025-08-27,Client Receipt - Vertex Advisory Client #1,Sales Receipt,PS-GL,0.0,4628.75,GBP,CHAPS Credit,Vertex Advisory Client #1,***2486,INV-202508-PS-GL-0009,,False,False,REF-328447,First Continental Bank,***9128,Globex Consulting UK Ltd.,UK,-8901577.67
2025-08-27,2025-08-27,Client Receipt - CloudBridge Co. #51,Sales Receipt,SaaS-GL,0.0,10942.84,GBP,CHAPS Credit,CloudBridge Co. #51,***2836,INV-202508-SaaS-GL-0013,,False,False,REF-282230,First Continental Bank,***9149,Globex Consulting UK Ltd.,UK,-8890634.83
2025-08-28,2025-08-28,Supplier Payment - ExpertNet Subcontractors #2,Supplier Payment,PS-GL,262.14,0.0,GBP,Faster Payments,ExpertNet Subcontractors #2,***7158,,PO-202508-PS-GL-0002,False,False,REF-837950,First Continental Bank,***1096,Globex Consulting UK Ltd.,UK,-8890896.97
2025-08-28,2025-08-28,Supplier Payment - EuroFab Assembly #11,Supplier Payment,CEM-EMEA,4722.04,0.0,GBP,Faster Payments,EuroFab Assembly #11,***9954,,PO-202508-CEM-EMEA-0001,False,False,REF-783877,First Continental Bank,***6907,Globex Consulting UK Ltd.,UK,-8895619.01
2025-08-28,2025-08-28,Client Receipt - CloudBridge Co. #56,Sales Receipt,SaaS-GL,0.0,305.5,GBP,CHAPS Credit,CloudBridge Co. #56,***5804,INV-202508-SaaS-GL-0002,,False,False,REF-274670,First Continental Bank,***8490,Globex Consulting UK Ltd.,UK,-8895313.51
2025-08-28,2025-08-28,Client Receipt - Aurora Electronics GmbH #13,Sales Receipt,CEM-EMEA,0.0,20728.07,GBP,CHAPS Credit,Aurora Electronics GmbH #13,***1802,INV-202508-CEM-EMEA-0003,,False,False,REF-745610,First Continental Bank,***3107,Globex Consulting UK Ltd.,UK,-8874585.44
2025-08-29,2025-08-29,Payroll - GlobalPay Services Ltd,Payroll,ALL,98547.48,0.0,GBP,CHAPS,GlobalPay Services Ltd,***6782,,,False,False,REF-507378,First Continental Bank,***3206,Globex Consulting UK Ltd.,UK,-8973132.92
2025-08-29,2025-08-29,Client Receipt - Novatek Components Ltd #14,Sales Receipt,CEM-EMEA,0.0,18012.83,GBP,CHAPS Credit,Novatek Components Ltd #14,***8855,INV-202508-CEM-EMEA-0001,,False,False,REF-387455,First Continental Bank,***1123,Globex Consulting UK Ltd.,UK,-8955120.09
2025-08-30,2025-08-30,Client Receipt - CloudBridge Co. #63,Sales Receipt,SaaS-GL,0.0,3625.09,GBP,CHAPS Credit,CloudBridge Co. #63,***6494,INV-202508-SaaS-GL-0017,,False,False,REF-312476,First Continental Bank,***6719,Globex Consulting UK Ltd.,UK,-8951495.0
2025-08-30,2025-08-30,Interest Earned,Interest Income,ALL,0.0,12132.07,GBP,Faster Payments Credit,First Continental Bank,***6389,,,False,False,REF-414669,First Continental Bank,***1039,Globex Consulting UK Ltd.,UK,-8939362.93
2025-08-30,2025-08-30,Client Receipt - Vertex Advisory Client #27,Sales Receipt,PS-GL,0.0,21533.1,GBP,Faster Payments Credit,Vertex Advisory Client #27,***8126,INV-202508-PS-GL-0008,,False,False,REF-465703,First Continental Bank,***2894,Globex Consulting UK Ltd.,UK,-8917829.83
2025-08-31,2025-08-31,Supplier Payment - ExpertNet Subcontractors #13,Supplier Payment,PS-GL,588.25,0.0,GBP,Faster Payments,ExpertNet Subcontractors #13,***9848,,PO-202508-PS-GL-0007,False,False,REF-282753,First Continental Bank,***8051,Globex Consulting UK Ltd.,UK,-8918418.08
2025-08-31,2025-08-31,Client Receipt - CloudBridge Co. #19,Sales Receipt,SaaS-GL,0.0,13813.64,GBP,Faster Payments Credit,CloudBridge Co. #19,***4880,INV-202508-SaaS-GL-0001,,False,False,REF-223623,First Continental Bank,***7638,Globex Consulting UK Ltd.,UK,-8904604.44
