Date,ValueDate,Description,Category,BusinessUnit,Debit,Credit,Currency,PaymentRail,Counterparty,CounterpartyAccount,InvoiceID,PONumber,Intercompany,EliminateInConsolidation,Reference,Bank,AccountNumberMasked,Company,Jurisdiction,Balance
2023-09-01,2023-09-01,Supplier Payment - ExpertNet Subcontractors #3,Supplier Payment,PS-GL,470.85,0.0,USD,Fedwire,ExpertNet Subcontractors #3,***2281,,PO-202309-PS-GL-0001,False,False,REF-523653,First Continental Bank,***8579,Globex Retail NA LLC,US,11999529.15
2023-09-01,2023-09-01,Account Maintenance Fee,Bank/Merchant Fees,ALL,2500.0,0.0,USD,Fedwire,First Continental Bank,***4160,,,False,False,REF-405520,First Continental Bank,***3326,Globex Retail NA LLC,US,11997029.15
2023-09-01,2023-09-01,Client Receipt - CloudBridge Co. #67,Sales Receipt,SaaS-GL,0.0,4430.71,USD,Card Settlement,CloudBridge Co. #67,***9465,INV-202309-SaaS-GL-0001,,False,False,REF-952409,First Continental Bank,***1222,Globex Retail NA LLC,US,12001459.86
2023-09-02,2023-09-02,Supplier Payment - CodeCraft Contractors #1,Supplier Payment,SaaS-GL,14713.84,0.0,USD,ACH Debit,CodeCraft Contractors #1,***7373,,PO-202309-SaaS-GL-0006,False,False,REF-450346,First Continental Bank,***4104,Globex Retail NA LLC,US,11986746.02
2023-09-03,2023-09-03,Client Receipt - Vertex Advisory Client #48,Sales Receipt,PS-GL,0.0,42909.15,USD,Card Settlement,Vertex Advisory Client #48,***6087,INV-202309-PS-GL-0004,,False,False,REF-379622,First Continental Bank,***5719,Globex Retail NA LLC,US,12029655.17
2023-09-04,2023-09-04,Supplier Payment - CodeCraft Contractors #4,Supplier Payment,SaaS-GL,7998.97,0.0,USD,Fedwire,CodeCraft Contractors #4,***6472,,PO-202309-SaaS-GL-0010,False,False,REF-595556,First Continental Bank,***7642,Globex Retail NA LLC,US,12021656.2
2023-09-04,2023-09-04,Client Receipt - CloudBridge Co. #4,Sales Receipt,SaaS-GL,0.0,15036.97,USD,Card Settlement,CloudBridge Co. #4,***3560,INV-202309-SaaS-GL-0028,,False,False,REF-164258,First Continental Bank,***7395,Globex Retail NA LLC,US,12036693.17
2023-09-04,2023-09-04,Client Receipt - CloudBridge Co. #66,Sales Receipt,SaaS-GL,0.0,15681.33,USD,ACH Credit,CloudBridge Co. #66,***9465,INV-202309-SaaS-GL-0013,,False,False,REF-654611,First Continental Bank,***6261,Globex Retail NA LLC,US,12052374.5
2023-09-04,2023-09-04,Client Receipt - CloudBridge Co. #60,Sales Receipt,SaaS-GL,0.0,22468.14,USD,Card Settlement,CloudBridge Co. #60,***1375,INV-202309-SaaS-GL-0005,,False,False,REF-746177,First Continental Bank,***9656,Globex Retail NA LLC,US,12074842.64
2023-09-04,2023-09-04,Client Receipt - Vertex Advisory Client #27,Sales Receipt,PS-GL,0.0,25034.77,USD,Card Settlement,Vertex Advisory Client #27,***3075,INV-202309-PS-GL-0005,,False,False,REF-654306,First Continental Bank,***2533,Globex Retail NA LLC,US,12099877.41
2023-09-05,2023-09-05,Supplier Payment - HyperCloud Infra #16,Supplier Payment,SaaS-GL,1048.7,0.0,USD,ACH Debit,HyperCloud Infra #16,***7397,,PO-202309-SaaS-GL-0004,False,False,REF-314015,First Continental Bank,***2090,Globex Retail NA LLC,US,12098828.71
2023-09-05,2023-09-05,Client Receipt - CloudBridge Co. #17,Sales Receipt,SaaS-GL,0.0,5137.13,USD,Card Settlement,CloudBridge Co. #17,***5071,INV-202309-SaaS-GL-0011,,False,False,REF-527670,First Continental Bank,***2714,Globex Retail NA LLC,US,12103965.84
2023-09-05,2023-09-05,Client Receipt - CloudBridge Co. #3,Sales Receipt,SaaS-GL,0.0,10759.53,USD,ACH Credit,CloudBridge Co. #3,***2488,INV-202309-SaaS-GL-0024,,False,False,REF-165535,First Continental Bank,***7828,Globex Retail NA LLC,US,12114725.37
2023-09-05,2023-09-05,Client Receipt - CloudBridge Co. #6,Sales Receipt,SaaS-GL,0.0,13498.56,USD,ACH Credit,CloudBridge Co. #6,***4605,INV-202309-SaaS-GL-0006,,False,False,REF-787851,First Continental Bank,***8900,Globex Retail NA LLC,US,12128223.93
2023-09-06,2023-09-06,Supplier Payment - ExpertNet Subcontractors #18,Supplier Payment,PS-GL,10503.79,0.0,USD,Fedwire,ExpertNet Subcontractors #18,***9344,,PO-202309-PS-GL-0003,False,False,REF-666333,First Continental Bank,***6390,Globex Retail NA LLC,US,12117720.14
2023-09-06,2023-09-06,Supplier Payment - NorthRiver Apparel Mfg #4,Supplier Payment,Retail-NA,35719.3,0.0,USD,Fedwire,NorthRiver Apparel Mfg #4,***9008,,PO-202309-Retail-NA-0001,False,False,REF-178367,First Continental Bank,***5489,Globex Retail NA LLC,US,12082000.84
2023-09-06,2023-09-06,Client Receipt - CloudBridge Co. #67,Sales Receipt,SaaS-GL,0.0,1213.28,USD,ACH Credit,CloudBridge Co. #67,***6663,INV-202309-SaaS-GL-0002,,False,False,REF-699369,First Continental Bank,***9789,Globex Retail NA LLC,US,12083214.12
2023-09-06,2023-09-06,Client Receipt - CloudBridge Co. #69,Sales Receipt,SaaS-GL,0.0,3652.99,USD,ACH Credit,CloudBridge Co. #69,***6725,INV-202309-SaaS-GL-0030,,False,False,REF-270534,First Continental Bank,***6678,Globex Retail NA LLC,US,12086867.11
2023-09-06,2023-09-06,Client Receipt - CloudBridge Co. #44,Sales Receipt,SaaS-GL,0.0,5617.16,USD,Card Settlement,CloudBridge Co. #44,***2480,INV-202309-SaaS-GL-0003,,False,False,REF-633173,First Continental Bank,***3289,Globex Retail NA LLC,US,12092484.27
2023-09-07,2023-09-07,Client Receipt - Card Settlement Batch #7,Sales Receipt,Retail-NA,0.0,23797.85,USD,ACH Credit,Card Settlement Batch #7,***9689,INV-202309-Retail-NA-0007,,False,False,REF-688005,First Continental Bank,***9150,Globex Retail NA LLC,US,12116282.12
2023-09-07,2023-09-07,Client Receipt - ShopSphere Partner #23,Sales Receipt,Retail-NA,0.0,43387.88,USD,Card Settlement,ShopSphere Partner #23,***6679,INV-202309-Retail-NA-0008,,False,False,REF-488972,First Continental Bank,***3267,Globex Retail NA LLC,US,12159670.0
2023-09-08,2023-09-08,Supplier Payment - CodeCraft Contractors #4,Supplier Payment,SaaS-GL,14687.03,0.0,USD,ACH Debit,CodeCraft Contractors #4,***6717,,PO-202309-SaaS-GL-0003,False,False,REF-711432,First Continental Bank,***2068,Globex Retail NA LLC,US,12144982.97
2023-09-08,2023-09-08,Client Receipt - CloudBridge Co. #9,Sales Receipt,SaaS-GL,0.0,9754.84,USD,Card Settlement,CloudBridge Co. #9,***6363,INV-202309-SaaS-GL-0020,,False,False,REF-273028,First Continental Bank,***1600,Globex Retail NA LLC,US,12154737.81
2023-09-08,2023-09-08,Client Receipt - ShopSphere Partner #26,Sales Receipt,Retail-NA,0.0,15742.13,USD,Card Settlement,ShopSphere Partner #26,***3269,INV-202309-Retail-NA-0004,,False,False,REF-746670,First Continental Bank,***3005,Globex Retail NA LLC,US,12170479.94
2023-09-10,2023-09-10,Supplier Payment - NorthRiver Apparel Mfg #20,Supplier Payment,Retail-NA,4860.6,0.0,USD,Fedwire,NorthRiver Apparel Mfg #20,***2802,,PO-202309-Retail-NA-0009,False,False,REF-356740,First Continental Bank,***7024,Globex Retail NA LLC,US,12165619.34
2023-09-11,2023-09-11,Merchant Processing Fees,Bank/Merchant Fees,ALL,1818.68,0.0,USD,Fedwire,First Continental Bank,***4278,,,False,False,REF-841653,First Continental Bank,***7859,Globex Retail NA LLC,US,12163800.66
2023-09-11,2023-09-11,Supplier Payment - ExpertNet Subcontractors #14,Supplier Payment,PS-GL,2560.78,0.0,USD,Fedwire,ExpertNet Subcontractors #14,***6840,,PO-202309-PS-GL-0002,False,False,REF-103453,First Continental Bank,***2448,Globex Retail NA LLC,US,12161239.88
2023-09-11,2023-09-11,Client Receipt - CloudBridge Co. #78,Sales Receipt,SaaS-GL,0.0,1540.86,USD,Card Settlement,CloudBridge Co. #78,***7663,INV-202309-SaaS-GL-0007,,False,False,REF-786988,First Continental Bank,***1414,Globex Retail NA LLC,US,12162780.74
2023-09-11,2023-09-11,Client Receipt - CloudBridge Co. #61,Sales Receipt,SaaS-GL,0.0,2118.24,USD,Card Settlement,CloudBridge Co. #61,***1368,INV-202309-SaaS-GL-0031,,False,False,REF-361863,First Continental Bank,***3196,Globex Retail NA LLC,US,12164898.98
2023-09-11,2023-09-11,Client Receipt - ShopSphere Partner #65,Sales Receipt,Retail-NA,0.0,6496.47,USD,Card Settlement,ShopSphere Partner #65,***7049,INV-202309-Retail-NA-0011,,False,False,REF-670447,First Continental Bank,***4625,Globex Retail NA LLC,US,12171395.45
2023-09-11,2023-09-11,Client Receipt - CloudBridge Co. #19,Sales Receipt,SaaS-GL,0.0,10198.88,USD,Card Settlement,CloudBridge Co. #19,***4219,INV-202309-SaaS-GL-0022,,False,False,REF-609555,First Continental Bank,***7899,Globex Retail NA LLC,US,12181594.33
2023-09-12,2023-09-12,Supplier Payment - ExpertNet Subcontractors #4,Supplier Payment,PS-GL,13586.39,0.0,USD,ACH Debit,ExpertNet Subcontractors #4,***5243,,PO-202309-PS-GL-0005,False,False,REF-271898,First Continental Bank,***7894,Globex Retail NA LLC,US,12168007.94
2023-09-12,2023-09-12,Intercompany Settlement - Globex APAC Logistics Pte. Ltd.,Intercompany Transfer,ALL,205429.0,0.0,USD,Internal Transfer,Globex APAC Logistics Pte. Ltd.,***4225,,,True,True,REF-341684,First Continental Bank,***3377,Globex Retail NA LLC,US,11962578.94
2023-09-12,2023-09-12,Client Receipt - Vertex Advisory Client #10,Sales Receipt,PS-GL,0.0,9122.61,USD,Card Settlement,Vertex Advisory Client #10,***1142,INV-202309-PS-GL-0002,,False,False,REF-420507,First Continental Bank,***2768,Globex Retail NA LLC,US,11971701.55
2023-09-12,2023-09-12,Client Receipt - CloudBridge Co. #30,Sales Receipt,SaaS-GL,0.0,19088.15,USD,Card Settlement,CloudBridge Co. #30,***4626,INV-202309-SaaS-GL-0012,,False,False,REF-859850,First Continental Bank,***6868,Globex Retail NA LLC,US,11990789.7
2023-09-12,2023-09-12,Client Receipt - ShopSphere Partner #29,Sales Receipt,Retail-NA,0.0,54866.32,USD,Card Settlement,ShopSphere Partner #29,***3221,INV-202309-Retail-NA-0009,,False,False,REF-544183,First Continental Bank,***6134,Globex Retail NA LLC,US,12045656.02
2023-09-13,2023-09-13,Supplier Payment - HyperCloud Infra #9,Supplier Payment,SaaS-GL,1361.09,0.0,USD,ACH Debit,HyperCloud Infra #9,***5317,,PO-202309-SaaS-GL-0009,False,False,REF-548642,First Continental Bank,***5882,Globex Retail NA LLC,US,12044294.93
2023-09-13,2023-09-13,Supplier Payment - CodeCraft Contractors #11,Supplier Payment,SaaS-GL,4049.75,0.0,USD,ACH Debit,CodeCraft Contractors #11,***6266,,PO-202309-SaaS-GL-0005,False,False,REF-486701,First Continental Bank,***9274,Globex Retail NA LLC,US,12040245.18
2023-09-13,2023-09-13,Supplier Payment - CodeCraft Contractors #3,Supplier Payment,SaaS-GL,11647.94,0.0,USD,ACH Debit,CodeCraft Contractors #3,***3926,,PO-202309-SaaS-GL-0007,False,False,REF-775991,First Continental Bank,***5438,Globex Retail NA LLC,US,12028597.24
2023-09-13,2023-09-13,Client Receipt - CloudBridge Co. #78,Sales Receipt,SaaS-GL,0.0,118.57,USD,Card Settlement,CloudBridge Co. #78,***9511,INV-202309-SaaS-GL-0009,,False,False,REF-794847,First Continental Bank,***4573,Globex Retail NA LLC,US,12028715.81
2023-09-14,2023-09-14,Marketing - Beacon Digital #8,Marketing,ALL,236.55,0.0,USD,ACH Debit,Beacon Digital #8,***4729,,,False,False,REF-263123,First Continental Bank,***7105,Globex Retail NA LLC,US,12028479.26
2023-09-14,2023-09-14,Supplier Payment - ExpertNet Subcontractors #16,Supplier Payment,PS-GL,9011.22,0.0,USD,Fedwire,ExpertNet Subcontractors #16,***2788,,PO-202309-PS-GL-0006,False,False,REF-663441,First Continental Bank,***4380,Globex Retail NA LLC,US,12019468.04
2023-09-14,2023-09-14,Supplier Payment - NorthRiver Apparel Mfg #27,Supplier Payment,Retail-NA,10242.02,0.0,USD,Fedwire,NorthRiver Apparel Mfg #27,***5735,,PO-202309-Retail-NA-0003,False,False,REF-397460,First Continental Bank,***6939,Globex Retail NA LLC,US,12009226.02
2023-09-14,2023-09-14,Client Receipt - CloudBridge Co. #39,Sales Receipt,SaaS-GL,0.0,4526.73,USD,Card Settlement,CloudBridge Co. #39,***4450,INV-202309-SaaS-GL-0014,,False,False,REF-779006,First Continental Bank,***4694,Globex Retail NA LLC,US,12013752.75
2023-09-14,2023-09-14,Client Receipt - Card Settlement Batch #4,Sales Receipt,Retail-NA,0.0,7029.95,USD,Card Settlement,Card Settlement Batch #4,***5883,INV-202309-Retail-NA-0001,,False,False,REF-458358,First Continental Bank,***3298,Globex Retail NA LLC,US,12020782.7
2023-09-14,2023-09-14,Client Receipt - CloudBridge Co. #67,Sales Receipt,SaaS-GL,0.0,8729.33,USD,Card Settlement,CloudBridge Co. #67,***5055,INV-202309-SaaS-GL-0021,,False,False,REF-517288,First Continental Bank,***2388,Globex Retail NA LLC,US,12029512.03
2023-09-14,2023-09-14,Client Receipt - CloudBridge Co. #68,Sales Receipt,SaaS-GL,0.0,36520.81,USD,Card Settlement,CloudBridge Co. #68,***7573,INV-202309-SaaS-GL-0004,,False,False,REF-853026,First Continental Bank,***4316,Globex Retail NA LLC,US,12066032.84
2023-09-15,2023-09-15,Merchant Processing Fees,Bank/Merchant Fees,ALL,1137.8,0.0,USD,Fedwire,First Continental Bank,***9087,,,False,False,REF-236359,First Continental Bank,***1955,Globex Retail NA LLC,US,12064895.04
2023-09-15,2023-09-15,Supplier Payment - PackFast Fulfillment #15,Supplier Payment,Retail-NA,48154.41,0.0,USD,Fedwire,PackFast Fulfillment #15,***6500,,PO-202309-Retail-NA-0008,False,False,REF-442251,First Continental Bank,***2081,Globex Retail NA LLC,US,12016740.63
2023-09-15,2023-09-15,Client Receipt - CloudBridge Co. #54,Sales Receipt,SaaS-GL,0.0,18634.13,USD,ACH Credit,CloudBridge Co. #54,***5490,INV-202309-SaaS-GL-0026,,False,False,REF-668435,First Continental Bank,***1417,Globex Retail NA LLC,US,12035374.76
2023-09-15,2023-09-15,Client Receipt - Vertex Advisory Client #5,Sales Receipt,PS-GL,0.0,38091.27,USD,Card Settlement,Vertex Advisory Client #5,***2675,INV-202309-PS-GL-0006,,False,False,REF-121316,First Continental Bank,***8480,Globex Retail NA LLC,US,12073466.03
2023-09-18,2023-09-18,Supplier Payment - NorthRiver Apparel Mfg #8,Supplier Payment,Retail-NA,9377.55,0.0,USD,ACH Debit,NorthRiver Apparel Mfg #8,***8432,,PO-202309-Retail-NA-0007,False,False,REF-189024,First Continental Bank,***8505,Globex Retail NA LLC,US,12064088.48
2023-09-18,2023-09-18,Client Receipt - Vertex Advisory Client #48,Sales Receipt,PS-GL,0.0,23770.85,USD,Card Settlement,Vertex Advisory Client #48,***5916,INV-202309-PS-GL-0003,,False,False,REF-443216,First Continental Bank,***4628,Globex Retail NA LLC,US,12087859.33
2023-09-18,2023-09-18,Client Receipt - ShopSphere Partner #36,Sales Receipt,Retail-NA,0.0,59027.88,USD,ACH Credit,ShopSphere Partner #36,***4992,INV-202309-Retail-NA-0003,,False,False,REF-412183,First Continental Bank,***5356,Globex Retail NA LLC,US,12146887.21
2023-09-19,2023-09-19,Supplier Payment - ExpertNet Subcontractors #8,Supplier Payment,PS-GL,4716.74,0.0,USD,ACH Debit,ExpertNet Subcontractors #8,***2187,,PO-202309-PS-GL-0007,False,False,REF-562952,First Continental Bank,***7799,Globex Retail NA LLC,US,12142170.47
2023-09-19,2023-09-19,Supplier Payment - ExpertNet Subcontractors #8,Supplier Payment,PS-GL,9904.25,0.0,USD,Fedwire,ExpertNet Subcontractors #8,***2137,,PO-202309-PS-GL-0008,False,False,REF-964122,First Continental Bank,***1327,Globex Retail NA LLC,US,12132266.22
2023-09-19,2023-09-19,Client Receipt - CloudBridge Co. #3,Sales Receipt,SaaS-GL,0.0,8885.12,USD,ACH Credit,CloudBridge Co. #3,***1993,INV-202309-SaaS-GL-0027,,False,False,REF-888998,First Continental Bank,***3007,Globex Retail NA LLC,US,12141151.34
2023-09-19,2023-09-19,Client Receipt - Vertex Advisory Client #49,Sales Receipt,PS-GL,0.0,27043.23,USD,Card Settlement,Vertex Advisory Client #49,***1722,INV-202309-PS-GL-0010,,False,False,REF-277381,First Continental Bank,***6495,Globex Retail NA LLC,US,12168194.57
2023-09-20,2023-09-20,Supplier Payment - NorthRiver Apparel Mfg #6,Supplier Payment,Retail-NA,9084.16,0.0,USD,Fedwire,NorthRiver Apparel Mfg #6,***1815,,PO-202309-Retail-NA-0005,False,False,REF-715115,First Continental Bank,***8114,Globex Retail NA LLC,US,12159110.41
2023-09-20,2023-09-20,VAT/GST Remittance - US IRS,Tax Payment,ALL,59868.5,0.0,USD,ACH Debit,US IRS,***4653,,,False,False,REF-320539,First Continental Bank,***5093,Globex Retail NA LLC,US,12099241.91
2023-09-20,2023-09-20,Client Receipt - ShopSphere Partner #1,Sales Receipt,Retail-NA,0.0,34870.96,USD,ACH Credit,ShopSphere Partner #1,***1829,INV-202309-Retail-NA-0010,,False,False,REF-323694,First Continental Bank,***2702,Globex Retail NA LLC,US,12134112.87
2023-09-21,2023-09-21,Supplier Payment - CodeCraft Contractors #6,Supplier Payment,SaaS-GL,3243.08,0.0,USD,Fedwire,CodeCraft Contractors #6,***9321,,PO-202309-SaaS-GL-0008,False,False,REF-998010,First Continental Bank,***3635,Globex Retail NA LLC,US,12130869.79
2023-09-21,2023-09-21,Supplier Payment - NorthRiver Apparel Mfg #16,Supplier Payment,Retail-NA,49974.31,0.0,USD,Fedwire,NorthRiver Apparel Mfg #16,***8530,,PO-202309-Retail-NA-0010,False,False,REF-179853,First Continental Bank,***2478,Globex Retail NA LLC,US,12080895.48
2023-09-21,2023-09-21,Client Receipt - Vertex Advisory Client #41,Sales Receipt,PS-GL,0.0,16894.27,USD,Card Settlement,Vertex Advisory Client #41,***6364,INV-202309-PS-GL-0007,,False,False,REF-371020,First Continental Bank,***5456,Globex Retail NA LLC,US,12097789.75
2023-09-21,2023-09-21,Client Receipt - Vertex Advisory Client #39,Sales Receipt,PS-GL,0.0,18934.84,USD,Card Settlement,Vertex Advisory Client #39,***4614,INV-202309-PS-GL-0008,,False,False,REF-161296,First Continental Bank,***7756,Globex Retail NA LLC,US,12116724.59
2023-09-22,2023-09-22,Supplier Payment - NorthRiver Apparel Mfg #6,Supplier Payment,Retail-NA,17893.7,0.0,USD,Fedwire,NorthRiver Apparel Mfg #6,***2771,,PO-202309-Retail-NA-0002,False,False,REF-351191,First Continental Bank,***6458,Globex Retail NA LLC,US,12098830.89
2023-09-23,2023-09-23,Client Receipt - CloudBridge Co. #69,Sales Receipt,SaaS-GL,0.0,4888.57,USD,Card Settlement,CloudBridge Co. #69,***3476,INV-202309-SaaS-GL-0010,,False,False,REF-945204,First Continental Bank,***1796,Globex Retail NA LLC,US,12103719.46
2023-09-24,2023-09-24,Client Receipt - ShopSphere Partner #78,Sales Receipt,Retail-NA,0.0,108407.7,USD,Card Settlement,ShopSphere Partner #78,***1891,INV-202309-Retail-NA-0002,,False,False,REF-411240,First Continental Bank,***8471,Globex Retail NA LLC,US,12212127.16
2023-09-25,2023-09-25,Marketing - Aurelia Media #1,Marketing,ALL,22847.0,0.0,USD,Fedwire,Aurelia Media #1,***3538,,,False,False,REF-620515,First Continental Bank,***4998,Globex Retail NA LLC,US,12189280.16
2023-09-25,2023-09-25,Client Receipt - CloudBridge Co. #4,Sales Receipt,SaaS-GL,0.0,7341.39,USD,Card Settlement,CloudBridge Co. #4,***8099,INV-202309-SaaS-GL-0018,,False,False,REF-589237,First Continental Bank,***2632,Globex Retail NA LLC,US,12196621.55
2023-09-26,2023-09-26,Supplier Payment - CodeCraft Contractors #1,Supplier Payment,SaaS-GL,7566.91,0.0,USD,Fedwire,CodeCraft Contractors #1,***2091,,PO-202309-SaaS-GL-0001,False,False,REF-470985,First Continental Bank,***4528,Globex Retail NA LLC,US,12189054.64
2023-09-26,2023-09-26,Supplier Payment - PackFast Fulfillment #4,Supplier Payment,Retail-NA,20991.3,0.0,USD,ACH Debit,PackFast Fulfillment #4,***9862,,PO-202309-Retail-NA-0006,False,False,REF-135217,First Continental Bank,***7755,Globex Retail NA LLC,US,12168063.34
2023-09-26,2023-09-26,Intercompany Settlement - Globex EMEA Manufacturing Ltd.,Intercompany Transfer,ALL,668076.0,0.0,USD,Internal Transfer,Globex EMEA Manufacturing Ltd.,***3179,,,True,True,REF-507291,First Continental Bank,***3214,Globex Retail NA LLC,US,11499987.34
2023-09-26,2023-09-26,Client Receipt - ShopSphere Partner #64,Sales Receipt,Retail-NA,0.0,25029.13,USD,ACH Credit,ShopSphere Partner #64,***7449,INV-202309-Retail-NA-0006,,False,False,REF-388183,First Continental Bank,***7255,Globex Retail NA LLC,US,11525016.47
2023-09-26,2023-09-26,Client Receipt - Card Settlement Batch #20,Sales Receipt,Retail-NA,0.0,34101.7,USD,Card Settlement,Card Settlement Batch #20,***1885,INV-202309-Retail-NA-0005,,False,False,REF-123834,First Continental Bank,***4316,Globex Retail NA LLC,US,11559118.17
2023-09-27,2023-09-27,Client Receipt - CloudBridge Co. #53,Sales Receipt,SaaS-GL,0.0,4225.45,USD,ACH Credit,CloudBridge Co. #53,***6222,INV-202309-SaaS-GL-0029,,False,False,REF-708765,First Continental Bank,***9843,Globex Retail NA LLC,US,11563343.62
2023-09-27,2023-09-27,Client Receipt - CloudBridge Co. #56,Sales Receipt,SaaS-GL,0.0,7062.85,USD,ACH Credit,CloudBridge Co. #56,***3735,INV-202309-SaaS-GL-0019,,False,False,REF-456910,First Continental Bank,***4064,Globex Retail NA LLC,US,11570406.47
2023-09-28,2023-09-28,Supplier Payment - CodeCraft Contractors #11,Supplier Payment,SaaS-GL,7979.13,0.0,USD,ACH Debit,CodeCraft Contractors #11,***2408,,PO-202309-SaaS-GL-0002,False,False,REF-937454,First Continental Bank,***9549,Globex Retail NA LLC,US,11562427.34
2023-09-28,2023-09-28,Supplier Payment - ExpertNet Subcontractors #1,Supplier Payment,PS-GL,16788.19,0.0,USD,ACH Debit,ExpertNet Subcontractors #1,***3735,,PO-202309-PS-GL-0004,False,False,REF-907381,First Continental Bank,***6158,Globex Retail NA LLC,US,11545639.15
2023-09-28,2023-09-28,Supplier Payment - NorthRiver Apparel Mfg #5,Supplier Payment,Retail-NA,20719.54,0.0,USD,Fedwire,NorthRiver Apparel Mfg #5,***3149,,PO-202309-Retail-NA-0004,False,False,REF-141327,First Continental Bank,***5361,Globex Retail NA LLC,US,11524919.61
2023-09-28,2023-09-28,Payroll - GlobalPay Services Ltd,Payroll,ALL,156449.96,0.0,USD,ACH Debit,GlobalPay Services Ltd,***7719,,,False,False,REF-861680,First Continental Bank,***8384,Globex Retail NA LLC,US,11368469.65
2023-09-28,2023-09-28,Client Receipt - CloudBridge Co. #60,Sales Receipt,SaaS-GL,0.0,636.61,USD,Card Settlement,CloudBridge Co. #60,***8293,INV-202309-SaaS-GL-0008,,False,False,REF-190511,First Continental Bank,***1507,Globex Retail NA LLC,US,11369106.26
2023-09-28,2023-09-28,Client Receipt - Vertex Advisory Client #57,Sales Receipt,PS-GL,0.0,2926.35,USD,ACH Credit,Vertex Advisory Client #57,***2068,INV-202309-PS-GL-0001,,False,False,REF-193099,First Continental Bank,***1735,Globex Retail NA LLC,US,11372032.61
2023-09-28,2023-09-28,Client Receipt - CloudBridge Co. #59,Sales Receipt,SaaS-GL,0.0,7049.41,USD,Card Settlement,CloudBridge Co. #59,***9955,INV-202309-SaaS-GL-0017,,False,False,REF-504879,First Continental Bank,***5239,Globex Retail NA LLC,US,11379082.02
2023-09-28,2023-09-28,Client Receipt - CloudBridge Co. #30,Sales Receipt,SaaS-GL,0.0,7790.6,USD,Card Settlement,CloudBridge Co. #30,***5088,INV-202309-SaaS-GL-0016,,False,False,REF-638216,First Continental Bank,***4720,Globex Retail NA LLC,US,11386872.62
2023-09-28,2023-09-28,Client Receipt - CloudBridge Co. #44,Sales Receipt,SaaS-GL,0.0,16864.14,USD,Card Settlement,CloudBridge Co. #44,***7983,INV-202309-SaaS-GL-0025,,False,False,REF-978191,First Continental Bank,***6064,Globex Retail NA LLC,US,11403736.76
2023-09-28,2023-09-28,Client Receipt - CloudBridge Co. #66,Sales Receipt,SaaS-GL,0.0,17354.56,USD,ACH Credit,CloudBridge Co. #66,***4683,INV-202309-SaaS-GL-0023,,False,False,REF-558874,First Continental Bank,***4172,Globex Retail NA LLC,US,11421091.32
2023-09-28,2023-09-28,Client Receipt - Vertex Advisory Client #27,Sales Receipt,PS-GL,0.0,20413.37,USD,ACH Credit,Vertex Advisory Client #27,***1855,INV-202309-PS-GL-0009,,False,False,REF-757825,First Continental Bank,***1434,Globex Retail NA LLC,US,11441504.69
2023-09-29,2023-09-29,Marketing - Aurelia Media #3,Marketing,ALL,737.59,0.0,USD,Fedwire,Aurelia Media #3,***2264,,,False,False,REF-936112,First Continental Bank,***2232,Globex Retail NA LLC,US,11440767.1
2023-09-29,2023-09-29,BluePeak Property Mgmt,Rent & Utilities,ALL,7725.1,0.0,USD,Fedwire,BluePeak Property Mgmt,***9784,,,False,False,REF-201657,First Continental Bank,***1597,Globex Retail NA LLC,US,11433042.0
2023-09-29,2023-09-29,Client Receipt - CloudBridge Co. #46,Sales Receipt,SaaS-GL,0.0,15234.33,USD,Card Settlement,CloudBridge Co. #46,***5443,INV-202309-SaaS-GL-0015,,False,False,REF-917616,First Continental Bank,***1028,Globex Retail NA LLC,US,11448276.33
2023-09-29,2023-09-29,Client Receipt - CloudBridge Co. #54,Sales Receipt,SaaS-GL,0.0,31651.7,USD,ACH Credit,CloudBridge Co. #54,***3317,INV-202309-SaaS-GL-0032,,False,False,REF-486735,First Continental Bank,***1108,Globex Retail NA LLC,US,11479928.03
2023-09-30,2023-09-30,Interest Earned,Interest Income,ALL,0.0,10799.16,USD,Card Settlement,First Continental Bank,***3713,,,False,False,REF-780295,First Continental Bank,***5251,Globex Retail NA LLC,US,11490727.19
2023-10-01,2023-10-01,Account Maintenance Fee,Bank/Merchant Fees,ALL,2500.0,0.0,USD,Fedwire,First Continental Bank,***8957,,,False,False,REF-881294,First Continental Bank,***1814,Globex Retail NA LLC,US,11488227.19
2023-10-01,2023-10-01,Client Receipt - CloudBridge Co. #31,Sales Receipt,SaaS-GL,0.0,573.72,USD,ACH Credit,CloudBridge Co. #31,***7862,INV-202310-SaaS-GL-0006,,False,False,REF-243314,First Continental Bank,***9932,Globex Retail NA LLC,US,11488800.91
2023-10-02,2023-10-02,Supplier Payment - CodeCraft Contractors #10,Supplier Payment,SaaS-GL,4529.95,0.0,USD,Fedwire,CodeCraft Contractors #10,***3712,,PO-202310-SaaS-GL-0001,False,False,REF-595515,First Continental Bank,***3889,Globex Retail NA LLC,US,11484270.96
2023-10-02,2023-10-02,Client Receipt - CloudBridge Co. #74,Sales Receipt,SaaS-GL,0.0,27093.43,USD,ACH Credit,CloudBridge Co. #74,***9860,INV-202310-SaaS-GL-0031,,False,False,REF-477390,First Continental Bank,***5721,Globex Retail NA LLC,US,11511364.39
2023-10-02,2023-10-02,Client Receipt - CloudBridge Co. #3,Sales Receipt,SaaS-GL,0.0,32655.95,USD,ACH Credit,CloudBridge Co. #3,***9114,INV-202310-SaaS-GL-0003,,False,False,REF-526112,First Continental Bank,***8694,Globex Retail NA LLC,US,11544020.34
2023-10-02,2023-10-02,Client Receipt - Vertex Advisory Client #39,Sales Receipt,PS-GL,0.0,39419.57,USD,Card Settlement,Vertex Advisory Client #39,***8231,INV-202310-PS-GL-0002,,False,False,REF-981366,First Continental Bank,***7772,Globex Retail NA LLC,US,11583439.91
2023-10-02,2023-10-02,Client Receipt - ShopSphere Partner #23,Sales Receipt,Retail-NA,0.0,55628.05,USD,Card Settlement,ShopSphere Partner #23,***1308,INV-202310-Retail-NA-0011,,False,False,REF-242986,First Continental Bank,***7427,Globex Retail NA LLC,US,11639067.96
2023-10-03,2023-10-03,Supplier Payment - CodeCraft Contractors #10,Supplier Payment,SaaS-GL,4224.28,0.0,USD,Fedwire,CodeCraft Contractors #10,***3335,,PO-202310-SaaS-GL-0006,False,False,REF-438523,First Continental Bank,***5628,Globex Retail NA LLC,US,11634843.68
2023-10-03,2023-10-03,Supplier Payment - ExpertNet Subcontractors #14,Supplier Payment,PS-GL,5475.42,0.0,USD,Fedwire,ExpertNet Subcontractors #14,***8517,,PO-202310-PS-GL-0009,False,False,REF-789259,First Continental Bank,***1038,Globex Retail NA LLC,US,11629368.26
2023-10-03,2023-10-03,Marketing - Beacon Digital #8,Marketing,ALL,5952.06,0.0,USD,ACH Debit,Beacon Digital #8,***1954,,,False,False,REF-499055,First Continental Bank,***6821,Globex Retail NA LLC,US,11623416.2
2023-10-03,2023-10-03,Supplier Payment - ExpertNet Subcontractors #17,Supplier Payment,PS-GL,6320.95,0.0,USD,ACH Debit,ExpertNet Subcontractors #17,***7072,,PO-202310-PS-GL-0005,False,False,REF-159285,First Continental Bank,***3121,Globex Retail NA LLC,US,11617095.25
2023-10-03,2023-10-03,Supplier Payment - PackFast Fulfillment #18,Supplier Payment,Retail-NA,17299.09,0.0,USD,ACH Debit,PackFast Fulfillment #18,***4674,,PO-202310-Retail-NA-0001,False,False,REF-337903,First Continental Bank,***6413,Globex Retail NA LLC,US,11599796.16
2023-10-03,2023-10-03,Client Receipt - ShopSphere Partner #53,Sales Receipt,Retail-NA,0.0,4623.63,USD,Card Settlement,ShopSphere Partner #53,***1601,INV-202310-Retail-NA-0009,,False,False,REF-501979,First Continental Bank,***7017,Globex Retail NA LLC,US,11604419.79
2023-10-03,2023-10-03,Client Receipt - CloudBridge Co. #15,Sales Receipt,SaaS-GL,0.0,7504.41,USD,Card Settlement,CloudBridge Co. #15,***7239,INV-202310-SaaS-GL-0009,,False,False,REF-108373,First Continental Bank,***9594,Globex Retail NA LLC,US,11611924.2
2023-10-03,2023-10-03,Client Receipt - CloudBridge Co. #58,Sales Receipt,SaaS-GL,0.0,11709.39,USD,ACH Credit,CloudBridge Co. #58,***5364,INV-202310-SaaS-GL-0021,,False,False,REF-185396,First Continental Bank,***2853,Globex Retail NA LLC,US,11623633.59
2023-10-03,2023-10-03,Client Receipt - ShopSphere Partner #75,Sales Receipt,Retail-NA,0.0,13883.07,USD,ACH Credit,ShopSphere Partner #75,***3295,INV-202310-Retail-NA-0007,,False,False,REF-285756,First Continental Bank,***6417,Globex Retail NA LLC,US,11637516.66
2023-10-03,2023-10-03,Client Receipt - CloudBridge Co. #1,Sales Receipt,SaaS-GL,0.0,16998.7,USD,ACH Credit,CloudBridge Co. #1,***6158,INV-202310-SaaS-GL-0014,,False,False,REF-360654,First Continental Bank,***3480,Globex Retail NA LLC,US,11654515.36
2023-10-03,2023-10-03,Client Receipt - ShopSphere Partner #28,Sales Receipt,Retail-NA,0.0,88186.76,USD,ACH Credit,ShopSphere Partner #28,***7470,INV-202310-Retail-NA-0013,,False,False,REF-388665,First Continental Bank,***4288,Globex Retail NA LLC,US,11742702.12
2023-10-04,2023-10-04,Supplier Payment - ExpertNet Subcontractors #15,Supplier Payment,PS-GL,227.14,0.0,USD,Fedwire,ExpertNet Subcontractors #15,***5037,,PO-202310-PS-GL-0003,False,False,REF-217849,First Continental Bank,***2196,Globex Retail NA LLC,US,11742474.98
2023-10-04,2023-10-04,Supplier Payment - HyperCloud Infra #9,Supplier Payment,SaaS-GL,3904.24,0.0,USD,ACH Debit,HyperCloud Infra #9,***8696,,PO-202310-SaaS-GL-0004,False,False,REF-238439,First Continental Bank,***5174,Globex Retail NA LLC,US,11738570.74
2023-10-04,2023-10-04,Supplier Payment - NorthRiver Apparel Mfg #28,Supplier Payment,Retail-NA,32029.22,0.0,USD,ACH Debit,NorthRiver Apparel Mfg #28,***4975,,PO-202310-Retail-NA-0006,False,False,REF-105039,First Continental Bank,***7691,Globex Retail NA LLC,US,11706541.52
2023-10-05,2023-10-05,Supplier Payment - HyperCloud Infra #2,Supplier Payment,SaaS-GL,19748.95,0.0,USD,ACH Debit,HyperCloud Infra #2,***6868,,PO-202310-SaaS-GL-0007,False,False,REF-103991,First Continental Bank,***3314,Globex Retail NA LLC,US,11686792.57
2023-10-05,2023-10-05,Supplier Payment - ExpertNet Subcontractors #8,Supplier Payment,PS-GL,20087.88,0.0,USD,ACH Debit,ExpertNet Subcontractors #8,***6471,,PO-202310-PS-GL-0008,False,False,REF-523718,First Continental Bank,***6005,Globex Retail NA LLC,US,11666704.69
2023-10-05,2023-10-05,Client Receipt - CloudBridge Co. #51,Sales Receipt,SaaS-GL,0.0,2404.52,USD,Card Settlement,CloudBridge Co. #51,***6696,INV-202310-SaaS-GL-0027,,False,False,REF-413587,First Continental Bank,***1288,Globex Retail NA LLC,US,11669109.21
2023-10-06,2023-10-06,Northshore Power,Rent & Utilities,ALL,3929.28,0.0,USD,ACH Debit,Northshore Power,***1100,,,False,False,REF-364148,First Continental Bank,***1897,Globex Retail NA LLC,US,11665179.93
2023-10-06,2023-10-06,Client Receipt - CloudBridge Co. #38,Sales Receipt,SaaS-GL,0.0,1368.43,USD,Card Settlement,CloudBridge Co. #38,***4004,INV-202310-SaaS-GL-0012,,False,False,REF-298856,First Continental Bank,***5778,Globex Retail NA LLC,US,11666548.36
2023-10-06,2023-10-06,Client Receipt - ShopSphere Partner #39,Sales Receipt,Retail-NA,0.0,2971.63,USD,Card Settlement,ShopSphere Partner #39,***3061,INV-202310-Retail-NA-0014,,False,False,REF-125995,First Continental Bank,***4363,Globex Retail NA LLC,US,11669519.99
2023-10-08,2023-10-08,Client Receipt - CloudBridge Co. #55,Sales Receipt,SaaS-GL,0.0,13325.68,USD,Card Settlement,CloudBridge Co. #55,***5337,INV-202310-SaaS-GL-0005,,False,False,REF-175573,First Continental Bank,***7878,Globex Retail NA LLC,US,11682845.67
2023-10-09,2023-10-09,Marketing - Aurelia Media #1,Marketing,ALL,12488.92,0.0,USD,Fedwire,Aurelia Media #1,***1714,,,False,False,REF-575342,First Continental Bank,***1561,Globex Retail NA LLC,US,11670356.75
2023-10-09,2023-10-09,Client Receipt - CloudBridge Co. #39,Sales Receipt,SaaS-GL,0.0,2429.38,USD,ACH Credit,CloudBridge Co. #39,***8747,INV-202310-SaaS-GL-0024,,False,False,REF-807761,First Continental Bank,***5541,Globex Retail NA LLC,US,11672786.13
2023-10-09,2023-10-09,Client Receipt - Vertex Advisory Client #47,Sales Receipt,PS-GL,0.0,3860.65,USD,Card Settlement,Vertex Advisory Client #47,***7119,INV-202310-PS-GL-0008,,False,False,REF-672238,First Continental Bank,***3097,Globex Retail NA LLC,US,11676646.78
2023-10-09,2023-10-09,Client Receipt - ShopSphere Partner #60,Sales Receipt,Retail-NA,0.0,3974.82,USD,ACH Credit,ShopSphere Partner #60,***1594,INV-202310-Retail-NA-0006,,False,False,REF-127908,First Continental Bank,***1853,Globex Retail NA LLC,US,11680621.6
2023-10-09,2023-10-09,Client Receipt - Vertex Advisory Client #21,Sales Receipt,PS-GL,0.0,5765.59,USD,Card Settlement,Vertex Advisory Client #21,***3704,INV-202310-PS-GL-0003,,False,False,REF-139974,First Continental Bank,***2729,Globex Retail NA LLC,US,11686387.19
2023-10-09,2023-10-09,Client Receipt - Vertex Advisory Client #35,Sales Receipt,PS-GL,0.0,22048.05,USD,Card Settlement,Vertex Advisory Client #35,***9990,INV-202310-PS-GL-0009,,False,False,REF-232435,First Continental Bank,***9190,Globex Retail NA LLC,US,11708435.24
2023-10-09,2023-10-09,Client Receipt - CloudBridge Co. #68,Sales Receipt,SaaS-GL,0.0,32749.24,USD,ACH Credit,CloudBridge Co. #68,***5587,INV-202310-SaaS-GL-0022,,False,False,REF-869972,First Continental Bank,***8832,Globex Retail NA LLC,US,11741184.48
2023-10-10,2023-10-10,Supplier Payment - ExpertNet Subcontractors #17,Supplier Payment,PS-GL,1528.74,0.0,USD,Fedwire,ExpertNet Subcontractors #17,***6881,,PO-202310-PS-GL-0006,False,False,REF-884445,First Continental Bank,***4861,Globex Retail NA LLC,US,11739655.74
2023-10-10,2023-10-10,Client Receipt - Vertex Advisory Client #22,Sales Receipt,PS-GL,0.0,38987.56,USD,Card Settlement,Vertex Advisory Client #22,***1980,INV-202310-PS-GL-0011,,False,False,REF-526617,First Continental Bank,***9205,Globex Retail NA LLC,US,11778643.3
2023-10-10,2023-10-10,Client Receipt - Card Settlement Batch #16,Sales Receipt,Retail-NA,0.0,108631.99,USD,ACH Credit,Card Settlement Batch #16,***1529,INV-202310-Retail-NA-0008,,False,False,REF-776140,First Continental Bank,***9771,Globex Retail NA LLC,US,11887275.29
2023-10-11,2023-10-11,Supplier Payment - ExpertNet Subcontractors #18,Supplier Payment,PS-GL,2297.49,0.0,USD,Fedwire,ExpertNet Subcontractors #18,***2416,,PO-202310-PS-GL-0007,False,False,REF-677587,First Continental Bank,***8157,Globex Retail NA LLC,US,11884977.8
2023-10-11,2023-10-11,Supplier Payment - ExpertNet Subcontractors #7,Supplier Payment,PS-GL,7765.2,0.0,USD,Fedwire,ExpertNet Subcontractors #7,***8081,,PO-202310-PS-GL-0011,False,False,REF-588623,First Continental Bank,***9704,Globex Retail NA LLC,US,11877212.6
2023-10-11,2023-10-11,Client Receipt - Vertex Advisory Client #8,Sales Receipt,PS-GL,0.0,5830.41,USD,Card Settlement,Vertex Advisory Client #8,***1773,INV-202310-PS-GL-0007,,False,False,REF-405880,First Continental Bank,***6035,Globex Retail NA LLC,US,11883043.01
2023-10-11,2023-10-11,Client Receipt - ShopSphere Partner #21,Sales Receipt,Retail-NA,0.0,10753.36,USD,ACH Credit,ShopSphere Partner #21,***9423,INV-202310-Retail-NA-0010,,False,False,REF-668784,First Continental Bank,***5688,Globex Retail NA LLC,US,11893796.37
2023-10-11,2023-10-11,Client Receipt - CloudBridge Co. #23,Sales Receipt,SaaS-GL,0.0,14772.88,USD,Card Settlement,CloudBridge Co. #23,***6493,INV-202310-SaaS-GL-0011,,False,False,REF-692201,First Continental Bank,***8761,Globex Retail NA LLC,US,11908569.25
2023-10-11,2023-10-11,Client Receipt - Vertex Advisory Client #46,Sales Receipt,PS-GL,0.0,31285.9,USD,Card Settlement,Vertex Advisory Client #46,***7638,INV-202310-PS-GL-0004,,False,False,REF-139650,First Continental Bank,***5847,Globex Retail NA LLC,US,11939855.15
2023-10-12,2023-10-12,Supplier Payment - HyperCloud Infra #8,Supplier Payment,SaaS-GL,6687.35,0.0,USD,ACH Debit,HyperCloud Infra #8,***9613,,PO-202310-SaaS-GL-0008,False,False,REF-881605,First Continental Bank,***4987,Globex Retail NA LLC,US,11933167.8
2023-10-12,2023-10-12,"Intercompany Settlement - Globex International Holdings, Inc.",Intercompany Transfer,ALL,643796.0,0.0,USD,Internal Transfer,"Globex International Holdings, Inc.",***4417,,,True,True,REF-196978,First Continental Bank,***4821,Globex Retail NA LLC,US,11289371.8
2023-10-12,2023-10-12,Client Receipt - Vertex Advisory Client #24,Sales Receipt,PS-GL,0.0,22610.48,USD,ACH Credit,Vertex Advisory Client #24,***7873,INV-202310-PS-GL-0012,,False,False,REF-632496,First Continental Bank,***2757,Globex Retail NA LLC,US,11311982.28
2023-10-13,2023-10-13,Merchant Processing Fees,Bank/Merchant Fees,ALL,2640.83,0.0,USD,Fedwire,First Continental Bank,***9536,,,False,False,REF-608171,First Continental Bank,***1406,Globex Retail NA LLC,US,11309341.45
2023-10-13,2023-10-13,Supplier Payment - CodeCraft Contractors #7,Supplier Payment,SaaS-GL,9492.84,0.0,USD,Fedwire,CodeCraft Contractors #7,***8328,,PO-202310-SaaS-GL-0005,False,False,REF-737870,First Continental Bank,***2567,Globex Retail NA LLC,US,11299848.61
2023-10-13,2023-10-13,Supplier Payment - PackFast Fulfillment #17,Supplier Payment,Retail-NA,40541.41,0.0,USD,Fedwire,PackFast Fulfillment #17,***9174,,PO-202310-Retail-NA-0003,False,False,REF-760147,First Continental Bank,***1612,Globex Retail NA LLC,US,11259307.2
2023-10-14,2023-10-14,Client Receipt - Vertex Advisory Client #17,Sales Receipt,PS-GL,0.0,21010.41,USD,Card Settlement,Vertex Advisory Client #17,***1552,INV-202310-PS-GL-0001,,False,False,REF-449344,First Continental Bank,***9259,Globex Retail NA LLC,US,11280317.61
2023-10-15,2023-10-15,Client Receipt - CloudBridge Co. #49,Sales Receipt,SaaS-GL,0.0,6429.04,USD,Card Settlement,CloudBridge Co. #49,***6107,INV-202310-SaaS-GL-0010,,False,False,REF-408110,First Continental Bank,***9427,Globex Retail NA LLC,US,11286746.65
2023-10-15,2023-10-15,Client Receipt - Card Settlement Batch #2,Sales Receipt,Retail-NA,0.0,8756.99,USD,Card Settlement,Card Settlement Batch #2,***5323,INV-202310-Retail-NA-0002,,False,False,REF-160643,First Continental Bank,***2410,Globex Retail NA LLC,US,11295503.64
2023-10-15,2023-10-15,Client Receipt - Vertex Advisory Client #44,Sales Receipt,PS-GL,0.0,48727.28,USD,ACH Credit,Vertex Advisory Client #44,***5032,INV-202310-PS-GL-0005,,False,False,REF-277264,First Continental Bank,***9645,Globex Retail NA LLC,US,11344230.92
2023-10-16,2023-10-16,Supplier Payment - HyperCloud Infra #7,Supplier Payment,SaaS-GL,12908.17,0.0,USD,Fedwire,HyperCloud Infra #7,***9719,,PO-202310-SaaS-GL-0002,False,False,REF-454182,First Continental Bank,***2089,Globex Retail NA LLC,US,11331322.75
2023-10-17,2023-10-17,Supplier Payment - NorthRiver Apparel Mfg #25,Supplier Payment,Retail-NA,59447.5,0.0,USD,Fedwire,NorthRiver Apparel Mfg #25,***6378,,PO-202310-Retail-NA-0009,False,False,REF-784037,First Continental Bank,***6214,Globex Retail NA LLC,US,11271875.25
2023-10-17,2023-10-17,Client Receipt - CloudBridge Co. #25,Sales Receipt,SaaS-GL,0.0,3643.2,USD,Card Settlement,CloudBridge Co. #25,***7860,INV-202310-SaaS-GL-0002,,False,False,REF-480741,First Continental Bank,***7834,Globex Retail NA LLC,US,11275518.45
2023-10-17,2023-10-17,Client Receipt - ShopSphere Partner #60,Sales Receipt,Retail-NA,0.0,47355.4,USD,Card Settlement,ShopSphere Partner #60,***5965,INV-202310-Retail-NA-0005,,False,False,REF-768643,First Continental Bank,***3371,Globex Retail NA LLC,US,11322873.85
2023-10-18,2023-10-18,Merchant Processing Fees,Bank/Merchant Fees,ALL,596.72,0.0,USD,ACH Debit,First Continental Bank,***1917,,,False,False,REF-765344,First Continental Bank,***9905,Globex Retail NA LLC,US,11322277.13
2023-10-18,2023-10-18,Supplier Payment - ExpertNet Subcontractors #3,Supplier Payment,PS-GL,7359.93,0.0,USD,ACH Debit,ExpertNet Subcontractors #3,***6346,,PO-202310-PS-GL-0002,False,False,REF-294625,First Continental Bank,***8957,Globex Retail NA LLC,US,11314917.2
2023-10-18,2023-10-18,Supplier Payment - ExpertNet Subcontractors #17,Supplier Payment,PS-GL,20732.83,0.0,USD,ACH Debit,ExpertNet Subcontractors #17,***1183,,PO-202310-PS-GL-0010,False,False,REF-123619,First Continental Bank,***3996,Globex Retail NA LLC,US,11294184.37
2023-10-18,2023-10-18,Client Receipt - CloudBridge Co. #34,Sales Receipt,SaaS-GL,0.0,4627.17,USD,ACH Credit,CloudBridge Co. #34,***5899,INV-202310-SaaS-GL-0025,,False,False,REF-391023,First Continental Bank,***7795,Globex Retail NA LLC,US,11298811.54
2023-10-18,2023-10-18,Client Receipt - CloudBridge Co. #60,Sales Receipt,SaaS-GL,0.0,13879.98,USD,Card Settlement,CloudBridge Co. #60,***9110,INV-202310-SaaS-GL-0018,,False,False,REF-797364,First Continental Bank,***2007,Globex Retail NA LLC,US,11312691.52
2023-10-20,2023-10-20,Marketing - Beacon Digital #9,Marketing,ALL,7981.3,0.0,USD,ACH Debit,Beacon Digital #9,***7756,,,False,False,REF-915153,First Continental Bank,***9219,Globex Retail NA LLC,US,11304710.22
2023-10-20,2023-10-20,Supplier Payment - NorthRiver Apparel Mfg #28,Supplier Payment,Retail-NA,48338.28,0.0,USD,Fedwire,NorthRiver Apparel Mfg #28,***9917,,PO-202310-Retail-NA-0005,False,False,REF-742257,First Continental Bank,***6173,Globex Retail NA LLC,US,11256371.94
2023-10-20,2023-10-20,Client Receipt - CloudBridge Co. #34,Sales Receipt,SaaS-GL,0.0,2821.99,USD,Card Settlement,CloudBridge Co. #34,***2176,INV-202310-SaaS-GL-0026,,False,False,REF-735028,First Continental Bank,***6675,Globex Retail NA LLC,US,11259193.93
2023-10-20,2023-10-20,Client Receipt - CloudBridge Co. #74,Sales Receipt,SaaS-GL,0.0,3996.11,USD,ACH Credit,CloudBridge Co. #74,***8883,INV-202310-SaaS-GL-0001,,False,False,REF-511868,First Continental Bank,***9349,Globex Retail NA LLC,US,11263190.04
2023-10-20,2023-10-20,Client Receipt - CloudBridge Co. #64,Sales Receipt,SaaS-GL,0.0,11260.18,USD,ACH Credit,CloudBridge Co. #64,***6186,INV-202310-SaaS-GL-0015,,False,False,REF-753916,First Continental Bank,***3039,Globex Retail NA LLC,US,11274450.22
2023-10-21,2023-10-21,Supplier Payment - PackFast Fulfillment #13,Supplier Payment,Retail-NA,18410.34,0.0,USD,Fedwire,PackFast Fulfillment #13,***5813,,PO-202310-Retail-NA-0008,False,False,REF-291618,First Continental Bank,***9151,Globex Retail NA LLC,US,11256039.88
2023-10-21,2023-10-21,VAT/GST Remittance - US IRS,Tax Payment,ALL,65693.79,0.0,USD,Fedwire,US IRS,***7560,,,False,False,REF-130471,First Continental Bank,***8191,Globex Retail NA LLC,US,11190346.09
2023-10-21,2023-10-21,Client Receipt - CloudBridge Co. #59,Sales Receipt,SaaS-GL,0.0,2901.12,USD,Card Settlement,CloudBridge Co. #59,***1901,INV-202310-SaaS-GL-0016,,False,False,REF-699182,First Continental Bank,***7519,Globex Retail NA LLC,US,11193247.21
2023-10-21,2023-10-21,Client Receipt - CloudBridge Co. #44,Sales Receipt,SaaS-GL,0.0,11927.88,USD,ACH Credit,CloudBridge Co. #44,***3001,INV-202310-SaaS-GL-0007,,False,False,REF-310229,First Continental Bank,***7560,Globex Retail NA LLC,US,11205175.09
2023-10-22,2023-10-22,Skyline Internet Services,Rent & Utilities,ALL,4668.87,0.0,USD,Fedwire,Skyline Internet Services,***9101,,,False,False,REF-138621,First Continental Bank,***5919,Globex Retail NA LLC,US,11200506.22
2023-10-22,2023-10-22,Client Receipt - CloudBridge Co. #27,Sales Receipt,SaaS-GL,0.0,21690.04,USD,ACH Credit,CloudBridge Co. #27,***3768,INV-202310-SaaS-GL-0030,,False,False,REF-330811,First Continental Bank,***9405,Globex Retail NA LLC,US,11222196.26
2023-10-23,2023-10-23,Supplier Payment - ExpertNet Subcontractors #10,Supplier Payment,PS-GL,167.84,0.0,USD,Fedwire,ExpertNet Subcontractors #10,***1994,,PO-202310-PS-GL-0001,False,False,REF-277603,First Continental Bank,***1223,Globex Retail NA LLC,US,11222028.42
2023-10-23,2023-10-23,Supplier Payment - ExpertNet Subcontractors #6,Supplier Payment,PS-GL,2333.02,0.0,USD,ACH Debit,ExpertNet Subcontractors #6,***3894,,PO-202310-PS-GL-0004,False,False,REF-834228,First Continental Bank,***6117,Globex Retail NA LLC,US,11219695.4
2023-10-23,2023-10-23,Client Receipt - ShopSphere Partner #22,Sales Receipt,Retail-NA,0.0,6052.75,USD,Card Settlement,ShopSphere Partner #22,***6310,INV-202310-Retail-NA-0004,,False,False,REF-823963,First Continental Bank,***4050,Globex Retail NA LLC,US,11225748.15
2023-10-24,2023-10-24,Client Receipt - CloudBridge Co. #63,Sales Receipt,SaaS-GL,0.0,11489.53,USD,ACH Credit,CloudBridge Co. #63,***4173,INV-202310-SaaS-GL-0013,,False,False,REF-834368,First Continental Bank,***6270,Globex Retail NA LLC,US,11237237.68
2023-10-25,2023-10-25,Client Receipt - Vertex Advisory Client #17,Sales Receipt,PS-GL,0.0,7101.91,USD,ACH Credit,Vertex Advisory Client #17,***3242,INV-202310-PS-GL-0006,,False,False,REF-931723,First Continental Bank,***4559,Globex Retail NA LLC,US,11244339.59
2023-10-25,2023-10-25,Client Receipt - CloudBridge Co. #72,Sales Receipt,SaaS-GL,0.0,10885.51,USD,Card Settlement,CloudBridge Co. #72,***6937,INV-202310-SaaS-GL-0020,,False,False,REF-741635,First Continental Bank,***4041,Globex Retail NA LLC,US,11255225.1
2023-10-25,2023-10-25,Client Receipt - CloudBridge Co. #45,Sales Receipt,SaaS-GL,0.0,12699.47,USD,Card Settlement,CloudBridge Co. #45,***7282,INV-202310-SaaS-GL-0004,,False,False,REF-587744,First Continental Bank,***1150,Globex Retail NA LLC,US,11267924.57
2023-10-26,2023-10-26,Supplier Payment - PackFast Fulfillment #2,Supplier Payment,Retail-NA,2036.23,0.0,USD,Fedwire,PackFast Fulfillment #2,***3316,,PO-202310-Retail-NA-0004,False,False,REF-767191,First Continental Bank,***5421,Globex Retail NA LLC,US,11265888.34
2023-10-26,2023-10-26,Supplier Payment - PackFast Fulfillment #12,Supplier Payment,Retail-NA,4621.28,0.0,USD,ACH Debit,PackFast Fulfillment #12,***1778,,PO-202310-Retail-NA-0007,False,False,REF-714504,First Continental Bank,***6127,Globex Retail NA LLC,US,11261267.06
2023-10-26,2023-10-26,Supplier Payment - NorthRiver Apparel Mfg #25,Supplier Payment,Retail-NA,20200.53,0.0,USD,Fedwire,NorthRiver Apparel Mfg #25,***2017,,PO-202310-Retail-NA-0002,False,False,REF-654054,First Continental Bank,***4750,Globex Retail NA LLC,US,11241066.53
2023-10-26,2023-10-26,Intercompany Settlement - Globex EMEA Manufacturing Ltd.,Intercompany Transfer,ALL,309759.0,0.0,USD,Internal Transfer,Globex EMEA Manufacturing Ltd.,***9753,,,True,True,REF-452277,First Continental Bank,***2399,Globex Retail NA LLC,US,10931307.53
2023-10-26,2023-10-26,Client Receipt - CloudBridge Co. #58,Sales Receipt,SaaS-GL,0.0,18455.75,USD,ACH Credit,CloudBridge Co. #58,***2400,INV-202310-SaaS-GL-0023,,False,False,REF-918218,First Continental Bank,***1014,Globex Retail NA LLC,US,10949763.28
2023-10-26,2023-10-26,Client Receipt - ShopSphere Partner #22,Sales Receipt,Retail-NA,0.0,45214.03,USD,ACH Credit,ShopSphere Partner #22,***7624,INV-202310-Retail-NA-0001,,False,False,REF-820835,First Continental Bank,***7734,Globex Retail NA LLC,US,10994977.31
2023-10-27,2023-10-27,Client Receipt - Card Settlement Batch #4,Sales Receipt,Retail-NA,0.0,37023.75,USD,ACH Credit,Card Settlement Batch #4,***4124,INV-202310-Retail-NA-0003,,False,False,REF-358881,First Continental Bank,***2485,Globex Retail NA LLC,US,11032001.06
2023-10-28,2023-10-28,Corporate Tax Estimate,Tax Payment,ALL,49166.43,0.0,USD,Fedwire,State of NY DoF,***2998,,,False,False,REF-844956,First Continental Bank,***6446,Globex Retail NA LLC,US,10982834.63
2023-10-28,2023-10-28,Client Receipt - CloudBridge Co. #17,Sales Receipt,SaaS-GL,0.0,954.97,USD,ACH Credit,CloudBridge Co. #17,***8361,INV-202310-SaaS-GL-0028,,False,False,REF-188081,First Continental Bank,***8768,Globex Retail NA LLC,US,10983789.6
2023-10-28,2023-10-28,Client Receipt - ShopSphere Partner #37,Sales Receipt,Retail-NA,0.0,20977.54,USD,Card Settlement,ShopSphere Partner #37,***5314,INV-202310-Retail-NA-0012,,False,False,REF-951743,First Continental Bank,***7462,Globex Retail NA LLC,US,11004767.14
2023-10-29,2023-10-29,Payroll - GlobalPay Services Ltd,Payroll,ALL,172364.61,0.0,USD,Fedwire,GlobalPay Services Ltd,***8174,,,False,False,REF-726168,First Continental Bank,***3889,Globex Retail NA LLC,US,10832402.53
2023-10-30,2023-10-30,Supplier Payment - CodeCraft Contractors #1,Supplier Payment,SaaS-GL,20230.3,0.0,USD,ACH Debit,CodeCraft Contractors #1,***4591,,PO-202310-SaaS-GL-0003,False,False,REF-352773,First Continental Bank,***7270,Globex Retail NA LLC,US,10812172.23
2023-10-30,2023-10-30,Interest Earned,Interest Income,ALL,0.0,9663.31,USD,Card Settlement,First Continental Bank,***4091,,,False,False,REF-118882,First Continental Bank,***8149,Globex Retail NA LLC,US,10821835.54
2023-10-30,2023-10-30,Client Receipt - CloudBridge Co. #70,Sales Receipt,SaaS-GL,0.0,12143.5,USD,Card Settlement,CloudBridge Co. #70,***7337,INV-202310-SaaS-GL-0008,,False,False,REF-260269,First Continental Bank,***5075,Globex Retail NA LLC,US,10833979.04
2023-10-30,2023-10-30,Client Receipt - CloudBridge Co. #25,Sales Receipt,SaaS-GL,0.0,21090.94,USD,Card Settlement,CloudBridge Co. #25,***3404,INV-202310-SaaS-GL-0029,,False,False,REF-677250,First Continental Bank,***3015,Globex Retail NA LLC,US,10855069.98
2023-10-31,2023-10-31,Supplier Payment - NorthRiver Apparel Mfg #5,Supplier Payment,Retail-NA,6794.69,0.0,USD,ACH Debit,NorthRiver Apparel Mfg #5,***7480,,PO-202310-Retail-NA-0010,False,False,REF-872561,First Continental Bank,***9921,Globex Retail NA LLC,US,10848275.29
2023-10-31,2023-10-31,Client Receipt - CloudBridge Co. #57,Sales Receipt,SaaS-GL,0.0,670.58,USD,Card Settlement,CloudBridge Co. #57,***1980,INV-202310-SaaS-GL-0017,,False,False,REF-645151,First Continental Bank,***7791,Globex Retail NA LLC,US,10848945.87
2023-10-31,2023-10-31,Client Receipt - Vertex Advisory Client #24,Sales Receipt,PS-GL,0.0,1006.97,USD,ACH Credit,Vertex Advisory Client #24,***5526,INV-202310-PS-GL-0010,,False,False,REF-662818,First Continental Bank,***1203,Globex Retail NA LLC,US,10849952.84
2023-10-31,2023-10-31,Client Receipt - CloudBridge Co. #63,Sales Receipt,SaaS-GL,0.0,36329.49,USD,ACH Credit,CloudBridge Co. #63,***2495,INV-202310-SaaS-GL-0019,,False,False,REF-132507,First Continental Bank,***4812,Globex Retail NA LLC,US,10886282.33
2023-11-01,2023-11-01,Supplier Payment - PackFast Fulfillment #15,Supplier Payment,Retail-NA,2171.39,0.0,USD,ACH Debit,PackFast Fulfillment #15,***5553,,PO-202311-Retail-NA-0006,False,False,REF-500566,First Continental Bank,***3543,Globex Retail NA LLC,US,10884110.94
2023-11-01,2023-11-01,Account Maintenance Fee,Bank/Merchant Fees,ALL,2500.0,0.0,USD,Fedwire,First Continental Bank,***6168,,,False,False,REF-250089,First Continental Bank,***5754,Globex Retail NA LLC,US,10881610.94
2023-11-01,2023-11-01,Supplier Payment - ExpertNet Subcontractors #2,Supplier Payment,PS-GL,3578.61,0.0,USD,ACH Debit,ExpertNet Subcontractors #2,***8279,,PO-202311-PS-GL-0007,False,False,REF-891330,First Continental Bank,***3202,Globex Retail NA LLC,US,10878032.33
2023-11-01,2023-11-01,Client Receipt - CloudBridge Co. #48,Sales Receipt,SaaS-GL,0.0,750.24,USD,Card Settlement,CloudBridge Co. #48,***5786,INV-202311-SaaS-GL-0006,,False,False,REF-627294,First Continental Bank,***6158,Globex Retail NA LLC,US,10878782.57
2023-11-02,2023-11-02,Marketing - Aurelia Media #5,Marketing,ALL,13677.21,0.0,USD,ACH Debit,Aurelia Media #5,***8857,,,False,False,REF-734930,First Continental Bank,***7612,Globex Retail NA LLC,US,10865105.36
2023-11-02,2023-11-02,Client Receipt - ShopSphere Partner #65,Sales Receipt,Retail-NA,0.0,92571.84,USD,Card Settlement,ShopSphere Partner #65,***2391,INV-202311-Retail-NA-0009,,False,False,REF-942326,First Continental Bank,***8735,Globex Retail NA LLC,US,10957677.2
2023-11-03,2023-11-03,Client Receipt - CloudBridge Co. #59,Sales Receipt,SaaS-GL,0.0,8437.76,USD,ACH Credit,CloudBridge Co. #59,***6789,INV-202311-SaaS-GL-0011,,False,False,REF-688993,First Continental Bank,***5921,Globex Retail NA LLC,US,10966114.96
2023-11-03,2023-11-03,Client Receipt - CloudBridge Co. #76,Sales Receipt,SaaS-GL,0.0,45301.58,USD,ACH Credit,CloudBridge Co. #76,***3064,INV-202311-SaaS-GL-0008,,False,False,REF-224352,First Continental Bank,***5225,Globex Retail NA LLC,US,11011416.54
2023-11-04,2023-11-04,Client Receipt - CloudBridge Co. #77,Sales Receipt,SaaS-GL,0.0,13685.07,USD,Card Settlement,CloudBridge Co. #77,***2987,INV-202311-SaaS-GL-0015,,False,False,REF-370455,First Continental Bank,***8325,Globex Retail NA LLC,US,11025101.61
2023-11-06,2023-11-06,Supplier Payment - NorthRiver Apparel Mfg #1,Supplier Payment,Retail-NA,13880.18,0.0,USD,ACH Debit,NorthRiver Apparel Mfg #1,***7734,,PO-202311-Retail-NA-0005,False,False,REF-927092,First Continental Bank,***5028,Globex Retail NA LLC,US,11011221.43
2023-11-06,2023-11-06,Client Receipt - ShopSphere Partner #17,Sales Receipt,Retail-NA,0.0,3657.03,USD,Card Settlement,ShopSphere Partner #17,***6924,INV-202311-Retail-NA-0002,,False,False,REF-321340,First Continental Bank,***7107,Globex Retail NA LLC,US,11014878.46
2023-11-06,2023-11-06,Client Receipt - ShopSphere Partner #43,Sales Receipt,Retail-NA,0.0,16742.85,USD,Card Settlement,ShopSphere Partner #43,***6905,INV-202311-Retail-NA-0015,,False,False,REF-857167,First Continental Bank,***6303,Globex Retail NA LLC,US,11031621.31
2023-11-07,2023-11-07,Supplier Payment - CodeCraft Contractors #8,Supplier Payment,SaaS-GL,22749.67,0.0,USD,Fedwire,CodeCraft Contractors #8,***9463,,PO-202311-SaaS-GL-0007,False,False,REF-287123,First Continental Bank,***7637,Globex Retail NA LLC,US,11008871.64
2023-11-07,2023-11-07,Client Receipt - CloudBridge Co. #32,Sales Receipt,SaaS-GL,0.0,2929.6,USD,Card Settlement,CloudBridge Co. #32,***1192,INV-202311-SaaS-GL-0003,,False,False,REF-756004,First Continental Bank,***6152,Globex Retail NA LLC,US,11011801.24
2023-11-07,2023-11-07,Client Receipt - CloudBridge Co. #40,Sales Receipt,SaaS-GL,0.0,15577.19,USD,Card Settlement,CloudBridge Co. #40,***8372,INV-202311-SaaS-GL-0016,,False,False,REF-359411,First Continental Bank,***4814,Globex Retail NA LLC,US,11027378.43
2023-11-07,2023-11-07,Client Receipt - CloudBridge Co. #46,Sales Receipt,SaaS-GL,0.0,24682.38,USD,Card Settlement,CloudBridge Co. #46,***8559,INV-202311-SaaS-GL-0009,,False,False,REF-971743,First Continental Bank,***8879,Globex Retail NA LLC,US,11052060.81
2023-11-08,2023-11-08,Client Receipt - Vertex Advisory Client #54,Sales Receipt,PS-GL,0.0,20342.6,USD,ACH Credit,Vertex Advisory Client #54,***6827,INV-202311-PS-GL-0002,,False,False,REF-423454,First Continental Bank,***7901,Globex Retail NA LLC,US,11072403.41
2023-11-08,2023-11-08,Client Receipt - Vertex Advisory Client #57,Sales Receipt,PS-GL,0.0,20642.12,USD,Card Settlement,Vertex Advisory Client #57,***4469,INV-202311-PS-GL-0008,,False,False,REF-152440,First Continental Bank,***6108,Globex Retail NA LLC,US,11093045.53
2023-11-08,2023-11-08,Client Receipt - Vertex Advisory Client #2,Sales Receipt,PS-GL,0.0,25333.74,USD,ACH Credit,Vertex Advisory Client #2,***4486,INV-202311-PS-GL-0005,,False,False,REF-628797,First Continental Bank,***5579,Globex Retail NA LLC,US,11118379.27
2023-11-08,2023-11-08,Client Receipt - ShopSphere Partner #54,Sales Receipt,Retail-NA,0.0,84778.73,USD,Card Settlement,ShopSphere Partner #54,***9742,INV-202311-Retail-NA-0008,,False,False,REF-798781,First Continental Bank,***3052,Globex Retail NA LLC,US,11203158.0
2023-11-09,2023-11-09,Client Receipt - CloudBridge Co. #28,Sales Receipt,SaaS-GL,0.0,3830.92,USD,ACH Credit,CloudBridge Co. #28,***8408,INV-202311-SaaS-GL-0019,,False,False,REF-917922,First Continental Bank,***8572,Globex Retail NA LLC,US,11206988.92
2023-11-09,2023-11-09,Client Receipt - CloudBridge Co. #69,Sales Receipt,SaaS-GL,0.0,21056.29,USD,Card Settlement,CloudBridge Co. #69,***6941,INV-202311-SaaS-GL-0007,,False,False,REF-907776,First Continental Bank,***2552,Globex Retail NA LLC,US,11228045.21
2023-11-09,2023-11-09,Client Receipt - Vertex Advisory Client #28,Sales Receipt,PS-GL,0.0,22620.12,USD,Card Settlement,Vertex Advisory Client #28,***6333,INV-202311-PS-GL-0007,,False,False,REF-587705,First Continental Bank,***1400,Globex Retail NA LLC,US,11250665.33
2023-11-11,2023-11-11,Client Receipt - Vertex Advisory Client #3,Sales Receipt,PS-GL,0.0,3284.11,USD,Card Settlement,Vertex Advisory Client #3,***8385,INV-202311-PS-GL-0001,,False,False,REF-897001,First Continental Bank,***8938,Globex Retail NA LLC,US,11253949.44
2023-11-11,2023-11-11,Client Receipt - CloudBridge Co. #72,Sales Receipt,SaaS-GL,0.0,41883.12,USD,ACH Credit,CloudBridge Co. #72,***1911,INV-202311-SaaS-GL-0004,,False,False,REF-823409,First Continental Bank,***2453,Globex Retail NA LLC,US,11295832.56
2023-11-12,2023-11-12,"Intercompany Settlement - Globex International Holdings, Inc.",Intercompany Transfer,ALL,791840.0,0.0,USD,Internal Transfer,"Globex International Holdings, Inc.",***9990,,,True,True,REF-735304,First Continental Bank,***2428,Globex Retail NA LLC,US,10503992.56
2023-11-12,2023-11-12,Client Receipt - ShopSphere Partner #44,Sales Receipt,Retail-NA,0.0,71421.19,USD,Card Settlement,ShopSphere Partner #44,***1741,INV-202311-Retail-NA-0011,,False,False,REF-964172,First Continental Bank,***8667,Globex Retail NA LLC,US,10575413.75
2023-11-13,2023-11-13,Client Receipt - CloudBridge Co. #4,Sales Receipt,SaaS-GL,0.0,5536.05,USD,Card Settlement,CloudBridge Co. #4,***2350,INV-202311-SaaS-GL-0021,,False,False,REF-551957,First Continental Bank,***6692,Globex Retail NA LLC,US,10580949.8
2023-11-13,2023-11-13,Client Receipt - CloudBridge Co. #35,Sales Receipt,SaaS-GL,0.0,45987.83,USD,ACH Credit,CloudBridge Co. #35,***6167,INV-202311-SaaS-GL-0017,,False,False,REF-300389,First Continental Bank,***6034,Globex Retail NA LLC,US,10626937.63
2023-11-14,2023-11-14,Supplier Payment - CodeCraft Contractors #1,Supplier Payment,SaaS-GL,1457.74,0.0,USD,Fedwire,CodeCraft Contractors #1,***7854,,PO-202311-SaaS-GL-0003,False,False,REF-831069,First Continental Bank,***7763,Globex Retail NA LLC,US,10625479.89
2023-11-14,2023-11-14,Merchant Processing Fees,Bank/Merchant Fees,ALL,2626.02,0.0,USD,ACH Debit,First Continental Bank,***5983,,,False,False,REF-909492,First Continental Bank,***7583,Globex Retail NA LLC,US,10622853.87
2023-11-14,2023-11-14,Marketing - Aurelia Media #3,Marketing,ALL,3597.41,0.0,USD,Fedwire,Aurelia Media #3,***2064,,,False,False,REF-679028,First Continental Bank,***7989,Globex Retail NA LLC,US,10619256.46
2023-11-14,2023-11-14,Supplier Payment - PackFast Fulfillment #9,Supplier Payment,Retail-NA,33570.93,0.0,USD,Fedwire,PackFast Fulfillment #9,***1739,,PO-202311-Retail-NA-0001,False,False,REF-260050,First Continental Bank,***5044,Globex Retail NA LLC,US,10585685.53
2023-11-14,2023-11-14,Supplier Payment - NorthRiver Apparel Mfg #12,Supplier Payment,Retail-NA,47125.14,0.0,USD,Fedwire,NorthRiver Apparel Mfg #12,***3241,,PO-202311-Retail-NA-0010,False,False,REF-629682,First Continental Bank,***7490,Globex Retail NA LLC,US,10538560.39
2023-11-14,2023-11-14,Client Receipt - ShopSphere Partner #51,Sales Receipt,Retail-NA,0.0,1799.1,USD,Card Settlement,ShopSphere Partner #51,***3127,INV-202311-Retail-NA-0013,,False,False,REF-156040,First Continental Bank,***8156,Globex Retail NA LLC,US,10540359.49
2023-11-14,2023-11-14,Client Receipt - CloudBridge Co. #51,Sales Receipt,SaaS-GL,0.0,23772.17,USD,Card Settlement,CloudBridge Co. #51,***5197,INV-202311-SaaS-GL-0014,,False,False,REF-809303,First Continental Bank,***7001,Globex Retail NA LLC,US,10564131.66
2023-11-14,2023-11-14,Client Receipt - Vertex Advisory Client #13,Sales Receipt,PS-GL,0.0,43905.53,USD,Card Settlement,Vertex Advisory Client #13,***2356,INV-202311-PS-GL-0010,,False,False,REF-903248,First Continental Bank,***3306,Globex Retail NA LLC,US,10608037.19
2023-11-14,2023-11-14,Client Receipt - ShopSphere Partner #24,Sales Receipt,Retail-NA,0.0,63666.19,USD,Card Settlement,ShopSphere Partner #24,***5895,INV-202311-Retail-NA-0007,,False,False,REF-433059,First Continental Bank,***9541,Globex Retail NA LLC,US,10671703.38
2023-11-15,2023-11-15,Supplier Payment - ExpertNet Subcontractors #5,Supplier Payment,PS-GL,16957.85,0.0,USD,ACH Debit,ExpertNet Subcontractors #5,***9997,,PO-202311-PS-GL-0010,False,False,REF-520505,First Continental Bank,***7352,Globex Retail NA LLC,US,10654745.53
2023-11-15,2023-11-15,Client Receipt - CloudBridge Co. #12,Sales Receipt,SaaS-GL,0.0,11352.94,USD,ACH Credit,CloudBridge Co. #12,***2217,INV-202311-SaaS-GL-0022,,False,False,REF-912952,First Continental Bank,***7550,Globex Retail NA LLC,US,10666098.47
2023-11-15,2023-11-15,Client Receipt - Vertex Advisory Client #56,Sales Receipt,PS-GL,0.0,54321.63,USD,Card Settlement,Vertex Advisory Client #56,***2928,INV-202311-PS-GL-0011,,False,False,REF-345471,First Continental Bank,***6956,Globex Retail NA LLC,US,10720420.1
2023-11-16,2023-11-16,Merchant Processing Fees,Bank/Merchant Fees,ALL,985.32,0.0,USD,ACH Debit,First Continental Bank,***9031,,,False,False,REF-625701,First Continental Bank,***7271,Globex Retail NA LLC,US,10719434.78
2023-11-16,2023-11-16,BluePeak Property Mgmt,Rent & Utilities,ALL,9710.64,0.0,USD,ACH Debit,BluePeak Property Mgmt,***1463,,,False,False,REF-101055,First Continental Bank,***1845,Globex Retail NA LLC,US,10709724.14
2023-11-16,2023-11-16,Supplier Payment - PackFast Fulfillment #7,Supplier Payment,Retail-NA,33567.94,0.0,USD,ACH Debit,PackFast Fulfillment #7,***4393,,PO-202311-Retail-NA-0008,False,False,REF-519196,First Continental Bank,***1233,Globex Retail NA LLC,US,10676156.2
2023-11-17,2023-11-17,Supplier Payment - ExpertNet Subcontractors #3,Supplier Payment,PS-GL,2678.36,0.0,USD,Fedwire,ExpertNet Subcontractors #3,***3058,,PO-202311-PS-GL-0005,False,False,REF-432643,First Continental Bank,***3860,Globex Retail NA LLC,US,10673477.84
2023-11-17,2023-11-17,Supplier Payment - ExpertNet Subcontractors #1,Supplier Payment,PS-GL,4441.36,0.0,USD,Fedwire,ExpertNet Subcontractors #1,***4995,,PO-202311-PS-GL-0003,False,False,REF-506725,First Continental Bank,***8925,Globex Retail NA LLC,US,10669036.48
2023-11-17,2023-11-17,Supplier Payment - CodeCraft Contractors #5,Supplier Payment,SaaS-GL,6130.2,0.0,USD,ACH Debit,CodeCraft Contractors #5,***9624,,PO-202311-SaaS-GL-0002,False,False,REF-776044,First Continental Bank,***5022,Globex Retail NA LLC,US,10662906.28
2023-11-17,2023-11-17,Supplier Payment - NorthRiver Apparel Mfg #27,Supplier Payment,Retail-NA,68344.74,0.0,USD,ACH Debit,NorthRiver Apparel Mfg #27,***1436,,PO-202311-Retail-NA-0003,False,False,REF-303773,First Continental Bank,***7955,Globex Retail NA LLC,US,10594561.54
2023-11-17,2023-11-17,Client Receipt - ShopSphere Partner #31,Sales Receipt,Retail-NA,0.0,1565.59,USD,Card Settlement,ShopSphere Partner #31,***2092,INV-202311-Retail-NA-0014,,False,False,REF-490838,First Continental Bank,***2533,Globex Retail NA LLC,US,10596127.13
2023-11-17,2023-11-17,Client Receipt - ShopSphere Partner #40,Sales Receipt,Retail-NA,0.0,7673.38,USD,Card Settlement,ShopSphere Partner #40,***6687,INV-202311-Retail-NA-0001,,False,False,REF-272062,First Continental Bank,***9089,Globex Retail NA LLC,US,10603800.51
2023-11-17,2023-11-17,Client Receipt - Card Settlement Batch #15,Sales Receipt,Retail-NA,0.0,12865.54,USD,Card Settlement,Card Settlement Batch #15,***8851,INV-202311-Retail-NA-0012,,False,False,REF-240926,First Continental Bank,***2598,Globex Retail NA LLC,US,10616666.05
2023-11-17,2023-11-17,Client Receipt - CloudBridge Co. #44,Sales Receipt,SaaS-GL,0.0,68360.25,USD,ACH Credit,CloudBridge Co. #44,***5676,INV-202311-SaaS-GL-0013,,False,False,REF-608052,First Continental Bank,***3445,Globex Retail NA LLC,US,10685026.3
2023-11-19,2023-11-19,Client Receipt - Vertex Advisory Client #59,Sales Receipt,PS-GL,0.0,18803.6,USD,ACH Credit,Vertex Advisory Client #59,***7368,INV-202311-PS-GL-0003,,False,False,REF-719036,First Continental Bank,***9162,Globex Retail NA LLC,US,10703829.9
2023-11-20,2023-11-20,Supplier Payment - HyperCloud Infra #5,Supplier Payment,SaaS-GL,9950.14,0.0,USD,ACH Debit,HyperCloud Infra #5,***7130,,PO-202311-SaaS-GL-0005,False,False,REF-237296,First Continental Bank,***6106,Globex Retail NA LLC,US,10693879.76
2023-11-21,2023-11-21,Client Receipt - Vertex Advisory Client #12,Sales Receipt,PS-GL,0.0,1872.85,USD,Card Settlement,Vertex Advisory Client #12,***2144,INV-202311-PS-GL-0006,,False,False,REF-225769,First Continental Bank,***5641,Globex Retail NA LLC,US,10695752.61
2023-11-21,2023-11-21,Client Receipt - CloudBridge Co. #13,Sales Receipt,SaaS-GL,0.0,11986.67,USD,ACH Credit,CloudBridge Co. #13,***6889,INV-202311-SaaS-GL-0012,,False,False,REF-854627,First Continental Bank,***7975,Globex Retail NA LLC,US,10707739.28
2023-11-22,2023-11-22,Supplier Payment - NorthRiver Apparel Mfg #7,Supplier Payment,Retail-NA,8318.96,0.0,USD,ACH Debit,NorthRiver Apparel Mfg #7,***3455,,PO-202311-Retail-NA-0004,False,False,REF-280871,First Continental Bank,***3726,Globex Retail NA LLC,US,10699420.32
2023-11-22,2023-11-22,Supplier Payment - NorthRiver Apparel Mfg #19,Supplier Payment,Retail-NA,12298.98,0.0,USD,Fedwire,NorthRiver Apparel Mfg #19,***4326,,PO-202311-Retail-NA-0002,False,False,REF-777157,First Continental Bank,***1629,Globex Retail NA LLC,US,10687121.34
2023-11-22,2023-11-22,Supplier Payment - ExpertNet Subcontractors #8,Supplier Payment,PS-GL,22246.12,0.0,USD,Fedwire,ExpertNet Subcontractors #8,***6981,,PO-202311-PS-GL-0002,False,False,REF-430186,First Continental Bank,***4042,Globex Retail NA LLC,US,10664875.22
2023-11-22,2023-11-22,VAT/GST Remittance - US IRS,Tax Payment,ALL,73980.69,0.0,USD,Fedwire,US IRS,***3748,,,False,False,REF-950406,First Continental Bank,***7182,Globex Retail NA LLC,US,10590894.53
2023-11-22,2023-11-22,Client Receipt - CloudBridge Co. #73,Sales Receipt,SaaS-GL,0.0,4595.18,USD,Card Settlement,CloudBridge Co. #73,***2875,INV-202311-SaaS-GL-0010,,False,False,REF-799119,First Continental Bank,***3430,Globex Retail NA LLC,US,10595489.71
2023-11-22,2023-11-22,Client Receipt - CloudBridge Co. #66,Sales Receipt,SaaS-GL,0.0,6346.16,USD,ACH Credit,CloudBridge Co. #66,***3564,INV-202311-SaaS-GL-0002,,False,False,REF-349448,First Continental Bank,***2237,Globex Retail NA LLC,US,10601835.87
2023-11-22,2023-11-22,Client Receipt - CloudBridge Co. #53,Sales Receipt,SaaS-GL,0.0,24862.89,USD,ACH Credit,CloudBridge Co. #53,***6397,INV-202311-SaaS-GL-0018,,False,False,REF-256339,First Continental Bank,***6731,Globex Retail NA LLC,US,10626698.76
2023-11-22,2023-11-22,Client Receipt - ShopSphere Partner #14,Sales Receipt,Retail-NA,0.0,31827.93,USD,ACH Credit,ShopSphere Partner #14,***3655,INV-202311-Retail-NA-0006,,False,False,REF-557655,First Continental Bank,***8966,Globex Retail NA LLC,US,10658526.69
2023-11-23,2023-11-23,Supplier Payment - PackFast Fulfillment #13,Supplier Payment,Retail-NA,43514.51,0.0,USD,ACH Debit,PackFast Fulfillment #13,***9527,,PO-202311-Retail-NA-0007,False,False,REF-255624,First Continental Bank,***9925,Globex Retail NA LLC,US,10615012.18
2023-11-23,2023-11-23,Client Receipt - Vertex Advisory Client #46,Sales Receipt,PS-GL,0.0,3169.74,USD,Card Settlement,Vertex Advisory Client #46,***6032,INV-202311-PS-GL-0004,,False,False,REF-237021,First Continental Bank,***9800,Globex Retail NA LLC,US,10618181.92
2023-11-23,2023-11-23,Client Receipt - Card Settlement Batch #6,Sales Receipt,Retail-NA,0.0,7278.46,USD,ACH Credit,Card Settlement Batch #6,***4687,INV-202311-Retail-NA-0004,,False,False,REF-870501,First Continental Bank,***2957,Globex Retail NA LLC,US,10625460.38
2023-11-23,2023-11-23,Client Receipt - Card Settlement Batch #7,Sales Receipt,Retail-NA,0.0,53164.6,USD,ACH Credit,Card Settlement Batch #7,***8926,INV-202311-Retail-NA-0005,,False,False,REF-847238,First Continental Bank,***2885,Globex Retail NA LLC,US,10678624.98
2023-11-24,2023-11-24,Supplier Payment - ExpertNet Subcontractors #12,Supplier Payment,PS-GL,19774.68,0.0,USD,ACH Debit,ExpertNet Subcontractors #12,***1637,,PO-202311-PS-GL-0001,False,False,REF-476966,First Continental Bank,***7805,Globex Retail NA LLC,US,10658850.3
2023-11-26,2023-11-26,Supplier Payment - PackFast Fulfillment #10,Supplier Payment,Retail-NA,20978.34,0.0,USD,ACH Debit,PackFast Fulfillment #10,***2653,,PO-202311-Retail-NA-0009,False,False,REF-749463,First Continental Bank,***6809,Globex Retail NA LLC,US,10637871.96
2023-11-26,2023-11-26,Intercompany Settlement - Globex APAC Logistics Pte. Ltd.,Intercompany Transfer,ALL,662444.0,0.0,USD,Internal Transfer,Globex APAC Logistics Pte. Ltd.,***6746,,,True,True,REF-429904,First Continental Bank,***4670,Globex Retail NA LLC,US,9975427.96
2023-11-26,2023-11-26,Client Receipt - Vertex Advisory Client #28,Sales Receipt,PS-GL,0.0,67129.85,USD,ACH Credit,Vertex Advisory Client #28,***8884,INV-202311-PS-GL-0009,,False,False,REF-781372,First Continental Bank,***8525,Globex Retail NA LLC,US,10042557.81
2023-11-27,2023-11-27,Supplier Payment - CodeCraft Contractors #6,Supplier Payment,SaaS-GL,5552.73,0.0,USD,ACH Debit,CodeCraft Contractors #6,***3460,,PO-202311-SaaS-GL-0006,False,False,REF-741943,First Continental Bank,***5267,Globex Retail NA LLC,US,10037005.08
2023-11-27,2023-11-27,Supplier Payment - HyperCloud Infra #8,Supplier Payment,SaaS-GL,5781.39,0.0,USD,ACH Debit,HyperCloud Infra #8,***4752,,PO-202311-SaaS-GL-0004,False,False,REF-319291,First Continental Bank,***6557,Globex Retail NA LLC,US,10031223.69
2023-11-27,2023-11-27,Marketing - Aurelia Media #1,Marketing,ALL,12790.19,0.0,USD,ACH Debit,Aurelia Media #1,***8382,,,False,False,REF-262265,First Continental Bank,***9207,Globex Retail NA LLC,US,10018433.5
2023-11-28,2023-11-28,Supplier Payment - ExpertNet Subcontractors #4,Supplier Payment,PS-GL,3051.29,0.0,USD,ACH Debit,ExpertNet Subcontractors #4,***7648,,PO-202311-PS-GL-0008,False,False,REF-976409,First Continental Bank,***6349,Globex Retail NA LLC,US,10015382.21
2023-11-28,2023-11-28,Supplier Payment - ExpertNet Subcontractors #9,Supplier Payment,PS-GL,4818.58,0.0,USD,ACH Debit,ExpertNet Subcontractors #9,***5496,,PO-202311-PS-GL-0004,False,False,REF-619569,First Continental Bank,***4396,Globex Retail NA LLC,US,10010563.63
2023-11-28,2023-11-28,Payroll - GlobalPay Services Ltd,Payroll,ALL,194233.77,0.0,USD,ACH Debit,GlobalPay Services Ltd,***2243,,,False,False,REF-197429,First Continental Bank,***8903,Globex Retail NA LLC,US,9816329.86
2023-11-28,2023-11-28,Client Receipt - CloudBridge Co. #31,Sales Receipt,SaaS-GL,0.0,3643.74,USD,ACH Credit,CloudBridge Co. #31,***6676,INV-202311-SaaS-GL-0001,,False,False,REF-864682,First Continental Bank,***3246,Globex Retail NA LLC,US,9819973.6
2023-11-28,2023-11-28,Client Receipt - ShopSphere Partner #28,Sales Receipt,Retail-NA,0.0,3947.36,USD,ACH Credit,ShopSphere Partner #28,***1505,INV-202311-Retail-NA-0003,,False,False,REF-250424,First Continental Bank,***4319,Globex Retail NA LLC,US,9823920.96
2023-11-28,2023-11-28,Client Receipt - CloudBridge Co. #7,Sales Receipt,SaaS-GL,0.0,20798.72,USD,Card Settlement,CloudBridge Co. #7,***2870,INV-202311-SaaS-GL-0005,,False,False,REF-129459,First Continental Bank,***4210,Globex Retail NA LLC,US,9844719.68
2023-11-28,2023-11-28,Client Receipt - ShopSphere Partner #50,Sales Receipt,Retail-NA,0.0,62987.68,USD,ACH Credit,ShopSphere Partner #50,***4390,INV-202311-Retail-NA-0010,,False,False,REF-230230,First Continental Bank,***5535,Globex Retail NA LLC,US,9907707.36
2023-11-29,2023-11-29,Supplier Payment - ExpertNet Subcontractors #5,Supplier Payment,PS-GL,3819.77,0.0,USD,Fedwire,ExpertNet Subcontractors #5,***1328,,PO-202311-PS-GL-0006,False,False,REF-469381,First Continental Bank,***2641,Globex Retail NA LLC,US,9903887.59
2023-11-29,2023-11-29,Supplier Payment - HyperCloud Infra #10,Supplier Payment,SaaS-GL,14188.15,0.0,USD,ACH Debit,HyperCloud Infra #10,***8727,,PO-202311-SaaS-GL-0008,False,False,REF-136135,First Continental Bank,***7534,Globex Retail NA LLC,US,9889699.44
2023-11-29,2023-11-29,Supplier Payment - HyperCloud Infra #2,Supplier Payment,SaaS-GL,27060.52,0.0,USD,Fedwire,HyperCloud Infra #2,***3471,,PO-202311-SaaS-GL-0001,False,False,REF-160299,First Continental Bank,***5566,Globex Retail NA LLC,US,9862638.92
2023-11-29,2023-11-29,Client Receipt - CloudBridge Co. #72,Sales Receipt,SaaS-GL,0.0,16762.09,USD,ACH Credit,CloudBridge Co. #72,***1181,INV-202311-SaaS-GL-0020,,False,False,REF-804274,First Continental Bank,***9230,Globex Retail NA LLC,US,9879401.01
2023-11-30,2023-11-30,Supplier Payment - ExpertNet Subcontractors #19,Supplier Payment,PS-GL,3061.15,0.0,USD,Fedwire,ExpertNet Subcontractors #19,***3387,,PO-202311-PS-GL-0009,False,False,REF-257961,First Continental Bank,***6294,Globex Retail NA LLC,US,9876339.86
2023-11-30,2023-11-30,Interest Earned,Interest Income,ALL,0.0,11583.25,USD,ACH Credit,First Continental Bank,***3075,,,False,False,REF-854736,First Continental Bank,***9101,Globex Retail NA LLC,US,9887923.11
2023-12-01,2023-12-01,Account Maintenance Fee,Bank/Merchant Fees,ALL,2500.0,0.0,USD,Fedwire,First Continental Bank,***1767,,,False,False,REF-430461,First Continental Bank,***7101,Globex Retail NA LLC,US,9885423.11
2023-12-01,2023-12-01,Supplier Payment - ExpertNet Subcontractors #19,Supplier Payment,PS-GL,3084.42,0.0,USD,Fedwire,ExpertNet Subcontractors #19,***5913,,PO-202312-PS-GL-0005,False,False,REF-469322,First Continental Bank,***4085,Globex Retail NA LLC,US,9882338.69
2023-12-01,2023-12-01,Client Receipt - Vertex Advisory Client #45,Sales Receipt,PS-GL,0.0,5665.44,USD,ACH Credit,Vertex Advisory Client #45,***4336,INV-202312-PS-GL-0007,,False,False,REF-714668,First Continental Bank,***5425,Globex Retail NA LLC,US,9888004.13
2023-12-02,2023-12-02,Client Receipt - Vertex Advisory Client #13,Sales Receipt,PS-GL,0.0,31374.39,USD,ACH Credit,Vertex Advisory Client #13,***8859,INV-202312-PS-GL-0004,,False,False,REF-547966,First Continental Bank,***5909,Globex Retail NA LLC,US,9919378.52
2023-12-04,2023-12-04,Supplier Payment - HyperCloud Infra #17,Supplier Payment,SaaS-GL,11844.68,0.0,USD,Fedwire,HyperCloud Infra #17,***9013,,PO-202312-SaaS-GL-0007,False,False,REF-802906,First Continental Bank,***6080,Globex Retail NA LLC,US,9907533.84
2023-12-04,2023-12-04,Client Receipt - CloudBridge Co. #26,Sales Receipt,SaaS-GL,0.0,9427.03,USD,Card Settlement,CloudBridge Co. #26,***1718,INV-202312-SaaS-GL-0010,,False,False,REF-574668,First Continental Bank,***8917,Globex Retail NA LLC,US,9916960.87
2023-12-04,2023-12-04,Client Receipt - ShopSphere Partner #5,Sales Receipt,Retail-NA,0.0,9461.74,USD,ACH Credit,ShopSphere Partner #5,***9877,INV-202312-Retail-NA-0010,,False,False,REF-619850,First Continental Bank,***8469,Globex Retail NA LLC,US,9926422.61
2023-12-04,2023-12-04,Client Receipt - ShopSphere Partner #42,Sales Receipt,Retail-NA,0.0,61132.82,USD,ACH Credit,ShopSphere Partner #42,***6542,INV-202312-Retail-NA-0006,,False,False,REF-804213,First Continental Bank,***7994,Globex Retail NA LLC,US,9987555.43
2023-12-05,2023-12-05,Supplier Payment - ExpertNet Subcontractors #1,Supplier Payment,PS-GL,6746.42,0.0,USD,ACH Debit,ExpertNet Subcontractors #1,***3628,,PO-202312-PS-GL-0002,False,False,REF-836241,First Continental Bank,***1221,Globex Retail NA LLC,US,9980809.01
2023-12-05,2023-12-05,Supplier Payment - NorthRiver Apparel Mfg #21,Supplier Payment,Retail-NA,80806.8,0.0,USD,Fedwire,NorthRiver Apparel Mfg #21,***9201,,PO-202312-Retail-NA-0007,False,False,REF-476987,First Continental Bank,***5177,Globex Retail NA LLC,US,9900002.21
2023-12-05,2023-12-05,Client Receipt - CloudBridge Co. #72,Sales Receipt,SaaS-GL,0.0,339.19,USD,Card Settlement,CloudBridge Co. #72,***2723,INV-202312-SaaS-GL-0016,,False,False,REF-484710,First Continental Bank,***7993,Globex Retail NA LLC,US,9900341.4
2023-12-06,2023-12-06,Supplier Payment - ExpertNet Subcontractors #14,Supplier Payment,PS-GL,8700.7,0.0,USD,ACH Debit,ExpertNet Subcontractors #14,***1771,,PO-202312-PS-GL-0010,False,False,REF-331460,First Continental Bank,***8045,Globex Retail NA LLC,US,9891640.7
2023-12-06,2023-12-06,Supplier Payment - NorthRiver Apparel Mfg #18,Supplier Payment,Retail-NA,12572.41,0.0,USD,Fedwire,NorthRiver Apparel Mfg #18,***2578,,PO-202312-Retail-NA-0004,False,False,REF-306667,First Continental Bank,***3876,Globex Retail NA LLC,US,9879068.29
2023-12-06,2023-12-06,Client Receipt - CloudBridge Co. #69,Sales Receipt,SaaS-GL,0.0,12653.72,USD,ACH Credit,CloudBridge Co. #69,***4668,INV-202312-SaaS-GL-0003,,False,False,REF-767302,First Continental Bank,***6281,Globex Retail NA LLC,US,9891722.01
2023-12-06,2023-12-06,Client Receipt - ShopSphere Partner #17,Sales Receipt,Retail-NA,0.0,28680.59,USD,ACH Credit,ShopSphere Partner #17,***3013,INV-202312-Retail-NA-0001,,False,False,REF-236000,First Continental Bank,***7479,Globex Retail NA LLC,US,9920402.6
2023-12-07,2023-12-07,Marketing - Aurelia Media #10,Marketing,ALL,10186.66,0.0,USD,Fedwire,Aurelia Media #10,***1160,,,False,False,REF-571103,First Continental Bank,***8999,Globex Retail NA LLC,US,9910215.94
2023-12-07,2023-12-07,Supplier Payment - CodeCraft Contractors #13,Supplier Payment,SaaS-GL,11029.26,0.0,USD,ACH Debit,CodeCraft Contractors #13,***3412,,PO-202312-SaaS-GL-0004,False,False,REF-965024,First Continental Bank,***2036,Globex Retail NA LLC,US,9899186.68
2023-12-07,2023-12-07,Supplier Payment - HyperCloud Infra #15,Supplier Payment,SaaS-GL,13870.33,0.0,USD,ACH Debit,HyperCloud Infra #15,***7388,,PO-202312-SaaS-GL-0005,False,False,REF-448152,First Continental Bank,***6831,Globex Retail NA LLC,US,9885316.35
2023-12-07,2023-12-07,Client Receipt - ShopSphere Partner #27,Sales Receipt,Retail-NA,0.0,97105.52,USD,ACH Credit,ShopSphere Partner #27,***2828,INV-202312-Retail-NA-0004,,False,False,REF-895579,First Continental Bank,***3243,Globex Retail NA LLC,US,9982421.87
2023-12-08,2023-12-08,Merchant Processing Fees,Bank/Merchant Fees,ALL,906.65,0.0,USD,Fedwire,First Continental Bank,***2903,,,False,False,REF-195136,First Continental Bank,***4546,Globex Retail NA LLC,US,9981515.22
2023-12-08,2023-12-08,Client Receipt - CloudBridge Co. #23,Sales Receipt,SaaS-GL,0.0,905.45,USD,Card Settlement,CloudBridge Co. #23,***8430,INV-202312-SaaS-GL-0011,,False,False,REF-196226,First Continental Bank,***9871,Globex Retail NA LLC,US,9982420.67
2023-12-08,2023-12-08,Client Receipt - CloudBridge Co. #77,Sales Receipt,SaaS-GL,0.0,24064.11,USD,ACH Credit,CloudBridge Co. #77,***9302,INV-202312-SaaS-GL-0002,,False,False,REF-616033,First Continental Bank,***9649,Globex Retail NA LLC,US,10006484.78
2023-12-08,2023-12-08,Client Receipt - CloudBridge Co. #61,Sales Receipt,SaaS-GL,0.0,28645.06,USD,Card Settlement,CloudBridge Co. #61,***6850,INV-202312-SaaS-GL-0012,,False,False,REF-775789,First Continental Bank,***7262,Globex Retail NA LLC,US,10035129.84
2023-12-09,2023-12-09,Supplier Payment - NorthRiver Apparel Mfg #25,Supplier Payment,Retail-NA,19040.84,0.0,USD,ACH Debit,NorthRiver Apparel Mfg #25,***1603,,PO-202312-Retail-NA-0008,False,False,REF-281908,First Continental Bank,***9762,Globex Retail NA LLC,US,10016089.0
2023-12-09,2023-12-09,Client Receipt - CloudBridge Co. #43,Sales Receipt,SaaS-GL,0.0,2047.99,USD,Card Settlement,CloudBridge Co. #43,***8165,INV-202312-SaaS-GL-0001,,False,False,REF-971378,First Continental Bank,***4598,Globex Retail NA LLC,US,10018136.99
2023-12-10,2023-12-10,Merchant Processing Fees,Bank/Merchant Fees,ALL,3066.92,0.0,USD,ACH Debit,First Continental Bank,***1383,,,False,False,REF-303120,First Continental Bank,***6567,Globex Retail NA LLC,US,10015070.07
2023-12-10,2023-12-10,Supplier Payment - NorthRiver Apparel Mfg #33,Supplier Payment,Retail-NA,31179.56,0.0,USD,Fedwire,NorthRiver Apparel Mfg #33,***8906,,PO-202312-Retail-NA-0003,False,False,REF-759755,First Continental Bank,***5916,Globex Retail NA LLC,US,9983890.51
2023-12-10,2023-12-10,Client Receipt - CloudBridge Co. #36,Sales Receipt,SaaS-GL,0.0,2644.83,USD,ACH Credit,CloudBridge Co. #36,***8615,INV-202312-SaaS-GL-0021,,False,False,REF-651762,First Continental Bank,***2270,Globex Retail NA LLC,US,9986535.34
2023-12-11,2023-12-11,Supplier Payment - PackFast Fulfillment #5,Supplier Payment,Retail-NA,7736.3,0.0,USD,Fedwire,PackFast Fulfillment #5,***7834,,PO-202312-Retail-NA-0006,False,False,REF-333659,First Continental Bank,***6437,Globex Retail NA LLC,US,9978799.04
2023-12-11,2023-12-11,Supplier Payment - ExpertNet Subcontractors #5,Supplier Payment,PS-GL,8405.84,0.0,USD,Fedwire,ExpertNet Subcontractors #5,***8226,,PO-202312-PS-GL-0008,False,False,REF-110393,First Continental Bank,***3084,Globex Retail NA LLC,US,9970393.2
2023-12-11,2023-12-11,Metro Water & Waste,Rent & Utilities,ALL,9365.48,0.0,USD,Fedwire,Metro Water & Waste,***3620,,,False,False,REF-998874,First Continental Bank,***6151,Globex Retail NA LLC,US,9961027.72
2023-12-11,2023-12-11,Supplier Payment - NorthRiver Apparel Mfg #30,Supplier Payment,Retail-NA,66215.42,0.0,USD,ACH Debit,NorthRiver Apparel Mfg #30,***7278,,PO-202312-Retail-NA-0002,False,False,REF-838365,First Continental Bank,***4657,Globex Retail NA LLC,US,9894812.3
2023-12-12,2023-12-12,Supplier Payment - HyperCloud Infra #16,Supplier Payment,SaaS-GL,2350.79,0.0,USD,Fedwire,HyperCloud Infra #16,***1072,,PO-202312-SaaS-GL-0001,False,False,REF-661329,First Continental Bank,***3726,Globex Retail NA LLC,US,9892461.51
2023-12-12,2023-12-12,Supplier Payment - ExpertNet Subcontractors #3,Supplier Payment,PS-GL,16267.64,0.0,USD,ACH Debit,ExpertNet Subcontractors #3,***3245,,PO-202312-PS-GL-0003,False,False,REF-301310,First Continental Bank,***7041,Globex Retail NA LLC,US,9876193.87
2023-12-12,2023-12-12,Supplier Payment - HyperCloud Infra #16,Supplier Payment,SaaS-GL,25878.31,0.0,USD,Fedwire,HyperCloud Infra #16,***3729,,PO-202312-SaaS-GL-0010,False,False,REF-949999,First Continental Bank,***4187,Globex Retail NA LLC,US,9850315.56
2023-12-12,2023-12-12,Intercompany Settlement - Globex EMEA Manufacturing Ltd.,Intercompany Transfer,ALL,515550.0,0.0,USD,Internal Transfer,Globex EMEA Manufacturing Ltd.,***8258,,,True,True,REF-296288,First Continental Bank,***5235,Globex Retail NA LLC,US,9334765.56
2023-12-12,2023-12-12,Client Receipt - CloudBridge Co. #59,Sales Receipt,SaaS-GL,0.0,22801.12,USD,ACH Credit,CloudBridge Co. #59,***1367,INV-202312-SaaS-GL-0005,,False,False,REF-387058,First Continental Bank,***3066,Globex Retail NA LLC,US,9357566.68
2023-12-12,2023-12-12,Client Receipt - Vertex Advisory Client #32,Sales Receipt,PS-GL,0.0,63084.55,USD,ACH Credit,Vertex Advisory Client #32,***1147,INV-202312-PS-GL-0005,,False,False,REF-846135,First Continental Bank,***6966,Globex Retail NA LLC,US,9420651.23
2023-12-12,2023-12-12,Intercompany Reimbursement - Globex EMEA Manufacturing Ltd.,Intercompany Transfer,ALL,0.0,206220.0,USD,Internal Transfer,Globex EMEA Manufacturing Ltd.,***1821,,,True,True,REF-750512,First Continental Bank,***6279,Globex Retail NA LLC,US,9626871.23
2023-12-13,2023-12-13,Supplier Payment - ExpertNet Subcontractors #2,Supplier Payment,PS-GL,2921.37,0.0,USD,ACH Debit,ExpertNet Subcontractors #2,***1234,,PO-202312-PS-GL-0001,False,False,REF-105231,First Continental Bank,***4825,Globex Retail NA LLC,US,9623949.86
2023-12-13,2023-12-13,Supplier Payment - HyperCloud Infra #16,Supplier Payment,SaaS-GL,3044.2,0.0,USD,Fedwire,HyperCloud Infra #16,***6558,,PO-202312-SaaS-GL-0002,False,False,REF-365069,First Continental Bank,***4118,Globex Retail NA LLC,US,9620905.66
2023-12-13,2023-12-13,Marketing - Aurelia Media #6,Marketing,ALL,3121.34,0.0,USD,Fedwire,Aurelia Media #6,***2751,,,False,False,REF-590888,First Continental Bank,***9481,Globex Retail NA LLC,US,9617784.32
2023-12-13,2023-12-13,Client Receipt - Vertex Advisory Client #37,Sales Receipt,PS-GL,0.0,91775.64,USD,ACH Credit,Vertex Advisory Client #37,***8424,INV-202312-PS-GL-0002,,False,False,REF-863285,First Continental Bank,***3364,Globex Retail NA LLC,US,9709559.96
2023-12-14,2023-12-14,Metro Water & Waste,Rent & Utilities,ALL,1531.75,0.0,USD,ACH Debit,Metro Water & Waste,***4954,,,False,False,REF-798838,First Continental Bank,***2702,Globex Retail NA LLC,US,9708028.21
2023-12-14,2023-12-14,Supplier Payment - ExpertNet Subcontractors #2,Supplier Payment,PS-GL,4111.16,0.0,USD,ACH Debit,ExpertNet Subcontractors #2,***7284,,PO-202312-PS-GL-0004,False,False,REF-348446,First Continental Bank,***6761,Globex Retail NA LLC,US,9703917.05
2023-12-14,2023-12-14,Marketing - Aurelia Media #2,Marketing,ALL,20297.31,0.0,USD,ACH Debit,Aurelia Media #2,***1083,,,False,False,REF-616586,First Continental Bank,***7920,Globex Retail NA LLC,US,9683619.74
2023-12-14,2023-12-14,Client Receipt - CloudBridge Co. #53,Sales Receipt,SaaS-GL,0.0,8336.32,USD,ACH Credit,CloudBridge Co. #53,***9410,INV-202312-SaaS-GL-0032,,False,False,REF-811467,First Continental Bank,***9998,Globex Retail NA LLC,US,9691956.06
2023-12-14,2023-12-14,Client Receipt - CloudBridge Co. #19,Sales Receipt,SaaS-GL,0.0,8366.44,USD,Card Settlement,CloudBridge Co. #19,***2888,INV-202312-SaaS-GL-0019,,False,False,REF-797022,First Continental Bank,***5418,Globex Retail NA LLC,US,9700322.5
2023-12-14,2023-12-14,Client Receipt - CloudBridge Co. #6,Sales Receipt,SaaS-GL,0.0,20103.15,USD,ACH Credit,CloudBridge Co. #6,***2503,INV-202312-SaaS-GL-0013,,False,False,REF-348910,First Continental Bank,***5728,Globex Retail NA LLC,US,9720425.65
2023-12-14,2023-12-14,Client Receipt - ShopSphere Partner #49,Sales Receipt,Retail-NA,0.0,146859.36,USD,Card Settlement,ShopSphere Partner #49,***5179,INV-202312-Retail-NA-0002,,False,False,REF-126925,First Continental Bank,***5804,Globex Retail NA LLC,US,9867285.01
2023-12-15,2023-12-15,Client Receipt - ShopSphere Partner #71,Sales Receipt,Retail-NA,0.0,22045.55,USD,ACH Credit,ShopSphere Partner #71,***4945,INV-202312-Retail-NA-0008,,False,False,REF-234146,First Continental Bank,***3099,Globex Retail NA LLC,US,9889330.56
2023-12-16,2023-12-16,Client Receipt - Card Settlement Batch #24,Sales Receipt,Retail-NA,0.0,82957.64,USD,ACH Credit,Card Settlement Batch #24,***3038,INV-202312-Retail-NA-0009,,False,False,REF-156849,First Continental Bank,***5619,Globex Retail NA LLC,US,9972288.2
2023-12-17,2023-12-17,Client Receipt - CloudBridge Co. #23,Sales Receipt,SaaS-GL,0.0,8332.58,USD,ACH Credit,CloudBridge Co. #23,***6243,INV-202312-SaaS-GL-0009,,False,False,REF-581417,First Continental Bank,***4375,Globex Retail NA LLC,US,9980620.78
2023-12-18,2023-12-18,Client Receipt - Vertex Advisory Client #44,Sales Receipt,PS-GL,0.0,774.16,USD,Card Settlement,Vertex Advisory Client #44,***8895,INV-202312-PS-GL-0006,,False,False,REF-459475,First Continental Bank,***9224,Globex Retail NA LLC,US,9981394.94
2023-12-18,2023-12-18,Client Receipt - CloudBridge Co. #4,Sales Receipt,SaaS-GL,0.0,2070.14,USD,ACH Credit,CloudBridge Co. #4,***2927,INV-202312-SaaS-GL-0015,,False,False,REF-902667,First Continental Bank,***5803,Globex Retail NA LLC,US,9983465.08
2023-12-18,2023-12-18,Client Receipt - CloudBridge Co. #67,Sales Receipt,SaaS-GL,0.0,12413.51,USD,ACH Credit,CloudBridge Co. #67,***3308,INV-202312-SaaS-GL-0022,,False,False,REF-384227,First Continental Bank,***4393,Globex Retail NA LLC,US,9995878.59
2023-12-18,2023-12-18,Client Receipt - CloudBridge Co. #9,Sales Receipt,SaaS-GL,0.0,20214.05,USD,Card Settlement,CloudBridge Co. #9,***9948,INV-202312-SaaS-GL-0006,,False,False,REF-943224,First Continental Bank,***5348,Globex Retail NA LLC,US,10016092.64
2023-12-18,2023-12-18,Client Receipt - Card Settlement Batch #24,Sales Receipt,Retail-NA,0.0,30243.07,USD,Card Settlement,Card Settlement Batch #24,***6439,INV-202312-Retail-NA-0005,,False,False,REF-973807,First Continental Bank,***2538,Globex Retail NA LLC,US,10046335.71
2023-12-19,2023-12-19,Supplier Payment - HyperCloud Infra #19,Supplier Payment,SaaS-GL,1894.56,0.0,USD,ACH Debit,HyperCloud Infra #19,***2707,,PO-202312-SaaS-GL-0008,False,False,REF-745764,First Continental Bank,***1711,Globex Retail NA LLC,US,10044441.15
2023-12-19,2023-12-19,Supplier Payment - HyperCloud Infra #9,Supplier Payment,SaaS-GL,16590.03,0.0,USD,Fedwire,HyperCloud Infra #9,***2450,,PO-202312-SaaS-GL-0009,False,False,REF-279257,First Continental Bank,***9067,Globex Retail NA LLC,US,10027851.12
2023-12-19,2023-12-19,Client Receipt - CloudBridge Co. #40,Sales Receipt,SaaS-GL,0.0,8436.65,USD,ACH Credit,CloudBridge Co. #40,***8084,INV-202312-SaaS-GL-0018,,False,False,REF-761661,First Continental Bank,***1903,Globex Retail NA LLC,US,10036287.77
2023-12-19,2023-12-19,Client Receipt - CloudBridge Co. #8,Sales Receipt,SaaS-GL,0.0,33400.22,USD,Card Settlement,CloudBridge Co. #8,***9943,INV-202312-SaaS-GL-0031,,False,False,REF-556786,First Continental Bank,***1798,Globex Retail NA LLC,US,10069687.99
2023-12-19,2023-12-19,Client Receipt - Vertex Advisory Client #3,Sales Receipt,PS-GL,0.0,40066.73,USD,Card Settlement,Vertex Advisory Client #3,***6737,INV-202312-PS-GL-0009,,False,False,REF-307655,First Continental Bank,***9339,Globex Retail NA LLC,US,10109754.72
2023-12-20,2023-12-20,Supplier Payment - HyperCloud Infra #4,Supplier Payment,SaaS-GL,5656.01,0.0,USD,ACH Debit,HyperCloud Infra #4,***6613,,PO-202312-SaaS-GL-0003,False,False,REF-840942,First Continental Bank,***6620,Globex Retail NA LLC,US,10104098.71
2023-12-20,2023-12-20,Supplier Payment - ExpertNet Subcontractors #1,Supplier Payment,PS-GL,10722.94,0.0,USD,ACH Debit,ExpertNet Subcontractors #1,***3856,,PO-202312-PS-GL-0007,False,False,REF-839812,First Continental Bank,***6168,Globex Retail NA LLC,US,10093375.77
2023-12-20,2023-12-20,Client Receipt - ShopSphere Partner #55,Sales Receipt,Retail-NA,0.0,76177.15,USD,ACH Credit,ShopSphere Partner #55,***3303,INV-202312-Retail-NA-0003,,False,False,REF-703159,First Continental Bank,***8182,Globex Retail NA LLC,US,10169552.92
2023-12-21,2023-12-21,Client Receipt - ShopSphere Partner #15,Sales Receipt,Retail-NA,0.0,23197.72,USD,ACH Credit,ShopSphere Partner #15,***6483,INV-202312-Retail-NA-0007,,False,False,REF-637725,First Continental Bank,***1865,Globex Retail NA LLC,US,10192750.64
2023-12-21,2023-12-21,Client Receipt - CloudBridge Co. #65,Sales Receipt,SaaS-GL,0.0,32409.24,USD,ACH Credit,CloudBridge Co. #65,***7445,INV-202312-SaaS-GL-0014,,False,False,REF-772117,First Continental Bank,***9711,Globex Retail NA LLC,US,10225159.88
2023-12-21,2023-12-21,Client Receipt - CloudBridge Co. #64,Sales Receipt,SaaS-GL,0.0,79937.79,USD,Card Settlement,CloudBridge Co. #64,***6762,INV-202312-SaaS-GL-0004,,False,False,REF-907456,First Continental Bank,***6390,Globex Retail NA LLC,US,10305097.67
2023-12-22,2023-12-22,Supplier Payment - PackFast Fulfillment #7,Supplier Payment,Retail-NA,22396.34,0.0,USD,Fedwire,PackFast Fulfillment #7,***3755,,PO-202312-Retail-NA-0005,False,False,REF-389452,First Continental Bank,***8039,Globex Retail NA LLC,US,10282701.33
2023-12-22,2023-12-22,VAT/GST Remittance - US IRS,Tax Payment,ALL,83494.85,0.0,USD,ACH Debit,US IRS,***4993,,,False,False,REF-876180,First Continental Bank,***3569,Globex Retail NA LLC,US,10199206.48
2023-12-22,2023-12-22,Client Receipt - CloudBridge Co. #8,Sales Receipt,SaaS-GL,0.0,8704.82,USD,Card Settlement,CloudBridge Co. #8,***6481,INV-202312-SaaS-GL-0025,,False,False,REF-309734,First Continental Bank,***9337,Globex Retail NA LLC,US,10207911.3
2023-12-24,2023-12-24,Client Receipt - CloudBridge Co. #29,Sales Receipt,SaaS-GL,0.0,5049.31,USD,ACH Credit,CloudBridge Co. #29,***2867,INV-202312-SaaS-GL-0008,,False,False,REF-255943,First Continental Bank,***8819,Globex Retail NA LLC,US,10212960.61
2023-12-24,2023-12-24,Client Receipt - CloudBridge Co. #4,Sales Receipt,SaaS-GL,0.0,8434.28,USD,Card Settlement,CloudBridge Co. #4,***1415,INV-202312-SaaS-GL-0027,,False,False,REF-129218,First Continental Bank,***1724,Globex Retail NA LLC,US,10221394.89
2023-12-24,2023-12-24,Client Receipt - CloudBridge Co. #51,Sales Receipt,SaaS-GL,0.0,31952.73,USD,ACH Credit,CloudBridge Co. #51,***8388,INV-202312-SaaS-GL-0007,,False,False,REF-806193,First Continental Bank,***3628,Globex Retail NA LLC,US,10253347.62
2023-12-25,2023-12-25,Supplier Payment - HyperCloud Infra #17,Supplier Payment,SaaS-GL,5214.92,0.0,USD,Fedwire,HyperCloud Infra #17,***4355,,PO-202312-SaaS-GL-0011,False,False,REF-473120,First Continental Bank,***9969,Globex Retail NA LLC,US,10248132.7
2023-12-25,2023-12-25,Supplier Payment - NorthRiver Apparel Mfg #4,Supplier Payment,Retail-NA,77875.97,0.0,USD,ACH Debit,NorthRiver Apparel Mfg #4,***8349,,PO-202312-Retail-NA-0001,False,False,REF-405614,First Continental Bank,***5938,Globex Retail NA LLC,US,10170256.73
2023-12-25,2023-12-25,Client Receipt - CloudBridge Co. #50,Sales Receipt,SaaS-GL,0.0,4154.84,USD,Card Settlement,CloudBridge Co. #50,***4083,INV-202312-SaaS-GL-0026,,False,False,REF-197687,First Continental Bank,***9160,Globex Retail NA LLC,US,10174411.57
2023-12-25,2023-12-25,Client Receipt - Vertex Advisory Client #41,Sales Receipt,PS-GL,0.0,14137.02,USD,ACH Credit,Vertex Advisory Client #41,***7375,INV-202312-PS-GL-0003,,False,False,REF-558037,First Continental Bank,***4626,Globex Retail NA LLC,US,10188548.59
2023-12-25,2023-12-25,Client Receipt - Vertex Advisory Client #49,Sales Receipt,PS-GL,0.0,26388.3,USD,Card Settlement,Vertex Advisory Client #49,***2686,INV-202312-PS-GL-0001,,False,False,REF-275662,First Continental Bank,***8439,Globex Retail NA LLC,US,10214936.89
2023-12-26,2023-12-26,Supplier Payment - ExpertNet Subcontractors #6,Supplier Payment,PS-GL,28094.21,0.0,USD,Fedwire,ExpertNet Subcontractors #6,***2305,,PO-202312-PS-GL-0009,False,False,REF-701174,First Continental Bank,***5174,Globex Retail NA LLC,US,10186842.68
2023-12-26,2023-12-26,Intercompany Settlement - Globex Consulting UK Ltd.,Intercompany Transfer,ALL,386602.0,0.0,USD,Internal Transfer,Globex Consulting UK Ltd.,***9608,,,True,True,REF-456650,First Continental Bank,***3116,Globex Retail NA LLC,US,9800240.68
2023-12-26,2023-12-26,Intercompany Reimbursement - Globex Consulting UK Ltd.,Intercompany Transfer,ALL,0.0,154640.8,USD,Internal Transfer,Globex Consulting UK Ltd.,***4983,,,True,True,REF-773150,First Continental Bank,***4468,Globex Retail NA LLC,US,9954881.48
2023-12-27,2023-12-27,Supplier Payment - HyperCloud Infra #3,Supplier Payment,SaaS-GL,6641.92,0.0,USD,ACH Debit,HyperCloud Infra #3,***9966,,PO-202312-SaaS-GL-0006,False,False,REF-936182,First Continental Bank,***4634,Globex Retail NA LLC,US,9948239.56
2023-12-27,2023-12-27,Payroll - GlobalPay Services Ltd,Payroll,ALL,108367.92,0.0,USD,Fedwire,GlobalPay Services Ltd,***8790,,,False,False,REF-681751,First Continental Bank,***1882,Globex Retail NA LLC,US,9839871.64
2023-12-27,2023-12-27,Client Receipt - CloudBridge Co. #16,Sales Receipt,SaaS-GL,0.0,4468.38,USD,Card Settlement,CloudBridge Co. #16,***8425,INV-202312-SaaS-GL-0023,,False,False,REF-164357,First Continental Bank,***2042,Globex Retail NA LLC,US,9844340.02
2023-12-28,2023-12-28,Client Receipt - CloudBridge Co. #56,Sales Receipt,SaaS-GL,0.0,13875.83,USD,ACH Credit,CloudBridge Co. #56,***7051,INV-202312-SaaS-GL-0024,,False,False,REF-477604,First Continental Bank,***4850,Globex Retail NA LLC,US,9858215.85
2023-12-28,2023-12-28,Client Receipt - CloudBridge Co. #31,Sales Receipt,SaaS-GL,0.0,14254.09,USD,ACH Credit,CloudBridge Co. #31,***2571,INV-202312-SaaS-GL-0029,,False,False,REF-445456,First Continental Bank,***3216,Globex Retail NA LLC,US,9872469.94
2023-12-28,2023-12-28,Client Receipt - Vertex Advisory Client #41,Sales Receipt,PS-GL,0.0,41930.77,USD,Card Settlement,Vertex Advisory Client #41,***8087,INV-202312-PS-GL-0008,,False,False,REF-599571,First Continental Bank,***5466,Globex Retail NA LLC,US,9914400.71
2023-12-29,2023-12-29,Client Receipt - CloudBridge Co. #75,Sales Receipt,SaaS-GL,0.0,572.47,USD,ACH Credit,CloudBridge Co. #75,***1876,INV-202312-SaaS-GL-0017,,False,False,REF-935545,First Continental Bank,***7380,Globex Retail NA LLC,US,9914973.18
2023-12-29,2023-12-29,Client Receipt - CloudBridge Co. #66,Sales Receipt,SaaS-GL,0.0,16236.68,USD,Card Settlement,CloudBridge Co. #66,***7061,INV-202312-SaaS-GL-0020,,False,False,REF-238683,First Continental Bank,***8574,Globex Retail NA LLC,US,9931209.86
2023-12-29,2023-12-29,Client Receipt - CloudBridge Co. #68,Sales Receipt,SaaS-GL,0.0,17645.11,USD,Card Settlement,CloudBridge Co. #68,***8034,INV-202312-SaaS-GL-0028,,False,False,REF-220131,First Continental Bank,***3183,Globex Retail NA LLC,US,9948854.97
2023-12-30,2023-12-30,Supplier Payment - ExpertNet Subcontractors #8,Supplier Payment,PS-GL,5504.4,0.0,USD,ACH Debit,ExpertNet Subcontractors #8,***3103,,PO-202312-PS-GL-0006,False,False,REF-896557,First Continental Bank,***1842,Globex Retail NA LLC,US,9943350.57
2023-12-30,2023-12-30,Payroll - GlobalPay Services Ltd,Payroll,ALL,108367.92,0.0,USD,Fedwire,GlobalPay Services Ltd,***8770,,,False,False,REF-597436,First Continental Bank,***7466,Globex Retail NA LLC,US,9834982.65
2023-12-30,2023-12-30,Interest Earned,Interest Income,ALL,0.0,12451.95,USD,ACH Credit,First Continental Bank,***6029,,,False,False,REF-517019,First Continental Bank,***9310,Globex Retail NA LLC,US,9847434.6
2023-12-31,2023-12-31,Client Receipt - CloudBridge Co. #2,Sales Receipt,SaaS-GL,0.0,9898.37,USD,ACH Credit,CloudBridge Co. #2,***3175,INV-202312-SaaS-GL-0030,,False,False,REF-192162,First Continental Bank,***1140,Globex Retail NA LLC,US,9857332.97
2024-01-01,2024-01-01,Supplier Payment - HyperCloud Infra #9,Supplier Payment,SaaS-GL,1589.91,0.0,USD,ACH Debit,HyperCloud Infra #9,***7424,,PO-202401-SaaS-GL-0009,False,False,REF-467311,First Continental Bank,***1539,Globex Retail NA LLC,US,9855743.06
2024-01-01,2024-01-01,Account Maintenance Fee,Bank/Merchant Fees,ALL,2500.0,0.0,USD,ACH Debit,First Continental Bank,***4757,,,False,False,REF-846663,First Continental Bank,***6521,Globex Retail NA LLC,US,9853243.06
2024-01-01,2024-01-01,Client Receipt - CloudBridge Co. #71,Sales Receipt,SaaS-GL,0.0,3230.81,USD,ACH Credit,CloudBridge Co. #71,***1008,INV-202401-SaaS-GL-0010,,False,False,REF-381758,First Continental Bank,***7503,Globex Retail NA LLC,US,9856473.87
2024-01-01,2024-01-01,Client Receipt - CloudBridge Co. #67,Sales Receipt,SaaS-GL,0.0,5333.38,USD,ACH Credit,CloudBridge Co. #67,***8945,INV-202401-SaaS-GL-0011,,False,False,REF-843159,First Continental Bank,***7560,Globex Retail NA LLC,US,9861807.25
2024-01-02,2024-01-02,Client Receipt - CloudBridge Co. #72,Sales Receipt,SaaS-GL,0.0,1779.51,USD,Card Settlement,CloudBridge Co. #72,***5534,INV-202401-SaaS-GL-0008,,False,False,REF-909213,First Continental Bank,***7858,Globex Retail NA LLC,US,9863586.76
2024-01-03,2024-01-03,Supplier Payment - ExpertNet Subcontractors #4,Supplier Payment,PS-GL,4611.34,0.0,USD,Fedwire,ExpertNet Subcontractors #4,***4820,,PO-202401-PS-GL-0004,False,False,REF-557629,First Continental Bank,***9611,Globex Retail NA LLC,US,9858975.42
2024-01-03,2024-01-03,Client Receipt - ShopSphere Partner #17,Sales Receipt,Retail-NA,0.0,8715.77,USD,ACH Credit,ShopSphere Partner #17,***5209,INV-202401-Retail-NA-0002,,False,False,REF-430288,First Continental Bank,***8082,Globex Retail NA LLC,US,9867691.19
2024-01-04,2024-01-04,Client Receipt - CloudBridge Co. #16,Sales Receipt,SaaS-GL,0.0,7211.31,USD,ACH Credit,CloudBridge Co. #16,***7525,INV-202401-SaaS-GL-0018,,False,False,REF-376518,First Continental Bank,***2120,Globex Retail NA LLC,US,9874902.5
2024-01-04,2024-01-04,Client Receipt - CloudBridge Co. #77,Sales Receipt,SaaS-GL,0.0,16042.23,USD,Card Settlement,CloudBridge Co. #77,***6430,INV-202401-SaaS-GL-0021,,False,False,REF-206089,First Continental Bank,***5009,Globex Retail NA LLC,US,9890944.73
2024-01-04,2024-01-04,Client Receipt - Card Settlement Batch #1,Sales Receipt,Retail-NA,0.0,21575.12,USD,Card Settlement,Card Settlement Batch #1,***2916,INV-202401-Retail-NA-0003,,False,False,REF-555909,First Continental Bank,***2923,Globex Retail NA LLC,US,9912519.85
2024-01-04,2024-01-04,Client Receipt - Vertex Advisory Client #10,Sales Receipt,PS-GL,0.0,30250.45,USD,Card Settlement,Vertex Advisory Client #10,***5937,INV-202401-PS-GL-0005,,False,False,REF-871328,First Continental Bank,***4913,Globex Retail NA LLC,US,9942770.3
2024-01-05,2024-01-05,Supplier Payment - ExpertNet Subcontractors #10,Supplier Payment,PS-GL,6663.17,0.0,USD,ACH Debit,ExpertNet Subcontractors #10,***2842,,PO-202401-PS-GL-0005,False,False,REF-468740,First Continental Bank,***4735,Globex Retail NA LLC,US,9936107.13
2024-01-05,2024-01-05,Supplier Payment - NorthRiver Apparel Mfg #16,Supplier Payment,Retail-NA,18250.43,0.0,USD,Fedwire,NorthRiver Apparel Mfg #16,***6064,,PO-202401-Retail-NA-0010,False,False,REF-500980,First Continental Bank,***7127,Globex Retail NA LLC,US,9917856.7
2024-01-05,2024-01-05,Client Receipt - Card Settlement Batch #14,Sales Receipt,Retail-NA,0.0,7733.03,USD,ACH Credit,Card Settlement Batch #14,***3247,INV-202401-Retail-NA-0012,,False,False,REF-391478,First Continental Bank,***8701,Globex Retail NA LLC,US,9925589.73
2024-01-05,2024-01-05,Client Receipt - ShopSphere Partner #74,Sales Receipt,Retail-NA,0.0,9427.24,USD,Card Settlement,ShopSphere Partner #74,***3846,INV-202401-Retail-NA-0006,,False,False,REF-330629,First Continental Bank,***3601,Globex Retail NA LLC,US,9935016.97
2024-01-05,2024-01-05,Client Receipt - Card Settlement Batch #14,Sales Receipt,Retail-NA,0.0,11823.38,USD,Card Settlement,Card Settlement Batch #14,***6008,INV-202401-Retail-NA-0008,,False,False,REF-559212,First Continental Bank,***1600,Globex Retail NA LLC,US,9946840.35
2024-01-06,2024-01-06,Supplier Payment - PackFast Fulfillment #20,Supplier Payment,Retail-NA,10749.09,0.0,USD,Fedwire,PackFast Fulfillment #20,***2645,,PO-202401-Retail-NA-0001,False,False,REF-454921,First Continental Bank,***1488,Globex Retail NA LLC,US,9936091.26
2024-01-06,2024-01-06,Client Receipt - CloudBridge Co. #7,Sales Receipt,SaaS-GL,0.0,10.4,USD,Card Settlement,CloudBridge Co. #7,***8880,INV-202401-SaaS-GL-0016,,False,False,REF-727074,First Continental Bank,***9023,Globex Retail NA LLC,US,9936101.66
2024-01-07,2024-01-07,Merchant Processing Fees,Bank/Merchant Fees,ALL,174.41,0.0,USD,ACH Debit,First Continental Bank,***3845,,,False,False,REF-939427,First Continental Bank,***1748,Globex Retail NA LLC,US,9935927.25
2024-01-07,2024-01-07,Supplier Payment - ExpertNet Subcontractors #1,Supplier Payment,PS-GL,11892.14,0.0,USD,ACH Debit,ExpertNet Subcontractors #1,***5130,,PO-202401-PS-GL-0001,False,False,REF-423082,First Continental Bank,***3479,Globex Retail NA LLC,US,9924035.11
2024-01-08,2024-01-08,Supplier Payment - ExpertNet Subcontractors #1,Supplier Payment,PS-GL,1572.34,0.0,USD,ACH Debit,ExpertNet Subcontractors #1,***2171,,PO-202401-PS-GL-0006,False,False,REF-849377,First Continental Bank,***7100,Globex Retail NA LLC,US,9922462.77
2024-01-08,2024-01-08,Marketing - Aurelia Media #6,Marketing,ALL,10773.72,0.0,USD,Fedwire,Aurelia Media #6,***8382,,,False,False,REF-959286,First Continental Bank,***7609,Globex Retail NA LLC,US,9911689.05
2024-01-08,2024-01-08,Client Receipt - CloudBridge Co. #60,Sales Receipt,SaaS-GL,0.0,16295.17,USD,ACH Credit,CloudBridge Co. #60,***3231,INV-202401-SaaS-GL-0004,,False,False,REF-274448,First Continental Bank,***4537,Globex Retail NA LLC,US,9927984.22
2024-01-08,2024-01-08,Client Receipt - CloudBridge Co. #60,Sales Receipt,SaaS-GL,0.0,37237.1,USD,ACH Credit,CloudBridge Co. #60,***2073,INV-202401-SaaS-GL-0017,,False,False,REF-974942,First Continental Bank,***4013,Globex Retail NA LLC,US,9965221.32
2024-01-09,2024-01-09,Supplier Payment - HyperCloud Infra #16,Supplier Payment,SaaS-GL,5697.07,0.0,USD,Fedwire,HyperCloud Infra #16,***1265,,PO-202401-SaaS-GL-0008,False,False,REF-378490,First Continental Bank,***4260,Globex Retail NA LLC,US,9959524.25
2024-01-09,2024-01-09,Client Receipt - CloudBridge Co. #5,Sales Receipt,SaaS-GL,0.0,3517.79,USD,Card Settlement,CloudBridge Co. #5,***1177,INV-202401-SaaS-GL-0013,,False,False,REF-104751,First Continental Bank,***5165,Globex Retail NA LLC,US,9963042.04
2024-01-09,2024-01-09,Client Receipt - CloudBridge Co. #65,Sales Receipt,SaaS-GL,0.0,14605.77,USD,ACH Credit,CloudBridge Co. #65,***5635,INV-202401-SaaS-GL-0022,,False,False,REF-461934,First Continental Bank,***6324,Globex Retail NA LLC,US,9977647.81
2024-01-10,2024-01-10,Supplier Payment - ExpertNet Subcontractors #4,Supplier Payment,PS-GL,846.48,0.0,USD,ACH Debit,ExpertNet Subcontractors #4,***2548,,PO-202401-PS-GL-0002,False,False,REF-385185,First Continental Bank,***1111,Globex Retail NA LLC,US,9976801.33
2024-01-10,2024-01-10,Supplier Payment - CodeCraft Contractors #14,Supplier Payment,SaaS-GL,2090.46,0.0,USD,ACH Debit,CodeCraft Contractors #14,***5304,,PO-202401-SaaS-GL-0007,False,False,REF-727308,First Continental Bank,***4614,Globex Retail NA LLC,US,9974710.87
2024-01-10,2024-01-10,Supplier Payment - NorthRiver Apparel Mfg #21,Supplier Payment,Retail-NA,3154.23,0.0,USD,Fedwire,NorthRiver Apparel Mfg #21,***7484,,PO-202401-Retail-NA-0007,False,False,REF-646669,First Continental Bank,***7098,Globex Retail NA LLC,US,9971556.64
2024-01-10,2024-01-10,Supplier Payment - CodeCraft Contractors #5,Supplier Payment,SaaS-GL,4066.37,0.0,USD,Fedwire,CodeCraft Contractors #5,***2215,,PO-202401-SaaS-GL-0005,False,False,REF-924019,First Continental Bank,***8207,Globex Retail NA LLC,US,9967490.27
2024-01-10,2024-01-10,Client Receipt - CloudBridge Co. #9,Sales Receipt,SaaS-GL,0.0,6928.45,USD,Card Settlement,CloudBridge Co. #9,***5686,INV-202401-SaaS-GL-0002,,False,False,REF-780280,First Continental Bank,***4555,Globex Retail NA LLC,US,9974418.72
2024-01-10,2024-01-10,Client Receipt - ShopSphere Partner #65,Sales Receipt,Retail-NA,0.0,16571.02,USD,Card Settlement,ShopSphere Partner #65,***5394,INV-202401-Retail-NA-0001,,False,False,REF-789880,First Continental Bank,***5435,Globex Retail NA LLC,US,9990989.74
2024-01-11,2024-01-11,Supplier Payment - ExpertNet Subcontractors #11,Supplier Payment,PS-GL,733.37,0.0,USD,ACH Debit,ExpertNet Subcontractors #11,***1045,,PO-202401-PS-GL-0010,False,False,REF-539407,First Continental Bank,***8423,Globex Retail NA LLC,US,9990256.37
2024-01-11,2024-01-11,Supplier Payment - PackFast Fulfillment #10,Supplier Payment,Retail-NA,27871.94,0.0,USD,ACH Debit,PackFast Fulfillment #10,***8475,,PO-202401-Retail-NA-0008,False,False,REF-218227,First Continental Bank,***6997,Globex Retail NA LLC,US,9962384.43
2024-01-11,2024-01-11,Client Receipt - CloudBridge Co. #59,Sales Receipt,SaaS-GL,0.0,7386.78,USD,Card Settlement,CloudBridge Co. #59,***6440,INV-202401-SaaS-GL-0014,,False,False,REF-929162,First Continental Bank,***1118,Globex Retail NA LLC,US,9969771.21
2024-01-11,2024-01-11,Client Receipt - Vertex Advisory Client #38,Sales Receipt,PS-GL,0.0,54387.32,USD,Card Settlement,Vertex Advisory Client #38,***7177,INV-202401-PS-GL-0007,,False,False,REF-873730,First Continental Bank,***8733,Globex Retail NA LLC,US,10024158.53
2024-01-12,2024-01-12,Intercompany Settlement - Globex Consulting UK Ltd.,Intercompany Transfer,ALL,297365.0,0.0,USD,Internal Transfer,Globex Consulting UK Ltd.,***7357,,,True,True,REF-676144,First Continental Bank,***5814,Globex Retail NA LLC,US,9726793.53
2024-01-12,2024-01-12,Client Receipt - Vertex Advisory Client #26,Sales Receipt,PS-GL,0.0,519.98,USD,ACH Credit,Vertex Advisory Client #26,***4261,INV-202401-PS-GL-0002,,False,False,REF-681841,First Continental Bank,***7046,Globex Retail NA LLC,US,9727313.51
2024-01-12,2024-01-12,Client Receipt - Vertex Advisory Client #6,Sales Receipt,PS-GL,0.0,21521.22,USD,ACH Credit,Vertex Advisory Client #6,***1300,INV-202401-PS-GL-0008,,False,False,REF-262994,First Continental Bank,***7944,Globex Retail NA LLC,US,9748834.73
2024-01-12,2024-01-12,Client Receipt - ShopSphere Partner #50,Sales Receipt,Retail-NA,0.0,31887.26,USD,ACH Credit,ShopSphere Partner #50,***2674,INV-202401-Retail-NA-0013,,False,False,REF-342869,First Continental Bank,***6295,Globex Retail NA LLC,US,9780721.99
2024-01-13,2024-01-13,Metro Water & Waste,Rent & Utilities,ALL,5430.14,0.0,USD,ACH Debit,Metro Water & Waste,***1611,,,False,False,REF-689062,First Continental Bank,***4674,Globex Retail NA LLC,US,9775291.85
2024-01-15,2024-01-15,Merchant Processing Fees,Bank/Merchant Fees,ALL,1878.75,0.0,USD,Fedwire,First Continental Bank,***3957,,,False,False,REF-811749,First Continental Bank,***2112,Globex Retail NA LLC,US,9773413.1
2024-01-15,2024-01-15,Supplier Payment - NorthRiver Apparel Mfg #32,Supplier Payment,Retail-NA,20276.85,0.0,USD,ACH Debit,NorthRiver Apparel Mfg #32,***1254,,PO-202401-Retail-NA-0003,False,False,REF-645963,First Continental Bank,***6427,Globex Retail NA LLC,US,9753136.25
2024-01-15,2024-01-15,Client Receipt - ShopSphere Partner #40,Sales Receipt,Retail-NA,0.0,13352.55,USD,Card Settlement,ShopSphere Partner #40,***5795,INV-202401-Retail-NA-0010,,False,False,REF-576752,First Continental Bank,***5522,Globex Retail NA LLC,US,9766488.8
2024-01-16,2024-01-16,Supplier Payment - HyperCloud Infra #9,Supplier Payment,SaaS-GL,2603.73,0.0,USD,ACH Debit,HyperCloud Infra #9,***8411,,PO-202401-SaaS-GL-0006,False,False,REF-579774,First Continental Bank,***4018,Globex Retail NA LLC,US,9763885.07
2024-01-16,2024-01-16,Supplier Payment - ExpertNet Subcontractors #16,Supplier Payment,PS-GL,4233.73,0.0,USD,ACH Debit,ExpertNet Subcontractors #16,***9805,,PO-202401-PS-GL-0007,False,False,REF-908126,First Continental Bank,***6005,Globex Retail NA LLC,US,9759651.34
2024-01-16,2024-01-16,Supplier Payment - PackFast Fulfillment #9,Supplier Payment,Retail-NA,17860.59,0.0,USD,ACH Debit,PackFast Fulfillment #9,***2356,,PO-202401-Retail-NA-0005,False,False,REF-166841,First Continental Bank,***8480,Globex Retail NA LLC,US,9741790.75
2024-01-17,2024-01-17,Supplier Payment - HyperCloud Infra #6,Supplier Payment,SaaS-GL,5155.19,0.0,USD,Fedwire,HyperCloud Infra #6,***7207,,PO-202401-SaaS-GL-0001,False,False,REF-847425,First Continental Bank,***6162,Globex Retail NA LLC,US,9736635.56
2024-01-17,2024-01-17,Client Receipt - CloudBridge Co. #73,Sales Receipt,SaaS-GL,0.0,7419.6,USD,ACH Credit,CloudBridge Co. #73,***9622,INV-202401-SaaS-GL-0007,,False,False,REF-353918,First Continental Bank,***3475,Globex Retail NA LLC,US,9744055.16
2024-01-17,2024-01-17,Client Receipt - ShopSphere Partner #54,Sales Receipt,Retail-NA,0.0,29338.77,USD,ACH Credit,ShopSphere Partner #54,***7791,INV-202401-Retail-NA-0007,,False,False,REF-569254,First Continental Bank,***1281,Globex Retail NA LLC,US,9773393.93
2024-01-18,2024-01-18,Supplier Payment - HyperCloud Infra #2,Supplier Payment,SaaS-GL,3385.16,0.0,USD,Fedwire,HyperCloud Infra #2,***8059,,PO-202401-SaaS-GL-0003,False,False,REF-442745,First Continental Bank,***7525,Globex Retail NA LLC,US,9770008.77
2024-01-18,2024-01-18,Client Receipt - CloudBridge Co. #20,Sales Receipt,SaaS-GL,0.0,2731.15,USD,ACH Credit,CloudBridge Co. #20,***5243,INV-202401-SaaS-GL-0003,,False,False,REF-352711,First Continental Bank,***8278,Globex Retail NA LLC,US,9772739.92
2024-01-18,2024-01-18,Client Receipt - CloudBridge Co. #64,Sales Receipt,SaaS-GL,0.0,16017.21,USD,Card Settlement,CloudBridge Co. #64,***6767,INV-202401-SaaS-GL-0020,,False,False,REF-201303,First Continental Bank,***2774,Globex Retail NA LLC,US,9788757.13
2024-01-18,2024-01-18,Client Receipt - CloudBridge Co. #5,Sales Receipt,SaaS-GL,0.0,17310.89,USD,ACH Credit,CloudBridge Co. #5,***2452,INV-202401-SaaS-GL-0015,,False,False,REF-990921,First Continental Bank,***1560,Globex Retail NA LLC,US,9806068.02
2024-01-18,2024-01-18,Client Receipt - CloudBridge Co. #26,Sales Receipt,SaaS-GL,0.0,18953.44,USD,ACH Credit,CloudBridge Co. #26,***7476,INV-202401-SaaS-GL-0009,,False,False,REF-692220,First Continental Bank,***3485,Globex Retail NA LLC,US,9825021.46
2024-01-18,2024-01-18,Client Receipt - Vertex Advisory Client #3,Sales Receipt,PS-GL,0.0,21130.47,USD,ACH Credit,Vertex Advisory Client #3,***5273,INV-202401-PS-GL-0003,,False,False,REF-307219,First Continental Bank,***7964,Globex Retail NA LLC,US,9846151.93
2024-01-19,2024-01-19,Marketing - Aurelia Media #8,Marketing,ALL,5807.66,0.0,USD,Fedwire,Aurelia Media #8,***9198,,,False,False,REF-711529,First Continental Bank,***3235,Globex Retail NA LLC,US,9840344.27
2024-01-19,2024-01-19,Client Receipt - Vertex Advisory Client #56,Sales Receipt,PS-GL,0.0,7811.32,USD,ACH Credit,Vertex Advisory Client #56,***1687,INV-202401-PS-GL-0006,,False,False,REF-169769,First Continental Bank,***6473,Globex Retail NA LLC,US,9848155.59
2024-01-20,2024-01-20,VAT/GST Remittance - US IRS,Tax Payment,ALL,40826.85,0.0,USD,Fedwire,US IRS,***5854,,,False,False,REF-908400,First Continental Bank,***9131,Globex Retail NA LLC,US,9807328.74
2024-01-20,2024-01-20,Client Receipt - CloudBridge Co. #66,Sales Receipt,SaaS-GL,0.0,1561.3,USD,ACH Credit,CloudBridge Co. #66,***4923,INV-202401-SaaS-GL-0005,,False,False,REF-351448,First Continental Bank,***5125,Globex Retail NA LLC,US,9808890.04
2024-01-22,2024-01-22,Supplier Payment - ExpertNet Subcontractors #3,Supplier Payment,PS-GL,4590.8,0.0,USD,ACH Debit,ExpertNet Subcontractors #3,***1370,,PO-202401-PS-GL-0008,False,False,REF-302649,First Continental Bank,***1425,Globex Retail NA LLC,US,9804299.24
2024-01-22,2024-01-22,Supplier Payment - ExpertNet Subcontractors #14,Supplier Payment,PS-GL,7438.25,0.0,USD,ACH Debit,ExpertNet Subcontractors #14,***4125,,PO-202401-PS-GL-0003,False,False,REF-578825,First Continental Bank,***2655,Globex Retail NA LLC,US,9796860.99
2024-01-22,2024-01-22,Supplier Payment - PackFast Fulfillment #16,Supplier Payment,Retail-NA,9416.51,0.0,USD,ACH Debit,PackFast Fulfillment #16,***2766,,PO-202401-Retail-NA-0004,False,False,REF-142476,First Continental Bank,***9667,Globex Retail NA LLC,US,9787444.48
2024-01-22,2024-01-22,Supplier Payment - NorthRiver Apparel Mfg #19,Supplier Payment,Retail-NA,13981.16,0.0,USD,ACH Debit,NorthRiver Apparel Mfg #19,***9964,,PO-202401-Retail-NA-0006,False,False,REF-455951,First Continental Bank,***5546,Globex Retail NA LLC,US,9773463.32
2024-01-22,2024-01-22,Supplier Payment - NorthRiver Apparel Mfg #7,Supplier Payment,Retail-NA,20634.61,0.0,USD,Fedwire,NorthRiver Apparel Mfg #7,***2646,,PO-202401-Retail-NA-0002,False,False,REF-639842,First Continental Bank,***3455,Globex Retail NA LLC,US,9752828.71
2024-01-24,2024-01-24,Client Receipt - ShopSphere Partner #16,Sales Receipt,Retail-NA,0.0,16200.77,USD,ACH Credit,ShopSphere Partner #16,***9381,INV-202401-Retail-NA-0009,,False,False,REF-118772,First Continental Bank,***2256,Globex Retail NA LLC,US,9769029.48
2024-01-24,2024-01-24,Client Receipt - ShopSphere Partner #72,Sales Receipt,Retail-NA,0.0,20856.18,USD,ACH Credit,ShopSphere Partner #72,***2750,INV-202401-Retail-NA-0005,,False,False,REF-597628,First Continental Bank,***2164,Globex Retail NA LLC,US,9789885.66
2024-01-25,2024-01-25,Supplier Payment - ExpertNet Subcontractors #5,Supplier Payment,PS-GL,4697.93,0.0,USD,Fedwire,ExpertNet Subcontractors #5,***2479,,PO-202401-PS-GL-0009,False,False,REF-118233,First Continental Bank,***3297,Globex Retail NA LLC,US,9785187.73
2024-01-25,2024-01-25,Payroll - GlobalPay Services Ltd,Payroll,ALL,107853.24,0.0,USD,ACH Debit,GlobalPay Services Ltd,***6086,,,False,False,REF-847691,First Continental Bank,***5300,Globex Retail NA LLC,US,9677334.49
2024-01-25,2024-01-25,Client Receipt - CloudBridge Co. #6,Sales Receipt,SaaS-GL,0.0,8694.33,USD,ACH Credit,CloudBridge Co. #6,***8029,INV-202401-SaaS-GL-0019,,False,False,REF-153966,First Continental Bank,***5491,Globex Retail NA LLC,US,9686028.82
2024-01-25,2024-01-25,Client Receipt - CloudBridge Co. #77,Sales Receipt,SaaS-GL,0.0,10649.44,USD,ACH Credit,CloudBridge Co. #77,***8105,INV-202401-SaaS-GL-0006,,False,False,REF-893006,First Continental Bank,***6555,Globex Retail NA LLC,US,9696678.26
2024-01-26,2024-01-26,Intercompany Settlement - Globex APAC Logistics Pte. Ltd.,Intercompany Transfer,ALL,232217.0,0.0,USD,Internal Transfer,Globex APAC Logistics Pte. Ltd.,***8097,,,True,True,REF-116382,First Continental Bank,***7371,Globex Retail NA LLC,US,9464461.26
2024-01-26,2024-01-26,Client Receipt - Vertex Advisory Client #38,Sales Receipt,PS-GL,0.0,15512.04,USD,Card Settlement,Vertex Advisory Client #38,***6755,INV-202401-PS-GL-0004,,False,False,REF-552647,First Continental Bank,***1043,Globex Retail NA LLC,US,9479973.3
2024-01-28,2024-01-28,Corporate Tax Estimate,Tax Payment,ALL,30799.48,0.0,USD,Fedwire,State of NY DoF,***8312,,,False,False,REF-835540,First Continental Bank,***2634,Globex Retail NA LLC,US,9449173.82
2024-01-28,2024-01-28,Client Receipt - Vertex Advisory Client #27,Sales Receipt,PS-GL,0.0,6465.7,USD,Card Settlement,Vertex Advisory Client #27,***9998,INV-202401-PS-GL-0001,,False,False,REF-802763,First Continental Bank,***9576,Globex Retail NA LLC,US,9455639.52
2024-01-28,2024-01-28,Client Receipt - ShopSphere Partner #64,Sales Receipt,Retail-NA,0.0,41776.13,USD,ACH Credit,ShopSphere Partner #64,***1368,INV-202401-Retail-NA-0004,,False,False,REF-792304,First Continental Bank,***3399,Globex Retail NA LLC,US,9497415.65
2024-01-29,2024-01-29,Supplier Payment - HyperCloud Infra #6,Supplier Payment,SaaS-GL,3124.23,0.0,USD,ACH Debit,HyperCloud Infra #6,***7726,,PO-202401-SaaS-GL-0010,False,False,REF-513357,First Continental Bank,***5128,Globex Retail NA LLC,US,9494291.42
2024-01-29,2024-01-29,Client Receipt - CloudBridge Co. #15,Sales Receipt,SaaS-GL,0.0,2517.06,USD,ACH Credit,CloudBridge Co. #15,***4496,INV-202401-SaaS-GL-0001,,False,False,REF-378803,First Continental Bank,***4303,Globex Retail NA LLC,US,9496808.48
2024-01-29,2024-01-29,Client Receipt - ShopSphere Partner #6,Sales Receipt,Retail-NA,0.0,59673.36,USD,ACH Credit,ShopSphere Partner #6,***9024,INV-202401-Retail-NA-0011,,False,False,REF-300676,First Continental Bank,***4886,Globex Retail NA LLC,US,9556481.84
2024-01-30,2024-01-30,Supplier Payment - HyperCloud Infra #1,Supplier Payment,SaaS-GL,17645.02,0.0,USD,ACH Debit,HyperCloud Infra #1,***2317,,PO-202401-SaaS-GL-0002,False,False,REF-376929,First Continental Bank,***7611,Globex Retail NA LLC,US,9538836.82
2024-01-30,2024-01-30,Interest Earned,Interest Income,ALL,0.0,10399.07,USD,ACH Credit,First Continental Bank,***9078,,,False,False,REF-875102,First Continental Bank,***8308,Globex Retail NA LLC,US,9549235.89
2024-01-31,2024-01-31,Supplier Payment - CodeCraft Contractors #11,Supplier Payment,SaaS-GL,6650.36,0.0,USD,ACH Debit,CodeCraft Contractors #11,***8196,,PO-202401-SaaS-GL-0004,False,False,REF-176532,First Continental Bank,***6304,Globex Retail NA LLC,US,9542585.53
2024-01-31,2024-01-31,Supplier Payment - NorthRiver Apparel Mfg #13,Supplier Payment,Retail-NA,16716.41,0.0,USD,Fedwire,NorthRiver Apparel Mfg #13,***6873,,PO-202401-Retail-NA-0009,False,False,REF-478566,First Continental Bank,***1249,Globex Retail NA LLC,US,9525869.12
2024-01-31,2024-01-31,Client Receipt - CloudBridge Co. #1,Sales Receipt,SaaS-GL,0.0,30964.63,USD,Card Settlement,CloudBridge Co. #1,***9561,INV-202401-SaaS-GL-0012,,False,False,REF-999960,First Continental Bank,***1603,Globex Retail NA LLC,US,9556833.75
2024-02-01,2024-02-01,Account Maintenance Fee,Bank/Merchant Fees,ALL,2500.0,0.0,USD,Fedwire,First Continental Bank,***2013,,,False,False,REF-885007,First Continental Bank,***4806,Globex Retail NA LLC,US,9554333.75
2024-02-01,2024-02-01,Client Receipt - CloudBridge Co. #1,Sales Receipt,SaaS-GL,0.0,3423.46,USD,Card Settlement,CloudBridge Co. #1,***9262,INV-202402-SaaS-GL-0011,,False,False,REF-429151,First Continental Bank,***7669,Globex Retail NA LLC,US,9557757.21
2024-02-01,2024-02-01,Client Receipt - CloudBridge Co. #54,Sales Receipt,SaaS-GL,0.0,10827.97,USD,Card Settlement,CloudBridge Co. #54,***5763,INV-202402-SaaS-GL-0016,,False,False,REF-277393,First Continental Bank,***8719,Globex Retail NA LLC,US,9568585.18
2024-02-02,2024-02-02,Marketing - Beacon Digital #4,Marketing,ALL,8473.21,0.0,USD,Fedwire,Beacon Digital #4,***1464,,,False,False,REF-351005,First Continental Bank,***9063,Globex Retail NA LLC,US,9560111.97
2024-02-02,2024-02-02,Supplier Payment - CodeCraft Contractors #11,Supplier Payment,SaaS-GL,11403.87,0.0,USD,ACH Debit,CodeCraft Contractors #11,***3620,,PO-202402-SaaS-GL-0007,False,False,REF-408434,First Continental Bank,***9646,Globex Retail NA LLC,US,9548708.1
2024-02-02,2024-02-02,Client Receipt - Vertex Advisory Client #33,Sales Receipt,PS-GL,0.0,9310.14,USD,ACH Credit,Vertex Advisory Client #33,***7770,INV-202402-PS-GL-0005,,False,False,REF-160191,First Continental Bank,***6904,Globex Retail NA LLC,US,9558018.24
2024-02-02,2024-02-02,Client Receipt - ShopSphere Partner #19,Sales Receipt,Retail-NA,0.0,17920.11,USD,Card Settlement,ShopSphere Partner #19,***9421,INV-202402-Retail-NA-0002,,False,False,REF-294263,First Continental Bank,***7197,Globex Retail NA LLC,US,9575938.35
2024-02-03,2024-02-03,Client Receipt - CloudBridge Co. #75,Sales Receipt,SaaS-GL,0.0,1817.21,USD,ACH Credit,CloudBridge Co. #75,***9143,INV-202402-SaaS-GL-0019,,False,False,REF-245739,First Continental Bank,***9943,Globex Retail NA LLC,US,9577755.56
2024-02-05,2024-02-05,Supplier Payment - ExpertNet Subcontractors #10,Supplier Payment,PS-GL,6345.27,0.0,USD,Fedwire,ExpertNet Subcontractors #10,***5137,,PO-202402-PS-GL-0006,False,False,REF-589428,First Continental Bank,***6119,Globex Retail NA LLC,US,9571410.29
2024-02-05,2024-02-05,Client Receipt - Vertex Advisory Client #14,Sales Receipt,PS-GL,0.0,10880.59,USD,ACH Credit,Vertex Advisory Client #14,***3950,INV-202402-PS-GL-0001,,False,False,REF-875949,First Continental Bank,***6217,Globex Retail NA LLC,US,9582290.88
2024-02-06,2024-02-06,Supplier Payment - ExpertNet Subcontractors #15,Supplier Payment,PS-GL,4471.31,0.0,USD,Fedwire,ExpertNet Subcontractors #15,***6638,,PO-202402-PS-GL-0007,False,False,REF-433902,First Continental Bank,***2057,Globex Retail NA LLC,US,9577819.57
2024-02-06,2024-02-06,Supplier Payment - NorthRiver Apparel Mfg #6,Supplier Payment,Retail-NA,13501.76,0.0,USD,Fedwire,NorthRiver Apparel Mfg #6,***3979,,PO-202402-Retail-NA-0005,False,False,REF-842860,First Continental Bank,***6777,Globex Retail NA LLC,US,9564317.81
2024-02-06,2024-02-06,Client Receipt - Vertex Advisory Client #37,Sales Receipt,PS-GL,0.0,3287.42,USD,Card Settlement,Vertex Advisory Client #37,***5160,INV-202402-PS-GL-0012,,False,False,REF-581495,First Continental Bank,***2799,Globex Retail NA LLC,US,9567605.23
2024-02-06,2024-02-06,Client Receipt - Vertex Advisory Client #15,Sales Receipt,PS-GL,0.0,3589.42,USD,Card Settlement,Vertex Advisory Client #15,***1288,INV-202402-PS-GL-0003,,False,False,REF-243381,First Continental Bank,***5699,Globex Retail NA LLC,US,9571194.65
2024-02-06,2024-02-06,Client Receipt - CloudBridge Co. #11,Sales Receipt,SaaS-GL,0.0,6073.21,USD,ACH Credit,CloudBridge Co. #11,***1918,INV-202402-SaaS-GL-0005,,False,False,REF-787328,First Continental Bank,***9491,Globex Retail NA LLC,US,9577267.86
2024-02-06,2024-02-06,Client Receipt - ShopSphere Partner #4,Sales Receipt,Retail-NA,0.0,10503.23,USD,ACH Credit,ShopSphere Partner #4,***2202,INV-202402-Retail-NA-0003,,False,False,REF-815321,First Continental Bank,***7768,Globex Retail NA LLC,US,9587771.09
2024-02-06,2024-02-06,Client Receipt - CloudBridge Co. #22,Sales Receipt,SaaS-GL,0.0,20629.11,USD,Card Settlement,CloudBridge Co. #22,***1099,INV-202402-SaaS-GL-0015,,False,False,REF-784039,First Continental Bank,***7202,Globex Retail NA LLC,US,9608400.2
2024-02-06,2024-02-06,Client Receipt - Card Settlement Batch #12,Sales Receipt,Retail-NA,0.0,39599.09,USD,Card Settlement,Card Settlement Batch #12,***1372,INV-202402-Retail-NA-0010,,False,False,REF-961308,First Continental Bank,***7259,Globex Retail NA LLC,US,9647999.29
2024-02-07,2024-02-07,Supplier Payment - ExpertNet Subcontractors #4,Supplier Payment,PS-GL,1871.45,0.0,USD,Fedwire,ExpertNet Subcontractors #4,***8806,,PO-202402-PS-GL-0003,False,False,REF-676610,First Continental Bank,***4959,Globex Retail NA LLC,US,9646127.84
2024-02-07,2024-02-07,Client Receipt - Card Settlement Batch #12,Sales Receipt,Retail-NA,0.0,38769.62,USD,Card Settlement,Card Settlement Batch #12,***2305,INV-202402-Retail-NA-0005,,False,False,REF-385839,First Continental Bank,***9122,Globex Retail NA LLC,US,9684897.46
2024-02-08,2024-02-08,Supplier Payment - CodeCraft Contractors #2,Supplier Payment,SaaS-GL,2174.69,0.0,USD,Fedwire,CodeCraft Contractors #2,***5435,,PO-202402-SaaS-GL-0001,False,False,REF-516718,First Continental Bank,***7169,Globex Retail NA LLC,US,9682722.77
2024-02-08,2024-02-08,Supplier Payment - ExpertNet Subcontractors #8,Supplier Payment,PS-GL,3213.21,0.0,USD,ACH Debit,ExpertNet Subcontractors #8,***4095,,PO-202402-PS-GL-0008,False,False,REF-185495,First Continental Bank,***6607,Globex Retail NA LLC,US,9679509.56
2024-02-08,2024-02-08,Client Receipt - CloudBridge Co. #23,Sales Receipt,SaaS-GL,0.0,2788.77,USD,Card Settlement,CloudBridge Co. #23,***3649,INV-202402-SaaS-GL-0018,,False,False,REF-563719,First Continental Bank,***9171,Globex Retail NA LLC,US,9682298.33
2024-02-08,2024-02-08,Client Receipt - Vertex Advisory Client #9,Sales Receipt,PS-GL,0.0,32118.29,USD,ACH Credit,Vertex Advisory Client #9,***6648,INV-202402-PS-GL-0007,,False,False,REF-158161,First Continental Bank,***2778,Globex Retail NA LLC,US,9714416.62
2024-02-09,2024-02-09,Supplier Payment - HyperCloud Infra #4,Supplier Payment,SaaS-GL,5516.82,0.0,USD,Fedwire,HyperCloud Infra #4,***7206,,PO-202402-SaaS-GL-0003,False,False,REF-883030,First Continental Bank,***4498,Globex Retail NA LLC,US,9708899.8
2024-02-09,2024-02-09,Supplier Payment - PackFast Fulfillment #18,Supplier Payment,Retail-NA,43185.69,0.0,USD,ACH Debit,PackFast Fulfillment #18,***8417,,PO-202402-Retail-NA-0007,False,False,REF-474307,First Continental Bank,***4158,Globex Retail NA LLC,US,9665714.11
2024-02-09,2024-02-09,Client Receipt - CloudBridge Co. #60,Sales Receipt,SaaS-GL,0.0,74.81,USD,Card Settlement,CloudBridge Co. #60,***4890,INV-202402-SaaS-GL-0009,,False,False,REF-114296,First Continental Bank,***2006,Globex Retail NA LLC,US,9665788.92
2024-02-09,2024-02-09,Client Receipt - CloudBridge Co. #69,Sales Receipt,SaaS-GL,0.0,16609.78,USD,Card Settlement,CloudBridge Co. #69,***6192,INV-202402-SaaS-GL-0021,,False,False,REF-611190,First Continental Bank,***3964,Globex Retail NA LLC,US,9682398.7
2024-02-09,2024-02-09,Client Receipt - CloudBridge Co. #76,Sales Receipt,SaaS-GL,0.0,43648.69,USD,Card Settlement,CloudBridge Co. #76,***5589,INV-202402-SaaS-GL-0023,,False,False,REF-365449,First Continental Bank,***6839,Globex Retail NA LLC,US,9726047.39
2024-02-10,2024-02-10,Supplier Payment - CodeCraft Contractors #8,Supplier Payment,SaaS-GL,4600.0,0.0,USD,Fedwire,CodeCraft Contractors #8,***1731,,PO-202402-SaaS-GL-0002,False,False,REF-202227,First Continental Bank,***7662,Globex Retail NA LLC,US,9721447.39
2024-02-10,2024-02-10,Supplier Payment - ExpertNet Subcontractors #13,Supplier Payment,PS-GL,8542.09,0.0,USD,Fedwire,ExpertNet Subcontractors #13,***8143,,PO-202402-PS-GL-0002,False,False,REF-160181,First Continental Bank,***8011,Globex Retail NA LLC,US,9712905.3
2024-02-10,2024-02-10,Supplier Payment - CodeCraft Contractors #1,Supplier Payment,SaaS-GL,14846.03,0.0,USD,ACH Debit,CodeCraft Contractors #1,***1394,,PO-202402-SaaS-GL-0008,False,False,REF-811511,First Continental Bank,***1088,Globex Retail NA LLC,US,9698059.27
2024-02-10,2024-02-10,Client Receipt - ShopSphere Partner #18,Sales Receipt,Retail-NA,0.0,5203.41,USD,ACH Credit,ShopSphere Partner #18,***2769,INV-202402-Retail-NA-0009,,False,False,REF-635578,First Continental Bank,***8210,Globex Retail NA LLC,US,9703262.68
2024-02-11,2024-02-11,Client Receipt - CloudBridge Co. #51,Sales Receipt,SaaS-GL,0.0,5941.55,USD,ACH Credit,CloudBridge Co. #51,***8557,INV-202402-SaaS-GL-0008,,False,False,REF-899970,First Continental Bank,***5851,Globex Retail NA LLC,US,9709204.23
2024-02-12,2024-02-12,Marketing - Beacon Digital #4,Marketing,ALL,10517.19,0.0,USD,Fedwire,Beacon Digital #4,***9390,,,False,False,REF-817572,First Continental Bank,***6272,Globex Retail NA LLC,US,9698687.04
2024-02-12,2024-02-12,Supplier Payment - NorthRiver Apparel Mfg #32,Supplier Payment,Retail-NA,19339.01,0.0,USD,Fedwire,NorthRiver Apparel Mfg #32,***7888,,PO-202402-Retail-NA-0006,False,False,REF-516091,First Continental Bank,***5691,Globex Retail NA LLC,US,9679348.03
2024-02-12,2024-02-12,Intercompany Settlement - Globex APAC Logistics Pte. Ltd.,Intercompany Transfer,ALL,495880.0,0.0,USD,Internal Transfer,Globex APAC Logistics Pte. Ltd.,***9916,,,True,True,REF-611727,First Continental Bank,***8072,Globex Retail NA LLC,US,9183468.03
2024-02-12,2024-02-12,Client Receipt - ShopSphere Partner #52,Sales Receipt,Retail-NA,0.0,6075.08,USD,Card Settlement,ShopSphere Partner #52,***6850,INV-202402-Retail-NA-0015,,False,False,REF-200607,First Continental Bank,***4345,Globex Retail NA LLC,US,9189543.11
2024-02-13,2024-02-13,Supplier Payment - PackFast Fulfillment #21,Supplier Payment,Retail-NA,6324.87,0.0,USD,Fedwire,PackFast Fulfillment #21,***2930,,PO-202402-Retail-NA-0003,False,False,REF-456162,First Continental Bank,***8956,Globex Retail NA LLC,US,9183218.24
2024-02-13,2024-02-13,Supplier Payment - HyperCloud Infra #2,Supplier Payment,SaaS-GL,6724.63,0.0,USD,ACH Debit,HyperCloud Infra #2,***8742,,PO-202402-SaaS-GL-0010,False,False,REF-811704,First Continental Bank,***9068,Globex Retail NA LLC,US,9176493.61
2024-02-13,2024-02-13,Supplier Payment - ExpertNet Subcontractors #17,Supplier Payment,PS-GL,7659.97,0.0,USD,ACH Debit,ExpertNet Subcontractors #17,***3489,,PO-202402-PS-GL-0005,False,False,REF-699009,First Continental Bank,***2589,Globex Retail NA LLC,US,9168833.64
2024-02-13,2024-02-13,Client Receipt - Vertex Advisory Client #54,Sales Receipt,PS-GL,0.0,3418.51,USD,Card Settlement,Vertex Advisory Client #54,***5233,INV-202402-PS-GL-0010,,False,False,REF-890503,First Continental Bank,***6276,Globex Retail NA LLC,US,9172252.15
2024-02-13,2024-02-13,Client Receipt - ShopSphere Partner #68,Sales Receipt,Retail-NA,0.0,7287.44,USD,ACH Credit,ShopSphere Partner #68,***1848,INV-202402-Retail-NA-0014,,False,False,REF-268663,First Continental Bank,***1039,Globex Retail NA LLC,US,9179539.59
2024-02-13,2024-02-13,Client Receipt - Vertex Advisory Client #19,Sales Receipt,PS-GL,0.0,19828.48,USD,ACH Credit,Vertex Advisory Client #19,***7803,INV-202402-PS-GL-0006,,False,False,REF-876159,First Continental Bank,***9182,Globex Retail NA LLC,US,9199368.07
2024-02-14,2024-02-14,Supplier Payment - NorthRiver Apparel Mfg #20,Supplier Payment,Retail-NA,9007.51,0.0,USD,ACH Debit,NorthRiver Apparel Mfg #20,***3568,,PO-202402-Retail-NA-0008,False,False,REF-508926,First Continental Bank,***1072,Globex Retail NA LLC,US,9190360.56
2024-02-14,2024-02-14,Supplier Payment - PackFast Fulfillment #13,Supplier Payment,Retail-NA,11389.35,0.0,USD,ACH Debit,PackFast Fulfillment #13,***1597,,PO-202402-Retail-NA-0002,False,False,REF-172767,First Continental Bank,***1946,Globex Retail NA LLC,US,9178971.21
2024-02-14,2024-02-14,Client Receipt - CloudBridge Co. #41,Sales Receipt,SaaS-GL,0.0,575.0,USD,Card Settlement,CloudBridge Co. #41,***6136,INV-202402-SaaS-GL-0012,,False,False,REF-205564,First Continental Bank,***2593,Globex Retail NA LLC,US,9179546.21
2024-02-14,2024-02-14,Client Receipt - CloudBridge Co. #70,Sales Receipt,SaaS-GL,0.0,18993.83,USD,Card Settlement,CloudBridge Co. #70,***4601,INV-202402-SaaS-GL-0001,,False,False,REF-978253,First Continental Bank,***6081,Globex Retail NA LLC,US,9198540.04
2024-02-14,2024-02-14,Client Receipt - Card Settlement Batch #15,Sales Receipt,Retail-NA,0.0,46086.13,USD,ACH Credit,Card Settlement Batch #15,***7514,INV-202402-Retail-NA-0006,,False,False,REF-424854,First Continental Bank,***8338,Globex Retail NA LLC,US,9244626.17
2024-02-15,2024-02-15,Skyline Internet Services,Rent & Utilities,ALL,2252.39,0.0,USD,Fedwire,Skyline Internet Services,***9638,,,False,False,REF-490983,First Continental Bank,***8306,Globex Retail NA LLC,US,9242373.78
2024-02-15,2024-02-15,Client Receipt - CloudBridge Co. #3,Sales Receipt,SaaS-GL,0.0,6612.76,USD,ACH Credit,CloudBridge Co. #3,***9957,INV-202402-SaaS-GL-0020,,False,False,REF-963805,First Continental Bank,***6460,Globex Retail NA LLC,US,9248986.54
2024-02-15,2024-02-15,Client Receipt - Vertex Advisory Client #8,Sales Receipt,PS-GL,0.0,10248.3,USD,Card Settlement,Vertex Advisory Client #8,***4448,INV-202402-PS-GL-0002,,False,False,REF-624178,First Continental Bank,***9147,Globex Retail NA LLC,US,9259234.84
2024-02-15,2024-02-15,Client Receipt - ShopSphere Partner #60,Sales Receipt,Retail-NA,0.0,26511.13,USD,Card Settlement,ShopSphere Partner #60,***7276,INV-202402-Retail-NA-0007,,False,False,REF-713520,First Continental Bank,***3089,Globex Retail NA LLC,US,9285745.97
2024-02-16,2024-02-16,Supplier Payment - NorthRiver Apparel Mfg #33,Supplier Payment,Retail-NA,62909.56,0.0,USD,Fedwire,NorthRiver Apparel Mfg #33,***8124,,PO-202402-Retail-NA-0010,False,False,REF-728034,First Continental Bank,***8046,Globex Retail NA LLC,US,9222836.41
2024-02-16,2024-02-16,Client Receipt - ShopSphere Partner #28,Sales Receipt,Retail-NA,0.0,13259.4,USD,Card Settlement,ShopSphere Partner #28,***4862,INV-202402-Retail-NA-0004,,False,False,REF-743188,First Continental Bank,***1944,Globex Retail NA LLC,US,9236095.81
2024-02-17,2024-02-17,Merchant Processing Fees,Bank/Merchant Fees,ALL,2466.24,0.0,USD,ACH Debit,First Continental Bank,***4681,,,False,False,REF-808570,First Continental Bank,***2589,Globex Retail NA LLC,US,9233629.57
2024-02-17,2024-02-17,Supplier Payment - HyperCloud Infra #17,Supplier Payment,SaaS-GL,3768.45,0.0,USD,ACH Debit,HyperCloud Infra #17,***4271,,PO-202402-SaaS-GL-0004,False,False,REF-428030,First Continental Bank,***8892,Globex Retail NA LLC,US,9229861.12
2024-02-19,2024-02-19,Supplier Payment - ExpertNet Subcontractors #9,Supplier Payment,PS-GL,947.63,0.0,USD,Fedwire,ExpertNet Subcontractors #9,***8105,,PO-202402-PS-GL-0004,False,False,REF-275640,First Continental Bank,***9582,Globex Retail NA LLC,US,9228913.49
2024-02-19,2024-02-19,Client Receipt - CloudBridge Co. #21,Sales Receipt,SaaS-GL,0.0,10053.38,USD,ACH Credit,CloudBridge Co. #21,***1567,INV-202402-SaaS-GL-0013,,False,False,REF-353922,First Continental Bank,***7600,Globex Retail NA LLC,US,9238966.87
2024-02-19,2024-02-19,Client Receipt - CloudBridge Co. #68,Sales Receipt,SaaS-GL,0.0,15536.34,USD,ACH Credit,CloudBridge Co. #68,***3977,INV-202402-SaaS-GL-0014,,False,False,REF-400964,First Continental Bank,***5770,Globex Retail NA LLC,US,9254503.21
2024-02-20,2024-02-20,Skyline Internet Services,Rent & Utilities,ALL,4359.49,0.0,USD,ACH Debit,Skyline Internet Services,***3757,,,False,False,REF-994786,First Continental Bank,***6189,Globex Retail NA LLC,US,9250143.72
2024-02-20,2024-02-20,VAT/GST Remittance - US IRS,Tax Payment,ALL,47747.65,0.0,USD,Fedwire,US IRS,***7732,,,False,False,REF-433183,First Continental Bank,***1837,Globex Retail NA LLC,US,9202396.07
2024-02-20,2024-02-20,Client Receipt - Vertex Advisory Client #34,Sales Receipt,PS-GL,0.0,7524.79,USD,ACH Credit,Vertex Advisory Client #34,***7382,INV-202402-PS-GL-0011,,False,False,REF-619577,First Continental Bank,***6663,Globex Retail NA LLC,US,9209920.86
2024-02-20,2024-02-20,Client Receipt - CloudBridge Co. #38,Sales Receipt,SaaS-GL,0.0,10450.4,USD,ACH Credit,CloudBridge Co. #38,***5243,INV-202402-SaaS-GL-0004,,False,False,REF-549003,First Continental Bank,***8765,Globex Retail NA LLC,US,9220371.26
2024-02-20,2024-02-20,Client Receipt - CloudBridge Co. #23,Sales Receipt,SaaS-GL,0.0,32324.3,USD,ACH Credit,CloudBridge Co. #23,***6548,INV-202402-SaaS-GL-0002,,False,False,REF-171088,First Continental Bank,***2035,Globex Retail NA LLC,US,9252695.56
2024-02-21,2024-02-21,Supplier Payment - PackFast Fulfillment #13,Supplier Payment,Retail-NA,3523.73,0.0,USD,Fedwire,PackFast Fulfillment #13,***2051,,PO-202402-Retail-NA-0001,False,False,REF-453512,First Continental Bank,***6308,Globex Retail NA LLC,US,9249171.83
2024-02-21,2024-02-21,Client Receipt - CloudBridge Co. #15,Sales Receipt,SaaS-GL,0.0,3462.02,USD,Card Settlement,CloudBridge Co. #15,***3483,INV-202402-SaaS-GL-0007,,False,False,REF-125826,First Continental Bank,***6242,Globex Retail NA LLC,US,9252633.85
2024-02-22,2024-02-22,Supplier Payment - NorthRiver Apparel Mfg #29,Supplier Payment,Retail-NA,6835.51,0.0,USD,Fedwire,NorthRiver Apparel Mfg #29,***4921,,PO-202402-Retail-NA-0004,False,False,REF-782030,First Continental Bank,***5487,Globex Retail NA LLC,US,9245798.34
2024-02-22,2024-02-22,Client Receipt - Card Settlement Batch #20,Sales Receipt,Retail-NA,0.0,9616.57,USD,Card Settlement,Card Settlement Batch #20,***8706,INV-202402-Retail-NA-0011,,False,False,REF-626272,First Continental Bank,***6960,Globex Retail NA LLC,US,9255414.91
2024-02-22,2024-02-22,Client Receipt - CloudBridge Co. #4,Sales Receipt,SaaS-GL,0.0,25614.56,USD,ACH Credit,CloudBridge Co. #4,***4043,INV-202402-SaaS-GL-0003,,False,False,REF-569040,First Continental Bank,***6446,Globex Retail NA LLC,US,9281029.47
2024-02-22,2024-02-22,Client Receipt - Vertex Advisory Client #51,Sales Receipt,PS-GL,0.0,28930.06,USD,ACH Credit,Vertex Advisory Client #51,***4562,INV-202402-PS-GL-0009,,False,False,REF-929628,First Continental Bank,***4534,Globex Retail NA LLC,US,9309959.53
2024-02-23,2024-02-23,Supplier Payment - CodeCraft Contractors #7,Supplier Payment,SaaS-GL,5479.99,0.0,USD,Fedwire,CodeCraft Contractors #7,***9296,,PO-202402-SaaS-GL-0009,False,False,REF-560797,First Continental Bank,***9330,Globex Retail NA LLC,US,9304479.54
2024-02-23,2024-02-23,Supplier Payment - HyperCloud Infra #10,Supplier Payment,SaaS-GL,6120.87,0.0,USD,ACH Debit,HyperCloud Infra #10,***1623,,PO-202402-SaaS-GL-0006,False,False,REF-646324,First Continental Bank,***8367,Globex Retail NA LLC,US,9298358.67
2024-02-23,2024-02-23,Supplier Payment - NorthRiver Apparel Mfg #17,Supplier Payment,Retail-NA,16947.36,0.0,USD,Fedwire,NorthRiver Apparel Mfg #17,***8534,,PO-202402-Retail-NA-0009,False,False,REF-785760,First Continental Bank,***2146,Globex Retail NA LLC,US,9281411.31
2024-02-23,2024-02-23,Client Receipt - ShopSphere Partner #21,Sales Receipt,Retail-NA,0.0,7407.5,USD,ACH Credit,ShopSphere Partner #21,***8932,INV-202402-Retail-NA-0001,,False,False,REF-688712,First Continental Bank,***9949,Globex Retail NA LLC,US,9288818.81
2024-02-23,2024-02-23,Client Receipt - ShopSphere Partner #27,Sales Receipt,Retail-NA,0.0,63009.99,USD,ACH Credit,ShopSphere Partner #27,***6172,INV-202402-Retail-NA-0008,,False,False,REF-888652,First Continental Bank,***1415,Globex Retail NA LLC,US,9351828.8
2024-02-24,2024-02-24,Client Receipt - ShopSphere Partner #46,Sales Receipt,Retail-NA,0.0,34356.52,USD,ACH Credit,ShopSphere Partner #46,***6042,INV-202402-Retail-NA-0013,,False,False,REF-719133,First Continental Bank,***1281,Globex Retail NA LLC,US,9386185.32
2024-02-25,2024-02-25,Client Receipt - CloudBridge Co. #4,Sales Receipt,SaaS-GL,0.0,14151.12,USD,ACH Credit,CloudBridge Co. #4,***7546,INV-202402-SaaS-GL-0010,,False,False,REF-977195,First Continental Bank,***6565,Globex Retail NA LLC,US,9400336.44
2024-02-25,2024-02-25,Client Receipt - CloudBridge Co. #68,Sales Receipt,SaaS-GL,0.0,18086.55,USD,Card Settlement,CloudBridge Co. #68,***9817,INV-202402-SaaS-GL-0006,,False,False,REF-776109,First Continental Bank,***6956,Globex Retail NA LLC,US,9418422.99
2024-02-26,2024-02-26,Supplier Payment - ExpertNet Subcontractors #4,Supplier Payment,PS-GL,733.92,0.0,USD,Fedwire,ExpertNet Subcontractors #4,***1578,,PO-202402-PS-GL-0001,False,False,REF-444372,First Continental Bank,***1953,Globex Retail NA LLC,US,9417689.07
2024-02-26,2024-02-26,Supplier Payment - HyperCloud Infra #13,Supplier Payment,SaaS-GL,1657.53,0.0,USD,ACH Debit,HyperCloud Infra #13,***4199,,PO-202402-SaaS-GL-0005,False,False,REF-926653,First Continental Bank,***9477,Globex Retail NA LLC,US,9416031.54
2024-02-26,2024-02-26,Supplier Payment - ExpertNet Subcontractors #15,Supplier Payment,PS-GL,23626.03,0.0,USD,ACH Debit,ExpertNet Subcontractors #15,***7399,,PO-202402-PS-GL-0009,False,False,REF-391544,First Continental Bank,***6782,Globex Retail NA LLC,US,9392405.51
2024-02-26,2024-02-26,Intercompany Settlement - Globex EMEA Manufacturing Ltd.,Intercompany Transfer,ALL,567350.0,0.0,USD,Internal Transfer,Globex EMEA Manufacturing Ltd.,***3568,,,True,True,REF-769716,First Continental Bank,***4357,Globex Retail NA LLC,US,8825055.51
2024-02-27,2024-02-27,Marketing - Beacon Digital #9,Marketing,ALL,1134.8,0.0,USD,Fedwire,Beacon Digital #9,***4347,,,False,False,REF-738378,First Continental Bank,***3344,Globex Retail NA LLC,US,8823920.71
2024-02-27,2024-02-27,Payroll - GlobalPay Services Ltd,Payroll,ALL,133912.52,0.0,USD,ACH Debit,GlobalPay Services Ltd,***6001,,,False,False,REF-867335,First Continental Bank,***4977,Globex Retail NA LLC,US,8690008.19
2024-02-27,2024-02-27,Client Receipt - CloudBridge Co. #61,Sales Receipt,SaaS-GL,0.0,9690.34,USD,Card Settlement,CloudBridge Co. #61,***8010,INV-202402-SaaS-GL-0022,,False,False,REF-590042,First Continental Bank,***5159,Globex Retail NA LLC,US,8699698.53
2024-02-27,2024-02-27,Client Receipt - Vertex Advisory Client #15,Sales Receipt,PS-GL,0.0,37669.26,USD,Card Settlement,Vertex Advisory Client #15,***7489,INV-202402-PS-GL-0004,,False,False,REF-681661,First Continental Bank,***5384,Globex Retail NA LLC,US,8737367.79
2024-02-28,2024-02-28,Client Receipt - CloudBridge Co. #43,Sales Receipt,SaaS-GL,0.0,9553.9,USD,Card Settlement,CloudBridge Co. #43,***5174,INV-202402-SaaS-GL-0017,,False,False,REF-949324,First Continental Bank,***7638,Globex Retail NA LLC,US,8746921.69
2024-02-28,2024-02-28,Client Receipt - Vertex Advisory Client #32,Sales Receipt,PS-GL,0.0,24564.35,USD,Card Settlement,Vertex Advisory Client #32,***3506,INV-202402-PS-GL-0008,,False,False,REF-114354,First Continental Bank,***9469,Globex Retail NA LLC,US,8771486.04
2024-02-29,2024-02-29,Merchant Processing Fees,Bank/Merchant Fees,ALL,89.19,0.0,USD,ACH Debit,First Continental Bank,***8078,,,False,False,REF-216405,First Continental Bank,***9194,Globex Retail NA LLC,US,8771396.85
2024-02-29,2024-02-29,Supplier Payment - CodeCraft Contractors #6,Supplier Payment,SaaS-GL,859.09,0.0,USD,ACH Debit,CodeCraft Contractors #6,***5314,,PO-202402-SaaS-GL-0011,False,False,REF-799597,First Continental Bank,***2583,Globex Retail NA LLC,US,8770537.76
2024-02-29,2024-02-29,Client Receipt - CloudBridge Co. #38,Sales Receipt,SaaS-GL,0.0,115.35,USD,Card Settlement,CloudBridge Co. #38,***6537,INV-202402-SaaS-GL-0024,,False,False,REF-687534,First Continental Bank,***7155,Globex Retail NA LLC,US,8770653.11
2024-02-29,2024-02-29,Interest Earned,Interest Income,ALL,0.0,11472.59,USD,ACH Credit,First Continental Bank,***1222,,,False,False,REF-842466,First Continental Bank,***1811,Globex Retail NA LLC,US,8782125.7
2024-02-29,2024-02-29,Client Receipt - ShopSphere Partner #38,Sales Receipt,Retail-NA,0.0,25239.06,USD,ACH Credit,ShopSphere Partner #38,***8591,INV-202402-Retail-NA-0012,,False,False,REF-828966,First Continental Bank,***3728,Globex Retail NA LLC,US,8807364.76
2024-03-01,2024-03-01,Account Maintenance Fee,Bank/Merchant Fees,ALL,2500.0,0.0,USD,ACH Debit,First Continental Bank,***6597,,,False,False,REF-845724,First Continental Bank,***5080,Globex Retail NA LLC,US,8804864.76
2024-03-01,2024-03-01,Supplier Payment - PackFast Fulfillment #4,Supplier Payment,Retail-NA,13381.55,0.0,USD,Fedwire,PackFast Fulfillment #4,***2155,,PO-202403-Retail-NA-0004,False,False,REF-378352,First Continental Bank,***1469,Globex Retail NA LLC,US,8791483.21
2024-03-01,2024-03-01,Client Receipt - CloudBridge Co. #59,Sales Receipt,SaaS-GL,0.0,2184.79,USD,ACH Credit,CloudBridge Co. #59,***7699,INV-202403-SaaS-GL-0007,,False,False,REF-884072,First Continental Bank,***5017,Globex Retail NA LLC,US,8793668.0
2024-03-01,2024-03-01,Client Receipt - CloudBridge Co. #47,Sales Receipt,SaaS-GL,0.0,16729.06,USD,Card Settlement,CloudBridge Co. #47,***1357,INV-202403-SaaS-GL-0008,,False,False,REF-308074,First Continental Bank,***4611,Globex Retail NA LLC,US,8810397.06
2024-03-02,2024-03-02,Supplier Payment - ExpertNet Subcontractors #13,Supplier Payment,PS-GL,6774.57,0.0,USD,ACH Debit,ExpertNet Subcontractors #13,***6226,,PO-202403-PS-GL-0002,False,False,REF-559775,First Continental Bank,***2467,Globex Retail NA LLC,US,8803622.49
2024-03-02,2024-03-02,Client Receipt - ShopSphere Partner #43,Sales Receipt,Retail-NA,0.0,14672.5,USD,ACH Credit,ShopSphere Partner #43,***3461,INV-202403-Retail-NA-0005,,False,False,REF-265118,First Continental Bank,***4786,Globex Retail NA LLC,US,8818294.99
2024-03-04,2024-03-04,Supplier Payment - ExpertNet Subcontractors #19,Supplier Payment,PS-GL,5725.31,0.0,USD,ACH Debit,ExpertNet Subcontractors #19,***3574,,PO-202403-PS-GL-0004,False,False,REF-474254,First Continental Bank,***7556,Globex Retail NA LLC,US,8812569.68
2024-03-04,2024-03-04,Supplier Payment - ExpertNet Subcontractors #9,Supplier Payment,PS-GL,14504.03,0.0,USD,Fedwire,ExpertNet Subcontractors #9,***5009,,PO-202403-PS-GL-0009,False,False,REF-980532,First Continental Bank,***7982,Globex Retail NA LLC,US,8798065.65
2024-03-04,2024-03-04,Client Receipt - Vertex Advisory Client #38,Sales Receipt,PS-GL,0.0,21765.22,USD,ACH Credit,Vertex Advisory Client #38,***6278,INV-202403-PS-GL-0007,,False,False,REF-333764,First Continental Bank,***3378,Globex Retail NA LLC,US,8819830.87
2024-03-04,2024-03-04,Client Receipt - CloudBridge Co. #28,Sales Receipt,SaaS-GL,0.0,23775.62,USD,Card Settlement,CloudBridge Co. #28,***8007,INV-202403-SaaS-GL-0020,,False,False,REF-724256,First Continental Bank,***3430,Globex Retail NA LLC,US,8843606.49
2024-03-04,2024-03-04,Client Receipt - ShopSphere Partner #33,Sales Receipt,Retail-NA,0.0,83935.46,USD,ACH Credit,ShopSphere Partner #33,***9350,INV-202403-Retail-NA-0012,,False,False,REF-844151,First Continental Bank,***7855,Globex Retail NA LLC,US,8927541.95
2024-03-05,2024-03-05,Merchant Processing Fees,Bank/Merchant Fees,ALL,1066.74,0.0,USD,Fedwire,First Continental Bank,***5225,,,False,False,REF-312326,First Continental Bank,***3666,Globex Retail NA LLC,US,8926475.21
2024-03-05,2024-03-05,Client Receipt - CloudBridge Co. #78,Sales Receipt,SaaS-GL,0.0,4019.24,USD,Card Settlement,CloudBridge Co. #78,***4055,INV-202403-SaaS-GL-0015,,False,False,REF-597945,First Continental Bank,***2690,Globex Retail NA LLC,US,8930494.45
2024-03-05,2024-03-05,Client Receipt - CloudBridge Co. #28,Sales Receipt,SaaS-GL,0.0,6783.22,USD,Card Settlement,CloudBridge Co. #28,***6520,INV-202403-SaaS-GL-0016,,False,False,REF-585780,First Continental Bank,***5113,Globex Retail NA LLC,US,8937277.67
2024-03-06,2024-03-06,Client Receipt - CloudBridge Co. #41,Sales Receipt,SaaS-GL,0.0,572.86,USD,ACH Credit,CloudBridge Co. #41,***4060,INV-202403-SaaS-GL-0002,,False,False,REF-385089,First Continental Bank,***4490,Globex Retail NA LLC,US,8937850.53
2024-03-06,2024-03-06,Client Receipt - Vertex Advisory Client #40,Sales Receipt,PS-GL,0.0,35137.85,USD,ACH Credit,Vertex Advisory Client #40,***9221,INV-202403-PS-GL-0006,,False,False,REF-280075,First Continental Bank,***4008,Globex Retail NA LLC,US,8972988.38
2024-03-07,2024-03-07,Supplier Payment - PackFast Fulfillment #10,Supplier Payment,Retail-NA,6467.15,0.0,USD,ACH Debit,PackFast Fulfillment #10,***1628,,PO-202403-Retail-NA-0007,False,False,REF-462824,First Continental Bank,***2325,Globex Retail NA LLC,US,8966521.23
2024-03-07,2024-03-07,Client Receipt - CloudBridge Co. #2,Sales Receipt,SaaS-GL,0.0,11935.6,USD,Card Settlement,CloudBridge Co. #2,***3891,INV-202403-SaaS-GL-0013,,False,False,REF-598427,First Continental Bank,***7197,Globex Retail NA LLC,US,8978456.83
2024-03-07,2024-03-07,Client Receipt - ShopSphere Partner #69,Sales Receipt,Retail-NA,0.0,32772.9,USD,Card Settlement,ShopSphere Partner #69,***2550,INV-202403-Retail-NA-0008,,False,False,REF-669611,First Continental Bank,***5514,Globex Retail NA LLC,US,9011229.73
2024-03-07,2024-03-07,Client Receipt - CloudBridge Co. #19,Sales Receipt,SaaS-GL,0.0,35527.27,USD,ACH Credit,CloudBridge Co. #19,***8652,INV-202403-SaaS-GL-0017,,False,False,REF-628066,First Continental Bank,***4280,Globex Retail NA LLC,US,9046757.0
2024-03-08,2024-03-08,Supplier Payment - PackFast Fulfillment #15,Supplier Payment,Retail-NA,26332.72,0.0,USD,Fedwire,PackFast Fulfillment #15,***9931,,PO-202403-Retail-NA-0003,False,False,REF-239366,First Continental Bank,***1711,Globex Retail NA LLC,US,9020424.28
2024-03-08,2024-03-08,Supplier Payment - NorthRiver Apparel Mfg #29,Supplier Payment,Retail-NA,43316.02,0.0,USD,Fedwire,NorthRiver Apparel Mfg #29,***1388,,PO-202403-Retail-NA-0009,False,False,REF-898337,First Continental Bank,***6896,Globex Retail NA LLC,US,8977108.26
2024-03-09,2024-03-09,Supplier Payment - ExpertNet Subcontractors #17,Supplier Payment,PS-GL,3783.68,0.0,USD,Fedwire,ExpertNet Subcontractors #17,***7369,,PO-202403-PS-GL-0001,False,False,REF-539146,First Continental Bank,***9922,Globex Retail NA LLC,US,8973324.58
2024-03-10,2024-03-10,Supplier Payment - CodeCraft Contractors #6,Supplier Payment,SaaS-GL,8968.5,0.0,USD,Fedwire,CodeCraft Contractors #6,***8043,,PO-202403-SaaS-GL-0009,False,False,REF-802659,First Continental Bank,***7499,Globex Retail NA LLC,US,8964356.08
2024-03-11,2024-03-11,Supplier Payment - HyperCloud Infra #15,Supplier Payment,SaaS-GL,23961.18,0.0,USD,Fedwire,HyperCloud Infra #15,***8534,,PO-202403-SaaS-GL-0005,False,False,REF-829505,First Continental Bank,***6656,Globex Retail NA LLC,US,8940394.9
2024-03-12,2024-03-12,Supplier Payment - CodeCraft Contractors #14,Supplier Payment,SaaS-GL,6486.78,0.0,USD,Fedwire,CodeCraft Contractors #14,***3802,,PO-202403-SaaS-GL-0002,False,False,REF-184394,First Continental Bank,***6470,Globex Retail NA LLC,US,8933908.12
2024-03-12,2024-03-12,Intercompany Settlement - Globex EMEA Manufacturing Ltd.,Intercompany Transfer,ALL,171659.0,0.0,USD,Internal Transfer,Globex EMEA Manufacturing Ltd.,***8462,,,True,True,REF-647156,First Continental Bank,***6006,Globex Retail NA LLC,US,8762249.12
2024-03-12,2024-03-12,Client Receipt - CloudBridge Co. #61,Sales Receipt,SaaS-GL,0.0,4459.14,USD,Card Settlement,CloudBridge Co. #61,***3942,INV-202403-SaaS-GL-0005,,False,False,REF-807221,First Continental Bank,***5941,Globex Retail NA LLC,US,8766708.26
2024-03-12,2024-03-12,Client Receipt - ShopSphere Partner #60,Sales Receipt,Retail-NA,0.0,11658.16,USD,ACH Credit,ShopSphere Partner #60,***2553,INV-202403-Retail-NA-0007,,False,False,REF-472038,First Continental Bank,***4215,Globex Retail NA LLC,US,8778366.42
2024-03-13,2024-03-13,Supplier Payment - HyperCloud Infra #3,Supplier Payment,SaaS-GL,1118.32,0.0,USD,Fedwire,HyperCloud Infra #3,***9457,,PO-202403-SaaS-GL-0001,False,False,REF-459254,First Continental Bank,***3431,Globex Retail NA LLC,US,8777248.1
2024-03-13,2024-03-13,Supplier Payment - NorthRiver Apparel Mfg #24,Supplier Payment,Retail-NA,6782.41,0.0,USD,ACH Debit,NorthRiver Apparel Mfg #24,***1471,,PO-202403-Retail-NA-0005,False,False,REF-271311,First Continental Bank,***1959,Globex Retail NA LLC,US,8770465.69
2024-03-13,2024-03-13,Client Receipt - ShopSphere Partner #13,Sales Receipt,Retail-NA,0.0,2878.31,USD,Card Settlement,ShopSphere Partner #13,***1227,INV-202403-Retail-NA-0001,,False,False,REF-806919,First Continental Bank,***9498,Globex Retail NA LLC,US,8773344.0
2024-03-13,2024-03-13,Client Receipt - Card Settlement Batch #4,Sales Receipt,Retail-NA,0.0,38124.47,USD,Card Settlement,Card Settlement Batch #4,***7417,INV-202403-Retail-NA-0011,,False,False,REF-474758,First Continental Bank,***9449,Globex Retail NA LLC,US,8811468.47
2024-03-14,2024-03-14,Client Receipt - CloudBridge Co. #5,Sales Receipt,SaaS-GL,0.0,2989.42,USD,ACH Credit,CloudBridge Co. #5,***3404,INV-202403-SaaS-GL-0006,,False,False,REF-136445,First Continental Bank,***9525,Globex Retail NA LLC,US,8814457.89
2024-03-14,2024-03-14,Client Receipt - ShopSphere Partner #35,Sales Receipt,Retail-NA,0.0,51264.36,USD,ACH Credit,ShopSphere Partner #35,***6246,INV-202403-Retail-NA-0002,,False,False,REF-539126,First Continental Bank,***6601,Globex Retail NA LLC,US,8865722.25
2024-03-15,2024-03-15,Supplier Payment - HyperCloud Infra #16,Supplier Payment,SaaS-GL,985.16,0.0,USD,ACH Debit,HyperCloud Infra #16,***2790,,PO-202403-SaaS-GL-0007,False,False,REF-869933,First Continental Bank,***9615,Globex Retail NA LLC,US,8864737.09
2024-03-15,2024-03-15,Client Receipt - Vertex Advisory Client #43,Sales Receipt,PS-GL,0.0,6689.69,USD,Card Settlement,Vertex Advisory Client #43,***6646,INV-202403-PS-GL-0001,,False,False,REF-248195,First Continental Bank,***9126,Globex Retail NA LLC,US,8871426.78
2024-03-16,2024-03-16,Client Receipt - Vertex Advisory Client #47,Sales Receipt,PS-GL,0.0,33451.28,USD,ACH Credit,Vertex Advisory Client #47,***4838,INV-202403-PS-GL-0002,,False,False,REF-524720,First Continental Bank,***4219,Globex Retail NA LLC,US,8904878.06
2024-03-17,2024-03-17,Client Receipt - ShopSphere Partner #56,Sales Receipt,Retail-NA,0.0,493.36,USD,Card Settlement,ShopSphere Partner #56,***6242,INV-202403-Retail-NA-0009,,False,False,REF-692767,First Continental Bank,***7344,Globex Retail NA LLC,US,8905371.42
2024-03-18,2024-03-18,Supplier Payment - CodeCraft Contractors #7,Supplier Payment,SaaS-GL,11811.39,0.0,USD,ACH Debit,CodeCraft Contractors #7,***8784,,PO-202403-SaaS-GL-0004,False,False,REF-223023,First Continental Bank,***4915,Globex Retail NA LLC,US,8893560.03
2024-03-18,2024-03-18,Client Receipt - CloudBridge Co. #3,Sales Receipt,SaaS-GL,0.0,19584.47,USD,ACH Credit,CloudBridge Co. #3,***1287,INV-202403-SaaS-GL-0003,,False,False,REF-705018,First Continental Bank,***7372,Globex Retail NA LLC,US,8913144.5
2024-03-19,2024-03-19,Marketing - Beacon Digital #3,Marketing,ALL,666.08,0.0,USD,ACH Debit,Beacon Digital #3,***7761,,,False,False,REF-489702,First Continental Bank,***7113,Globex Retail NA LLC,US,8912478.42
2024-03-19,2024-03-19,Supplier Payment - NorthRiver Apparel Mfg #9,Supplier Payment,Retail-NA,22354.42,0.0,USD,Fedwire,NorthRiver Apparel Mfg #9,***7028,,PO-202403-Retail-NA-0001,False,False,REF-970757,First Continental Bank,***6977,Globex Retail NA LLC,US,8890124.0
2024-03-19,2024-03-19,Client Receipt - ShopSphere Partner #30,Sales Receipt,Retail-NA,0.0,4811.39,USD,Card Settlement,ShopSphere Partner #30,***3768,INV-202403-Retail-NA-0010,,False,False,REF-946871,First Continental Bank,***2555,Globex Retail NA LLC,US,8894935.39
2024-03-19,2024-03-19,Client Receipt - ShopSphere Partner #16,Sales Receipt,Retail-NA,0.0,14977.56,USD,Card Settlement,ShopSphere Partner #16,***2943,INV-202403-Retail-NA-0003,,False,False,REF-869020,First Continental Bank,***7348,Globex Retail NA LLC,US,8909912.95
2024-03-20,2024-03-20,VAT/GST Remittance - US IRS,Tax Payment,ALL,57929.17,0.0,USD,Fedwire,US IRS,***8053,,,False,False,REF-673615,First Continental Bank,***2312,Globex Retail NA LLC,US,8851983.78
2024-03-20,2024-03-20,Client Receipt - Vertex Advisory Client #15,Sales Receipt,PS-GL,0.0,45208.57,USD,ACH Credit,Vertex Advisory Client #15,***9282,INV-202403-PS-GL-0004,,False,False,REF-357076,First Continental Bank,***4419,Globex Retail NA LLC,US,8897192.35
2024-03-21,2024-03-21,Supplier Payment - HyperCloud Infra #11,Supplier Payment,SaaS-GL,1245.99,0.0,USD,Fedwire,HyperCloud Infra #11,***6113,,PO-202403-SaaS-GL-0006,False,False,REF-517715,First Continental Bank,***8564,Globex Retail NA LLC,US,8895946.36
2024-03-21,2024-03-21,Supplier Payment - ExpertNet Subcontractors #3,Supplier Payment,PS-GL,4260.4,0.0,USD,Fedwire,ExpertNet Subcontractors #3,***9423,,PO-202403-PS-GL-0003,False,False,REF-634473,First Continental Bank,***9022,Globex Retail NA LLC,US,8891685.96
2024-03-21,2024-03-21,Supplier Payment - ExpertNet Subcontractors #2,Supplier Payment,PS-GL,6584.49,0.0,USD,Fedwire,ExpertNet Subcontractors #2,***5948,,PO-202403-PS-GL-0008,False,False,REF-846142,First Continental Bank,***5234,Globex Retail NA LLC,US,8885101.47
2024-03-21,2024-03-21,BluePeak Property Mgmt,Rent & Utilities,ALL,7412.32,0.0,USD,Fedwire,BluePeak Property Mgmt,***7296,,,False,False,REF-544749,First Continental Bank,***4590,Globex Retail NA LLC,US,8877689.15
2024-03-21,2024-03-21,Supplier Payment - CodeCraft Contractors #8,Supplier Payment,SaaS-GL,10838.47,0.0,USD,Fedwire,CodeCraft Contractors #8,***6678,,PO-202403-SaaS-GL-0008,False,False,REF-299758,First Continental Bank,***5777,Globex Retail NA LLC,US,8866850.68
2024-03-21,2024-03-21,Supplier Payment - ExpertNet Subcontractors #1,Supplier Payment,PS-GL,12201.78,0.0,USD,ACH Debit,ExpertNet Subcontractors #1,***3328,,PO-202403-PS-GL-0005,False,False,REF-214635,First Continental Bank,***1368,Globex Retail NA LLC,US,8854648.9
2024-03-21,2024-03-21,Client Receipt - Vertex Advisory Client #33,Sales Receipt,PS-GL,0.0,5092.08,USD,ACH Credit,Vertex Advisory Client #33,***4524,INV-202403-PS-GL-0005,,False,False,REF-529120,First Continental Bank,***8544,Globex Retail NA LLC,US,8859740.98
2024-03-21,2024-03-21,Client Receipt - CloudBridge Co. #60,Sales Receipt,SaaS-GL,0.0,9784.2,USD,Card Settlement,CloudBridge Co. #60,***4308,INV-202403-SaaS-GL-0021,,False,False,REF-768434,First Continental Bank,***5162,Globex Retail NA LLC,US,8869525.18
2024-03-21,2024-03-21,Client Receipt - CloudBridge Co. #14,Sales Receipt,SaaS-GL,0.0,20418.96,USD,Card Settlement,CloudBridge Co. #14,***7344,INV-202403-SaaS-GL-0014,,False,False,REF-963614,First Continental Bank,***3953,Globex Retail NA LLC,US,8889944.14
2024-03-21,2024-03-21,Client Receipt - ShopSphere Partner #15,Sales Receipt,Retail-NA,0.0,31746.72,USD,Card Settlement,ShopSphere Partner #15,***3637,INV-202403-Retail-NA-0004,,False,False,REF-330851,First Continental Bank,***6836,Globex Retail NA LLC,US,8921690.86
2024-03-21,2024-03-21,Client Receipt - CloudBridge Co. #20,Sales Receipt,SaaS-GL,0.0,83253.59,USD,Card Settlement,CloudBridge Co. #20,***5634,INV-202403-SaaS-GL-0009,,False,False,REF-950183,First Continental Bank,***2555,Globex Retail NA LLC,US,9004944.45
2024-03-22,2024-03-22,Supplier Payment - HyperCloud Infra #12,Supplier Payment,SaaS-GL,5165.82,0.0,USD,Fedwire,HyperCloud Infra #12,***4789,,PO-202403-SaaS-GL-0003,False,False,REF-964182,First Continental Bank,***3318,Globex Retail NA LLC,US,8999778.63
2024-03-22,2024-03-22,Supplier Payment - ExpertNet Subcontractors #6,Supplier Payment,PS-GL,9921.53,0.0,USD,Fedwire,ExpertNet Subcontractors #6,***4719,,PO-202403-PS-GL-0007,False,False,REF-169274,First Continental Bank,***4513,Globex Retail NA LLC,US,8989857.1
2024-03-22,2024-03-22,Supplier Payment - NorthRiver Apparel Mfg #32,Supplier Payment,Retail-NA,24680.03,0.0,USD,ACH Debit,NorthRiver Apparel Mfg #32,***4711,,PO-202403-Retail-NA-0008,False,False,REF-453315,First Continental Bank,***4779,Globex Retail NA LLC,US,8965177.07
2024-03-22,2024-03-22,Client Receipt - Vertex Advisory Client #29,Sales Receipt,PS-GL,0.0,794.05,USD,ACH Credit,Vertex Advisory Client #29,***9710,INV-202403-PS-GL-0003,,False,False,REF-845460,First Continental Bank,***5244,Globex Retail NA LLC,US,8965971.12
2024-03-22,2024-03-22,Client Receipt - CloudBridge Co. #76,Sales Receipt,SaaS-GL,0.0,5940.06,USD,Card Settlement,CloudBridge Co. #76,***6974,INV-202403-SaaS-GL-0019,,False,False,REF-502781,First Continental Bank,***8724,Globex Retail NA LLC,US,8971911.18
2024-03-22,2024-03-22,Client Receipt - CloudBridge Co. #52,Sales Receipt,SaaS-GL,0.0,19707.85,USD,ACH Credit,CloudBridge Co. #52,***6799,INV-202403-SaaS-GL-0011,,False,False,REF-187539,First Continental Bank,***8878,Globex Retail NA LLC,US,8991619.03
2024-03-23,2024-03-23,Marketing - Aurelia Media #7,Marketing,ALL,3128.28,0.0,USD,Fedwire,Aurelia Media #7,***9209,,,False,False,REF-951951,First Continental Bank,***7824,Globex Retail NA LLC,US,8988490.75
2024-03-23,2024-03-23,Supplier Payment - NorthRiver Apparel Mfg #32,Supplier Payment,Retail-NA,18253.14,0.0,USD,Fedwire,NorthRiver Apparel Mfg #32,***6718,,PO-202403-Retail-NA-0002,False,False,REF-186130,First Continental Bank,***3938,Globex Retail NA LLC,US,8970237.61
2024-03-23,2024-03-23,Client Receipt - CloudBridge Co. #46,Sales Receipt,SaaS-GL,0.0,10250.37,USD,ACH Credit,CloudBridge Co. #46,***2015,INV-202403-SaaS-GL-0001,,False,False,REF-461623,First Continental Bank,***5064,Globex Retail NA LLC,US,8980487.98
2024-03-24,2024-03-24,Supplier Payment - NorthRiver Apparel Mfg #11,Supplier Payment,Retail-NA,54098.6,0.0,USD,ACH Debit,NorthRiver Apparel Mfg #11,***6337,,PO-202403-Retail-NA-0006,False,False,REF-222340,First Continental Bank,***3013,Globex Retail NA LLC,US,8926389.38
2024-03-25,2024-03-25,Merchant Processing Fees,Bank/Merchant Fees,ALL,1746.02,0.0,USD,Fedwire,First Continental Bank,***2514,,,False,False,REF-697078,First Continental Bank,***6115,Globex Retail NA LLC,US,8924643.36
2024-03-25,2024-03-25,Client Receipt - CloudBridge Co. #62,Sales Receipt,SaaS-GL,0.0,870.23,USD,ACH Credit,CloudBridge Co. #62,***4707,INV-202403-SaaS-GL-0010,,False,False,REF-230962,First Continental Bank,***7345,Globex Retail NA LLC,US,8925513.59
2024-03-25,2024-03-25,Client Receipt - Vertex Advisory Client #58,Sales Receipt,PS-GL,0.0,24533.25,USD,Card Settlement,Vertex Advisory Client #58,***8611,INV-202403-PS-GL-0008,,False,False,REF-135790,First Continental Bank,***4167,Globex Retail NA LLC,US,8950046.84
2024-03-25,2024-03-25,Client Receipt - CloudBridge Co. #38,Sales Receipt,SaaS-GL,0.0,38776.03,USD,Card Settlement,CloudBridge Co. #38,***6266,INV-202403-SaaS-GL-0012,,False,False,REF-335449,First Continental Bank,***5549,Globex Retail NA LLC,US,8988822.87
2024-03-26,2024-03-26,Marketing - Beacon Digital #4,Marketing,ALL,18679.7,0.0,USD,ACH Debit,Beacon Digital #4,***6766,,,False,False,REF-432655,First Continental Bank,***2646,Globex Retail NA LLC,US,8970143.17
2024-03-26,2024-03-26,Payroll - GlobalPay Services Ltd,Payroll,ALL,74252.07,0.0,USD,Fedwire,GlobalPay Services Ltd,***6309,,,False,False,REF-472042,First Continental Bank,***2457,Globex Retail NA LLC,US,8895891.1
2024-03-26,2024-03-26,Payroll - GlobalPay Services Ltd,Payroll,ALL,74252.07,0.0,USD,ACH Debit,GlobalPay Services Ltd,***7329,,,False,False,REF-721262,First Continental Bank,***4792,Globex Retail NA LLC,US,8821639.03
2024-03-26,2024-03-26,Intercompany Settlement - Globex APAC Logistics Pte. Ltd.,Intercompany Transfer,ALL,174370.0,0.0,USD,Internal Transfer,Globex APAC Logistics Pte. Ltd.,***5865,,,True,True,REF-303164,First Continental Bank,***3728,Globex Retail NA LLC,US,8647269.03
2024-03-26,2024-03-26,Client Receipt - CloudBridge Co. #47,Sales Receipt,SaaS-GL,0.0,2760.06,USD,ACH Credit,CloudBridge Co. #47,***8332,INV-202403-SaaS-GL-0004,,False,False,REF-331378,First Continental Bank,***7772,Globex Retail NA LLC,US,8650029.09
2024-03-26,2024-03-26,Intercompany Reimbursement - Globex APAC Logistics Pte. Ltd.,Intercompany Transfer,ALL,0.0,69748.0,USD,Internal Transfer,Globex APAC Logistics Pte. Ltd.,***6701,,,True,True,REF-482431,First Continental Bank,***5773,Globex Retail NA LLC,US,8719777.09
2024-03-27,2024-03-27,Supplier Payment - ExpertNet Subcontractors #5,Supplier Payment,PS-GL,409.31,0.0,USD,Fedwire,ExpertNet Subcontractors #5,***4198,,PO-202403-PS-GL-0006,False,False,REF-684881,First Continental Bank,***1785,Globex Retail NA LLC,US,8719367.78
2024-03-28,2024-03-28,Client Receipt - ShopSphere Partner #24,Sales Receipt,Retail-NA,0.0,104784.89,USD,ACH Credit,ShopSphere Partner #24,***2865,INV-202403-Retail-NA-0006,,False,False,REF-434666,First Continental Bank,***8592,Globex Retail NA LLC,US,8824152.67
2024-03-29,2024-03-29,Client Receipt - Vertex Advisory Client #1,Sales Receipt,PS-GL,0.0,41211.69,USD,ACH Credit,Vertex Advisory Client #1,***5360,INV-202403-PS-GL-0009,,False,False,REF-715640,First Continental Bank,***3112,Globex Retail NA LLC,US,8865364.36
2024-03-30,2024-03-30,Interest Earned,Interest Income,ALL,0.0,12167.08,USD,ACH Credit,First Continental Bank,***8008,,,False,False,REF-527619,First Continental Bank,***1716,Globex Retail NA LLC,US,8877531.44
2024-03-31,2024-03-31,Client Receipt - CloudBridge Co. #71,Sales Receipt,SaaS-GL,0.0,503.48,USD,Card Settlement,CloudBridge Co. #71,***8264,INV-202403-SaaS-GL-0018,,False,False,REF-911426,First Continental Bank,***2885,Globex Retail NA LLC,US,8878034.92
2024-04-01,2024-04-01,Account Maintenance Fee,Bank/Merchant Fees,ALL,2500.0,0.0,USD,ACH Debit,First Continental Bank,***7213,,,False,False,REF-622014,First Continental Bank,***6286,Globex Retail NA LLC,US,8875534.92
2024-04-01,2024-04-01,Client Receipt - ShopSphere Partner #50,Sales Receipt,Retail-NA,0.0,10977.92,USD,Card Settlement,ShopSphere Partner #50,***5841,INV-202404-Retail-NA-0006,,False,False,REF-923021,First Continental Bank,***2410,Globex Retail NA LLC,US,8886512.84
2024-04-02,2024-04-02,Marketing - Aurelia Media #7,Marketing,ALL,8256.04,0.0,USD,Fedwire,Aurelia Media #7,***7979,,,False,False,REF-790760,First Continental Bank,***5343,Globex Retail NA LLC,US,8878256.8
2024-04-02,2024-04-02,Supplier Payment - HyperCloud Infra #8,Supplier Payment,SaaS-GL,8866.88,0.0,USD,ACH Debit,HyperCloud Infra #8,***6544,,PO-202404-SaaS-GL-0005,False,False,REF-378388,First Continental Bank,***9194,Globex Retail NA LLC,US,8869389.92
2024-04-02,2024-04-02,Supplier Payment - HyperCloud Infra #2,Supplier Payment,SaaS-GL,23971.9,0.0,USD,Fedwire,HyperCloud Infra #2,***7265,,PO-202404-SaaS-GL-0010,False,False,REF-668447,First Continental Bank,***1946,Globex Retail NA LLC,US,8845418.02
2024-04-02,2024-04-02,Client Receipt - CloudBridge Co. #23,Sales Receipt,SaaS-GL,0.0,871.2,USD,ACH Credit,CloudBridge Co. #23,***7371,INV-202404-SaaS-GL-0024,,False,False,REF-635421,First Continental Bank,***6923,Globex Retail NA LLC,US,8846289.22
2024-04-02,2024-04-02,Client Receipt - CloudBridge Co. #24,Sales Receipt,SaaS-GL,0.0,7145.83,USD,ACH Credit,CloudBridge Co. #24,***3951,INV-202404-SaaS-GL-0027,,False,False,REF-253251,First Continental Bank,***6991,Globex Retail NA LLC,US,8853435.05
2024-04-03,2024-04-03,Supplier Payment - PackFast Fulfillment #20,Supplier Payment,Retail-NA,68894.19,0.0,USD,ACH Debit,PackFast Fulfillment #20,***5266,,PO-202404-Retail-NA-0008,False,False,REF-489421,First Continental Bank,***2560,Globex Retail NA LLC,US,8784540.86
2024-04-03,2024-04-03,Client Receipt - CloudBridge Co. #39,Sales Receipt,SaaS-GL,0.0,5086.56,USD,ACH Credit,CloudBridge Co. #39,***2499,INV-202404-SaaS-GL-0010,,False,False,REF-743042,First Continental Bank,***5461,Globex Retail NA LLC,US,8789627.42
2024-04-03,2024-04-03,Client Receipt - Card Settlement Batch #4,Sales Receipt,Retail-NA,0.0,9135.18,USD,Card Settlement,Card Settlement Batch #4,***7394,INV-202404-Retail-NA-0001,,False,False,REF-714953,First Continental Bank,***5145,Globex Retail NA LLC,US,8798762.6
2024-04-04,2024-04-04,Supplier Payment - NorthRiver Apparel Mfg #20,Supplier Payment,Retail-NA,3412.87,0.0,USD,ACH Debit,NorthRiver Apparel Mfg #20,***2279,,PO-202404-Retail-NA-0004,False,False,REF-833157,First Continental Bank,***1315,Globex Retail NA LLC,US,8795349.73
2024-04-04,2024-04-04,Marketing - Aurelia Media #1,Marketing,ALL,8870.97,0.0,USD,ACH Debit,Aurelia Media #1,***8797,,,False,False,REF-707678,First Continental Bank,***1092,Globex Retail NA LLC,US,8786478.76
2024-04-04,2024-04-04,Client Receipt - CloudBridge Co. #49,Sales Receipt,SaaS-GL,0.0,11567.71,USD,Card Settlement,CloudBridge Co. #49,***3565,INV-202404-SaaS-GL-0019,,False,False,REF-127480,First Continental Bank,***3059,Globex Retail NA LLC,US,8798046.47
2024-04-04,2024-04-04,Client Receipt - Card Settlement Batch #7,Sales Receipt,Retail-NA,0.0,11582.1,USD,Card Settlement,Card Settlement Batch #7,***7575,INV-202404-Retail-NA-0004,,False,False,REF-909029,First Continental Bank,***3227,Globex Retail NA LLC,US,8809628.57
2024-04-04,2024-04-04,Client Receipt - Card Settlement Batch #22,Sales Receipt,Retail-NA,0.0,42775.25,USD,ACH Credit,Card Settlement Batch #22,***8855,INV-202404-Retail-NA-0011,,False,False,REF-265947,First Continental Bank,***8829,Globex Retail NA LLC,US,8852403.82
2024-04-04,2024-04-04,Client Receipt - ShopSphere Partner #2,Sales Receipt,Retail-NA,0.0,160656.95,USD,ACH Credit,ShopSphere Partner #2,***2417,INV-202404-Retail-NA-0014,,False,False,REF-933040,First Continental Bank,***4776,Globex Retail NA LLC,US,9013060.77
2024-04-05,2024-04-05,Merchant Processing Fees,Bank/Merchant Fees,ALL,2065.41,0.0,USD,Fedwire,First Continental Bank,***3204,,,False,False,REF-275065,First Continental Bank,***2931,Globex Retail NA LLC,US,9010995.36
2024-04-05,2024-04-05,Supplier Payment - PackFast Fulfillment #19,Supplier Payment,Retail-NA,6997.33,0.0,USD,Fedwire,PackFast Fulfillment #19,***8256,,PO-202404-Retail-NA-0003,False,False,REF-262245,First Continental Bank,***1680,Globex Retail NA LLC,US,9003998.03
2024-04-05,2024-04-05,Client Receipt - Card Settlement Batch #9,Sales Receipt,Retail-NA,0.0,2911.29,USD,ACH Credit,Card Settlement Batch #9,***8367,INV-202404-Retail-NA-0016,,False,False,REF-658112,First Continental Bank,***3109,Globex Retail NA LLC,US,9006909.32
2024-04-05,2024-04-05,Client Receipt - Vertex Advisory Client #54,Sales Receipt,PS-GL,0.0,3457.7,USD,ACH Credit,Vertex Advisory Client #54,***7116,INV-202404-PS-GL-0001,,False,False,REF-211841,First Continental Bank,***4593,Globex Retail NA LLC,US,9010367.02
2024-04-05,2024-04-05,Client Receipt - CloudBridge Co. #78,Sales Receipt,SaaS-GL,0.0,5955.84,USD,ACH Credit,CloudBridge Co. #78,***1870,INV-202404-SaaS-GL-0035,,False,False,REF-272342,First Continental Bank,***4776,Globex Retail NA LLC,US,9016322.86
2024-04-06,2024-04-06,Client Receipt - ShopSphere Partner #51,Sales Receipt,Retail-NA,0.0,3521.17,USD,Card Settlement,ShopSphere Partner #51,***4137,INV-202404-Retail-NA-0010,,False,False,REF-840196,First Continental Bank,***5631,Globex Retail NA LLC,US,9019844.03
2024-04-07,2024-04-07,Merchant Processing Fees,Bank/Merchant Fees,ALL,753.43,0.0,USD,Fedwire,First Continental Bank,***5690,,,False,False,REF-359205,First Continental Bank,***1591,Globex Retail NA LLC,US,9019090.6
2024-04-08,2024-04-08,Supplier Payment - ExpertNet Subcontractors #3,Supplier Payment,PS-GL,534.47,0.0,USD,Fedwire,ExpertNet Subcontractors #3,***2898,,PO-202404-PS-GL-0005,False,False,REF-311950,First Continental Bank,***1292,Globex Retail NA LLC,US,9018556.13
2024-04-08,2024-04-08,Supplier Payment - CodeCraft Contractors #3,Supplier Payment,SaaS-GL,818.26,0.0,USD,ACH Debit,CodeCraft Contractors #3,***2544,,PO-202404-SaaS-GL-0008,False,False,REF-332711,First Continental Bank,***4130,Globex Retail NA LLC,US,9017737.87
2024-04-08,2024-04-08,Client Receipt - CloudBridge Co. #40,Sales Receipt,SaaS-GL,0.0,2805.35,USD,ACH Credit,CloudBridge Co. #40,***5153,INV-202404-SaaS-GL-0018,,False,False,REF-340174,First Continental Bank,***4717,Globex Retail NA LLC,US,9020543.22
2024-04-08,2024-04-08,Client Receipt - CloudBridge Co. #51,Sales Receipt,SaaS-GL,0.0,12250.14,USD,ACH Credit,CloudBridge Co. #51,***8990,INV-202404-SaaS-GL-0020,,False,False,REF-219988,First Continental Bank,***5157,Globex Retail NA LLC,US,9032793.36
2024-04-08,2024-04-08,Client Receipt - CloudBridge Co. #43,Sales Receipt,SaaS-GL,0.0,16157.68,USD,ACH Credit,CloudBridge Co. #43,***6044,INV-202404-SaaS-GL-0016,,False,False,REF-317095,First Continental Bank,***1733,Globex Retail NA LLC,US,9048951.04
2024-04-08,2024-04-08,Client Receipt - CloudBridge Co. #79,Sales Receipt,SaaS-GL,0.0,16578.63,USD,ACH Credit,CloudBridge Co. #79,***9716,INV-202404-SaaS-GL-0015,,False,False,REF-888963,First Continental Bank,***5785,Globex Retail NA LLC,US,9065529.67
2024-04-08,2024-04-08,Client Receipt - CloudBridge Co. #75,Sales Receipt,SaaS-GL,0.0,32483.75,USD,Card Settlement,CloudBridge Co. #75,***4439,INV-202404-SaaS-GL-0026,,False,False,REF-713625,First Continental Bank,***8356,Globex Retail NA LLC,US,9098013.42
2024-04-09,2024-04-09,Client Receipt - CloudBridge Co. #66,Sales Receipt,SaaS-GL,0.0,5258.16,USD,ACH Credit,CloudBridge Co. #66,***4085,INV-202404-SaaS-GL-0017,,False,False,REF-168383,First Continental Bank,***5579,Globex Retail NA LLC,US,9103271.58
2024-04-09,2024-04-09,Client Receipt - CloudBridge Co. #31,Sales Receipt,SaaS-GL,0.0,8334.07,USD,ACH Credit,CloudBridge Co. #31,***2250,INV-202404-SaaS-GL-0013,,False,False,REF-962068,First Continental Bank,***2397,Globex Retail NA LLC,US,9111605.65
2024-04-09,2024-04-09,Client Receipt - CloudBridge Co. #35,Sales Receipt,SaaS-GL,0.0,14123.5,USD,ACH Credit,CloudBridge Co. #35,***9373,INV-202404-SaaS-GL-0034,,False,False,REF-931415,First Continental Bank,***1193,Globex Retail NA LLC,US,9125729.15
2024-04-09,2024-04-09,Client Receipt - Card Settlement Batch #21,Sales Receipt,Retail-NA,0.0,34068.0,USD,ACH Credit,Card Settlement Batch #21,***7174,INV-202404-Retail-NA-0003,,False,False,REF-915158,First Continental Bank,***8783,Globex Retail NA LLC,US,9159797.15
2024-04-11,2024-04-11,Supplier Payment - ExpertNet Subcontractors #15,Supplier Payment,PS-GL,4758.2,0.0,USD,ACH Debit,ExpertNet Subcontractors #15,***7277,,PO-202404-PS-GL-0002,False,False,REF-962208,First Continental Bank,***4162,Globex Retail NA LLC,US,9155038.95
2024-04-11,2024-04-11,Client Receipt - CloudBridge Co. #35,Sales Receipt,SaaS-GL,0.0,2170.58,USD,ACH Credit,CloudBridge Co. #35,***6922,INV-202404-SaaS-GL-0005,,False,False,REF-188752,First Continental Bank,***3758,Globex Retail NA LLC,US,9157209.53
2024-04-11,2024-04-11,Client Receipt - CloudBridge Co. #58,Sales Receipt,SaaS-GL,0.0,18012.26,USD,Card Settlement,CloudBridge Co. #58,***6660,INV-202404-SaaS-GL-0004,,False,False,REF-506904,First Continental Bank,***6893,Globex Retail NA LLC,US,9175221.79
2024-04-12,2024-04-12,Supplier Payment - CodeCraft Contractors #10,Supplier Payment,SaaS-GL,2503.88,0.0,USD,Fedwire,CodeCraft Contractors #10,***6769,,PO-202404-SaaS-GL-0001,False,False,REF-665493,First Continental Bank,***8709,Globex Retail NA LLC,US,9172717.91
2024-04-12,2024-04-12,Intercompany Settlement - Globex EMEA Manufacturing Ltd.,Intercompany Transfer,ALL,217907.0,0.0,USD,Internal Transfer,Globex EMEA Manufacturing Ltd.,***9469,,,True,True,REF-909867,First Continental Bank,***3249,Globex Retail NA LLC,US,8954810.91
2024-04-12,2024-04-12,Client Receipt - CloudBridge Co. #35,Sales Receipt,SaaS-GL,0.0,5085.23,USD,Card Settlement,CloudBridge Co. #35,***2459,INV-202404-SaaS-GL-0014,,False,False,REF-149906,First Continental Bank,***2187,Globex Retail NA LLC,US,8959896.14
2024-04-12,2024-04-12,Client Receipt - CloudBridge Co. #49,Sales Receipt,SaaS-GL,0.0,11027.29,USD,ACH Credit,CloudBridge Co. #49,***4408,INV-202404-SaaS-GL-0022,,False,False,REF-849078,First Continental Bank,***9045,Globex Retail NA LLC,US,8970923.43
2024-04-13,2024-04-13,Client Receipt - CloudBridge Co. #7,Sales Receipt,SaaS-GL,0.0,14479.87,USD,Card Settlement,CloudBridge Co. #7,***6189,INV-202404-SaaS-GL-0023,,False,False,REF-321658,First Continental Bank,***5390,Globex Retail NA LLC,US,8985403.3
2024-04-13,2024-04-13,Client Receipt - CloudBridge Co. #63,Sales Receipt,SaaS-GL,0.0,22842.7,USD,Card Settlement,CloudBridge Co. #63,***2292,INV-202404-SaaS-GL-0011,,False,False,REF-647608,First Continental Bank,***5002,Globex Retail NA LLC,US,9008246.0
2024-04-13,2024-04-13,Client Receipt - Vertex Advisory Client #45,Sales Receipt,PS-GL,0.0,36701.59,USD,ACH Credit,Vertex Advisory Client #45,***8253,INV-202404-PS-GL-0006,,False,False,REF-148758,First Continental Bank,***6305,Globex Retail NA LLC,US,9044947.59
2024-04-14,2024-04-14,Supplier Payment - HyperCloud Infra #17,Supplier Payment,SaaS-GL,83.44,0.0,USD,ACH Debit,HyperCloud Infra #17,***3244,,PO-202404-SaaS-GL-0003,False,False,REF-386587,First Continental Bank,***2737,Globex Retail NA LLC,US,9044864.15
2024-04-15,2024-04-15,Supplier Payment - ExpertNet Subcontractors #14,Supplier Payment,PS-GL,2993.08,0.0,USD,ACH Debit,ExpertNet Subcontractors #14,***3487,,PO-202404-PS-GL-0008,False,False,REF-308507,First Continental Bank,***7496,Globex Retail NA LLC,US,9041871.07
2024-04-15,2024-04-15,Supplier Payment - ExpertNet Subcontractors #2,Supplier Payment,PS-GL,9930.92,0.0,USD,ACH Debit,ExpertNet Subcontractors #2,***9534,,PO-202404-PS-GL-0007,False,False,REF-536360,First Continental Bank,***9514,Globex Retail NA LLC,US,9031940.15
2024-04-15,2024-04-15,Supplier Payment - NorthRiver Apparel Mfg #24,Supplier Payment,Retail-NA,47072.85,0.0,USD,ACH Debit,NorthRiver Apparel Mfg #24,***7594,,PO-202404-Retail-NA-0005,False,False,REF-233854,First Continental Bank,***8382,Globex Retail NA LLC,US,8984867.3
2024-04-15,2024-04-15,Client Receipt - ShopSphere Partner #49,Sales Receipt,Retail-NA,0.0,9955.39,USD,ACH Credit,ShopSphere Partner #49,***1308,INV-202404-Retail-NA-0005,,False,False,REF-236261,First Continental Bank,***9911,Globex Retail NA LLC,US,8994822.69
2024-04-15,2024-04-15,Client Receipt - Vertex Advisory Client #7,Sales Receipt,PS-GL,0.0,26856.32,USD,Card Settlement,Vertex Advisory Client #7,***5582,INV-202404-PS-GL-0005,,False,False,REF-793498,First Continental Bank,***9142,Globex Retail NA LLC,US,9021679.01
2024-04-16,2024-04-16,Client Receipt - CloudBridge Co. #60,Sales Receipt,SaaS-GL,0.0,5294.37,USD,Card Settlement,CloudBridge Co. #60,***1786,INV-202404-SaaS-GL-0025,,False,False,REF-819856,First Continental Bank,***2051,Globex Retail NA LLC,US,9026973.38
2024-04-17,2024-04-17,Supplier Payment - ExpertNet Subcontractors #6,Supplier Payment,PS-GL,3825.12,0.0,USD,Fedwire,ExpertNet Subcontractors #6,***7105,,PO-202404-PS-GL-0010,False,False,REF-333628,First Continental Bank,***7317,Globex Retail NA LLC,US,9023148.26
2024-04-17,2024-04-17,Supplier Payment - ExpertNet Subcontractors #11,Supplier Payment,PS-GL,8539.38,0.0,USD,Fedwire,ExpertNet Subcontractors #11,***1913,,PO-202404-PS-GL-0004,False,False,REF-134730,First Continental Bank,***2518,Globex Retail NA LLC,US,9014608.88
2024-04-17,2024-04-17,Client Receipt - CloudBridge Co. #37,Sales Receipt,SaaS-GL,0.0,4035.48,USD,Card Settlement,CloudBridge Co. #37,***9478,INV-202404-SaaS-GL-0031,,False,False,REF-807556,First Continental Bank,***8627,Globex Retail NA LLC,US,9018644.36
2024-04-17,2024-04-17,Client Receipt - Vertex Advisory Client #13,Sales Receipt,PS-GL,0.0,5684.89,USD,Card Settlement,Vertex Advisory Client #13,***7737,INV-202404-PS-GL-0008,,False,False,REF-957663,First Continental Bank,***1257,Globex Retail NA LLC,US,9024329.25
2024-04-18,2024-04-18,Client Receipt - CloudBridge Co. #17,Sales Receipt,SaaS-GL,0.0,8407.07,USD,Card Settlement,CloudBridge Co. #17,***8645,INV-202404-SaaS-GL-0029,,False,False,REF-631632,First Continental Bank,***2638,Globex Retail NA LLC,US,9032736.32
2024-04-18,2024-04-18,Client Receipt - Vertex Advisory Client #10,Sales Receipt,PS-GL,0.0,56383.86,USD,Card Settlement,Vertex Advisory Client #10,***6150,INV-202404-PS-GL-0002,,False,False,REF-172316,First Continental Bank,***1435,Globex Retail NA LLC,US,9089120.18
2024-04-19,2024-04-19,VAT/GST Remittance - US IRS,Tax Payment,ALL,58370.61,0.0,USD,ACH Debit,US IRS,***7472,,,False,False,REF-570053,First Continental Bank,***9893,Globex Retail NA LLC,US,9030749.57
2024-04-19,2024-04-19,Client Receipt - ShopSphere Partner #76,Sales Receipt,Retail-NA,0.0,2961.22,USD,Card Settlement,ShopSphere Partner #76,***6661,INV-202404-Retail-NA-0015,,False,False,REF-886027,First Continental Bank,***5838,Globex Retail NA LLC,US,9033710.79
2024-04-19,2024-04-19,Client Receipt - CloudBridge Co. #51,Sales Receipt,SaaS-GL,0.0,6110.26,USD,ACH Credit,CloudBridge Co. #51,***3309,INV-202404-SaaS-GL-0032,,False,False,REF-909149,First Continental Bank,***7851,Globex Retail NA LLC,US,9039821.05
2024-04-19,2024-04-19,Client Receipt - CloudBridge Co. #75,Sales Receipt,SaaS-GL,0.0,12741.61,USD,ACH Credit,CloudBridge Co. #75,***4576,INV-202404-SaaS-GL-0021,,False,False,REF-688204,First Continental Bank,***7784,Globex Retail NA LLC,US,9052562.66
2024-04-20,2024-04-20,Client Receipt - ShopSphere Partner #49,Sales Receipt,Retail-NA,0.0,26198.53,USD,Card Settlement,ShopSphere Partner #49,***9059,INV-202404-Retail-NA-0009,,False,False,REF-393633,First Continental Bank,***2084,Globex Retail NA LLC,US,9078761.19
2024-04-21,2024-04-21,Metro Water & Waste,Rent & Utilities,ALL,7743.8,0.0,USD,ACH Debit,Metro Water & Waste,***2594,,,False,False,REF-767478,First Continental Bank,***4887,Globex Retail NA LLC,US,9071017.39
2024-04-22,2024-04-22,Supplier Payment - HyperCloud Infra #12,Supplier Payment,SaaS-GL,6454.65,0.0,USD,ACH Debit,HyperCloud Infra #12,***1757,,PO-202404-SaaS-GL-0004,False,False,REF-907005,First Continental Bank,***8626,Globex Retail NA LLC,US,9064562.74
2024-04-22,2024-04-22,Client Receipt - CloudBridge Co. #27,Sales Receipt,SaaS-GL,0.0,9871.43,USD,Card Settlement,CloudBridge Co. #27,***8137,INV-202404-SaaS-GL-0030,,False,False,REF-727778,First Continental Bank,***5048,Globex Retail NA LLC,US,9074434.17
2024-04-23,2024-04-23,Marketing - Aurelia Media #2,Marketing,ALL,7468.85,0.0,USD,Fedwire,Aurelia Media #2,***8455,,,False,False,REF-424957,First Continental Bank,***2977,Globex Retail NA LLC,US,9066965.32
2024-04-23,2024-04-23,Supplier Payment - CodeCraft Contractors #2,Supplier Payment,SaaS-GL,8879.22,0.0,USD,Fedwire,CodeCraft Contractors #2,***8900,,PO-202404-SaaS-GL-0006,False,False,REF-414068,First Continental Bank,***3147,Globex Retail NA LLC,US,9058086.1
2024-04-23,2024-04-23,Supplier Payment - NorthRiver Apparel Mfg #29,Supplier Payment,Retail-NA,25705.66,0.0,USD,Fedwire,NorthRiver Apparel Mfg #29,***2291,,PO-202404-Retail-NA-0001,False,False,REF-448967,First Continental Bank,***4692,Globex Retail NA LLC,US,9032380.44
2024-04-23,2024-04-23,Client Receipt - CloudBridge Co. #9,Sales Receipt,SaaS-GL,0.0,4516.89,USD,Card Settlement,CloudBridge Co. #9,***6956,INV-202404-SaaS-GL-0003,,False,False,REF-874151,First Continental Bank,***6430,Globex Retail NA LLC,US,9036897.33
2024-04-23,2024-04-23,Client Receipt - ShopSphere Partner #50,Sales Receipt,Retail-NA,0.0,38003.19,USD,Card Settlement,ShopSphere Partner #50,***9639,INV-202404-Retail-NA-0013,,False,False,REF-979411,First Continental Bank,***8811,Globex Retail NA LLC,US,9074900.52
2024-04-24,2024-04-24,Supplier Payment - ExpertNet Subcontractors #11,Supplier Payment,PS-GL,3647.2,0.0,USD,ACH Debit,ExpertNet Subcontractors #11,***4402,,PO-202404-PS-GL-0009,False,False,REF-973015,First Continental Bank,***2491,Globex Retail NA LLC,US,9071253.32
2024-04-24,2024-04-24,Supplier Payment - HyperCloud Infra #17,Supplier Payment,SaaS-GL,5585.52,0.0,USD,ACH Debit,HyperCloud Infra #17,***6227,,PO-202404-SaaS-GL-0007,False,False,REF-576057,First Continental Bank,***2637,Globex Retail NA LLC,US,9065667.8
2024-04-24,2024-04-24,Client Receipt - CloudBridge Co. #63,Sales Receipt,SaaS-GL,0.0,8169.39,USD,ACH Credit,CloudBridge Co. #63,***6167,INV-202404-SaaS-GL-0006,,False,False,REF-203153,First Continental Bank,***4742,Globex Retail NA LLC,US,9073837.19
2024-04-25,2024-04-25,Supplier Payment - ExpertNet Subcontractors #2,Supplier Payment,PS-GL,4506.99,0.0,USD,ACH Debit,ExpertNet Subcontractors #2,***5558,,PO-202404-PS-GL-0003,False,False,REF-669460,First Continental Bank,***3918,Globex Retail NA LLC,US,9069330.2
2024-04-25,2024-04-25,Client Receipt - ShopSphere Partner #51,Sales Receipt,Retail-NA,0.0,610.2,USD,Card Settlement,ShopSphere Partner #51,***5856,INV-202404-Retail-NA-0012,,False,False,REF-833191,First Continental Bank,***7539,Globex Retail NA LLC,US,9069940.4
2024-04-25,2024-04-25,Client Receipt - CloudBridge Co. #10,Sales Receipt,SaaS-GL,0.0,745.1,USD,Card Settlement,CloudBridge Co. #10,***5458,INV-202404-SaaS-GL-0001,,False,False,REF-939747,First Continental Bank,***4231,Globex Retail NA LLC,US,9070685.5
2024-04-25,2024-04-25,Client Receipt - CloudBridge Co. #67,Sales Receipt,SaaS-GL,0.0,3133.82,USD,Card Settlement,CloudBridge Co. #67,***6966,INV-202404-SaaS-GL-0033,,False,False,REF-220210,First Continental Bank,***4558,Globex Retail NA LLC,US,9073819.32
2024-04-25,2024-04-25,Client Receipt - CloudBridge Co. #44,Sales Receipt,SaaS-GL,0.0,3546.92,USD,ACH Credit,CloudBridge Co. #44,***9589,INV-202404-SaaS-GL-0028,,False,False,REF-656914,First Continental Bank,***9258,Globex Retail NA LLC,US,9077366.24
2024-04-25,2024-04-25,Client Receipt - CloudBridge Co. #2,Sales Receipt,SaaS-GL,0.0,37506.9,USD,Card Settlement,CloudBridge Co. #2,***4725,INV-202404-SaaS-GL-0002,,False,False,REF-567098,First Continental Bank,***8160,Globex Retail NA LLC,US,9114873.14
2024-04-26,2024-04-26,Supplier Payment - NorthRiver Apparel Mfg #7,Supplier Payment,Retail-NA,5712.71,0.0,USD,Fedwire,NorthRiver Apparel Mfg #7,***9171,,PO-202404-Retail-NA-0002,False,False,REF-107411,First Continental Bank,***5316,Globex Retail NA LLC,US,9109160.43
2024-04-26,2024-04-26,Supplier Payment - CodeCraft Contractors #8,Supplier Payment,SaaS-GL,14040.64,0.0,USD,ACH Debit,CodeCraft Contractors #8,***9990,,PO-202404-SaaS-GL-0009,False,False,REF-124444,First Continental Bank,***7179,Globex Retail NA LLC,US,9095119.79
2024-04-26,2024-04-26,Payroll - GlobalPay Services Ltd,Payroll,ALL,79160.82,0.0,USD,Fedwire,GlobalPay Services Ltd,***8436,,,False,False,REF-461368,First Continental Bank,***2788,Globex Retail NA LLC,US,9015958.97
2024-04-26,2024-04-26,Intercompany Settlement - Globex APAC Logistics Pte. Ltd.,Intercompany Transfer,ALL,549038.0,0.0,USD,Internal Transfer,Globex APAC Logistics Pte. Ltd.,***7485,,,True,True,REF-240538,First Continental Bank,***5881,Globex Retail NA LLC,US,8466920.97
2024-04-26,2024-04-26,Client Receipt - ShopSphere Partner #30,Sales Receipt,Retail-NA,0.0,46197.83,USD,Card Settlement,ShopSphere Partner #30,***5102,INV-202404-Retail-NA-0007,,False,False,REF-484010,First Continental Bank,***8773,Globex Retail NA LLC,US,8513118.8
2024-04-27,2024-04-27,Payroll - GlobalPay Services Ltd,Payroll,ALL,79160.82,0.0,USD,ACH Debit,GlobalPay Services Ltd,***5455,,,False,False,REF-325129,First Continental Bank,***2174,Globex Retail NA LLC,US,8433957.98
2024-04-27,2024-04-27,Client Receipt - CloudBridge Co. #72,Sales Receipt,SaaS-GL,0.0,4024.02,USD,Card Settlement,CloudBridge Co. #72,***2535,INV-202404-SaaS-GL-0008,,False,False,REF-173057,First Continental Bank,***6330,Globex Retail NA LLC,US,8437982.0
2024-04-27,2024-04-27,Client Receipt - ShopSphere Partner #62,Sales Receipt,Retail-NA,0.0,7494.55,USD,Card Settlement,ShopSphere Partner #62,***9175,INV-202404-Retail-NA-0002,,False,False,REF-300500,First Continental Bank,***8960,Globex Retail NA LLC,US,8445476.55
2024-04-28,2024-04-28,Corporate Tax Estimate,Tax Payment,ALL,44976.55,0.0,USD,Fedwire,State of NY DoF,***9511,,,False,False,REF-703895,First Continental Bank,***9854,Globex Retail NA LLC,US,8400500.0
2024-04-28,2024-04-28,Client Receipt - Vertex Advisory Client #28,Sales Receipt,PS-GL,0.0,24514.5,USD,Card Settlement,Vertex Advisory Client #28,***2948,INV-202404-PS-GL-0003,,False,False,REF-876698,First Continental Bank,***5094,Globex Retail NA LLC,US,8425014.5
2024-04-29,2024-04-29,Supplier Payment - ExpertNet Subcontractors #16,Supplier Payment,PS-GL,7686.95,0.0,USD,Fedwire,ExpertNet Subcontractors #16,***4922,,PO-202404-PS-GL-0001,False,False,REF-622122,First Continental Bank,***2477,Globex Retail NA LLC,US,8417327.55
2024-04-29,2024-04-29,Supplier Payment - ExpertNet Subcontractors #16,Supplier Payment,PS-GL,21119.9,0.0,USD,Fedwire,ExpertNet Subcontractors #16,***1299,,PO-202404-PS-GL-0006,False,False,REF-497580,First Continental Bank,***8060,Globex Retail NA LLC,US,8396207.65
2024-04-29,2024-04-29,Supplier Payment - PackFast Fulfillment #7,Supplier Payment,Retail-NA,46566.92,0.0,USD,ACH Debit,PackFast Fulfillment #7,***7939,,PO-202404-Retail-NA-0007,False,False,REF-256204,First Continental Bank,***1706,Globex Retail NA LLC,US,8349640.73
2024-04-29,2024-04-29,Client Receipt - Vertex Advisory Client #4,Sales Receipt,PS-GL,0.0,3713.0,USD,ACH Credit,Vertex Advisory Client #4,***3462,INV-202404-PS-GL-0004,,False,False,REF-458590,First Continental Bank,***7340,Globex Retail NA LLC,US,8353353.73
2024-04-29,2024-04-29,Client Receipt - ShopSphere Partner #47,Sales Receipt,Retail-NA,0.0,5709.2,USD,ACH Credit,ShopSphere Partner #47,***3061,INV-202404-Retail-NA-0008,,False,False,REF-547028,First Continental Bank,***4896,Globex Retail NA LLC,US,8359062.93
2024-04-29,2024-04-29,Client Receipt - CloudBridge Co. #15,Sales Receipt,SaaS-GL,0.0,10319.16,USD,ACH Credit,CloudBridge Co. #15,***8972,INV-202404-SaaS-GL-0007,,False,False,REF-990996,First Continental Bank,***5921,Globex Retail NA LLC,US,8369382.09
2024-04-30,2024-04-30,Supplier Payment - HyperCloud Infra #10,Supplier Payment,SaaS-GL,3092.05,0.0,USD,Fedwire,HyperCloud Infra #10,***6351,,PO-202404-SaaS-GL-0002,False,False,REF-790862,First Continental Bank,***1057,Globex Retail NA LLC,US,8366290.04
2024-04-30,2024-04-30,Supplier Payment - NorthRiver Apparel Mfg #1,Supplier Payment,Retail-NA,22654.36,0.0,USD,ACH Debit,NorthRiver Apparel Mfg #1,***8801,,PO-202404-Retail-NA-0006,False,False,REF-715015,First Continental Bank,***8470,Globex Retail NA LLC,US,8343635.68
2024-04-30,2024-04-30,Client Receipt - CloudBridge Co. #30,Sales Receipt,SaaS-GL,0.0,1113.28,USD,ACH Credit,CloudBridge Co. #30,***8573,INV-202404-SaaS-GL-0012,,False,False,REF-529838,First Continental Bank,***5269,Globex Retail NA LLC,US,8344748.96
2024-04-30,2024-04-30,Client Receipt - CloudBridge Co. #4,Sales Receipt,SaaS-GL,0.0,5939.02,USD,ACH Credit,CloudBridge Co. #4,***4764,INV-202404-SaaS-GL-0009,,False,False,REF-880460,First Continental Bank,***3426,Globex Retail NA LLC,US,8350687.98
2024-04-30,2024-04-30,Interest Earned,Interest Income,ALL,0.0,12403.64,USD,ACH Credit,First Continental Bank,***3906,,,False,False,REF-625115,First Continental Bank,***8886,Globex Retail NA LLC,US,8363091.62
2024-04-30,2024-04-30,Client Receipt - Vertex Advisory Client #21,Sales Receipt,PS-GL,0.0,67828.85,USD,Card Settlement,Vertex Advisory Client #21,***1276,INV-202404-PS-GL-0007,,False,False,REF-296538,First Continental Bank,***2946,Globex Retail NA LLC,US,8430920.47
2024-05-01,2024-05-01,Account Maintenance Fee,Bank/Merchant Fees,ALL,2500.0,0.0,USD,ACH Debit,First Continental Bank,***6476,,,False,False,REF-431329,First Continental Bank,***7200,Globex Retail NA LLC,US,8428420.47
2024-05-01,2024-05-01,Client Receipt - CloudBridge Co. #27,Sales Receipt,SaaS-GL,0.0,331.54,USD,ACH Credit,CloudBridge Co. #27,***3514,INV-202405-SaaS-GL-0008,,False,False,REF-947274,First Continental Bank,***5263,Globex Retail NA LLC,US,8428752.01
2024-05-01,2024-05-01,Client Receipt - CloudBridge Co. #60,Sales Receipt,SaaS-GL,0.0,10725.27,USD,Card Settlement,CloudBridge Co. #60,***7946,INV-202405-SaaS-GL-0020,,False,False,REF-171434,First Continental Bank,***2846,Globex Retail NA LLC,US,8439477.28
2024-05-01,2024-05-01,Client Receipt - CloudBridge Co. #71,Sales Receipt,SaaS-GL,0.0,12862.67,USD,ACH Credit,CloudBridge Co. #71,***7188,INV-202405-SaaS-GL-0006,,False,False,REF-449587,First Continental Bank,***2584,Globex Retail NA LLC,US,8452339.95
2024-05-01,2024-05-01,Client Receipt - ShopSphere Partner #48,Sales Receipt,Retail-NA,0.0,67504.63,USD,ACH Credit,ShopSphere Partner #48,***6608,INV-202405-Retail-NA-0005,,False,False,REF-145972,First Continental Bank,***2571,Globex Retail NA LLC,US,8519844.58
2024-05-02,2024-05-02,Client Receipt - Vertex Advisory Client #33,Sales Receipt,PS-GL,0.0,1935.77,USD,ACH Credit,Vertex Advisory Client #33,***7781,INV-202405-PS-GL-0003,,False,False,REF-509984,First Continental Bank,***5120,Globex Retail NA LLC,US,8521780.35
2024-05-02,2024-05-02,Client Receipt - Vertex Advisory Client #58,Sales Receipt,PS-GL,0.0,4630.26,USD,ACH Credit,Vertex Advisory Client #58,***7758,INV-202405-PS-GL-0005,,False,False,REF-909333,First Continental Bank,***8900,Globex Retail NA LLC,US,8526410.61
2024-05-02,2024-05-02,Client Receipt - CloudBridge Co. #33,Sales Receipt,SaaS-GL,0.0,6340.27,USD,ACH Credit,CloudBridge Co. #33,***4834,INV-202405-SaaS-GL-0015,,False,False,REF-933263,First Continental Bank,***4376,Globex Retail NA LLC,US,8532750.88
2024-05-02,2024-05-02,Client Receipt - CloudBridge Co. #50,Sales Receipt,SaaS-GL,0.0,9415.82,USD,Card Settlement,CloudBridge Co. #50,***2560,INV-202405-SaaS-GL-0017,,False,False,REF-498199,First Continental Bank,***1046,Globex Retail NA LLC,US,8542166.7
2024-05-02,2024-05-02,Client Receipt - ShopSphere Partner #4,Sales Receipt,Retail-NA,0.0,24286.12,USD,Card Settlement,ShopSphere Partner #4,***3622,INV-202405-Retail-NA-0007,,False,False,REF-197356,First Continental Bank,***9486,Globex Retail NA LLC,US,8566452.82
2024-05-02,2024-05-02,Client Receipt - CloudBridge Co. #23,Sales Receipt,SaaS-GL,0.0,35685.94,USD,ACH Credit,CloudBridge Co. #23,***9250,INV-202405-SaaS-GL-0018,,False,False,REF-945026,First Continental Bank,***1658,Globex Retail NA LLC,US,8602138.76
2024-05-03,2024-05-03,Merchant Processing Fees,Bank/Merchant Fees,ALL,1630.31,0.0,USD,ACH Debit,First Continental Bank,***9786,,,False,False,REF-673519,First Continental Bank,***2865,Globex Retail NA LLC,US,8600508.45
2024-05-03,2024-05-03,Supplier Payment - ExpertNet Subcontractors #19,Supplier Payment,PS-GL,8422.92,0.0,USD,ACH Debit,ExpertNet Subcontractors #19,***6172,,PO-202405-PS-GL-0004,False,False,REF-891792,First Continental Bank,***4505,Globex Retail NA LLC,US,8592085.53
2024-05-03,2024-05-03,Client Receipt - CloudBridge Co. #8,Sales Receipt,SaaS-GL,0.0,8918.35,USD,ACH Credit,CloudBridge Co. #8,***1024,INV-202405-SaaS-GL-0012,,False,False,REF-915695,First Continental Bank,***2306,Globex Retail NA LLC,US,8601003.88
2024-05-03,2024-05-03,Client Receipt - Card Settlement Batch #19,Sales Receipt,Retail-NA,0.0,19827.88,USD,Card Settlement,Card Settlement Batch #19,***5864,INV-202405-Retail-NA-0001,,False,False,REF-774031,First Continental Bank,***7796,Globex Retail NA LLC,US,8620831.76
2024-05-03,2024-05-03,Client Receipt - ShopSphere Partner #14,Sales Receipt,Retail-NA,0.0,38072.98,USD,ACH Credit,ShopSphere Partner #14,***9902,INV-202405-Retail-NA-0006,,False,False,REF-370569,First Continental Bank,***7810,Globex Retail NA LLC,US,8658904.74
2024-05-03,2024-05-03,Client Receipt - Vertex Advisory Client #38,Sales Receipt,PS-GL,0.0,68357.8,USD,ACH Credit,Vertex Advisory Client #38,***8554,INV-202405-PS-GL-0007,,False,False,REF-492041,First Continental Bank,***9848,Globex Retail NA LLC,US,8727262.54
2024-05-05,2024-05-05,Client Receipt - CloudBridge Co. #5,Sales Receipt,SaaS-GL,0.0,22705.07,USD,ACH Credit,CloudBridge Co. #5,***9763,INV-202405-SaaS-GL-0005,,False,False,REF-680524,First Continental Bank,***8189,Globex Retail NA LLC,US,8749967.61
2024-05-06,2024-05-06,Supplier Payment - CodeCraft Contractors #13,Supplier Payment,SaaS-GL,2920.4,0.0,USD,Fedwire,CodeCraft Contractors #13,***1794,,PO-202405-SaaS-GL-0006,False,False,REF-271372,First Continental Bank,***5362,Globex Retail NA LLC,US,8747047.21
2024-05-06,2024-05-06,Supplier Payment - NorthRiver Apparel Mfg #24,Supplier Payment,Retail-NA,4897.86,0.0,USD,ACH Debit,NorthRiver Apparel Mfg #24,***2946,,PO-202405-Retail-NA-0004,False,False,REF-543395,First Continental Bank,***7445,Globex Retail NA LLC,US,8742149.35
2024-05-06,2024-05-06,Supplier Payment - ExpertNet Subcontractors #13,Supplier Payment,PS-GL,6096.45,0.0,USD,ACH Debit,ExpertNet Subcontractors #13,***7666,,PO-202405-PS-GL-0009,False,False,REF-540786,First Continental Bank,***2133,Globex Retail NA LLC,US,8736052.9
2024-05-06,2024-05-06,Supplier Payment - NorthRiver Apparel Mfg #18,Supplier Payment,Retail-NA,7841.94,0.0,USD,Fedwire,NorthRiver Apparel Mfg #18,***6065,,PO-202405-Retail-NA-0010,False,False,REF-439633,First Continental Bank,***1452,Globex Retail NA LLC,US,8728210.96
2024-05-06,2024-05-06,Client Receipt - CloudBridge Co. #62,Sales Receipt,SaaS-GL,0.0,19206.54,USD,ACH Credit,CloudBridge Co. #62,***5415,INV-202405-SaaS-GL-0009,,False,False,REF-420573,First Continental Bank,***9143,Globex Retail NA LLC,US,8747417.5
2024-05-06,2024-05-06,Client Receipt - CloudBridge Co. #75,Sales Receipt,SaaS-GL,0.0,35306.25,USD,Card Settlement,CloudBridge Co. #75,***5905,INV-202405-SaaS-GL-0007,,False,False,REF-235033,First Continental Bank,***3196,Globex Retail NA LLC,US,8782723.75
2024-05-06,2024-05-06,Client Receipt - CloudBridge Co. #21,Sales Receipt,SaaS-GL,0.0,47566.57,USD,ACH Credit,CloudBridge Co. #21,***6805,INV-202405-SaaS-GL-0011,,False,False,REF-543084,First Continental Bank,***9267,Globex Retail NA LLC,US,8830290.32
2024-05-07,2024-05-07,Supplier Payment - HyperCloud Infra #16,Supplier Payment,SaaS-GL,15814.92,0.0,USD,Fedwire,HyperCloud Infra #16,***3966,,PO-202405-SaaS-GL-0003,False,False,REF-720079,First Continental Bank,***9783,Globex Retail NA LLC,US,8814475.4
2024-05-07,2024-05-07,Supplier Payment - NorthRiver Apparel Mfg #16,Supplier Payment,Retail-NA,35529.46,0.0,USD,Fedwire,NorthRiver Apparel Mfg #16,***9356,,PO-202405-Retail-NA-0003,False,False,REF-404630,First Continental Bank,***4457,Globex Retail NA LLC,US,8778945.94
2024-05-08,2024-05-08,Supplier Payment - HyperCloud Infra #9,Supplier Payment,SaaS-GL,3938.02,0.0,USD,ACH Debit,HyperCloud Infra #9,***7255,,PO-202405-SaaS-GL-0008,False,False,REF-282459,First Continental Bank,***6412,Globex Retail NA LLC,US,8775007.92
2024-05-08,2024-05-08,Client Receipt - CloudBridge Co. #56,Sales Receipt,SaaS-GL,0.0,10651.42,USD,Card Settlement,CloudBridge Co. #56,***4826,INV-202405-SaaS-GL-0004,,False,False,REF-584586,First Continental Bank,***5415,Globex Retail NA LLC,US,8785659.34
2024-05-08,2024-05-08,Client Receipt - Vertex Advisory Client #40,Sales Receipt,PS-GL,0.0,19448.51,USD,Card Settlement,Vertex Advisory Client #40,***6908,INV-202405-PS-GL-0002,,False,False,REF-314420,First Continental Bank,***9475,Globex Retail NA LLC,US,8805107.85
2024-05-09,2024-05-09,Supplier Payment - ExpertNet Subcontractors #7,Supplier Payment,PS-GL,5397.62,0.0,USD,Fedwire,ExpertNet Subcontractors #7,***4030,,PO-202405-PS-GL-0003,False,False,REF-714536,First Continental Bank,***7059,Globex Retail NA LLC,US,8799710.23
2024-05-09,2024-05-09,Supplier Payment - HyperCloud Infra #6,Supplier Payment,SaaS-GL,8165.79,0.0,USD,ACH Debit,HyperCloud Infra #6,***8130,,PO-202405-SaaS-GL-0007,False,False,REF-507196,First Continental Bank,***1782,Globex Retail NA LLC,US,8791544.44
2024-05-09,2024-05-09,Client Receipt - CloudBridge Co. #57,Sales Receipt,SaaS-GL,0.0,9597.76,USD,ACH Credit,CloudBridge Co. #57,***7039,INV-202405-SaaS-GL-0026,,False,False,REF-279545,First Continental Bank,***4793,Globex Retail NA LLC,US,8801142.2
2024-05-10,2024-05-10,Metro Water & Waste,Rent & Utilities,ALL,2922.15,0.0,USD,Fedwire,Metro Water & Waste,***2589,,,False,False,REF-224127,First Continental Bank,***5481,Globex Retail NA LLC,US,8798220.05
2024-05-10,2024-05-10,Supplier Payment - ExpertNet Subcontractors #13,Supplier Payment,PS-GL,5172.51,0.0,USD,ACH Debit,ExpertNet Subcontractors #13,***6504,,PO-202405-PS-GL-0001,False,False,REF-195262,First Continental Bank,***4809,Globex Retail NA LLC,US,8793047.54
2024-05-10,2024-05-10,Client Receipt - CloudBridge Co. #72,Sales Receipt,SaaS-GL,0.0,2471.36,USD,ACH Credit,CloudBridge Co. #72,***8649,INV-202405-SaaS-GL-0013,,False,False,REF-987776,First Continental Bank,***1871,Globex Retail NA LLC,US,8795518.9
2024-05-10,2024-05-10,Client Receipt - ShopSphere Partner #69,Sales Receipt,Retail-NA,0.0,19978.48,USD,Card Settlement,ShopSphere Partner #69,***7000,INV-202405-Retail-NA-0011,,False,False,REF-386768,First Continental Bank,***9139,Globex Retail NA LLC,US,8815497.38
2024-05-11,2024-05-11,Supplier Payment - NorthRiver Apparel Mfg #4,Supplier Payment,Retail-NA,30821.41,0.0,USD,Fedwire,NorthRiver Apparel Mfg #4,***9384,,PO-202405-Retail-NA-0001,False,False,REF-217852,First Continental Bank,***9790,Globex Retail NA LLC,US,8784675.97
2024-05-12,2024-05-12,Intercompany Settlement - Globex EMEA Manufacturing Ltd.,Intercompany Transfer,ALL,282608.0,0.0,USD,Internal Transfer,Globex EMEA Manufacturing Ltd.,***2916,,,True,True,REF-979615,First Continental Bank,***4117,Globex Retail NA LLC,US,8502067.97
2024-05-14,2024-05-14,Supplier Payment - CodeCraft Contractors #14,Supplier Payment,SaaS-GL,3010.15,0.0,USD,Fedwire,CodeCraft Contractors #14,***1871,,PO-202405-SaaS-GL-0010,False,False,REF-917583,First Continental Bank,***7698,Globex Retail NA LLC,US,8499057.82
2024-05-14,2024-05-14,Supplier Payment - HyperCloud Infra #12,Supplier Payment,SaaS-GL,7622.96,0.0,USD,ACH Debit,HyperCloud Infra #12,***6539,,PO-202405-SaaS-GL-0009,False,False,REF-380366,First Continental Bank,***7871,Globex Retail NA LLC,US,8491434.86
2024-05-14,2024-05-14,Supplier Payment - ExpertNet Subcontractors #2,Supplier Payment,PS-GL,8022.93,0.0,USD,ACH Debit,ExpertNet Subcontractors #2,***5649,,PO-202405-PS-GL-0002,False,False,REF-296902,First Continental Bank,***5996,Globex Retail NA LLC,US,8483411.93
2024-05-14,2024-05-14,Supplier Payment - NorthRiver Apparel Mfg #16,Supplier Payment,Retail-NA,38478.26,0.0,USD,Fedwire,NorthRiver Apparel Mfg #16,***7275,,PO-202405-Retail-NA-0006,False,False,REF-432412,First Continental Bank,***1509,Globex Retail NA LLC,US,8444933.67
2024-05-14,2024-05-14,Client Receipt - CloudBridge Co. #43,Sales Receipt,SaaS-GL,0.0,33490.95,USD,ACH Credit,CloudBridge Co. #43,***2563,INV-202405-SaaS-GL-0027,,False,False,REF-131949,First Continental Bank,***3325,Globex Retail NA LLC,US,8478424.62
2024-05-15,2024-05-15,Supplier Payment - CodeCraft Contractors #4,Supplier Payment,SaaS-GL,3191.48,0.0,USD,ACH Debit,CodeCraft Contractors #4,***7956,,PO-202405-SaaS-GL-0005,False,False,REF-539191,First Continental Bank,***6144,Globex Retail NA LLC,US,8475233.14
2024-05-15,2024-05-15,Client Receipt - CloudBridge Co. #78,Sales Receipt,SaaS-GL,0.0,238.23,USD,ACH Credit,CloudBridge Co. #78,***2369,INV-202405-SaaS-GL-0019,,False,False,REF-699772,First Continental Bank,***8186,Globex Retail NA LLC,US,8475471.37
2024-05-15,2024-05-15,Client Receipt - CloudBridge Co. #40,Sales Receipt,SaaS-GL,0.0,13609.46,USD,ACH Credit,CloudBridge Co. #40,***4419,INV-202405-SaaS-GL-0024,,False,False,REF-477231,First Continental Bank,***2594,Globex Retail NA LLC,US,8489080.83
2024-05-15,2024-05-15,Client Receipt - Vertex Advisory Client #3,Sales Receipt,PS-GL,0.0,17170.16,USD,ACH Credit,Vertex Advisory Client #3,***6954,INV-202405-PS-GL-0008,,False,False,REF-421176,First Continental Bank,***8229,Globex Retail NA LLC,US,8506250.99
2024-05-16,2024-05-16,Supplier Payment - HyperCloud Infra #10,Supplier Payment,SaaS-GL,4097.86,0.0,USD,Fedwire,HyperCloud Infra #10,***4209,,PO-202405-SaaS-GL-0011,False,False,REF-392358,First Continental Bank,***9350,Globex Retail NA LLC,US,8502153.13
2024-05-16,2024-05-16,Supplier Payment - HyperCloud Infra #14,Supplier Payment,SaaS-GL,8289.15,0.0,USD,Fedwire,HyperCloud Infra #14,***3446,,PO-202405-SaaS-GL-0002,False,False,REF-791656,First Continental Bank,***2325,Globex Retail NA LLC,US,8493863.98
2024-05-16,2024-05-16,Client Receipt - ShopSphere Partner #27,Sales Receipt,Retail-NA,0.0,31425.29,USD,ACH Credit,ShopSphere Partner #27,***1742,INV-202405-Retail-NA-0016,,False,False,REF-152366,First Continental Bank,***1178,Globex Retail NA LLC,US,8525289.27
2024-05-16,2024-05-16,Client Receipt - Card Settlement Batch #6,Sales Receipt,Retail-NA,0.0,61803.69,USD,ACH Credit,Card Settlement Batch #6,***9860,INV-202405-Retail-NA-0009,,False,False,REF-145091,First Continental Bank,***1851,Globex Retail NA LLC,US,8587092.96
2024-05-17,2024-05-17,Supplier Payment - ExpertNet Subcontractors #6,Supplier Payment,PS-GL,5415.24,0.0,USD,ACH Debit,ExpertNet Subcontractors #6,***2082,,PO-202405-PS-GL-0005,False,False,REF-964318,First Continental Bank,***7918,Globex Retail NA LLC,US,8581677.72
2024-05-17,2024-05-17,Client Receipt - CloudBridge Co. #36,Sales Receipt,SaaS-GL,0.0,3829.43,USD,Card Settlement,CloudBridge Co. #36,***8099,INV-202405-SaaS-GL-0022,,False,False,REF-594512,First Continental Bank,***5185,Globex Retail NA LLC,US,8585507.15
2024-05-18,2024-05-18,Supplier Payment - PackFast Fulfillment #20,Supplier Payment,Retail-NA,54216.7,0.0,USD,ACH Debit,PackFast Fulfillment #20,***4227,,PO-202405-Retail-NA-0007,False,False,REF-880885,First Continental Bank,***4260,Globex Retail NA LLC,US,8531290.45
2024-05-18,2024-05-18,Client Receipt - CloudBridge Co. #5,Sales Receipt,SaaS-GL,0.0,4094.96,USD,Card Settlement,CloudBridge Co. #5,***9992,INV-202405-SaaS-GL-0010,,False,False,REF-231998,First Continental Bank,***3014,Globex Retail NA LLC,US,8535385.41
2024-05-19,2024-05-19,Supplier Payment - NorthRiver Apparel Mfg #11,Supplier Payment,Retail-NA,11937.85,0.0,USD,Fedwire,NorthRiver Apparel Mfg #11,***2603,,PO-202405-Retail-NA-0005,False,False,REF-889252,First Continental Bank,***7283,Globex Retail NA LLC,US,8523447.56
2024-05-19,2024-05-19,Client Receipt - ShopSphere Partner #26,Sales Receipt,Retail-NA,0.0,13029.08,USD,Card Settlement,ShopSphere Partner #26,***7463,INV-202405-Retail-NA-0008,,False,False,REF-166493,First Continental Bank,***7562,Globex Retail NA LLC,US,8536476.64
2024-05-20,2024-05-20,Client Receipt - ShopSphere Partner #53,Sales Receipt,Retail-NA,0.0,7745.49,USD,Card Settlement,ShopSphere Partner #53,***6626,INV-202405-Retail-NA-0002,,False,False,REF-530273,First Continental Bank,***5302,Globex Retail NA LLC,US,8544222.13
2024-05-20,2024-05-20,Client Receipt - Vertex Advisory Client #22,Sales Receipt,PS-GL,0.0,40199.08,USD,ACH Credit,Vertex Advisory Client #22,***8983,INV-202405-PS-GL-0004,,False,False,REF-190978,First Continental Bank,***1734,Globex Retail NA LLC,US,8584421.21
2024-05-21,2024-05-21,Merchant Processing Fees,Bank/Merchant Fees,ALL,1370.95,0.0,USD,ACH Debit,First Continental Bank,***5778,,,False,False,REF-969156,First Continental Bank,***3302,Globex Retail NA LLC,US,8583050.26
2024-05-21,2024-05-21,VAT/GST Remittance - US IRS,Tax Payment,ALL,60308.8,0.0,USD,ACH Debit,US IRS,***8176,,,False,False,REF-299322,First Continental Bank,***4749,Globex Retail NA LLC,US,8522741.46
2024-05-21,2024-05-21,Client Receipt - CloudBridge Co. #38,Sales Receipt,SaaS-GL,0.0,7480.94,USD,ACH Credit,CloudBridge Co. #38,***2723,INV-202405-SaaS-GL-0014,,False,False,REF-271985,First Continental Bank,***2261,Globex Retail NA LLC,US,8530222.4
2024-05-21,2024-05-21,Client Receipt - Vertex Advisory Client #8,Sales Receipt,PS-GL,0.0,7788.0,USD,Card Settlement,Vertex Advisory Client #8,***5190,INV-202405-PS-GL-0012,,False,False,REF-943622,First Continental Bank,***7403,Globex Retail NA LLC,US,8538010.4
2024-05-21,2024-05-21,Client Receipt - CloudBridge Co. #26,Sales Receipt,SaaS-GL,0.0,10483.57,USD,Card Settlement,CloudBridge Co. #26,***6668,INV-202405-SaaS-GL-0025,,False,False,REF-796741,First Continental Bank,***2725,Globex Retail NA LLC,US,8548493.97
2024-05-22,2024-05-22,Supplier Payment - CodeCraft Contractors #3,Supplier Payment,SaaS-GL,1284.63,0.0,USD,Fedwire,CodeCraft Contractors #3,***7675,,PO-202405-SaaS-GL-0001,False,False,REF-773537,First Continental Bank,***1896,Globex Retail NA LLC,US,8547209.34
2024-05-22,2024-05-22,Supplier Payment - PackFast Fulfillment #12,Supplier Payment,Retail-NA,27385.98,0.0,USD,ACH Debit,PackFast Fulfillment #12,***9122,,PO-202405-Retail-NA-0009,False,False,REF-525822,First Continental Bank,***5403,Globex Retail NA LLC,US,8519823.36
2024-05-22,2024-05-22,Client Receipt - CloudBridge Co. #46,Sales Receipt,SaaS-GL,0.0,2410.88,USD,Card Settlement,CloudBridge Co. #46,***6373,INV-202405-SaaS-GL-0021,,False,False,REF-693029,First Continental Bank,***8579,Globex Retail NA LLC,US,8522234.24
2024-05-22,2024-05-22,Client Receipt - ShopSphere Partner #13,Sales Receipt,Retail-NA,0.0,3242.14,USD,Card Settlement,ShopSphere Partner #13,***4127,INV-202405-Retail-NA-0010,,False,False,REF-259532,First Continental Bank,***6145,Globex Retail NA LLC,US,8525476.38
2024-05-23,2024-05-23,Supplier Payment - ExpertNet Subcontractors #1,Supplier Payment,PS-GL,4776.47,0.0,USD,ACH Debit,ExpertNet Subcontractors #1,***7414,,PO-202405-PS-GL-0007,False,False,REF-556468,First Continental Bank,***5743,Globex Retail NA LLC,US,8520699.91
2024-05-24,2024-05-24,Client Receipt - Vertex Advisory Client #51,Sales Receipt,PS-GL,0.0,4058.11,USD,Card Settlement,Vertex Advisory Client #51,***1459,INV-202405-PS-GL-0001,,False,False,REF-298078,First Continental Bank,***8033,Globex Retail NA LLC,US,8524758.02
2024-05-24,2024-05-24,Client Receipt - CloudBridge Co. #38,Sales Receipt,SaaS-GL,0.0,4209.91,USD,ACH Credit,CloudBridge Co. #38,***7806,INV-202405-SaaS-GL-0002,,False,False,REF-203763,First Continental Bank,***9199,Globex Retail NA LLC,US,8528967.93
2024-05-24,2024-05-24,Client Receipt - Card Settlement Batch #5,Sales Receipt,Retail-NA,0.0,32402.24,USD,ACH Credit,Card Settlement Batch #5,***1897,INV-202405-Retail-NA-0012,,False,False,REF-795555,First Continental Bank,***3473,Globex Retail NA LLC,US,8561370.17
2024-05-25,2024-05-25,Payroll - GlobalPay Services Ltd,Payroll,ALL,80894.74,0.0,USD,ACH Debit,GlobalPay Services Ltd,***1053,,,False,False,REF-603244,First Continental Bank,***4110,Globex Retail NA LLC,US,8480475.43
2024-05-26,2024-05-26,Intercompany Settlement - Globex Consulting UK Ltd.,Intercompany Transfer,ALL,548636.0,0.0,USD,Internal Transfer,Globex Consulting UK Ltd.,***7865,,,True,True,REF-834371,First Continental Bank,***4445,Globex Retail NA LLC,US,7931839.43
2024-05-27,2024-05-27,Supplier Payment - ExpertNet Subcontractors #12,Supplier Payment,PS-GL,17745.15,0.0,USD,Fedwire,ExpertNet Subcontractors #12,***2513,,PO-202405-PS-GL-0006,False,False,REF-584980,First Continental Bank,***2707,Globex Retail NA LLC,US,7914094.28
2024-05-27,2024-05-27,Client Receipt - Vertex Advisory Client #49,Sales Receipt,PS-GL,0.0,25953.04,USD,Card Settlement,Vertex Advisory Client #49,***9657,INV-202405-PS-GL-0010,,False,False,REF-760931,First Continental Bank,***6303,Globex Retail NA LLC,US,7940047.32
2024-05-28,2024-05-28,Supplier Payment - HyperCloud Infra #18,Supplier Payment,SaaS-GL,17042.81,0.0,USD,Fedwire,HyperCloud Infra #18,***4660,,PO-202405-SaaS-GL-0012,False,False,REF-201118,First Continental Bank,***1713,Globex Retail NA LLC,US,7923004.51
2024-05-28,2024-05-28,Client Receipt - CloudBridge Co. #5,Sales Receipt,SaaS-GL,0.0,6111.37,USD,ACH Credit,CloudBridge Co. #5,***7893,INV-202405-SaaS-GL-0003,,False,False,REF-656066,First Continental Bank,***4775,Globex Retail NA LLC,US,7929115.88
2024-05-28,2024-05-28,Client Receipt - ShopSphere Partner #40,Sales Receipt,Retail-NA,0.0,8125.42,USD,Card Settlement,ShopSphere Partner #40,***5054,INV-202405-Retail-NA-0013,,False,False,REF-762724,First Continental Bank,***8013,Globex Retail NA LLC,US,7937241.3
2024-05-28,2024-05-28,Client Receipt - CloudBridge Co. #20,Sales Receipt,SaaS-GL,0.0,17438.34,USD,ACH Credit,CloudBridge Co. #20,***2728,INV-202405-SaaS-GL-0023,,False,False,REF-530900,First Continental Bank,***4107,Globex Retail NA LLC,US,7954679.64
2024-05-28,2024-05-28,Client Receipt - Card Settlement Batch #20,Sales Receipt,Retail-NA,0.0,28536.46,USD,ACH Credit,Card Settlement Batch #20,***1485,INV-202405-Retail-NA-0015,,False,False,REF-465047,First Continental Bank,***6573,Globex Retail NA LLC,US,7983216.1
2024-05-28,2024-05-28,Client Receipt - ShopSphere Partner #57,Sales Receipt,Retail-NA,0.0,46751.21,USD,ACH Credit,ShopSphere Partner #57,***3111,INV-202405-Retail-NA-0003,,False,False,REF-512921,First Continental Bank,***3757,Globex Retail NA LLC,US,8029967.31
2024-05-29,2024-05-29,Supplier Payment - HyperCloud Infra #16,Supplier Payment,SaaS-GL,2633.09,0.0,USD,ACH Debit,HyperCloud Infra #16,***8394,,PO-202405-SaaS-GL-0004,False,False,REF-629467,First Continental Bank,***8048,Globex Retail NA LLC,US,8027334.22
2024-05-29,2024-05-29,Supplier Payment - NorthRiver Apparel Mfg #2,Supplier Payment,Retail-NA,3414.86,0.0,USD,ACH Debit,NorthRiver Apparel Mfg #2,***2697,,PO-202405-Retail-NA-0002,False,False,REF-660516,First Continental Bank,***9365,Globex Retail NA LLC,US,8023919.36
2024-05-29,2024-05-29,Metro Water & Waste,Rent & Utilities,ALL,5268.64,0.0,USD,Fedwire,Metro Water & Waste,***3749,,,False,False,REF-535596,First Continental Bank,***6448,Globex Retail NA LLC,US,8018650.72
2024-05-29,2024-05-29,Supplier Payment - ExpertNet Subcontractors #13,Supplier Payment,PS-GL,9870.03,0.0,USD,Fedwire,ExpertNet Subcontractors #13,***7145,,PO-202405-PS-GL-0008,False,False,REF-265339,First Continental Bank,***4358,Globex Retail NA LLC,US,8008780.69
2024-05-29,2024-05-29,Supplier Payment - PackFast Fulfillment #9,Supplier Payment,Retail-NA,11605.51,0.0,USD,Fedwire,PackFast Fulfillment #9,***6254,,PO-202405-Retail-NA-0011,False,False,REF-717250,First Continental Bank,***5236,Globex Retail NA LLC,US,7997175.18
2024-05-29,2024-05-29,Marketing - Aurelia Media #8,Marketing,ALL,15704.8,0.0,USD,ACH Debit,Aurelia Media #8,***2915,,,False,False,REF-443561,First Continental Bank,***1682,Globex Retail NA LLC,US,7981470.38
2024-05-29,2024-05-29,Client Receipt - Vertex Advisory Client #10,Sales Receipt,PS-GL,0.0,8196.47,USD,ACH Credit,Vertex Advisory Client #10,***6859,INV-202405-PS-GL-0009,,False,False,REF-529972,First Continental Bank,***9013,Globex Retail NA LLC,US,7989666.85
2024-05-30,2024-05-30,Supplier Payment - PackFast Fulfillment #21,Supplier Payment,Retail-NA,12237.9,0.0,USD,ACH Debit,PackFast Fulfillment #21,***1615,,PO-202405-Retail-NA-0008,False,False,REF-177403,First Continental Bank,***1257,Globex Retail NA LLC,US,7977428.95
2024-05-30,2024-05-30,Payroll - GlobalPay Services Ltd,Payroll,ALL,80894.74,0.0,USD,Fedwire,GlobalPay Services Ltd,***8480,,,False,False,REF-819316,First Continental Bank,***8340,Globex Retail NA LLC,US,7896534.21
2024-05-30,2024-05-30,Client Receipt - CloudBridge Co. #49,Sales Receipt,SaaS-GL,0.0,7092.52,USD,ACH Credit,CloudBridge Co. #49,***4813,INV-202405-SaaS-GL-0016,,False,False,REF-272833,First Continental Bank,***5088,Globex Retail NA LLC,US,7903626.73
2024-05-30,2024-05-30,Interest Earned,Interest Income,ALL,0.0,10956.06,USD,Card Settlement,First Continental Bank,***7512,,,False,False,REF-377131,First Continental Bank,***1544,Globex Retail NA LLC,US,7914582.79
2024-05-30,2024-05-30,Client Receipt - ShopSphere Partner #71,Sales Receipt,Retail-NA,0.0,26804.82,USD,Card Settlement,ShopSphere Partner #71,***5544,INV-202405-Retail-NA-0004,,False,False,REF-903569,First Continental Bank,***2401,Globex Retail NA LLC,US,7941387.61
2024-05-31,2024-05-31,Marketing - Aurelia Media #2,Marketing,ALL,9709.4,0.0,USD,ACH Debit,Aurelia Media #2,***3000,,,False,False,REF-247342,First Continental Bank,***9278,Globex Retail NA LLC,US,7931678.21
2024-05-31,2024-05-31,Client Receipt - ShopSphere Partner #26,Sales Receipt,Retail-NA,0.0,3859.94,USD,ACH Credit,ShopSphere Partner #26,***1789,INV-202405-Retail-NA-0014,,False,False,REF-217845,First Continental Bank,***6457,Globex Retail NA LLC,US,7935538.15
2024-05-31,2024-05-31,Client Receipt - CloudBridge Co. #32,Sales Receipt,SaaS-GL,0.0,12321.23,USD,ACH Credit,CloudBridge Co. #32,***6594,INV-202405-SaaS-GL-0001,,False,False,REF-804481,First Continental Bank,***4906,Globex Retail NA LLC,US,7947859.38
2024-05-31,2024-05-31,Client Receipt - Vertex Advisory Client #52,Sales Receipt,PS-GL,0.0,18104.24,USD,Card Settlement,Vertex Advisory Client #52,***8894,INV-202405-PS-GL-0006,,False,False,REF-454092,First Continental Bank,***8116,Globex Retail NA LLC,US,7965963.62
2024-05-31,2024-05-31,Client Receipt - Vertex Advisory Client #41,Sales Receipt,PS-GL,0.0,20556.31,USD,ACH Credit,Vertex Advisory Client #41,***2274,INV-202405-PS-GL-0011,,False,False,REF-822775,First Continental Bank,***4814,Globex Retail NA LLC,US,7986519.93
2024-06-01,2024-06-01,Account Maintenance Fee,Bank/Merchant Fees,ALL,2500.0,0.0,USD,Fedwire,First Continental Bank,***5260,,,False,False,REF-972778,First Continental Bank,***5855,Globex Retail NA LLC,US,7984019.93
2024-06-01,2024-06-01,Marketing - Aurelia Media #5,Marketing,ALL,3564.93,0.0,USD,ACH Debit,Aurelia Media #5,***1492,,,False,False,REF-230582,First Continental Bank,***8920,Globex Retail NA LLC,US,7980455.0
2024-06-03,2024-06-03,Supplier Payment - CodeCraft Contractors #8,Supplier Payment,SaaS-GL,10219.99,0.0,USD,Fedwire,CodeCraft Contractors #8,***4864,,PO-202406-SaaS-GL-0001,False,False,REF-310739,First Continental Bank,***3231,Globex Retail NA LLC,US,7970235.01
2024-06-03,2024-06-03,Client Receipt - CloudBridge Co. #60,Sales Receipt,SaaS-GL,0.0,8189.21,USD,Card Settlement,CloudBridge Co. #60,***9082,INV-202406-SaaS-GL-0030,,False,False,REF-252285,First Continental Bank,***7636,Globex Retail NA LLC,US,7978424.22
2024-06-03,2024-06-03,Client Receipt - CloudBridge Co. #71,Sales Receipt,SaaS-GL,0.0,15080.18,USD,ACH Credit,CloudBridge Co. #71,***4584,INV-202406-SaaS-GL-0013,,False,False,REF-155063,First Continental Bank,***6474,Globex Retail NA LLC,US,7993504.4
2024-06-03,2024-06-03,Client Receipt - ShopSphere Partner #24,Sales Receipt,Retail-NA,0.0,30889.05,USD,Card Settlement,ShopSphere Partner #24,***4268,INV-202406-Retail-NA-0005,,False,False,REF-809330,First Continental Bank,***7638,Globex Retail NA LLC,US,8024393.45
2024-06-04,2024-06-04,Client Receipt - Vertex Advisory Client #22,Sales Receipt,PS-GL,0.0,10305.7,USD,ACH Credit,Vertex Advisory Client #22,***7078,INV-202406-PS-GL-0005,,False,False,REF-581461,First Continental Bank,***7139,Globex Retail NA LLC,US,8034699.15
2024-06-05,2024-06-05,Supplier Payment - ExpertNet Subcontractors #2,Supplier Payment,PS-GL,7369.29,0.0,USD,Fedwire,ExpertNet Subcontractors #2,***2713,,PO-202406-PS-GL-0002,False,False,REF-359657,First Continental Bank,***1646,Globex Retail NA LLC,US,8027329.86
2024-06-05,2024-06-05,Supplier Payment - NorthRiver Apparel Mfg #6,Supplier Payment,Retail-NA,18460.42,0.0,USD,ACH Debit,NorthRiver Apparel Mfg #6,***1439,,PO-202406-Retail-NA-0009,False,False,REF-320549,First Continental Bank,***6378,Globex Retail NA LLC,US,8008869.44
2024-06-05,2024-06-05,Client Receipt - Vertex Advisory Client #50,Sales Receipt,PS-GL,0.0,4242.39,USD,ACH Credit,Vertex Advisory Client #50,***6718,INV-202406-PS-GL-0003,,False,False,REF-819639,First Continental Bank,***9813,Globex Retail NA LLC,US,8013111.83
2024-06-05,2024-06-05,Client Receipt - CloudBridge Co. #45,Sales Receipt,SaaS-GL,0.0,5849.7,USD,ACH Credit,CloudBridge Co. #45,***2228,INV-202406-SaaS-GL-0012,,False,False,REF-602356,First Continental Bank,***1578,Globex Retail NA LLC,US,8018961.53
2024-06-05,2024-06-05,Client Receipt - ShopSphere Partner #46,Sales Receipt,Retail-NA,0.0,14369.46,USD,Card Settlement,ShopSphere Partner #46,***3745,INV-202406-Retail-NA-0009,,False,False,REF-974086,First Continental Bank,***6366,Globex Retail NA LLC,US,8033330.99
2024-06-06,2024-06-06,Supplier Payment - HyperCloud Infra #15,Supplier Payment,SaaS-GL,4898.89,0.0,USD,ACH Debit,HyperCloud Infra #15,***1314,,PO-202406-SaaS-GL-0002,False,False,REF-425123,First Continental Bank,***5416,Globex Retail NA LLC,US,8028432.1
2024-06-06,2024-06-06,Client Receipt - Card Settlement Batch #1,Sales Receipt,Retail-NA,0.0,24332.12,USD,ACH Credit,Card Settlement Batch #1,***1227,INV-202406-Retail-NA-0003,,False,False,REF-993293,First Continental Bank,***2390,Globex Retail NA LLC,US,8052764.22
2024-06-06,2024-06-06,Client Receipt - CloudBridge Co. #41,Sales Receipt,SaaS-GL,0.0,24814.05,USD,ACH Credit,CloudBridge Co. #41,***6225,INV-202406-SaaS-GL-0015,,False,False,REF-673488,First Continental Bank,***1828,Globex Retail NA LLC,US,8077578.27
2024-06-07,2024-06-07,Supplier Payment - HyperCloud Infra #11,Supplier Payment,SaaS-GL,13674.4,0.0,USD,ACH Debit,HyperCloud Infra #11,***2049,,PO-202406-SaaS-GL-0007,False,False,REF-467868,First Continental Bank,***6641,Globex Retail NA LLC,US,8063903.87
2024-06-07,2024-06-07,Supplier Payment - PackFast Fulfillment #15,Supplier Payment,Retail-NA,28099.98,0.0,USD,ACH Debit,PackFast Fulfillment #15,***6915,,PO-202406-Retail-NA-0010,False,False,REF-351602,First Continental Bank,***9858,Globex Retail NA LLC,US,8035803.89
2024-06-07,2024-06-07,Client Receipt - Vertex Advisory Client #48,Sales Receipt,PS-GL,0.0,2047.25,USD,Card Settlement,Vertex Advisory Client #48,***5985,INV-202406-PS-GL-0012,,False,False,REF-210922,First Continental Bank,***4616,Globex Retail NA LLC,US,8037851.14
2024-06-07,2024-06-07,Client Receipt - CloudBridge Co. #65,Sales Receipt,SaaS-GL,0.0,7352.66,USD,ACH Credit,CloudBridge Co. #65,***6638,INV-202406-SaaS-GL-0020,,False,False,REF-843314,First Continental Bank,***4728,Globex Retail NA LLC,US,8045203.8
2024-06-08,2024-06-08,Client Receipt - Vertex Advisory Client #52,Sales Receipt,PS-GL,0.0,41947.19,USD,ACH Credit,Vertex Advisory Client #52,***4340,INV-202406-PS-GL-0002,,False,False,REF-183264,First Continental Bank,***6366,Globex Retail NA LLC,US,8087150.99
2024-06-09,2024-06-09,Client Receipt - ShopSphere Partner #70,Sales Receipt,Retail-NA,0.0,9864.36,USD,ACH Credit,ShopSphere Partner #70,***3940,INV-202406-Retail-NA-0006,,False,False,REF-569023,First Continental Bank,***8915,Globex Retail NA LLC,US,8097015.35
2024-06-10,2024-06-10,Client Receipt - ShopSphere Partner #45,Sales Receipt,Retail-NA,0.0,48448.98,USD,ACH Credit,ShopSphere Partner #45,***7175,INV-202406-Retail-NA-0007,,False,False,REF-156587,First Continental Bank,***2191,Globex Retail NA LLC,US,8145464.33
2024-06-11,2024-06-11,Supplier Payment - ExpertNet Subcontractors #17,Supplier Payment,PS-GL,11634.27,0.0,USD,Fedwire,ExpertNet Subcontractors #17,***8207,,PO-202406-PS-GL-0008,False,False,REF-387741,First Continental Bank,***9333,Globex Retail NA LLC,US,8133830.06
2024-06-11,2024-06-11,Supplier Payment - NorthRiver Apparel Mfg #17,Supplier Payment,Retail-NA,41752.77,0.0,USD,Fedwire,NorthRiver Apparel Mfg #17,***5752,,PO-202406-Retail-NA-0006,False,False,REF-551492,First Continental Bank,***5761,Globex Retail NA LLC,US,8092077.29
2024-06-11,2024-06-11,Supplier Payment - NorthRiver Apparel Mfg #16,Supplier Payment,Retail-NA,47748.93,0.0,USD,Fedwire,NorthRiver Apparel Mfg #16,***5611,,PO-202406-Retail-NA-0008,False,False,REF-363809,First Continental Bank,***8943,Globex Retail NA LLC,US,8044328.36
2024-06-11,2024-06-11,Client Receipt - CloudBridge Co. #38,Sales Receipt,SaaS-GL,0.0,4278.04,USD,Card Settlement,CloudBridge Co. #38,***7808,INV-202406-SaaS-GL-0001,,False,False,REF-163407,First Continental Bank,***7680,Globex Retail NA LLC,US,8048606.4
2024-06-11,2024-06-11,Client Receipt - CloudBridge Co. #33,Sales Receipt,SaaS-GL,0.0,5330.09,USD,Card Settlement,CloudBridge Co. #33,***2260,INV-202406-SaaS-GL-0009,,False,False,REF-371720,First Continental Bank,***5832,Globex Retail NA LLC,US,8053936.49
2024-06-11,2024-06-11,Client Receipt - Vertex Advisory Client #29,Sales Receipt,PS-GL,0.0,21478.94,USD,Card Settlement,Vertex Advisory Client #29,***8268,INV-202406-PS-GL-0006,,False,False,REF-646459,First Continental Bank,***6491,Globex Retail NA LLC,US,8075415.43
2024-06-12,2024-06-12,Supplier Payment - PackFast Fulfillment #16,Supplier Payment,Retail-NA,23526.96,0.0,USD,Fedwire,PackFast Fulfillment #16,***8785,,PO-202406-Retail-NA-0002,False,False,REF-364913,First Continental Bank,***9598,Globex Retail NA LLC,US,8051888.47
2024-06-12,2024-06-12,Intercompany Settlement - Globex EMEA Manufacturing Ltd.,Intercompany Transfer,ALL,519442.0,0.0,USD,Internal Transfer,Globex EMEA Manufacturing Ltd.,***7057,,,True,True,REF-153291,First Continental Bank,***7013,Globex Retail NA LLC,US,7532446.47
2024-06-12,2024-06-12,Client Receipt - CloudBridge Co. #44,Sales Receipt,SaaS-GL,0.0,970.58,USD,Card Settlement,CloudBridge Co. #44,***9145,INV-202406-SaaS-GL-0016,,False,False,REF-655258,First Continental Bank,***6702,Globex Retail NA LLC,US,7533417.05
2024-06-12,2024-06-12,Client Receipt - CloudBridge Co. #1,Sales Receipt,SaaS-GL,0.0,2321.35,USD,ACH Credit,CloudBridge Co. #1,***7973,INV-202406-SaaS-GL-0005,,False,False,REF-193490,First Continental Bank,***2142,Globex Retail NA LLC,US,7535738.4
2024-06-12,2024-06-12,Client Receipt - ShopSphere Partner #57,Sales Receipt,Retail-NA,0.0,47558.04,USD,Card Settlement,ShopSphere Partner #57,***4691,INV-202406-Retail-NA-0004,,False,False,REF-859423,First Continental Bank,***2476,Globex Retail NA LLC,US,7583296.44
2024-06-12,2024-06-12,Client Receipt - ShopSphere Partner #14,Sales Receipt,Retail-NA,0.0,88809.4,USD,Card Settlement,ShopSphere Partner #14,***4809,INV-202406-Retail-NA-0001,,False,False,REF-237363,First Continental Bank,***4701,Globex Retail NA LLC,US,7672105.84
2024-06-13,2024-06-13,Merchant Processing Fees,Bank/Merchant Fees,ALL,2607.1,0.0,USD,ACH Debit,First Continental Bank,***7338,,,False,False,REF-205149,First Continental Bank,***9496,Globex Retail NA LLC,US,7669498.74
2024-06-13,2024-06-13,Supplier Payment - CodeCraft Contractors #2,Supplier Payment,SaaS-GL,11572.66,0.0,USD,Fedwire,CodeCraft Contractors #2,***2071,,PO-202406-SaaS-GL-0003,False,False,REF-226349,First Continental Bank,***6751,Globex Retail NA LLC,US,7657926.08
2024-06-13,2024-06-13,Supplier Payment - PackFast Fulfillment #20,Supplier Payment,Retail-NA,22008.68,0.0,USD,Fedwire,PackFast Fulfillment #20,***9048,,PO-202406-Retail-NA-0001,False,False,REF-222412,First Continental Bank,***9558,Globex Retail NA LLC,US,7635917.4
2024-06-13,2024-06-13,Client Receipt - CloudBridge Co. #76,Sales Receipt,SaaS-GL,0.0,581.21,USD,ACH Credit,CloudBridge Co. #76,***7679,INV-202406-SaaS-GL-0028,,False,False,REF-954505,First Continental Bank,***9941,Globex Retail NA LLC,US,7636498.61
2024-06-13,2024-06-13,Client Receipt - CloudBridge Co. #34,Sales Receipt,SaaS-GL,0.0,13520.18,USD,Card Settlement,CloudBridge Co. #34,***6059,INV-202406-SaaS-GL-0010,,False,False,REF-391810,First Continental Bank,***5085,Globex Retail NA LLC,US,7650018.79
2024-06-13,2024-06-13,Client Receipt - Vertex Advisory Client #52,Sales Receipt,PS-GL,0.0,18828.58,USD,ACH Credit,Vertex Advisory Client #52,***4333,INV-202406-PS-GL-0011,,False,False,REF-287604,First Continental Bank,***1492,Globex Retail NA LLC,US,7668847.37
2024-06-13,2024-06-13,Client Receipt - CloudBridge Co. #74,Sales Receipt,SaaS-GL,0.0,25996.37,USD,Card Settlement,CloudBridge Co. #74,***4087,INV-202406-SaaS-GL-0021,,False,False,REF-516632,First Continental Bank,***4630,Globex Retail NA LLC,US,7694843.74
2024-06-14,2024-06-14,Alphagrid Utilities,Rent & Utilities,ALL,8144.69,0.0,USD,ACH Debit,Alphagrid Utilities,***3289,,,False,False,REF-346500,First Continental Bank,***2316,Globex Retail NA LLC,US,7686699.05
2024-06-14,2024-06-14,Marketing - Beacon Digital #7,Marketing,ALL,12165.5,0.0,USD,Fedwire,Beacon Digital #7,***4790,,,False,False,REF-738885,First Continental Bank,***4867,Globex Retail NA LLC,US,7674533.55
2024-06-14,2024-06-14,Client Receipt - CloudBridge Co. #28,Sales Receipt,SaaS-GL,0.0,632.4,USD,Card Settlement,CloudBridge Co. #28,***2310,INV-202406-SaaS-GL-0011,,False,False,REF-624326,First Continental Bank,***3392,Globex Retail NA LLC,US,7675165.95
2024-06-14,2024-06-14,Client Receipt - Vertex Advisory Client #48,Sales Receipt,PS-GL,0.0,8391.92,USD,Card Settlement,Vertex Advisory Client #48,***8385,INV-202406-PS-GL-0010,,False,False,REF-998736,First Continental Bank,***4600,Globex Retail NA LLC,US,7683557.87
2024-06-14,2024-06-14,Client Receipt - CloudBridge Co. #58,Sales Receipt,SaaS-GL,0.0,10358.07,USD,ACH Credit,CloudBridge Co. #58,***3635,INV-202406-SaaS-GL-0031,,False,False,REF-811899,First Continental Bank,***5252,Globex Retail NA LLC,US,7693915.94
2024-06-14,2024-06-14,Client Receipt - CloudBridge Co. #37,Sales Receipt,SaaS-GL,0.0,20238.45,USD,Card Settlement,CloudBridge Co. #37,***2591,INV-202406-SaaS-GL-0004,,False,False,REF-969925,First Continental Bank,***6152,Globex Retail NA LLC,US,7714154.39
2024-06-14,2024-06-14,Client Receipt - Vertex Advisory Client #16,Sales Receipt,PS-GL,0.0,25539.87,USD,Card Settlement,Vertex Advisory Client #16,***1384,INV-202406-PS-GL-0001,,False,False,REF-351366,First Continental Bank,***3271,Globex Retail NA LLC,US,7739694.26
2024-06-17,2024-06-17,Supplier Payment - ExpertNet Subcontractors #1,Supplier Payment,PS-GL,197.63,0.0,USD,Fedwire,ExpertNet Subcontractors #1,***2516,,PO-202406-PS-GL-0007,False,False,REF-432262,First Continental Bank,***9648,Globex Retail NA LLC,US,7739496.63
2024-06-17,2024-06-17,Client Receipt - Vertex Advisory Client #48,Sales Receipt,PS-GL,0.0,48192.66,USD,ACH Credit,Vertex Advisory Client #48,***3972,INV-202406-PS-GL-0008,,False,False,REF-120285,First Continental Bank,***9869,Globex Retail NA LLC,US,7787689.29
2024-06-18,2024-06-18,Client Receipt - CloudBridge Co. #26,Sales Receipt,SaaS-GL,0.0,21639.35,USD,Card Settlement,CloudBridge Co. #26,***9788,INV-202406-SaaS-GL-0032,,False,False,REF-798446,First Continental Bank,***7097,Globex Retail NA LLC,US,7809328.64
2024-06-19,2024-06-19,Supplier Payment - ExpertNet Subcontractors #5,Supplier Payment,PS-GL,1186.64,0.0,USD,Fedwire,ExpertNet Subcontractors #5,***7660,,PO-202406-PS-GL-0009,False,False,REF-585845,First Continental Bank,***9069,Globex Retail NA LLC,US,7808142.0
2024-06-19,2024-06-19,Supplier Payment - PackFast Fulfillment #4,Supplier Payment,Retail-NA,2462.03,0.0,USD,ACH Debit,PackFast Fulfillment #4,***4765,,PO-202406-Retail-NA-0007,False,False,REF-969022,First Continental Bank,***8914,Globex Retail NA LLC,US,7805679.97
2024-06-19,2024-06-19,Client Receipt - CloudBridge Co. #5,Sales Receipt,SaaS-GL,0.0,1829.72,USD,ACH Credit,CloudBridge Co. #5,***9185,INV-202406-SaaS-GL-0026,,False,False,REF-426737,First Continental Bank,***4058,Globex Retail NA LLC,US,7807509.69
2024-06-19,2024-06-19,Client Receipt - CloudBridge Co. #27,Sales Receipt,SaaS-GL,0.0,4136.87,USD,Card Settlement,CloudBridge Co. #27,***1602,INV-202406-SaaS-GL-0007,,False,False,REF-166064,First Continental Bank,***5085,Globex Retail NA LLC,US,7811646.56
2024-06-19,2024-06-19,Client Receipt - ShopSphere Partner #48,Sales Receipt,Retail-NA,0.0,8390.46,USD,ACH Credit,ShopSphere Partner #48,***4197,INV-202406-Retail-NA-0010,,False,False,REF-767569,First Continental Bank,***2672,Globex Retail NA LLC,US,7820037.02
2024-06-19,2024-06-19,Client Receipt - CloudBridge Co. #74,Sales Receipt,SaaS-GL,0.0,19021.0,USD,ACH Credit,CloudBridge Co. #74,***6449,INV-202406-SaaS-GL-0014,,False,False,REF-513368,First Continental Bank,***6031,Globex Retail NA LLC,US,7839058.02
2024-06-19,2024-06-19,Client Receipt - CloudBridge Co. #27,Sales Receipt,SaaS-GL,0.0,35731.5,USD,Card Settlement,CloudBridge Co. #27,***6852,INV-202406-SaaS-GL-0024,,False,False,REF-848604,First Continental Bank,***7365,Globex Retail NA LLC,US,7874789.52
2024-06-19,2024-06-19,Client Receipt - ShopSphere Partner #77,Sales Receipt,Retail-NA,0.0,74816.73,USD,ACH Credit,ShopSphere Partner #77,***8625,INV-202406-Retail-NA-0012,,False,False,REF-242325,First Continental Bank,***5798,Globex Retail NA LLC,US,7949606.25
2024-06-20,2024-06-20,Supplier Payment - ExpertNet Subcontractors #3,Supplier Payment,PS-GL,4621.36,0.0,USD,ACH Debit,ExpertNet Subcontractors #3,***3695,,PO-202406-PS-GL-0005,False,False,REF-218639,First Continental Bank,***8544,Globex Retail NA LLC,US,7944984.89
2024-06-20,2024-06-20,Supplier Payment - HyperCloud Infra #17,Supplier Payment,SaaS-GL,6577.05,0.0,USD,Fedwire,HyperCloud Infra #17,***4179,,PO-202406-SaaS-GL-0005,False,False,REF-134506,First Continental Bank,***6084,Globex Retail NA LLC,US,7938407.84
2024-06-20,2024-06-20,Supplier Payment - CodeCraft Contractors #7,Supplier Payment,SaaS-GL,9845.63,0.0,USD,ACH Debit,CodeCraft Contractors #7,***4983,,PO-202406-SaaS-GL-0004,False,False,REF-809183,First Continental Bank,***1308,Globex Retail NA LLC,US,7928562.21
2024-06-20,2024-06-20,VAT/GST Remittance - US IRS,Tax Payment,ALL,62303.82,0.0,USD,Fedwire,US IRS,***7879,,,False,False,REF-322388,First Continental Bank,***2835,Globex Retail NA LLC,US,7866258.39
2024-06-20,2024-06-20,Client Receipt - CloudBridge Co. #47,Sales Receipt,SaaS-GL,0.0,140.29,USD,ACH Credit,CloudBridge Co. #47,***2960,INV-202406-SaaS-GL-0023,,False,False,REF-155783,First Continental Bank,***1479,Globex Retail NA LLC,US,7866398.68
2024-06-20,2024-06-20,Client Receipt - CloudBridge Co. #76,Sales Receipt,SaaS-GL,0.0,5480.22,USD,ACH Credit,CloudBridge Co. #76,***4413,INV-202406-SaaS-GL-0029,,False,False,REF-875853,First Continental Bank,***2636,Globex Retail NA LLC,US,7871878.9
2024-06-20,2024-06-20,Client Receipt - CloudBridge Co. #52,Sales Receipt,SaaS-GL,0.0,27714.78,USD,ACH Credit,CloudBridge Co. #52,***8272,INV-202406-SaaS-GL-0025,,False,False,REF-518530,First Continental Bank,***6226,Globex Retail NA LLC,US,7899593.68
2024-06-21,2024-06-21,Supplier Payment - PackFast Fulfillment #8,Supplier Payment,Retail-NA,28727.27,0.0,USD,ACH Debit,PackFast Fulfillment #8,***3606,,PO-202406-Retail-NA-0004,False,False,REF-882715,First Continental Bank,***7103,Globex Retail NA LLC,US,7870866.41
2024-06-21,2024-06-21,Client Receipt - CloudBridge Co. #33,Sales Receipt,SaaS-GL,0.0,1033.04,USD,ACH Credit,CloudBridge Co. #33,***2669,INV-202406-SaaS-GL-0006,,False,False,REF-283671,First Continental Bank,***4933,Globex Retail NA LLC,US,7871899.45
2024-06-21,2024-06-21,Client Receipt - CloudBridge Co. #54,Sales Receipt,SaaS-GL,0.0,6858.63,USD,Card Settlement,CloudBridge Co. #54,***6741,INV-202406-SaaS-GL-0003,,False,False,REF-915168,First Continental Bank,***3515,Globex Retail NA LLC,US,7878758.08
2024-06-21,2024-06-21,Client Receipt - Card Settlement Batch #2,Sales Receipt,Retail-NA,0.0,12043.14,USD,Card Settlement,Card Settlement Batch #2,***8070,INV-202406-Retail-NA-0008,,False,False,REF-487150,First Continental Bank,***1469,Globex Retail NA LLC,US,7890801.22
2024-06-22,2024-06-22,Supplier Payment - NorthRiver Apparel Mfg #14,Supplier Payment,Retail-NA,13157.79,0.0,USD,ACH Debit,NorthRiver Apparel Mfg #14,***5765,,PO-202406-Retail-NA-0003,False,False,REF-312001,First Continental Bank,***1849,Globex Retail NA LLC,US,7877643.43
2024-06-23,2024-06-23,Supplier Payment - ExpertNet Subcontractors #2,Supplier Payment,PS-GL,14823.54,0.0,USD,Fedwire,ExpertNet Subcontractors #2,***3326,,PO-202406-PS-GL-0001,False,False,REF-629840,First Continental Bank,***6778,Globex Retail NA LLC,US,7862819.89
2024-06-24,2024-06-24,Supplier Payment - ExpertNet Subcontractors #18,Supplier Payment,PS-GL,4336.23,0.0,USD,ACH Debit,ExpertNet Subcontractors #18,***2957,,PO-202406-PS-GL-0004,False,False,REF-133594,First Continental Bank,***2988,Globex Retail NA LLC,US,7858483.66
2024-06-24,2024-06-24,Supplier Payment - ExpertNet Subcontractors #15,Supplier Payment,PS-GL,23642.77,0.0,USD,Fedwire,ExpertNet Subcontractors #15,***2237,,PO-202406-PS-GL-0003,False,False,REF-221480,First Continental Bank,***9106,Globex Retail NA LLC,US,7834840.89
2024-06-24,2024-06-24,Client Receipt - ShopSphere Partner #65,Sales Receipt,Retail-NA,0.0,19765.85,USD,ACH Credit,ShopSphere Partner #65,***9688,INV-202406-Retail-NA-0002,,False,False,REF-416526,First Continental Bank,***9106,Globex Retail NA LLC,US,7854606.74
2024-06-24,2024-06-24,Client Receipt - Vertex Advisory Client #38,Sales Receipt,PS-GL,0.0,25020.76,USD,ACH Credit,Vertex Advisory Client #38,***5737,INV-202406-PS-GL-0009,,False,False,REF-372427,First Continental Bank,***6931,Globex Retail NA LLC,US,7879627.5
2024-06-25,2024-06-25,Client Receipt - CloudBridge Co. #63,Sales Receipt,SaaS-GL,0.0,5236.29,USD,Card Settlement,CloudBridge Co. #63,***8147,INV-202406-SaaS-GL-0002,,False,False,REF-422204,First Continental Bank,***6253,Globex Retail NA LLC,US,7884863.79
2024-06-26,2024-06-26,Supplier Payment - HyperCloud Infra #10,Supplier Payment,SaaS-GL,8639.13,0.0,USD,ACH Debit,HyperCloud Infra #10,***2421,,PO-202406-SaaS-GL-0006,False,False,REF-774699,First Continental Bank,***3440,Globex Retail NA LLC,US,7876224.66
2024-06-26,2024-06-26,Marketing - Aurelia Media #7,Marketing,ALL,9767.84,0.0,USD,Fedwire,Aurelia Media #7,***7197,,,False,False,REF-960163,First Continental Bank,***4251,Globex Retail NA LLC,US,7866456.82
2024-06-26,2024-06-26,Intercompany Settlement - Globex Consulting UK Ltd.,Intercompany Transfer,ALL,686973.0,0.0,USD,Internal Transfer,Globex Consulting UK Ltd.,***2904,,,True,True,REF-593781,First Continental Bank,***7596,Globex Retail NA LLC,US,7179483.82
2024-06-26,2024-06-26,Client Receipt - CloudBridge Co. #23,Sales Receipt,SaaS-GL,0.0,19739.55,USD,ACH Credit,CloudBridge Co. #23,***1463,INV-202406-SaaS-GL-0017,,False,False,REF-404745,First Continental Bank,***1645,Globex Retail NA LLC,US,7199223.37
2024-06-27,2024-06-27,Supplier Payment - PackFast Fulfillment #14,Supplier Payment,Retail-NA,12422.9,0.0,USD,Fedwire,PackFast Fulfillment #14,***5905,,PO-202406-Retail-NA-0005,False,False,REF-497067,First Continental Bank,***7149,Globex Retail NA LLC,US,7186800.47
2024-06-27,2024-06-27,Supplier Payment - CodeCraft Contractors #3,Supplier Payment,SaaS-GL,12583.51,0.0,USD,ACH Debit,CodeCraft Contractors #3,***6687,,PO-202406-SaaS-GL-0008,False,False,REF-803420,First Continental Bank,***4848,Globex Retail NA LLC,US,7174216.96
2024-06-27,2024-06-27,Client Receipt - Vertex Advisory Client #8,Sales Receipt,PS-GL,0.0,10592.2,USD,Card Settlement,Vertex Advisory Client #8,***6170,INV-202406-PS-GL-0004,,False,False,REF-662991,First Continental Bank,***9406,Globex Retail NA LLC,US,7184809.16
2024-06-27,2024-06-27,Client Receipt - CloudBridge Co. #73,Sales Receipt,SaaS-GL,0.0,27517.82,USD,Card Settlement,CloudBridge Co. #73,***7023,INV-202406-SaaS-GL-0018,,False,False,REF-148120,First Continental Bank,***3954,Globex Retail NA LLC,US,7212326.98
2024-06-27,2024-06-27,Client Receipt - ShopSphere Partner #74,Sales Receipt,Retail-NA,0.0,54108.28,USD,Card Settlement,ShopSphere Partner #74,***4558,INV-202406-Retail-NA-0011,,False,False,REF-778146,First Continental Bank,***6748,Globex Retail NA LLC,US,7266435.26
2024-06-28,2024-06-28,Supplier Payment - ExpertNet Subcontractors #19,Supplier Payment,PS-GL,3107.59,0.0,USD,ACH Debit,ExpertNet Subcontractors #19,***9056,,PO-202406-PS-GL-0006,False,False,REF-409299,First Continental Bank,***3218,Globex Retail NA LLC,US,7263327.67
2024-06-28,2024-06-28,Client Receipt - CloudBridge Co. #79,Sales Receipt,SaaS-GL,0.0,1722.57,USD,Card Settlement,CloudBridge Co. #79,***5313,INV-202406-SaaS-GL-0008,,False,False,REF-625310,First Continental Bank,***3266,Globex Retail NA LLC,US,7265050.24
2024-06-28,2024-06-28,Client Receipt - CloudBridge Co. #77,Sales Receipt,SaaS-GL,0.0,5074.48,USD,Card Settlement,CloudBridge Co. #77,***6893,INV-202406-SaaS-GL-0027,,False,False,REF-314284,First Continental Bank,***9720,Globex Retail NA LLC,US,7270124.72
2024-06-28,2024-06-28,Client Receipt - CloudBridge Co. #40,Sales Receipt,SaaS-GL,0.0,12691.18,USD,ACH Credit,CloudBridge Co. #40,***7852,INV-202406-SaaS-GL-0022,,False,False,REF-588574,First Continental Bank,***2354,Globex Retail NA LLC,US,7282815.9
2024-06-29,2024-06-29,Payroll - GlobalPay Services Ltd,Payroll,ALL,82220.45,0.0,USD,ACH Debit,GlobalPay Services Ltd,***3268,,,False,False,REF-302310,First Continental Bank,***1399,Globex Retail NA LLC,US,7200595.45
2024-06-29,2024-06-29,Payroll - GlobalPay Services Ltd,Payroll,ALL,82220.45,0.0,USD,Fedwire,GlobalPay Services Ltd,***4442,,,False,False,REF-887385,First Continental Bank,***8978,Globex Retail NA LLC,US,7118375.0
2024-06-29,2024-06-29,Client Receipt - CloudBridge Co. #41,Sales Receipt,SaaS-GL,0.0,13516.79,USD,Card Settlement,CloudBridge Co. #41,***7424,INV-202406-SaaS-GL-0019,,False,False,REF-765336,First Continental Bank,***2615,Globex Retail NA LLC,US,7131891.79
2024-06-30,2024-06-30,Merchant Processing Fees,Bank/Merchant Fees,ALL,484.6,0.0,USD,ACH Debit,First Continental Bank,***8125,,,False,False,REF-205738,First Continental Bank,***8882,Globex Retail NA LLC,US,7131407.19
2024-06-30,2024-06-30,Interest Earned,Interest Income,ALL,0.0,10385.74,USD,Card Settlement,First Continental Bank,***1392,,,False,False,REF-846867,First Continental Bank,***7760,Globex Retail NA LLC,US,7141792.93
2024-06-30,2024-06-30,Client Receipt - Vertex Advisory Client #28,Sales Receipt,PS-GL,0.0,19810.29,USD,Card Settlement,Vertex Advisory Client #28,***2172,INV-202406-PS-GL-0007,,False,False,REF-364884,First Continental Bank,***5037,Globex Retail NA LLC,US,7161603.22
2024-07-01,2024-07-01,Account Maintenance Fee,Bank/Merchant Fees,ALL,2500.0,0.0,USD,Fedwire,First Continental Bank,***5588,,,False,False,REF-665722,First Continental Bank,***3048,Globex Retail NA LLC,US,7159103.22
2024-07-01,2024-07-01,Client Receipt - CloudBridge Co. #56,Sales Receipt,SaaS-GL,0.0,1960.9,USD,Card Settlement,CloudBridge Co. #56,***5865,INV-202407-SaaS-GL-0005,,False,False,REF-424741,First Continental Bank,***4317,Globex Retail NA LLC,US,7161064.12
2024-07-01,2024-07-01,Client Receipt - ShopSphere Partner #37,Sales Receipt,Retail-NA,0.0,18263.4,USD,Card Settlement,ShopSphere Partner #37,***7735,INV-202407-Retail-NA-0007,,False,False,REF-400390,First Continental Bank,***6838,Globex Retail NA LLC,US,7179327.52
2024-07-01,2024-07-01,Client Receipt - CloudBridge Co. #34,Sales Receipt,SaaS-GL,0.0,20218.68,USD,Card Settlement,CloudBridge Co. #34,***8013,INV-202407-SaaS-GL-0001,,False,False,REF-388140,First Continental Bank,***9718,Globex Retail NA LLC,US,7199546.2
2024-07-01,2024-07-01,Client Receipt - ShopSphere Partner #38,Sales Receipt,Retail-NA,0.0,36938.09,USD,ACH Credit,ShopSphere Partner #38,***7927,INV-202407-Retail-NA-0014,,False,False,REF-385706,First Continental Bank,***1440,Globex Retail NA LLC,US,7236484.29
2024-07-02,2024-07-02,Supplier Payment - ExpertNet Subcontractors #17,Supplier Payment,PS-GL,2852.66,0.0,USD,Fedwire,ExpertNet Subcontractors #17,***3612,,PO-202407-PS-GL-0010,False,False,REF-377839,First Continental Bank,***3053,Globex Retail NA LLC,US,7233631.63
2024-07-02,2024-07-02,Supplier Payment - HyperCloud Infra #14,Supplier Payment,SaaS-GL,6085.6,0.0,USD,Fedwire,HyperCloud Infra #14,***1356,,PO-202407-SaaS-GL-0008,False,False,REF-228082,First Continental Bank,***2054,Globex Retail NA LLC,US,7227546.03
2024-07-02,2024-07-02,Client Receipt - CloudBridge Co. #49,Sales Receipt,SaaS-GL,0.0,6858.23,USD,Card Settlement,CloudBridge Co. #49,***8796,INV-202407-SaaS-GL-0010,,False,False,REF-707655,First Continental Bank,***7149,Globex Retail NA LLC,US,7234404.26
2024-07-03,2024-07-03,Supplier Payment - ExpertNet Subcontractors #7,Supplier Payment,PS-GL,4846.55,0.0,USD,ACH Debit,ExpertNet Subcontractors #7,***6526,,PO-202407-PS-GL-0001,False,False,REF-172444,First Continental Bank,***5136,Globex Retail NA LLC,US,7229557.71
2024-07-03,2024-07-03,Supplier Payment - HyperCloud Infra #1,Supplier Payment,SaaS-GL,18008.08,0.0,USD,ACH Debit,HyperCloud Infra #1,***3365,,PO-202407-SaaS-GL-0002,False,False,REF-634407,First Continental Bank,***8274,Globex Retail NA LLC,US,7211549.63
2024-07-03,2024-07-03,Client Receipt - CloudBridge Co. #77,Sales Receipt,SaaS-GL,0.0,4031.41,USD,Card Settlement,CloudBridge Co. #77,***9979,INV-202407-SaaS-GL-0023,,False,False,REF-799496,First Continental Bank,***7483,Globex Retail NA LLC,US,7215581.04
2024-07-03,2024-07-03,Client Receipt - CloudBridge Co. #71,Sales Receipt,SaaS-GL,0.0,8060.05,USD,Card Settlement,CloudBridge Co. #71,***9489,INV-202407-SaaS-GL-0009,,False,False,REF-264540,First Continental Bank,***3843,Globex Retail NA LLC,US,7223641.09
2024-07-04,2024-07-04,Supplier Payment - HyperCloud Infra #6,Supplier Payment,SaaS-GL,11412.18,0.0,USD,Fedwire,HyperCloud Infra #6,***2456,,PO-202407-SaaS-GL-0003,False,False,REF-538833,First Continental Bank,***2055,Globex Retail NA LLC,US,7212228.91
2024-07-04,2024-07-04,Client Receipt - Vertex Advisory Client #50,Sales Receipt,PS-GL,0.0,12122.87,USD,Card Settlement,Vertex Advisory Client #50,***6926,INV-202407-PS-GL-0004,,False,False,REF-940491,First Continental Bank,***9825,Globex Retail NA LLC,US,7224351.78
2024-07-04,2024-07-04,Client Receipt - Card Settlement Batch #20,Sales Receipt,Retail-NA,0.0,69036.29,USD,ACH Credit,Card Settlement Batch #20,***5949,INV-202407-Retail-NA-0003,,False,False,REF-620323,First Continental Bank,***7446,Globex Retail NA LLC,US,7293388.07
2024-07-05,2024-07-05,Supplier Payment - PackFast Fulfillment #5,Supplier Payment,Retail-NA,59346.76,0.0,USD,ACH Debit,PackFast Fulfillment #5,***5094,,PO-202407-Retail-NA-0006,False,False,REF-160508,First Continental Bank,***6179,Globex Retail NA LLC,US,7234041.31
2024-07-05,2024-07-05,Client Receipt - Vertex Advisory Client #34,Sales Receipt,PS-GL,0.0,450.54,USD,Card Settlement,Vertex Advisory Client #34,***4924,INV-202407-PS-GL-0005,,False,False,REF-822699,First Continental Bank,***8971,Globex Retail NA LLC,US,7234491.85
2024-07-06,2024-07-06,Supplier Payment - ExpertNet Subcontractors #11,Supplier Payment,PS-GL,5299.02,0.0,USD,ACH Debit,ExpertNet Subcontractors #11,***2114,,PO-202407-PS-GL-0004,False,False,REF-115884,First Continental Bank,***3756,Globex Retail NA LLC,US,7229192.83
2024-07-08,2024-07-08,Client Receipt - CloudBridge Co. #30,Sales Receipt,SaaS-GL,0.0,1377.08,USD,ACH Credit,CloudBridge Co. #30,***8339,INV-202407-SaaS-GL-0030,,False,False,REF-348825,First Continental Bank,***8935,Globex Retail NA LLC,US,7230569.91
2024-07-08,2024-07-08,Client Receipt - ShopSphere Partner #60,Sales Receipt,Retail-NA,0.0,10900.93,USD,Card Settlement,ShopSphere Partner #60,***6889,INV-202407-Retail-NA-0006,,False,False,REF-789902,First Continental Bank,***7182,Globex Retail NA LLC,US,7241470.84
2024-07-08,2024-07-08,Client Receipt - ShopSphere Partner #22,Sales Receipt,Retail-NA,0.0,13766.09,USD,Card Settlement,ShopSphere Partner #22,***2440,INV-202407-Retail-NA-0004,,False,False,REF-956957,First Continental Bank,***6194,Globex Retail NA LLC,US,7255236.93
2024-07-08,2024-07-08,Client Receipt - Card Settlement Batch #13,Sales Receipt,Retail-NA,0.0,16729.54,USD,Card Settlement,Card Settlement Batch #13,***2492,INV-202407-Retail-NA-0015,,False,False,REF-467258,First Continental Bank,***9128,Globex Retail NA LLC,US,7271966.47
2024-07-09,2024-07-09,Supplier Payment - ExpertNet Subcontractors #15,Supplier Payment,PS-GL,7738.53,0.0,USD,ACH Debit,ExpertNet Subcontractors #15,***4856,,PO-202407-PS-GL-0002,False,False,REF-411526,First Continental Bank,***4963,Globex Retail NA LLC,US,7264227.94
2024-07-09,2024-07-09,Supplier Payment - NorthRiver Apparel Mfg #27,Supplier Payment,Retail-NA,37861.77,0.0,USD,Fedwire,NorthRiver Apparel Mfg #27,***7607,,PO-202407-Retail-NA-0007,False,False,REF-671415,First Continental Bank,***4962,Globex Retail NA LLC,US,7226366.17
2024-07-09,2024-07-09,Client Receipt - CloudBridge Co. #50,Sales Receipt,SaaS-GL,0.0,4541.75,USD,Card Settlement,CloudBridge Co. #50,***5217,INV-202407-SaaS-GL-0015,,False,False,REF-895401,First Continental Bank,***1153,Globex Retail NA LLC,US,7230907.92
2024-07-09,2024-07-09,Client Receipt - Card Settlement Batch #8,Sales Receipt,Retail-NA,0.0,51815.85,USD,Card Settlement,Card Settlement Batch #8,***7715,INV-202407-Retail-NA-0008,,False,False,REF-519805,First Continental Bank,***5906,Globex Retail NA LLC,US,7282723.77
2024-07-10,2024-07-10,Merchant Processing Fees,Bank/Merchant Fees,ALL,912.98,0.0,USD,Fedwire,First Continental Bank,***2372,,,False,False,REF-959481,First Continental Bank,***6760,Globex Retail NA LLC,US,7281810.79
2024-07-10,2024-07-10,Merchant Processing Fees,Bank/Merchant Fees,ALL,1985.75,0.0,USD,Fedwire,First Continental Bank,***5939,,,False,False,REF-825753,First Continental Bank,***5635,Globex Retail NA LLC,US,7279825.04
2024-07-10,2024-07-10,Supplier Payment - ExpertNet Subcontractors #10,Supplier Payment,PS-GL,9119.13,0.0,USD,Fedwire,ExpertNet Subcontractors #10,***3997,,PO-202407-PS-GL-0005,False,False,REF-414961,First Continental Bank,***2819,Globex Retail NA LLC,US,7270705.91
2024-07-10,2024-07-10,Client Receipt - Vertex Advisory Client #58,Sales Receipt,PS-GL,0.0,14925.98,USD,ACH Credit,Vertex Advisory Client #58,***4164,INV-202407-PS-GL-0006,,False,False,REF-467560,First Continental Bank,***5843,Globex Retail NA LLC,US,7285631.89
2024-07-11,2024-07-11,Client Receipt - CloudBridge Co. #17,Sales Receipt,SaaS-GL,0.0,119.65,USD,Card Settlement,CloudBridge Co. #17,***9381,INV-202407-SaaS-GL-0022,,False,False,REF-140269,First Continental Bank,***1692,Globex Retail NA LLC,US,7285751.54
2024-07-11,2024-07-11,Client Receipt - CloudBridge Co. #63,Sales Receipt,SaaS-GL,0.0,7453.45,USD,Card Settlement,CloudBridge Co. #63,***8870,INV-202407-SaaS-GL-0012,,False,False,REF-816736,First Continental Bank,***4741,Globex Retail NA LLC,US,7293204.99
2024-07-11,2024-07-11,Client Receipt - Vertex Advisory Client #48,Sales Receipt,PS-GL,0.0,28869.22,USD,Card Settlement,Vertex Advisory Client #48,***7249,INV-202407-PS-GL-0003,,False,False,REF-366867,First Continental Bank,***8843,Globex Retail NA LLC,US,7322074.21
2024-07-11,2024-07-11,Client Receipt - Vertex Advisory Client #43,Sales Receipt,PS-GL,0.0,79944.85,USD,Card Settlement,Vertex Advisory Client #43,***4407,INV-202407-PS-GL-0009,,False,False,REF-565541,First Continental Bank,***9366,Globex Retail NA LLC,US,7402019.06
2024-07-12,2024-07-12,Supplier Payment - ExpertNet Subcontractors #2,Supplier Payment,PS-GL,1904.96,0.0,USD,Fedwire,ExpertNet Subcontractors #2,***3450,,PO-202407-PS-GL-0008,False,False,REF-312394,First Continental Bank,***5667,Globex Retail NA LLC,US,7400114.1
2024-07-12,2024-07-12,Supplier Payment - HyperCloud Infra #7,Supplier Payment,SaaS-GL,2251.47,0.0,USD,ACH Debit,HyperCloud Infra #7,***9071,,PO-202407-SaaS-GL-0006,False,False,REF-865665,First Continental Bank,***2019,Globex Retail NA LLC,US,7397862.63
2024-07-12,2024-07-12,Intercompany Settlement - Globex Consulting UK Ltd.,Intercompany Transfer,ALL,392745.0,0.0,USD,Internal Transfer,Globex Consulting UK Ltd.,***9289,,,True,True,REF-851264,First Continental Bank,***2607,Globex Retail NA LLC,US,7005117.63
2024-07-12,2024-07-12,Client Receipt - Vertex Advisory Client #45,Sales Receipt,PS-GL,0.0,22660.76,USD,ACH Credit,Vertex Advisory Client #45,***8259,INV-202407-PS-GL-0008,,False,False,REF-937786,First Continental Bank,***4810,Globex Retail NA LLC,US,7027778.39
2024-07-13,2024-07-13,Client Receipt - ShopSphere Partner #60,Sales Receipt,Retail-NA,0.0,16957.54,USD,Card Settlement,ShopSphere Partner #60,***7138,INV-202407-Retail-NA-0002,,False,False,REF-411910,First Continental Bank,***1205,Globex Retail NA LLC,US,7044735.93
2024-07-14,2024-07-14,Marketing - Beacon Digital #8,Marketing,ALL,14889.32,0.0,USD,Fedwire,Beacon Digital #8,***4270,,,False,False,REF-502031,First Continental Bank,***4887,Globex Retail NA LLC,US,7029846.61
2024-07-15,2024-07-15,Supplier Payment - HyperCloud Infra #2,Supplier Payment,SaaS-GL,3794.07,0.0,USD,Fedwire,HyperCloud Infra #2,***5882,,PO-202407-SaaS-GL-0005,False,False,REF-356392,First Continental Bank,***1789,Globex Retail NA LLC,US,7026052.54
2024-07-15,2024-07-15,Supplier Payment - NorthRiver Apparel Mfg #18,Supplier Payment,Retail-NA,11051.41,0.0,USD,ACH Debit,NorthRiver Apparel Mfg #18,***6202,,PO-202407-Retail-NA-0005,False,False,REF-550393,First Continental Bank,***6971,Globex Retail NA LLC,US,7015001.13
2024-07-15,2024-07-15,Supplier Payment - HyperCloud Infra #1,Supplier Payment,SaaS-GL,19147.75,0.0,USD,Fedwire,HyperCloud Infra #1,***1160,,PO-202407-SaaS-GL-0007,False,False,REF-174034,First Continental Bank,***8961,Globex Retail NA LLC,US,6995853.38
2024-07-15,2024-07-15,Client Receipt - Vertex Advisory Client #39,Sales Receipt,PS-GL,0.0,9207.49,USD,Card Settlement,Vertex Advisory Client #39,***2308,INV-202407-PS-GL-0002,,False,False,REF-513523,First Continental Bank,***3804,Globex Retail NA LLC,US,7005060.87
2024-07-16,2024-07-16,Supplier Payment - ExpertNet Subcontractors #7,Supplier Payment,PS-GL,3229.24,0.0,USD,Fedwire,ExpertNet Subcontractors #7,***4465,,PO-202407-PS-GL-0006,False,False,REF-682096,First Continental Bank,***6443,Globex Retail NA LLC,US,7001831.63
2024-07-16,2024-07-16,Supplier Payment - ExpertNet Subcontractors #2,Supplier Payment,PS-GL,9992.77,0.0,USD,Fedwire,ExpertNet Subcontractors #2,***4399,,PO-202407-PS-GL-0007,False,False,REF-965779,First Continental Bank,***3336,Globex Retail NA LLC,US,6991838.86
2024-07-16,2024-07-16,Supplier Payment - PackFast Fulfillment #12,Supplier Payment,Retail-NA,39081.19,0.0,USD,Fedwire,PackFast Fulfillment #12,***5370,,PO-202407-Retail-NA-0003,False,False,REF-812107,First Continental Bank,***6610,Globex Retail NA LLC,US,6952757.67
2024-07-16,2024-07-16,Client Receipt - CloudBridge Co. #67,Sales Receipt,SaaS-GL,0.0,956.22,USD,Card Settlement,CloudBridge Co. #67,***1980,INV-202407-SaaS-GL-0011,,False,False,REF-431976,First Continental Bank,***7406,Globex Retail NA LLC,US,6953713.89
2024-07-16,2024-07-16,Client Receipt - CloudBridge Co. #8,Sales Receipt,SaaS-GL,0.0,1894.95,USD,ACH Credit,CloudBridge Co. #8,***7620,INV-202407-SaaS-GL-0017,,False,False,REF-341932,First Continental Bank,***8585,Globex Retail NA LLC,US,6955608.84
2024-07-16,2024-07-16,Client Receipt - CloudBridge Co. #50,Sales Receipt,SaaS-GL,0.0,8151.58,USD,Card Settlement,CloudBridge Co. #50,***4619,INV-202407-SaaS-GL-0008,,False,False,REF-958572,First Continental Bank,***3449,Globex Retail NA LLC,US,6963760.42
2024-07-17,2024-07-17,Supplier Payment - NorthRiver Apparel Mfg #14,Supplier Payment,Retail-NA,37712.53,0.0,USD,ACH Debit,NorthRiver Apparel Mfg #14,***6244,,PO-202407-Retail-NA-0008,False,False,REF-631095,First Continental Bank,***8695,Globex Retail NA LLC,US,6926047.89
2024-07-17,2024-07-17,Client Receipt - CloudBridge Co. #2,Sales Receipt,SaaS-GL,0.0,6369.35,USD,ACH Credit,CloudBridge Co. #2,***6657,INV-202407-SaaS-GL-0006,,False,False,REF-544672,First Continental Bank,***5310,Globex Retail NA LLC,US,6932417.24
2024-07-18,2024-07-18,Supplier Payment - ExpertNet Subcontractors #9,Supplier Payment,PS-GL,667.76,0.0,USD,Fedwire,ExpertNet Subcontractors #9,***4474,,PO-202407-PS-GL-0011,False,False,REF-242400,First Continental Bank,***6066,Globex Retail NA LLC,US,6931749.48
2024-07-18,2024-07-18,Client Receipt - CloudBridge Co. #56,Sales Receipt,SaaS-GL,0.0,881.11,USD,Card Settlement,CloudBridge Co. #56,***4750,INV-202407-SaaS-GL-0020,,False,False,REF-945936,First Continental Bank,***2111,Globex Retail NA LLC,US,6932630.59
2024-07-19,2024-07-19,Supplier Payment - HyperCloud Infra #13,Supplier Payment,SaaS-GL,2202.1,0.0,USD,Fedwire,HyperCloud Infra #13,***4128,,PO-202407-SaaS-GL-0009,False,False,REF-339442,First Continental Bank,***8946,Globex Retail NA LLC,US,6930428.49
2024-07-19,2024-07-19,Supplier Payment - CodeCraft Contractors #1,Supplier Payment,SaaS-GL,3832.05,0.0,USD,Fedwire,CodeCraft Contractors #1,***1245,,PO-202407-SaaS-GL-0004,False,False,REF-594064,First Continental Bank,***6407,Globex Retail NA LLC,US,6926596.44
2024-07-19,2024-07-19,Supplier Payment - PackFast Fulfillment #10,Supplier Payment,Retail-NA,9159.78,0.0,USD,Fedwire,PackFast Fulfillment #10,***7080,,PO-202407-Retail-NA-0002,False,False,REF-122971,First Continental Bank,***5157,Globex Retail NA LLC,US,6917436.66
2024-07-19,2024-07-19,VAT/GST Remittance - US IRS,Tax Payment,ALL,55726.25,0.0,USD,Fedwire,US IRS,***1847,,,False,False,REF-524759,First Continental Bank,***2124,Globex Retail NA LLC,US,6861710.41
2024-07-20,2024-07-20,Client Receipt - CloudBridge Co. #9,Sales Receipt,SaaS-GL,0.0,28333.18,USD,Card Settlement,CloudBridge Co. #9,***1010,INV-202407-SaaS-GL-0028,,False,False,REF-891167,First Continental Bank,***8250,Globex Retail NA LLC,US,6890043.59
2024-07-21,2024-07-21,Supplier Payment - HyperCloud Infra #17,Supplier Payment,SaaS-GL,2638.39,0.0,USD,Fedwire,HyperCloud Infra #17,***1691,,PO-202407-SaaS-GL-0011,False,False,REF-371514,First Continental Bank,***4432,Globex Retail NA LLC,US,6887405.2
2024-07-21,2024-07-21,Supplier Payment - PackFast Fulfillment #5,Supplier Payment,Retail-NA,6684.55,0.0,USD,Fedwire,PackFast Fulfillment #5,***2965,,PO-202407-Retail-NA-0001,False,False,REF-539858,First Continental Bank,***4759,Globex Retail NA LLC,US,6880720.65
2024-07-22,2024-07-22,Supplier Payment - ExpertNet Subcontractors #9,Supplier Payment,PS-GL,1183.69,0.0,USD,ACH Debit,ExpertNet Subcontractors #9,***6601,,PO-202407-PS-GL-0009,False,False,REF-203494,First Continental Bank,***8806,Globex Retail NA LLC,US,6879536.96
2024-07-22,2024-07-22,Client Receipt - CloudBridge Co. #64,Sales Receipt,SaaS-GL,0.0,20492.9,USD,ACH Credit,CloudBridge Co. #64,***2898,INV-202407-SaaS-GL-0019,,False,False,REF-121039,First Continental Bank,***1661,Globex Retail NA LLC,US,6900029.86
2024-07-22,2024-07-22,Client Receipt - Vertex Advisory Client #19,Sales Receipt,PS-GL,0.0,26643.78,USD,ACH Credit,Vertex Advisory Client #19,***7557,INV-202407-PS-GL-0007,,False,False,REF-566991,First Continental Bank,***1686,Globex Retail NA LLC,US,6926673.64
2024-07-23,2024-07-23,Client Receipt - ShopSphere Partner #28,Sales Receipt,Retail-NA,0.0,4933.44,USD,Card Settlement,ShopSphere Partner #28,***1753,INV-202407-Retail-NA-0001,,False,False,REF-454483,First Continental Bank,***7652,Globex Retail NA LLC,US,6931607.08
2024-07-23,2024-07-23,Client Receipt - CloudBridge Co. #10,Sales Receipt,SaaS-GL,0.0,9224.0,USD,Card Settlement,CloudBridge Co. #10,***6409,INV-202407-SaaS-GL-0021,,False,False,REF-678132,First Continental Bank,***2703,Globex Retail NA LLC,US,6940831.08
2024-07-23,2024-07-23,Client Receipt - CloudBridge Co. #77,Sales Receipt,SaaS-GL,0.0,12982.38,USD,ACH Credit,CloudBridge Co. #77,***1411,INV-202407-SaaS-GL-0029,,False,False,REF-657769,First Continental Bank,***7277,Globex Retail NA LLC,US,6953813.46
2024-07-23,2024-07-23,Client Receipt - CloudBridge Co. #25,Sales Receipt,SaaS-GL,0.0,22106.05,USD,Card Settlement,CloudBridge Co. #25,***7374,INV-202407-SaaS-GL-0024,,False,False,REF-742230,First Continental Bank,***2480,Globex Retail NA LLC,US,6975919.51
2024-07-23,2024-07-23,Client Receipt - ShopSphere Partner #11,Sales Receipt,Retail-NA,0.0,28770.46,USD,Card Settlement,ShopSphere Partner #11,***1249,INV-202407-Retail-NA-0012,,False,False,REF-615143,First Continental Bank,***7257,Globex Retail NA LLC,US,7004689.97
2024-07-24,2024-07-24,Marketing - Aurelia Media #2,Marketing,ALL,9695.6,0.0,USD,Fedwire,Aurelia Media #2,***8141,,,False,False,REF-172566,First Continental Bank,***8812,Globex Retail NA LLC,US,6994994.37
2024-07-24,2024-07-24,Client Receipt - CloudBridge Co. #23,Sales Receipt,SaaS-GL,0.0,14534.84,USD,Card Settlement,CloudBridge Co. #23,***6724,INV-202407-SaaS-GL-0004,,False,False,REF-486418,First Continental Bank,***8026,Globex Retail NA LLC,US,7009529.21
2024-07-24,2024-07-24,Client Receipt - CloudBridge Co. #76,Sales Receipt,SaaS-GL,0.0,20612.07,USD,Card Settlement,CloudBridge Co. #76,***8523,INV-202407-SaaS-GL-0014,,False,False,REF-179592,First Continental Bank,***9321,Globex Retail NA LLC,US,7030141.28
2024-07-24,2024-07-24,Client Receipt - CloudBridge Co. #4,Sales Receipt,SaaS-GL,0.0,28405.48,USD,ACH Credit,CloudBridge Co. #4,***8944,INV-202407-SaaS-GL-0025,,False,False,REF-307229,First Continental Bank,***4071,Globex Retail NA LLC,US,7058546.76
2024-07-24,2024-07-24,Client Receipt - Card Settlement Batch #11,Sales Receipt,Retail-NA,0.0,41969.12,USD,ACH Credit,Card Settlement Batch #11,***5141,INV-202407-Retail-NA-0011,,False,False,REF-234064,First Continental Bank,***3419,Globex Retail NA LLC,US,7100515.88
2024-07-25,2024-07-25,Supplier Payment - ExpertNet Subcontractors #5,Supplier Payment,PS-GL,11812.74,0.0,USD,ACH Debit,ExpertNet Subcontractors #5,***8728,,PO-202407-PS-GL-0003,False,False,REF-824234,First Continental Bank,***2874,Globex Retail NA LLC,US,7088703.14
2024-07-25,2024-07-25,Client Receipt - CloudBridge Co. #71,Sales Receipt,SaaS-GL,0.0,727.01,USD,Card Settlement,CloudBridge Co. #71,***3105,INV-202407-SaaS-GL-0007,,False,False,REF-149532,First Continental Bank,***6213,Globex Retail NA LLC,US,7089430.15
2024-07-25,2024-07-25,Client Receipt - CloudBridge Co. #42,Sales Receipt,SaaS-GL,0.0,23580.67,USD,Card Settlement,CloudBridge Co. #42,***9753,INV-202407-SaaS-GL-0026,,False,False,REF-947125,First Continental Bank,***9136,Globex Retail NA LLC,US,7113010.82
2024-07-26,2024-07-26,Intercompany Settlement - Globex Consulting UK Ltd.,Intercompany Transfer,ALL,240658.0,0.0,USD,Internal Transfer,Globex Consulting UK Ltd.,***7128,,,True,True,REF-950930,First Continental Bank,***2203,Globex Retail NA LLC,US,6872352.82
2024-07-26,2024-07-26,Client Receipt - CloudBridge Co. #64,Sales Receipt,SaaS-GL,0.0,2533.02,USD,Card Settlement,CloudBridge Co. #64,***3232,INV-202407-SaaS-GL-0003,,False,False,REF-785175,First Continental Bank,***1389,Globex Retail NA LLC,US,6874885.84
2024-07-26,2024-07-26,Client Receipt - CloudBridge Co. #61,Sales Receipt,SaaS-GL,0.0,31916.2,USD,ACH Credit,CloudBridge Co. #61,***8781,INV-202407-SaaS-GL-0027,,False,False,REF-520888,First Continental Bank,***5775,Globex Retail NA LLC,US,6906802.04
2024-07-26,2024-07-26,Intercompany Reimbursement - Globex Consulting UK Ltd.,Intercompany Transfer,ALL,0.0,96263.2,USD,Internal Transfer,Globex Consulting UK Ltd.,***2143,,,True,True,REF-713352,First Continental Bank,***5398,Globex Retail NA LLC,US,7003065.24
2024-07-27,2024-07-27,Supplier Payment - CodeCraft Contractors #3,Supplier Payment,SaaS-GL,2416.08,0.0,USD,ACH Debit,CodeCraft Contractors #3,***7459,,PO-202407-SaaS-GL-0001,False,False,REF-565466,First Continental Bank,***3852,Globex Retail NA LLC,US,7000649.16
2024-07-27,2024-07-27,Client Receipt - ShopSphere Partner #2,Sales Receipt,Retail-NA,0.0,1464.16,USD,ACH Credit,ShopSphere Partner #2,***5805,INV-202407-Retail-NA-0017,,False,False,REF-114560,First Continental Bank,***5343,Globex Retail NA LLC,US,7002113.32
2024-07-27,2024-07-27,Client Receipt - CloudBridge Co. #75,Sales Receipt,SaaS-GL,0.0,15225.78,USD,ACH Credit,CloudBridge Co. #75,***8821,INV-202407-SaaS-GL-0018,,False,False,REF-732970,First Continental Bank,***5313,Globex Retail NA LLC,US,7017339.1
2024-07-28,2024-07-28,Corporate Tax Estimate,Tax Payment,ALL,42552.12,0.0,USD,ACH Debit,State of CA FTB,***9276,,,False,False,REF-655006,First Continental Bank,***2649,Globex Retail NA LLC,US,6974786.98
2024-07-28,2024-07-28,Payroll - GlobalPay Services Ltd,Payroll,ALL,152511.0,0.0,USD,ACH Debit,GlobalPay Services Ltd,***6398,,,False,False,REF-835756,First Continental Bank,***3893,Globex Retail NA LLC,US,6822275.98
2024-07-29,2024-07-29,Supplier Payment - ExpertNet Subcontractors #17,Supplier Payment,PS-GL,8895.16,0.0,USD,Fedwire,ExpertNet Subcontractors #17,***1071,,PO-202407-PS-GL-0012,False,False,REF-705132,First Continental Bank,***4217,Globex Retail NA LLC,US,6813380.82
2024-07-29,2024-07-29,Client Receipt - CloudBridge Co. #35,Sales Receipt,SaaS-GL,0.0,3811.98,USD,Card Settlement,CloudBridge Co. #35,***8124,INV-202407-SaaS-GL-0016,,False,False,REF-586225,First Continental Bank,***2841,Globex Retail NA LLC,US,6817192.8
2024-07-29,2024-07-29,Client Receipt - Card Settlement Batch #2,Sales Receipt,Retail-NA,0.0,11904.49,USD,ACH Credit,Card Settlement Batch #2,***3350,INV-202407-Retail-NA-0016,,False,False,REF-810914,First Continental Bank,***1809,Globex Retail NA LLC,US,6829097.29
2024-07-29,2024-07-29,Client Receipt - Vertex Advisory Client #25,Sales Receipt,PS-GL,0.0,30315.22,USD,ACH Credit,Vertex Advisory Client #25,***5170,INV-202407-PS-GL-0001,,False,False,REF-691898,First Continental Bank,***1382,Globex Retail NA LLC,US,6859412.51
2024-07-29,2024-07-29,Client Receipt - ShopSphere Partner #52,Sales Receipt,Retail-NA,0.0,46706.32,USD,ACH Credit,ShopSphere Partner #52,***1668,INV-202407-Retail-NA-0013,,False,False,REF-450045,First Continental Bank,***2497,Globex Retail NA LLC,US,6906118.83
2024-07-30,2024-07-30,Supplier Payment - PackFast Fulfillment #10,Supplier Payment,Retail-NA,26118.9,0.0,USD,ACH Debit,PackFast Fulfillment #10,***8626,,PO-202407-Retail-NA-0004,False,False,REF-325977,First Continental Bank,***2469,Globex Retail NA LLC,US,6879999.93
2024-07-30,2024-07-30,Client Receipt - ShopSphere Partner #51,Sales Receipt,Retail-NA,0.0,3444.83,USD,Card Settlement,ShopSphere Partner #51,***4637,INV-202407-Retail-NA-0010,,False,False,REF-394814,First Continental Bank,***5617,Globex Retail NA LLC,US,6883444.76
2024-07-30,2024-07-30,Client Receipt - ShopSphere Partner #31,Sales Receipt,Retail-NA,0.0,9326.84,USD,Card Settlement,ShopSphere Partner #31,***2203,INV-202407-Retail-NA-0009,,False,False,REF-985644,First Continental Bank,***8454,Globex Retail NA LLC,US,6892771.6
2024-07-30,2024-07-30,Interest Earned,Interest Income,ALL,0.0,11147.06,USD,Card Settlement,First Continental Bank,***5778,,,False,False,REF-490571,First Continental Bank,***1518,Globex Retail NA LLC,US,6903918.66
2024-07-30,2024-07-30,Client Receipt - ShopSphere Partner #78,Sales Receipt,Retail-NA,0.0,16145.03,USD,Card Settlement,ShopSphere Partner #78,***1297,INV-202407-Retail-NA-0005,,False,False,REF-656487,First Continental Bank,***4726,Globex Retail NA LLC,US,6920063.69
2024-07-31,2024-07-31,Supplier Payment - CodeCraft Contractors #10,Supplier Payment,SaaS-GL,2508.67,0.0,USD,ACH Debit,CodeCraft Contractors #10,***9542,,PO-202407-SaaS-GL-0010,False,False,REF-567894,First Continental Bank,***5008,Globex Retail NA LLC,US,6917555.02
2024-07-31,2024-07-31,Metro Water & Waste,Rent & Utilities,ALL,7760.89,0.0,USD,ACH Debit,Metro Water & Waste,***6852,,,False,False,REF-240377,First Continental Bank,***6891,Globex Retail NA LLC,US,6909794.13
2024-07-31,2024-07-31,Client Receipt - CloudBridge Co. #39,Sales Receipt,SaaS-GL,0.0,7493.41,USD,ACH Credit,CloudBridge Co. #39,***2429,INV-202407-SaaS-GL-0013,,False,False,REF-242682,First Continental Bank,***8814,Globex Retail NA LLC,US,6917287.54
2024-07-31,2024-07-31,Client Receipt - ShopSphere Partner #5,Sales Receipt,Retail-NA,0.0,13685.55,USD,ACH Credit,ShopSphere Partner #5,***4933,INV-202407-Retail-NA-0018,,False,False,REF-232692,First Continental Bank,***8286,Globex Retail NA LLC,US,6930973.09
2024-07-31,2024-07-31,Client Receipt - CloudBridge Co. #20,Sales Receipt,SaaS-GL,0.0,22857.69,USD,Card Settlement,CloudBridge Co. #20,***3708,INV-202407-SaaS-GL-0002,,False,False,REF-942261,First Continental Bank,***9631,Globex Retail NA LLC,US,6953830.78
2024-08-01,2024-08-01,Account Maintenance Fee,Bank/Merchant Fees,ALL,2500.0,0.0,USD,ACH Debit,First Continental Bank,***8622,,,False,False,REF-110850,First Continental Bank,***8461,Globex Retail NA LLC,US,6951330.78
2024-08-01,2024-08-01,Supplier Payment - ExpertNet Subcontractors #4,Supplier Payment,PS-GL,3973.01,0.0,USD,ACH Debit,ExpertNet Subcontractors #4,***3395,,PO-202408-PS-GL-0006,False,False,REF-819940,First Continental Bank,***8782,Globex Retail NA LLC,US,6947357.77
2024-08-01,2024-08-01,Supplier Payment - ExpertNet Subcontractors #5,Supplier Payment,PS-GL,9140.89,0.0,USD,ACH Debit,ExpertNet Subcontractors #5,***8495,,PO-202408-PS-GL-0001,False,False,REF-399584,First Continental Bank,***9944,Globex Retail NA LLC,US,6938216.88
2024-08-01,2024-08-01,Marketing - Beacon Digital #3,Marketing,ALL,12000.16,0.0,USD,Fedwire,Beacon Digital #3,***6316,,,False,False,REF-552995,First Continental Bank,***6633,Globex Retail NA LLC,US,6926216.72
2024-08-01,2024-08-01,Client Receipt - Vertex Advisory Client #33,Sales Receipt,PS-GL,0.0,1538.94,USD,ACH Credit,Vertex Advisory Client #33,***9096,INV-202408-PS-GL-0003,,False,False,REF-142350,First Continental Bank,***9652,Globex Retail NA LLC,US,6927755.66
2024-08-01,2024-08-01,Client Receipt - CloudBridge Co. #22,Sales Receipt,SaaS-GL,0.0,3378.73,USD,ACH Credit,CloudBridge Co. #22,***4642,INV-202408-SaaS-GL-0002,,False,False,REF-539746,First Continental Bank,***8658,Globex Retail NA LLC,US,6931134.39
2024-08-01,2024-08-01,Client Receipt - CloudBridge Co. #62,Sales Receipt,SaaS-GL,0.0,5330.07,USD,Card Settlement,CloudBridge Co. #62,***9501,INV-202408-SaaS-GL-0013,,False,False,REF-677497,First Continental Bank,***1747,Globex Retail NA LLC,US,6936464.46
2024-08-02,2024-08-02,Client Receipt - Vertex Advisory Client #24,Sales Receipt,PS-GL,0.0,43947.68,USD,ACH Credit,Vertex Advisory Client #24,***2041,INV-202408-PS-GL-0006,,False,False,REF-478796,First Continental Bank,***9203,Globex Retail NA LLC,US,6980412.14
2024-08-02,2024-08-02,Client Receipt - CloudBridge Co. #28,Sales Receipt,SaaS-GL,0.0,53187.33,USD,Card Settlement,CloudBridge Co. #28,***5192,INV-202408-SaaS-GL-0015,,False,False,REF-233371,First Continental Bank,***2545,Globex Retail NA LLC,US,7033599.47
2024-08-03,2024-08-03,Supplier Payment - ExpertNet Subcontractors #1,Supplier Payment,PS-GL,11096.79,0.0,USD,Fedwire,ExpertNet Subcontractors #1,***2376,,PO-202408-PS-GL-0005,False,False,REF-121219,First Continental Bank,***4521,Globex Retail NA LLC,US,7022502.68
2024-08-06,2024-08-06,Supplier Payment - ExpertNet Subcontractors #2,Supplier Payment,PS-GL,4560.76,0.0,USD,ACH Debit,ExpertNet Subcontractors #2,***9303,,PO-202408-PS-GL-0004,False,False,REF-431264,First Continental Bank,***4553,Globex Retail NA LLC,US,7017941.92
2024-08-06,2024-08-06,Client Receipt - Vertex Advisory Client #28,Sales Receipt,PS-GL,0.0,22685.14,USD,ACH Credit,Vertex Advisory Client #28,***8869,INV-202408-PS-GL-0009,,False,False,REF-993539,First Continental Bank,***3745,Globex Retail NA LLC,US,7040627.06
2024-08-06,2024-08-06,Client Receipt - ShopSphere Partner #8,Sales Receipt,Retail-NA,0.0,39685.34,USD,ACH Credit,ShopSphere Partner #8,***5905,INV-202408-Retail-NA-0005,,False,False,REF-646345,First Continental Bank,***2866,Globex Retail NA LLC,US,7080312.4
2024-08-07,2024-08-07,Marketing - Aurelia Media #2,Marketing,ALL,2213.23,0.0,USD,ACH Debit,Aurelia Media #2,***8022,,,False,False,REF-396999,First Continental Bank,***9509,Globex Retail NA LLC,US,7078099.17
2024-08-08,2024-08-08,Client Receipt - CloudBridge Co. #7,Sales Receipt,SaaS-GL,0.0,8991.79,USD,ACH Credit,CloudBridge Co. #7,***2588,INV-202408-SaaS-GL-0009,,False,False,REF-924187,First Continental Bank,***2049,Globex Retail NA LLC,US,7087090.96
2024-08-08,2024-08-08,Client Receipt - Vertex Advisory Client #4,Sales Receipt,PS-GL,0.0,43721.83,USD,Card Settlement,Vertex Advisory Client #4,***4581,INV-202408-PS-GL-0008,,False,False,REF-978288,First Continental Bank,***4256,Globex Retail NA LLC,US,7130812.79
2024-08-09,2024-08-09,Client Receipt - CloudBridge Co. #62,Sales Receipt,SaaS-GL,0.0,98.83,USD,Card Settlement,CloudBridge Co. #62,***3041,INV-202408-SaaS-GL-0010,,False,False,REF-112644,First Continental Bank,***5110,Globex Retail NA LLC,US,7130911.62
2024-08-09,2024-08-09,Client Receipt - Vertex Advisory Client #51,Sales Receipt,PS-GL,0.0,3415.43,USD,Card Settlement,Vertex Advisory Client #51,***3285,INV-202408-PS-GL-0012,,False,False,REF-818870,First Continental Bank,***6416,Globex Retail NA LLC,US,7134327.05
2024-08-09,2024-08-09,Client Receipt - CloudBridge Co. #53,Sales Receipt,SaaS-GL,0.0,12091.31,USD,ACH Credit,CloudBridge Co. #53,***5246,INV-202408-SaaS-GL-0018,,False,False,REF-519010,First Continental Bank,***1502,Globex Retail NA LLC,US,7146418.36
2024-08-09,2024-08-09,Client Receipt - ShopSphere Partner #44,Sales Receipt,Retail-NA,0.0,16818.09,USD,ACH Credit,ShopSphere Partner #44,***9003,INV-202408-Retail-NA-0015,,False,False,REF-174302,First Continental Bank,***3566,Globex Retail NA LLC,US,7163236.45
2024-08-09,2024-08-09,Client Receipt - CloudBridge Co. #20,Sales Receipt,SaaS-GL,0.0,18082.98,USD,ACH Credit,CloudBridge Co. #20,***7465,INV-202408-SaaS-GL-0020,,False,False,REF-237532,First Continental Bank,***5167,Globex Retail NA LLC,US,7181319.43
2024-08-09,2024-08-09,Client Receipt - ShopSphere Partner #48,Sales Receipt,Retail-NA,0.0,43339.62,USD,Card Settlement,ShopSphere Partner #48,***4081,INV-202408-Retail-NA-0011,,False,False,REF-304245,First Continental Bank,***5141,Globex Retail NA LLC,US,7224659.05
2024-08-12,2024-08-12,Intercompany Settlement - Globex Consulting UK Ltd.,Intercompany Transfer,ALL,649400.0,0.0,USD,Internal Transfer,Globex Consulting UK Ltd.,***6986,,,True,True,REF-208597,First Continental Bank,***8733,Globex Retail NA LLC,US,6575259.05
2024-08-12,2024-08-12,Client Receipt - CloudBridge Co. #48,Sales Receipt,SaaS-GL,0.0,2305.1,USD,Card Settlement,CloudBridge Co. #48,***6607,INV-202408-SaaS-GL-0008,,False,False,REF-745134,First Continental Bank,***8363,Globex Retail NA LLC,US,6577564.15
2024-08-12,2024-08-12,Client Receipt - Card Settlement Batch #19,Sales Receipt,Retail-NA,0.0,22922.25,USD,Card Settlement,Card Settlement Batch #19,***1264,INV-202408-Retail-NA-0002,,False,False,REF-337449,First Continental Bank,***2396,Globex Retail NA LLC,US,6600486.4
2024-08-12,2024-08-12,Client Receipt - CloudBridge Co. #46,Sales Receipt,SaaS-GL,0.0,26373.2,USD,ACH Credit,CloudBridge Co. #46,***8877,INV-202408-SaaS-GL-0005,,False,False,REF-824793,First Continental Bank,***1112,Globex Retail NA LLC,US,6626859.6
2024-08-13,2024-08-13,Client Receipt - CloudBridge Co. #19,Sales Receipt,SaaS-GL,0.0,5434.01,USD,ACH Credit,CloudBridge Co. #19,***8486,INV-202408-SaaS-GL-0017,,False,False,REF-429691,First Continental Bank,***7126,Globex Retail NA LLC,US,6632293.61
2024-08-13,2024-08-13,Client Receipt - CloudBridge Co. #47,Sales Receipt,SaaS-GL,0.0,5510.96,USD,Card Settlement,CloudBridge Co. #47,***6215,INV-202408-SaaS-GL-0012,,False,False,REF-182471,First Continental Bank,***7674,Globex Retail NA LLC,US,6637804.57
2024-08-13,2024-08-13,Client Receipt - CloudBridge Co. #35,Sales Receipt,SaaS-GL,0.0,5511.41,USD,Card Settlement,CloudBridge Co. #35,***2408,INV-202408-SaaS-GL-0014,,False,False,REF-832691,First Continental Bank,***8244,Globex Retail NA LLC,US,6643315.98
2024-08-13,2024-08-13,Client Receipt - CloudBridge Co. #54,Sales Receipt,SaaS-GL,0.0,32695.34,USD,ACH Credit,CloudBridge Co. #54,***5343,INV-202408-SaaS-GL-0011,,False,False,REF-999835,First Continental Bank,***9527,Globex Retail NA LLC,US,6676011.32
2024-08-14,2024-08-14,Merchant Processing Fees,Bank/Merchant Fees,ALL,628.53,0.0,USD,ACH Debit,First Continental Bank,***5407,,,False,False,REF-722767,First Continental Bank,***7435,Globex Retail NA LLC,US,6675382.79
2024-08-14,2024-08-14,Supplier Payment - CodeCraft Contractors #8,Supplier Payment,SaaS-GL,1218.58,0.0,USD,Fedwire,CodeCraft Contractors #8,***4425,,PO-202408-SaaS-GL-0006,False,False,REF-471415,First Continental Bank,***4735,Globex Retail NA LLC,US,6674164.21
2024-08-14,2024-08-14,Supplier Payment - HyperCloud Infra #9,Supplier Payment,SaaS-GL,13554.44,0.0,USD,ACH Debit,HyperCloud Infra #9,***4675,,PO-202408-SaaS-GL-0002,False,False,REF-271689,First Continental Bank,***1098,Globex Retail NA LLC,US,6660609.77
2024-08-14,2024-08-14,Client Receipt - ShopSphere Partner #51,Sales Receipt,Retail-NA,0.0,17275.46,USD,Card Settlement,ShopSphere Partner #51,***7311,INV-202408-Retail-NA-0007,,False,False,REF-873986,First Continental Bank,***8605,Globex Retail NA LLC,US,6677885.23
2024-08-15,2024-08-15,Supplier Payment - NorthRiver Apparel Mfg #8,Supplier Payment,Retail-NA,25565.71,0.0,USD,ACH Debit,NorthRiver Apparel Mfg #8,***7900,,PO-202408-Retail-NA-0008,False,False,REF-575336,First Continental Bank,***7165,Globex Retail NA LLC,US,6652319.52
2024-08-15,2024-08-15,Supplier Payment - PackFast Fulfillment #16,Supplier Payment,Retail-NA,49712.92,0.0,USD,Fedwire,PackFast Fulfillment #16,***3450,,PO-202408-Retail-NA-0007,False,False,REF-895060,First Continental Bank,***1493,Globex Retail NA LLC,US,6602606.6
2024-08-15,2024-08-15,Client Receipt - ShopSphere Partner #10,Sales Receipt,Retail-NA,0.0,10798.72,USD,Card Settlement,ShopSphere Partner #10,***7702,INV-202408-Retail-NA-0013,,False,False,REF-275008,First Continental Bank,***4828,Globex Retail NA LLC,US,6613405.32
2024-08-16,2024-08-16,Client Receipt - CloudBridge Co. #65,Sales Receipt,SaaS-GL,0.0,5101.23,USD,ACH Credit,CloudBridge Co. #65,***5717,INV-202408-SaaS-GL-0016,,False,False,REF-366718,First Continental Bank,***7839,Globex Retail NA LLC,US,6618506.55
2024-08-16,2024-08-16,Client Receipt - ShopSphere Partner #33,Sales Receipt,Retail-NA,0.0,19425.46,USD,ACH Credit,ShopSphere Partner #33,***4800,INV-202408-Retail-NA-0006,,False,False,REF-204186,First Continental Bank,***7147,Globex Retail NA LLC,US,6637932.01
2024-08-18,2024-08-18,Merchant Processing Fees,Bank/Merchant Fees,ALL,2150.5,0.0,USD,ACH Debit,First Continental Bank,***5936,,,False,False,REF-304517,First Continental Bank,***2991,Globex Retail NA LLC,US,6635781.51
2024-08-18,2024-08-18,VAT/GST Remittance - US IRS,Tax Payment,ALL,53752.84,0.0,USD,Fedwire,US IRS,***8119,,,False,False,REF-337039,First Continental Bank,***4039,Globex Retail NA LLC,US,6582028.67
2024-08-18,2024-08-18,Client Receipt - CloudBridge Co. #57,Sales Receipt,SaaS-GL,0.0,1998.69,USD,ACH Credit,CloudBridge Co. #57,***1665,INV-202408-SaaS-GL-0001,,False,False,REF-337751,First Continental Bank,***5658,Globex Retail NA LLC,US,6584027.36
2024-08-19,2024-08-19,Client Receipt - Vertex Advisory Client #25,Sales Receipt,PS-GL,0.0,12869.42,USD,ACH Credit,Vertex Advisory Client #25,***4378,INV-202408-PS-GL-0001,,False,False,REF-269925,First Continental Bank,***9814,Globex Retail NA LLC,US,6596896.78
2024-08-20,2024-08-20,Supplier Payment - HyperCloud Infra #11,Supplier Payment,SaaS-GL,4697.95,0.0,USD,Fedwire,HyperCloud Infra #11,***5908,,PO-202408-SaaS-GL-0003,False,False,REF-940520,First Continental Bank,***1870,Globex Retail NA LLC,US,6592198.83
2024-08-20,2024-08-20,Supplier Payment - HyperCloud Infra #15,Supplier Payment,SaaS-GL,15659.25,0.0,USD,Fedwire,HyperCloud Infra #15,***8310,,PO-202408-SaaS-GL-0001,False,False,REF-877465,First Continental Bank,***5254,Globex Retail NA LLC,US,6576539.58
2024-08-20,2024-08-20,Client Receipt - CloudBridge Co. #18,Sales Receipt,SaaS-GL,0.0,37696.53,USD,ACH Credit,CloudBridge Co. #18,***5092,INV-202408-SaaS-GL-0004,,False,False,REF-335887,First Continental Bank,***2918,Globex Retail NA LLC,US,6614236.11
2024-08-21,2024-08-21,Supplier Payment - ExpertNet Subcontractors #10,Supplier Payment,PS-GL,909.97,0.0,USD,Fedwire,ExpertNet Subcontractors #10,***3246,,PO-202408-PS-GL-0002,False,False,REF-875108,First Continental Bank,***1334,Globex Retail NA LLC,US,6613326.14
2024-08-21,2024-08-21,Supplier Payment - ExpertNet Subcontractors #7,Supplier Payment,PS-GL,2519.16,0.0,USD,ACH Debit,ExpertNet Subcontractors #7,***6431,,PO-202408-PS-GL-0003,False,False,REF-330344,First Continental Bank,***9621,Globex Retail NA LLC,US,6610806.98
2024-08-21,2024-08-21,Supplier Payment - PackFast Fulfillment #1,Supplier Payment,Retail-NA,4728.67,0.0,USD,ACH Debit,PackFast Fulfillment #1,***7204,,PO-202408-Retail-NA-0005,False,False,REF-643695,First Continental Bank,***6315,Globex Retail NA LLC,US,6606078.31
2024-08-21,2024-08-21,Supplier Payment - HyperCloud Infra #5,Supplier Payment,SaaS-GL,13324.94,0.0,USD,ACH Debit,HyperCloud Infra #5,***5035,,PO-202408-SaaS-GL-0005,False,False,REF-297952,First Continental Bank,***2425,Globex Retail NA LLC,US,6592753.37
2024-08-21,2024-08-21,Client Receipt - Vertex Advisory Client #19,Sales Receipt,PS-GL,0.0,3726.66,USD,Card Settlement,Vertex Advisory Client #19,***9255,INV-202408-PS-GL-0010,,False,False,REF-298870,First Continental Bank,***4479,Globex Retail NA LLC,US,6596480.03
2024-08-21,2024-08-21,Client Receipt - CloudBridge Co. #43,Sales Receipt,SaaS-GL,0.0,7690.67,USD,Card Settlement,CloudBridge Co. #43,***1421,INV-202408-SaaS-GL-0003,,False,False,REF-114913,First Continental Bank,***9976,Globex Retail NA LLC,US,6604170.7
2024-08-21,2024-08-21,Client Receipt - ShopSphere Partner #77,Sales Receipt,Retail-NA,0.0,11436.54,USD,Card Settlement,ShopSphere Partner #77,***2898,INV-202408-Retail-NA-0001,,False,False,REF-178826,First Continental Bank,***1441,Globex Retail NA LLC,US,6615607.24
2024-08-21,2024-08-21,Client Receipt - Vertex Advisory Client #1,Sales Receipt,PS-GL,0.0,31781.7,USD,Card Settlement,Vertex Advisory Client #1,***8758,INV-202408-PS-GL-0002,,False,False,REF-139862,First Continental Bank,***6937,Globex Retail NA LLC,US,6647388.94
2024-08-21,2024-08-21,Client Receipt - CloudBridge Co. #38,Sales Receipt,SaaS-GL,0.0,34332.79,USD,Card Settlement,CloudBridge Co. #38,***9305,INV-202408-SaaS-GL-0006,,False,False,REF-586461,First Continental Bank,***7196,Globex Retail NA LLC,US,6681721.73
2024-08-22,2024-08-22,Marketing - Aurelia Media #3,Marketing,ALL,8588.87,0.0,USD,ACH Debit,Aurelia Media #3,***9211,,,False,False,REF-890855,First Continental Bank,***5212,Globex Retail NA LLC,US,6673132.86
2024-08-22,2024-08-22,Client Receipt - ShopSphere Partner #22,Sales Receipt,Retail-NA,0.0,39661.56,USD,ACH Credit,ShopSphere Partner #22,***3715,INV-202408-Retail-NA-0014,,False,False,REF-165676,First Continental Bank,***2932,Globex Retail NA LLC,US,6712794.42
2024-08-23,2024-08-23,Supplier Payment - ExpertNet Subcontractors #11,Supplier Payment,PS-GL,5100.54,0.0,USD,Fedwire,ExpertNet Subcontractors #11,***2311,,PO-202408-PS-GL-0008,False,False,REF-928056,First Continental Bank,***9600,Globex Retail NA LLC,US,6707693.88
2024-08-23,2024-08-23,Supplier Payment - CodeCraft Contractors #9,Supplier Payment,SaaS-GL,5783.57,0.0,USD,Fedwire,CodeCraft Contractors #9,***3764,,PO-202408-SaaS-GL-0008,False,False,REF-481446,First Continental Bank,***5676,Globex Retail NA LLC,US,6701910.31
2024-08-23,2024-08-23,Skyline Internet Services,Rent & Utilities,ALL,7424.46,0.0,USD,Fedwire,Skyline Internet Services,***3971,,,False,False,REF-681981,First Continental Bank,***6098,Globex Retail NA LLC,US,6694485.85
2024-08-23,2024-08-23,Supplier Payment - PackFast Fulfillment #9,Supplier Payment,Retail-NA,24826.69,0.0,USD,ACH Debit,PackFast Fulfillment #9,***9451,,PO-202408-Retail-NA-0004,False,False,REF-948392,First Continental Bank,***4392,Globex Retail NA LLC,US,6669659.16
2024-08-24,2024-08-24,Supplier Payment - NorthRiver Apparel Mfg #1,Supplier Payment,Retail-NA,2002.5,0.0,USD,ACH Debit,NorthRiver Apparel Mfg #1,***6831,,PO-202408-Retail-NA-0006,False,False,REF-182109,First Continental Bank,***5060,Globex Retail NA LLC,US,6667656.66
2024-08-24,2024-08-24,Supplier Payment - CodeCraft Contractors #2,Supplier Payment,SaaS-GL,14338.25,0.0,USD,ACH Debit,CodeCraft Contractors #2,***9187,,PO-202408-SaaS-GL-0004,False,False,REF-775549,First Continental Bank,***9867,Globex Retail NA LLC,US,6653318.41
2024-08-25,2024-08-25,Payroll - GlobalPay Services Ltd,Payroll,ALL,73177.53,0.0,USD,Fedwire,GlobalPay Services Ltd,***1928,,,False,False,REF-939309,First Continental Bank,***3128,Globex Retail NA LLC,US,6580140.88
2024-08-25,2024-08-25,Client Receipt - ShopSphere Partner #62,Sales Receipt,Retail-NA,0.0,26388.95,USD,Card Settlement,ShopSphere Partner #62,***1765,INV-202408-Retail-NA-0017,,False,False,REF-425649,First Continental Bank,***7737,Globex Retail NA LLC,US,6606529.83
2024-08-26,2024-08-26,Intercompany Settlement - Globex APAC Logistics Pte. Ltd.,Intercompany Transfer,ALL,572448.0,0.0,USD,Internal Transfer,Globex APAC Logistics Pte. Ltd.,***8691,,,True,True,REF-671888,First Continental Bank,***1878,Globex Retail NA LLC,US,6034081.83
2024-08-26,2024-08-26,Client Receipt - Vertex Advisory Client #2,Sales Receipt,PS-GL,0.0,13717.69,USD,ACH Credit,Vertex Advisory Client #2,***2409,INV-202408-PS-GL-0005,,False,False,REF-331012,First Continental Bank,***7019,Globex Retail NA LLC,US,6047799.52
2024-08-27,2024-08-27,Supplier Payment - NorthRiver Apparel Mfg #2,Supplier Payment,Retail-NA,10992.79,0.0,USD,Fedwire,NorthRiver Apparel Mfg #2,***6752,,PO-202408-Retail-NA-0002,False,False,REF-925407,First Continental Bank,***1313,Globex Retail NA LLC,US,6036806.73
2024-08-27,2024-08-27,Client Receipt - Vertex Advisory Client #10,Sales Receipt,PS-GL,0.0,1694.29,USD,Card Settlement,Vertex Advisory Client #10,***4948,INV-202408-PS-GL-0007,,False,False,REF-356604,First Continental Bank,***1840,Globex Retail NA LLC,US,6038501.02
2024-08-27,2024-08-27,Client Receipt - ShopSphere Partner #39,Sales Receipt,Retail-NA,0.0,14503.69,USD,Card Settlement,ShopSphere Partner #39,***4840,INV-202408-Retail-NA-0010,,False,False,REF-476795,First Continental Bank,***1001,Globex Retail NA LLC,US,6053004.71
2024-08-28,2024-08-28,Payroll - GlobalPay Services Ltd,Payroll,ALL,73177.53,0.0,USD,Fedwire,GlobalPay Services Ltd,***3097,,,False,False,REF-221436,First Continental Bank,***5636,Globex Retail NA LLC,US,5979827.18
2024-08-28,2024-08-28,Client Receipt - Card Settlement Batch #19,Sales Receipt,Retail-NA,0.0,10519.76,USD,Card Settlement,Card Settlement Batch #19,***9267,INV-202408-Retail-NA-0009,,False,False,REF-890280,First Continental Bank,***1440,Globex Retail NA LLC,US,5990346.94
2024-08-29,2024-08-29,Supplier Payment - HyperCloud Infra #12,Supplier Payment,SaaS-GL,2004.63,0.0,USD,Fedwire,HyperCloud Infra #12,***8399,,PO-202408-SaaS-GL-0007,False,False,REF-494044,First Continental Bank,***8841,Globex Retail NA LLC,US,5988342.31
2024-08-29,2024-08-29,Supplier Payment - ExpertNet Subcontractors #5,Supplier Payment,PS-GL,26863.98,0.0,USD,ACH Debit,ExpertNet Subcontractors #5,***9774,,PO-202408-PS-GL-0007,False,False,REF-269620,First Continental Bank,***1211,Globex Retail NA LLC,US,5961478.33
2024-08-29,2024-08-29,Supplier Payment - PackFast Fulfillment #16,Supplier Payment,Retail-NA,46517.58,0.0,USD,ACH Debit,PackFast Fulfillment #16,***8927,,PO-202408-Retail-NA-0003,False,False,REF-621314,First Continental Bank,***7664,Globex Retail NA LLC,US,5914960.75
2024-08-29,2024-08-29,Client Receipt - ShopSphere Partner #7,Sales Receipt,Retail-NA,0.0,2639.17,USD,ACH Credit,ShopSphere Partner #7,***4811,INV-202408-Retail-NA-0016,,False,False,REF-829889,First Continental Bank,***4459,Globex Retail NA LLC,US,5917599.92
2024-08-29,2024-08-29,Client Receipt - CloudBridge Co. #52,Sales Receipt,SaaS-GL,0.0,9057.63,USD,Card Settlement,CloudBridge Co. #52,***7802,INV-202408-SaaS-GL-0007,,False,False,REF-196120,First Continental Bank,***3118,Globex Retail NA LLC,US,5926657.55
2024-08-29,2024-08-29,Client Receipt - ShopSphere Partner #22,Sales Receipt,Retail-NA,0.0,18565.98,USD,ACH Credit,ShopSphere Partner #22,***6972,INV-202408-Retail-NA-0008,,False,False,REF-916371,First Continental Bank,***2852,Globex Retail NA LLC,US,5945223.53
2024-08-29,2024-08-29,Client Receipt - ShopSphere Partner #44,Sales Receipt,Retail-NA,0.0,54012.85,USD,ACH Credit,ShopSphere Partner #44,***5067,INV-202408-Retail-NA-0004,,False,False,REF-964683,First Continental Bank,***6540,Globex Retail NA LLC,US,5999236.38
2024-08-30,2024-08-30,Supplier Payment - PackFast Fulfillment #6,Supplier Payment,Retail-NA,51319.18,0.0,USD,Fedwire,PackFast Fulfillment #6,***7356,,PO-202408-Retail-NA-0001,False,False,REF-946500,First Continental Bank,***1750,Globex Retail NA LLC,US,5947917.2
2024-08-30,2024-08-30,Client Receipt - Vertex Advisory Client #18,Sales Receipt,PS-GL,0.0,11072.15,USD,Card Settlement,Vertex Advisory Client #18,***7155,INV-202408-PS-GL-0011,,False,False,REF-375403,First Continental Bank,***5228,Globex Retail NA LLC,US,5958989.35
2024-08-30,2024-08-30,Interest Earned,Interest Income,ALL,0.0,12282.32,USD,Card Settlement,First Continental Bank,***9209,,,False,False,REF-500260,First Continental Bank,***3156,Globex Retail NA LLC,US,5971271.67
2024-08-30,2024-08-30,Client Receipt - Card Settlement Batch #18,Sales Receipt,Retail-NA,0.0,20435.86,USD,Card Settlement,Card Settlement Batch #18,***2553,INV-202408-Retail-NA-0003,,False,False,REF-123775,First Continental Bank,***5583,Globex Retail NA LLC,US,5991707.53
2024-08-30,2024-08-30,Client Receipt - ShopSphere Partner #14,Sales Receipt,Retail-NA,0.0,23690.78,USD,Card Settlement,ShopSphere Partner #14,***8223,INV-202408-Retail-NA-0012,,False,False,REF-809702,First Continental Bank,***1743,Globex Retail NA LLC,US,6015398.31
2024-08-30,2024-08-30,Client Receipt - CloudBridge Co. #40,Sales Receipt,SaaS-GL,0.0,28133.42,USD,ACH Credit,CloudBridge Co. #40,***6522,INV-202408-SaaS-GL-0021,,False,False,REF-870509,First Continental Bank,***2364,Globex Retail NA LLC,US,6043531.73
2024-08-31,2024-08-31,Client Receipt - CloudBridge Co. #14,Sales Receipt,SaaS-GL,0.0,17823.5,USD,Card Settlement,CloudBridge Co. #14,***1996,INV-202408-SaaS-GL-0019,,False,False,REF-709935,First Continental Bank,***7885,Globex Retail NA LLC,US,6061355.23
2024-08-31,2024-08-31,Client Receipt - Vertex Advisory Client #38,Sales Receipt,PS-GL,0.0,23712.75,USD,ACH Credit,Vertex Advisory Client #38,***6472,INV-202408-PS-GL-0004,,False,False,REF-181875,First Continental Bank,***1749,Globex Retail NA LLC,US,6085067.98
2024-09-01,2024-09-01,Account Maintenance Fee,Bank/Merchant Fees,ALL,2500.0,0.0,USD,Fedwire,First Continental Bank,***8184,,,False,False,REF-817147,First Continental Bank,***6825,Globex Retail NA LLC,US,6082567.98
2024-09-01,2024-09-01,Metro Water & Waste,Rent & Utilities,ALL,4055.26,0.0,USD,Fedwire,Metro Water & Waste,***6878,,,False,False,REF-280702,First Continental Bank,***8908,Globex Retail NA LLC,US,6078512.72
2024-09-02,2024-09-02,Client Receipt - Vertex Advisory Client #40,Sales Receipt,PS-GL,0.0,32277.4,USD,ACH Credit,Vertex Advisory Client #40,***9690,INV-202409-PS-GL-0001,,False,False,REF-102377,First Continental Bank,***6240,Globex Retail NA LLC,US,6110790.12
2024-09-03,2024-09-03,Supplier Payment - HyperCloud Infra #17,Supplier Payment,SaaS-GL,1885.17,0.0,USD,Fedwire,HyperCloud Infra #17,***3962,,PO-202409-SaaS-GL-0005,False,False,REF-359278,First Continental Bank,***4589,Globex Retail NA LLC,US,6108904.95
2024-09-03,2024-09-03,Client Receipt - ShopSphere Partner #69,Sales Receipt,Retail-NA,0.0,16378.66,USD,Card Settlement,ShopSphere Partner #69,***1016,INV-202409-Retail-NA-0003,,False,False,REF-901261,First Continental Bank,***6266,Globex Retail NA LLC,US,6125283.61
2024-09-03,2024-09-03,Client Receipt - ShopSphere Partner #9,Sales Receipt,Retail-NA,0.0,33488.89,USD,ACH Credit,ShopSphere Partner #9,***3754,INV-202409-Retail-NA-0005,,False,False,REF-159290,First Continental Bank,***8942,Globex Retail NA LLC,US,6158772.5
2024-09-04,2024-09-04,Supplier Payment - CodeCraft Contractors #11,Supplier Payment,SaaS-GL,7818.48,0.0,USD,Fedwire,CodeCraft Contractors #11,***9861,,PO-202409-SaaS-GL-0001,False,False,REF-192956,First Continental Bank,***5398,Globex Retail NA LLC,US,6150954.02
2024-09-04,2024-09-04,Client Receipt - CloudBridge Co. #27,Sales Receipt,SaaS-GL,0.0,7741.8,USD,Card Settlement,CloudBridge Co. #27,***2749,INV-202409-SaaS-GL-0006,,False,False,REF-449471,First Continental Bank,***3906,Globex Retail NA LLC,US,6158695.82
2024-09-05,2024-09-05,Client Receipt - CloudBridge Co. #70,Sales Receipt,SaaS-GL,0.0,16563.1,USD,ACH Credit,CloudBridge Co. #70,***4631,INV-202409-SaaS-GL-0017,,False,False,REF-887094,First Continental Bank,***3742,Globex Retail NA LLC,US,6175258.92
2024-09-05,2024-09-05,Client Receipt - CloudBridge Co. #41,Sales Receipt,SaaS-GL,0.0,30178.58,USD,Card Settlement,CloudBridge Co. #41,***3931,INV-202409-SaaS-GL-0004,,False,False,REF-467402,First Continental Bank,***1300,Globex Retail NA LLC,US,6205437.5
2024-09-06,2024-09-06,Supplier Payment - NorthRiver Apparel Mfg #4,Supplier Payment,Retail-NA,15143.82,0.0,USD,ACH Debit,NorthRiver Apparel Mfg #4,***1938,,PO-202409-Retail-NA-0004,False,False,REF-714406,First Continental Bank,***1652,Globex Retail NA LLC,US,6190293.68
2024-09-06,2024-09-06,Client Receipt - CloudBridge Co. #77,Sales Receipt,SaaS-GL,0.0,6783.06,USD,ACH Credit,CloudBridge Co. #77,***3823,INV-202409-SaaS-GL-0008,,False,False,REF-939296,First Continental Bank,***7574,Globex Retail NA LLC,US,6197076.74
2024-09-06,2024-09-06,Client Receipt - ShopSphere Partner #50,Sales Receipt,Retail-NA,0.0,54330.28,USD,ACH Credit,ShopSphere Partner #50,***1481,INV-202409-Retail-NA-0007,,False,False,REF-148284,First Continental Bank,***4626,Globex Retail NA LLC,US,6251407.02
2024-09-07,2024-09-07,Supplier Payment - HyperCloud Infra #19,Supplier Payment,SaaS-GL,22857.92,0.0,USD,ACH Debit,HyperCloud Infra #19,***8684,,PO-202409-SaaS-GL-0007,False,False,REF-115075,First Continental Bank,***7836,Globex Retail NA LLC,US,6228549.1
2024-09-07,2024-09-07,Client Receipt - CloudBridge Co. #53,Sales Receipt,SaaS-GL,0.0,14091.11,USD,ACH Credit,CloudBridge Co. #53,***8937,INV-202409-SaaS-GL-0002,,False,False,REF-482661,First Continental Bank,***6835,Globex Retail NA LLC,US,6242640.21
2024-09-07,2024-09-07,Client Receipt - ShopSphere Partner #12,Sales Receipt,Retail-NA,0.0,77258.83,USD,ACH Credit,ShopSphere Partner #12,***3216,INV-202409-Retail-NA-0002,,False,False,REF-503583,First Continental Bank,***9715,Globex Retail NA LLC,US,6319899.04
2024-09-08,2024-09-08,Merchant Processing Fees,Bank/Merchant Fees,ALL,933.92,0.0,USD,ACH Debit,First Continental Bank,***7930,,,False,False,REF-187654,First Continental Bank,***3978,Globex Retail NA LLC,US,6318965.12
2024-09-08,2024-09-08,Supplier Payment - CodeCraft Contractors #10,Supplier Payment,SaaS-GL,1106.44,0.0,USD,ACH Debit,CodeCraft Contractors #10,***8089,,PO-202409-SaaS-GL-0004,False,False,REF-252299,First Continental Bank,***1309,Globex Retail NA LLC,US,6317858.68
2024-09-09,2024-09-09,Marketing - Aurelia Media #8,Marketing,ALL,4781.02,0.0,USD,ACH Debit,Aurelia Media #8,***1068,,,False,False,REF-521709,First Continental Bank,***4979,Globex Retail NA LLC,US,6313077.66
2024-09-10,2024-09-10,Supplier Payment - ExpertNet Subcontractors #14,Supplier Payment,PS-GL,7204.0,0.0,USD,Fedwire,ExpertNet Subcontractors #14,***1095,,PO-202409-PS-GL-0007,False,False,REF-565597,First Continental Bank,***2704,Globex Retail NA LLC,US,6305873.66
2024-09-10,2024-09-10,Supplier Payment - NorthRiver Apparel Mfg #7,Supplier Payment,Retail-NA,40581.64,0.0,USD,ACH Debit,NorthRiver Apparel Mfg #7,***3737,,PO-202409-Retail-NA-0010,False,False,REF-869297,First Continental Bank,***9821,Globex Retail NA LLC,US,6265292.02
2024-09-10,2024-09-10,Client Receipt - CloudBridge Co. #59,Sales Receipt,SaaS-GL,0.0,11524.45,USD,ACH Credit,CloudBridge Co. #59,***6726,INV-202409-SaaS-GL-0003,,False,False,REF-767030,First Continental Bank,***6260,Globex Retail NA LLC,US,6276816.47
2024-09-10,2024-09-10,Client Receipt - CloudBridge Co. #65,Sales Receipt,SaaS-GL,0.0,16566.74,USD,ACH Credit,CloudBridge Co. #65,***9234,INV-202409-SaaS-GL-0001,,False,False,REF-938696,First Continental Bank,***9598,Globex Retail NA LLC,US,6293383.21
2024-09-10,2024-09-10,Client Receipt - CloudBridge Co. #36,Sales Receipt,SaaS-GL,0.0,24467.29,USD,ACH Credit,CloudBridge Co. #36,***8536,INV-202409-SaaS-GL-0015,,False,False,REF-289626,First Continental Bank,***9816,Globex Retail NA LLC,US,6317850.5
2024-09-10,2024-09-10,Client Receipt - Card Settlement Batch #2,Sales Receipt,Retail-NA,0.0,95297.86,USD,ACH Credit,Card Settlement Batch #2,***1881,INV-202409-Retail-NA-0010,,False,False,REF-436410,First Continental Bank,***2900,Globex Retail NA LLC,US,6413148.36
2024-09-11,2024-09-11,Marketing - Aurelia Media #2,Marketing,ALL,3516.69,0.0,USD,ACH Debit,Aurelia Media #2,***8441,,,False,False,REF-648250,First Continental Bank,***6129,Globex Retail NA LLC,US,6409631.67
2024-09-11,2024-09-11,Supplier Payment - CodeCraft Contractors #12,Supplier Payment,SaaS-GL,8977.31,0.0,USD,Fedwire,CodeCraft Contractors #12,***9095,,PO-202409-SaaS-GL-0008,False,False,REF-724132,First Continental Bank,***2192,Globex Retail NA LLC,US,6400654.36
2024-09-11,2024-09-11,Client Receipt - CloudBridge Co. #60,Sales Receipt,SaaS-GL,0.0,2222.77,USD,ACH Credit,CloudBridge Co. #60,***5259,INV-202409-SaaS-GL-0021,,False,False,REF-850904,First Continental Bank,***3242,Globex Retail NA LLC,US,6402877.13
2024-09-11,2024-09-11,Client Receipt - Vertex Advisory Client #25,Sales Receipt,PS-GL,0.0,2917.4,USD,ACH Credit,Vertex Advisory Client #25,***1726,INV-202409-PS-GL-0008,,False,False,REF-673181,First Continental Bank,***2022,Globex Retail NA LLC,US,6405794.53
2024-09-11,2024-09-11,Client Receipt - ShopSphere Partner #13,Sales Receipt,Retail-NA,0.0,9768.33,USD,ACH Credit,ShopSphere Partner #13,***4963,INV-202409-Retail-NA-0009,,False,False,REF-332326,First Continental Bank,***1375,Globex Retail NA LLC,US,6415562.86
2024-09-12,2024-09-12,Supplier Payment - CodeCraft Contractors #2,Supplier Payment,SaaS-GL,4556.14,0.0,USD,Fedwire,CodeCraft Contractors #2,***9945,,PO-202409-SaaS-GL-0011,False,False,REF-525342,First Continental Bank,***9768,Globex Retail NA LLC,US,6411006.72
2024-09-12,2024-09-12,Supplier Payment - ExpertNet Subcontractors #11,Supplier Payment,PS-GL,6321.95,0.0,USD,Fedwire,ExpertNet Subcontractors #11,***8603,,PO-202409-PS-GL-0002,False,False,REF-241832,First Continental Bank,***7398,Globex Retail NA LLC,US,6404684.77
2024-09-12,2024-09-12,Intercompany Settlement - Globex EMEA Manufacturing Ltd.,Intercompany Transfer,ALL,249116.0,0.0,USD,Internal Transfer,Globex EMEA Manufacturing Ltd.,***4643,,,True,True,REF-382904,First Continental Bank,***5849,Globex Retail NA LLC,US,6155568.77
2024-09-12,2024-09-12,Client Receipt - ShopSphere Partner #77,Sales Receipt,Retail-NA,0.0,12264.68,USD,Card Settlement,ShopSphere Partner #77,***3666,INV-202409-Retail-NA-0001,,False,False,REF-401899,First Continental Bank,***5847,Globex Retail NA LLC,US,6167833.45
2024-09-13,2024-09-13,Supplier Payment - ExpertNet Subcontractors #17,Supplier Payment,PS-GL,1450.72,0.0,USD,ACH Debit,ExpertNet Subcontractors #17,***8461,,PO-202409-PS-GL-0009,False,False,REF-316899,First Continental Bank,***6966,Globex Retail NA LLC,US,6166382.73
2024-09-13,2024-09-13,Client Receipt - Vertex Advisory Client #34,Sales Receipt,PS-GL,0.0,59010.52,USD,ACH Credit,Vertex Advisory Client #34,***7012,INV-202409-PS-GL-0002,,False,False,REF-434181,First Continental Bank,***1399,Globex Retail NA LLC,US,6225393.25
2024-09-13,2024-09-13,Client Receipt - ShopSphere Partner #8,Sales Receipt,Retail-NA,0.0,86887.58,USD,ACH Credit,ShopSphere Partner #8,***2908,INV-202409-Retail-NA-0006,,False,False,REF-220478,First Continental Bank,***6729,Globex Retail NA LLC,US,6312280.83
2024-09-15,2024-09-15,Supplier Payment - CodeCraft Contractors #9,Supplier Payment,SaaS-GL,2345.51,0.0,USD,ACH Debit,CodeCraft Contractors #9,***1550,,PO-202409-SaaS-GL-0010,False,False,REF-729785,First Continental Bank,***7960,Globex Retail NA LLC,US,6309935.32
2024-09-15,2024-09-15,Supplier Payment - ExpertNet Subcontractors #7,Supplier Payment,PS-GL,2822.29,0.0,USD,Fedwire,ExpertNet Subcontractors #7,***6106,,PO-202409-PS-GL-0004,False,False,REF-219870,First Continental Bank,***5833,Globex Retail NA LLC,US,6307113.03
2024-09-15,2024-09-15,Client Receipt - CloudBridge Co. #45,Sales Receipt,SaaS-GL,0.0,9349.34,USD,Card Settlement,CloudBridge Co. #45,***9406,INV-202409-SaaS-GL-0023,,False,False,REF-503345,First Continental Bank,***6727,Globex Retail NA LLC,US,6316462.37
2024-09-15,2024-09-15,Client Receipt - CloudBridge Co. #37,Sales Receipt,SaaS-GL,0.0,12032.45,USD,Card Settlement,CloudBridge Co. #37,***5672,INV-202409-SaaS-GL-0024,,False,False,REF-484233,First Continental Bank,***7515,Globex Retail NA LLC,US,6328494.82
2024-09-16,2024-09-16,Supplier Payment - HyperCloud Infra #13,Supplier Payment,SaaS-GL,12397.14,0.0,USD,ACH Debit,HyperCloud Infra #13,***4112,,PO-202409-SaaS-GL-0006,False,False,REF-177941,First Continental Bank,***7074,Globex Retail NA LLC,US,6316097.68
2024-09-16,2024-09-16,Client Receipt - CloudBridge Co. #67,Sales Receipt,SaaS-GL,0.0,625.26,USD,ACH Credit,CloudBridge Co. #67,***8589,INV-202409-SaaS-GL-0016,,False,False,REF-811536,First Continental Bank,***3119,Globex Retail NA LLC,US,6316722.94
2024-09-16,2024-09-16,Client Receipt - CloudBridge Co. #16,Sales Receipt,SaaS-GL,0.0,8122.03,USD,ACH Credit,CloudBridge Co. #16,***9447,INV-202409-SaaS-GL-0012,,False,False,REF-513495,First Continental Bank,***2331,Globex Retail NA LLC,US,6324844.97
2024-09-16,2024-09-16,Client Receipt - Vertex Advisory Client #25,Sales Receipt,PS-GL,0.0,16750.71,USD,Card Settlement,Vertex Advisory Client #25,***7093,INV-202409-PS-GL-0004,,False,False,REF-788848,First Continental Bank,***7213,Globex Retail NA LLC,US,6341595.68
2024-09-17,2024-09-17,Supplier Payment - NorthRiver Apparel Mfg #23,Supplier Payment,Retail-NA,9033.48,0.0,USD,Fedwire,NorthRiver Apparel Mfg #23,***8889,,PO-202409-Retail-NA-0003,False,False,REF-227824,First Continental Bank,***4328,Globex Retail NA LLC,US,6332562.2
2024-09-17,2024-09-17,Client Receipt - CloudBridge Co. #47,Sales Receipt,SaaS-GL,0.0,11474.35,USD,ACH Credit,CloudBridge Co. #47,***2004,INV-202409-SaaS-GL-0020,,False,False,REF-369084,First Continental Bank,***5129,Globex Retail NA LLC,US,6344036.55
2024-09-17,2024-09-17,Client Receipt - CloudBridge Co. #23,Sales Receipt,SaaS-GL,0.0,17851.56,USD,ACH Credit,CloudBridge Co. #23,***9900,INV-202409-SaaS-GL-0010,,False,False,REF-424311,First Continental Bank,***2369,Globex Retail NA LLC,US,6361888.11
2024-09-17,2024-09-17,Client Receipt - CloudBridge Co. #60,Sales Receipt,SaaS-GL,0.0,19955.86,USD,ACH Credit,CloudBridge Co. #60,***1383,INV-202409-SaaS-GL-0025,,False,False,REF-670393,First Continental Bank,***9801,Globex Retail NA LLC,US,6381843.97
2024-09-17,2024-09-17,Client Receipt - ShopSphere Partner #16,Sales Receipt,Retail-NA,0.0,23854.64,USD,ACH Credit,ShopSphere Partner #16,***2966,INV-202409-Retail-NA-0008,,False,False,REF-686276,First Continental Bank,***9464,Globex Retail NA LLC,US,6405698.61
2024-09-18,2024-09-18,Client Receipt - CloudBridge Co. #78,Sales Receipt,SaaS-GL,0.0,17067.47,USD,Card Settlement,CloudBridge Co. #78,***1767,INV-202409-SaaS-GL-0027,,False,False,REF-975921,First Continental Bank,***5038,Globex Retail NA LLC,US,6422766.08
2024-09-18,2024-09-18,Client Receipt - Vertex Advisory Client #30,Sales Receipt,PS-GL,0.0,30374.56,USD,Card Settlement,Vertex Advisory Client #30,***7996,INV-202409-PS-GL-0007,,False,False,REF-204348,First Continental Bank,***1969,Globex Retail NA LLC,US,6453140.64
2024-09-19,2024-09-19,Merchant Processing Fees,Bank/Merchant Fees,ALL,2091.6,0.0,USD,Fedwire,First Continental Bank,***3273,,,False,False,REF-146063,First Continental Bank,***2668,Globex Retail NA LLC,US,6451049.04
2024-09-19,2024-09-19,Supplier Payment - PackFast Fulfillment #18,Supplier Payment,Retail-NA,3292.26,0.0,USD,ACH Debit,PackFast Fulfillment #18,***9338,,PO-202409-Retail-NA-0005,False,False,REF-934205,First Continental Bank,***3781,Globex Retail NA LLC,US,6447756.78
2024-09-19,2024-09-19,BluePeak Property Mgmt,Rent & Utilities,ALL,3787.0,0.0,USD,Fedwire,BluePeak Property Mgmt,***5832,,,False,False,REF-909801,First Continental Bank,***1800,Globex Retail NA LLC,US,6443969.78
2024-09-19,2024-09-19,Client Receipt - CloudBridge Co. #30,Sales Receipt,SaaS-GL,0.0,4584.61,USD,Card Settlement,CloudBridge Co. #30,***4744,INV-202409-SaaS-GL-0007,,False,False,REF-272622,First Continental Bank,***9240,Globex Retail NA LLC,US,6448554.39
2024-09-19,2024-09-19,Client Receipt - CloudBridge Co. #3,Sales Receipt,SaaS-GL,0.0,13706.16,USD,ACH Credit,CloudBridge Co. #3,***6882,INV-202409-SaaS-GL-0013,,False,False,REF-566756,First Continental Bank,***1073,Globex Retail NA LLC,US,6462260.55
2024-09-19,2024-09-19,Client Receipt - CloudBridge Co. #19,Sales Receipt,SaaS-GL,0.0,19535.66,USD,ACH Credit,CloudBridge Co. #19,***4071,INV-202409-SaaS-GL-0019,,False,False,REF-800997,First Continental Bank,***5097,Globex Retail NA LLC,US,6481796.21
2024-09-20,2024-09-20,Supplier Payment - NorthRiver Apparel Mfg #34,Supplier Payment,Retail-NA,18670.44,0.0,USD,ACH Debit,NorthRiver Apparel Mfg #34,***5500,,PO-202409-Retail-NA-0001,False,False,REF-672667,First Continental Bank,***4758,Globex Retail NA LLC,US,6463125.77
2024-09-20,2024-09-20,Client Receipt - Vertex Advisory Client #48,Sales Receipt,PS-GL,0.0,22037.09,USD,ACH Credit,Vertex Advisory Client #48,***5779,INV-202409-PS-GL-0005,,False,False,REF-861485,First Continental Bank,***8171,Globex Retail NA LLC,US,6485162.86
2024-09-21,2024-09-21,VAT/GST Remittance - US IRS,Tax Payment,ALL,56637.51,0.0,USD,ACH Debit,US IRS,***7505,,,False,False,REF-723071,First Continental Bank,***1376,Globex Retail NA LLC,US,6428525.35
2024-09-22,2024-09-22,Client Receipt - CloudBridge Co. #17,Sales Receipt,SaaS-GL,0.0,2581.6,USD,Card Settlement,CloudBridge Co. #17,***9421,INV-202409-SaaS-GL-0009,,False,False,REF-750186,First Continental Bank,***2562,Globex Retail NA LLC,US,6431106.95
2024-09-23,2024-09-23,Supplier Payment - HyperCloud Infra #12,Supplier Payment,SaaS-GL,4593.86,0.0,USD,Fedwire,HyperCloud Infra #12,***7896,,PO-202409-SaaS-GL-0002,False,False,REF-305098,First Continental Bank,***1902,Globex Retail NA LLC,US,6426513.09
2024-09-23,2024-09-23,Supplier Payment - ExpertNet Subcontractors #13,Supplier Payment,PS-GL,31466.64,0.0,USD,Fedwire,ExpertNet Subcontractors #13,***3349,,PO-202409-PS-GL-0003,False,False,REF-988603,First Continental Bank,***9635,Globex Retail NA LLC,US,6395046.45
2024-09-23,2024-09-23,Client Receipt - CloudBridge Co. #18,Sales Receipt,SaaS-GL,0.0,8481.3,USD,Card Settlement,CloudBridge Co. #18,***4043,INV-202409-SaaS-GL-0005,,False,False,REF-826431,First Continental Bank,***6929,Globex Retail NA LLC,US,6403527.75
2024-09-23,2024-09-23,Client Receipt - Vertex Advisory Client #22,Sales Receipt,PS-GL,0.0,56127.96,USD,ACH Credit,Vertex Advisory Client #22,***7960,INV-202409-PS-GL-0003,,False,False,REF-845856,First Continental Bank,***7427,Globex Retail NA LLC,US,6459655.71
2024-09-24,2024-09-24,Supplier Payment - NorthRiver Apparel Mfg #34,Supplier Payment,Retail-NA,6307.25,0.0,USD,Fedwire,NorthRiver Apparel Mfg #34,***6126,,PO-202409-Retail-NA-0012,False,False,REF-919770,First Continental Bank,***5482,Globex Retail NA LLC,US,6453348.46
2024-09-24,2024-09-24,Supplier Payment - HyperCloud Infra #6,Supplier Payment,SaaS-GL,6562.94,0.0,USD,ACH Debit,HyperCloud Infra #6,***7154,,PO-202409-SaaS-GL-0009,False,False,REF-695916,First Continental Bank,***2233,Globex Retail NA LLC,US,6446785.52
2024-09-24,2024-09-24,Client Receipt - CloudBridge Co. #37,Sales Receipt,SaaS-GL,0.0,4385.51,USD,Card Settlement,CloudBridge Co. #37,***5376,INV-202409-SaaS-GL-0018,,False,False,REF-748952,First Continental Bank,***4767,Globex Retail NA LLC,US,6451171.03
2024-09-24,2024-09-24,Client Receipt - CloudBridge Co. #11,Sales Receipt,SaaS-GL,0.0,8801.11,USD,ACH Credit,CloudBridge Co. #11,***5559,INV-202409-SaaS-GL-0022,,False,False,REF-350505,First Continental Bank,***3562,Globex Retail NA LLC,US,6459972.14
2024-09-24,2024-09-24,Client Receipt - CloudBridge Co. #76,Sales Receipt,SaaS-GL,0.0,21870.69,USD,Card Settlement,CloudBridge Co. #76,***4503,INV-202409-SaaS-GL-0011,,False,False,REF-171878,First Continental Bank,***8764,Globex Retail NA LLC,US,6481842.83
2024-09-25,2024-09-25,Supplier Payment - ExpertNet Subcontractors #14,Supplier Payment,PS-GL,15373.71,0.0,USD,Fedwire,ExpertNet Subcontractors #14,***7274,,PO-202409-PS-GL-0006,False,False,REF-210516,First Continental Bank,***8228,Globex Retail NA LLC,US,6466469.12
2024-09-25,2024-09-25,Marketing - Beacon Digital #3,Marketing,ALL,15945.88,0.0,USD,Fedwire,Beacon Digital #3,***1276,,,False,False,REF-135873,First Continental Bank,***4865,Globex Retail NA LLC,US,6450523.24
2024-09-25,2024-09-25,Client Receipt - CloudBridge Co. #54,Sales Receipt,SaaS-GL,0.0,22456.52,USD,Card Settlement,CloudBridge Co. #54,***8585,INV-202409-SaaS-GL-0014,,False,False,REF-644557,First Continental Bank,***3353,Globex Retail NA LLC,US,6472979.76
2024-09-26,2024-09-26,Supplier Payment - PackFast Fulfillment #1,Supplier Payment,Retail-NA,26564.19,0.0,USD,Fedwire,PackFast Fulfillment #1,***1898,,PO-202409-Retail-NA-0002,False,False,REF-932448,First Continental Bank,***5710,Globex Retail NA LLC,US,6446415.57
2024-09-26,2024-09-26,Supplier Payment - NorthRiver Apparel Mfg #17,Supplier Payment,Retail-NA,38234.99,0.0,USD,Fedwire,NorthRiver Apparel Mfg #17,***1240,,PO-202409-Retail-NA-0009,False,False,REF-481695,First Continental Bank,***6613,Globex Retail NA LLC,US,6408180.58
2024-09-26,2024-09-26,Intercompany Settlement - Globex APAC Logistics Pte. Ltd.,Intercompany Transfer,ALL,512323.0,0.0,USD,Internal Transfer,Globex APAC Logistics Pte. Ltd.,***8873,,,True,True,REF-352405,First Continental Bank,***2233,Globex Retail NA LLC,US,5895857.58
2024-09-26,2024-09-26,Client Receipt - Vertex Advisory Client #23,Sales Receipt,PS-GL,0.0,5645.07,USD,Card Settlement,Vertex Advisory Client #23,***2396,INV-202409-PS-GL-0006,,False,False,REF-795617,First Continental Bank,***4229,Globex Retail NA LLC,US,5901502.65
2024-09-27,2024-09-27,Supplier Payment - ExpertNet Subcontractors #10,Supplier Payment,PS-GL,813.51,0.0,USD,ACH Debit,ExpertNet Subcontractors #10,***3051,,PO-202409-PS-GL-0005,False,False,REF-269420,First Continental Bank,***3522,Globex Retail NA LLC,US,5900689.14
2024-09-27,2024-09-27,Supplier Payment - HyperCloud Infra #5,Supplier Payment,SaaS-GL,1195.53,0.0,USD,Fedwire,HyperCloud Infra #5,***2307,,PO-202409-SaaS-GL-0003,False,False,REF-451183,First Continental Bank,***8333,Globex Retail NA LLC,US,5899493.61
2024-09-27,2024-09-27,Supplier Payment - NorthRiver Apparel Mfg #18,Supplier Payment,Retail-NA,7073.13,0.0,USD,ACH Debit,NorthRiver Apparel Mfg #18,***3955,,PO-202409-Retail-NA-0007,False,False,REF-141527,First Continental Bank,***5029,Globex Retail NA LLC,US,5892420.48
2024-09-27,2024-09-27,Supplier Payment - PackFast Fulfillment #8,Supplier Payment,Retail-NA,9283.7,0.0,USD,ACH Debit,PackFast Fulfillment #8,***1385,,PO-202409-Retail-NA-0008,False,False,REF-496129,First Continental Bank,***9862,Globex Retail NA LLC,US,5883136.78
2024-09-27,2024-09-27,Supplier Payment - PackFast Fulfillment #12,Supplier Payment,Retail-NA,20807.44,0.0,USD,ACH Debit,PackFast Fulfillment #12,***3443,,PO-202409-Retail-NA-0011,False,False,REF-293605,First Continental Bank,***6458,Globex Retail NA LLC,US,5862329.34
2024-09-27,2024-09-27,Client Receipt - ShopSphere Partner #66,Sales Receipt,Retail-NA,0.0,3228.22,USD,Card Settlement,ShopSphere Partner #66,***5056,INV-202409-Retail-NA-0004,,False,False,REF-504412,First Continental Bank,***7739,Globex Retail NA LLC,US,5865557.56
2024-09-28,2024-09-28,Supplier Payment - ExpertNet Subcontractors #3,Supplier Payment,PS-GL,1061.58,0.0,USD,ACH Debit,ExpertNet Subcontractors #3,***8454,,PO-202409-PS-GL-0001,False,False,REF-603387,First Continental Bank,***1382,Globex Retail NA LLC,US,5864495.98
2024-09-28,2024-09-28,Supplier Payment - PackFast Fulfillment #3,Supplier Payment,Retail-NA,32024.55,0.0,USD,Fedwire,PackFast Fulfillment #3,***7899,,PO-202409-Retail-NA-0006,False,False,REF-397343,First Continental Bank,***9592,Globex Retail NA LLC,US,5832471.43
2024-09-28,2024-09-28,Payroll - GlobalPay Services Ltd,Payroll,ALL,78016.91,0.0,USD,Fedwire,GlobalPay Services Ltd,***2177,,,False,False,REF-123774,First Continental Bank,***8960,Globex Retail NA LLC,US,5754454.52
2024-09-29,2024-09-29,Payroll - GlobalPay Services Ltd,Payroll,ALL,78016.91,0.0,USD,Fedwire,GlobalPay Services Ltd,***9513,,,False,False,REF-419721,First Continental Bank,***8591,Globex Retail NA LLC,US,5676437.61
2024-09-29,2024-09-29,Client Receipt - CloudBridge Co. #45,Sales Receipt,SaaS-GL,0.0,4690.69,USD,Card Settlement,CloudBridge Co. #45,***5038,INV-202409-SaaS-GL-0026,,False,False,REF-153097,First Continental Bank,***8040,Globex Retail NA LLC,US,5681128.3
2024-09-30,2024-09-30,Supplier Payment - ExpertNet Subcontractors #17,Supplier Payment,PS-GL,1027.81,0.0,USD,Fedwire,ExpertNet Subcontractors #17,***8314,,PO-202409-PS-GL-0008,False,False,REF-711707,First Continental Bank,***9073,Globex Retail NA LLC,US,5680100.49
2024-09-30,2024-09-30,Interest Earned,Interest Income,ALL,0.0,10494.45,USD,ACH Credit,First Continental Bank,***2354,,,False,False,REF-380736,First Continental Bank,***1986,Globex Retail NA LLC,US,5690594.94
2024-10-01,2024-10-01,Account Maintenance Fee,Bank/Merchant Fees,ALL,2500.0,0.0,USD,ACH Debit,First Continental Bank,***6276,,,False,False,REF-195984,First Continental Bank,***2125,Globex Retail NA LLC,US,5688094.94
2024-10-01,2024-10-01,Marketing - Aurelia Media #8,Marketing,ALL,21891.34,0.0,USD,Fedwire,Aurelia Media #8,***5274,,,False,False,REF-916230,First Continental Bank,***8239,Globex Retail NA LLC,US,5666203.6
2024-10-01,2024-10-01,Client Receipt - CloudBridge Co. #50,Sales Receipt,SaaS-GL,0.0,19589.43,USD,Card Settlement,CloudBridge Co. #50,***4598,INV-202410-SaaS-GL-0018,,False,False,REF-106183,First Continental Bank,***2988,Globex Retail NA LLC,US,5685793.03
2024-10-02,2024-10-02,Supplier Payment - HyperCloud Infra #9,Supplier Payment,SaaS-GL,3837.73,0.0,USD,Fedwire,HyperCloud Infra #9,***8697,,PO-202410-SaaS-GL-0003,False,False,REF-438654,First Continental Bank,***6475,Globex Retail NA LLC,US,5681955.3
2024-10-02,2024-10-02,Client Receipt - Card Settlement Batch #19,Sales Receipt,Retail-NA,0.0,14556.19,USD,ACH Credit,Card Settlement Batch #19,***3266,INV-202410-Retail-NA-0004,,False,False,REF-238584,First Continental Bank,***6179,Globex Retail NA LLC,US,5696511.49
2024-10-02,2024-10-02,Client Receipt - ShopSphere Partner #35,Sales Receipt,Retail-NA,0.0,20048.35,USD,ACH Credit,ShopSphere Partner #35,***8412,INV-202410-Retail-NA-0002,,False,False,REF-425902,First Continental Bank,***4114,Globex Retail NA LLC,US,5716559.84
2024-10-03,2024-10-03,Supplier Payment - HyperCloud Infra #8,Supplier Payment,SaaS-GL,1408.45,0.0,USD,ACH Debit,HyperCloud Infra #8,***4023,,PO-202410-SaaS-GL-0009,False,False,REF-765697,First Continental Bank,***8785,Globex Retail NA LLC,US,5715151.39
2024-10-03,2024-10-03,Supplier Payment - NorthRiver Apparel Mfg #20,Supplier Payment,Retail-NA,20866.16,0.0,USD,ACH Debit,NorthRiver Apparel Mfg #20,***1935,,PO-202410-Retail-NA-0006,False,False,REF-441141,First Continental Bank,***7785,Globex Retail NA LLC,US,5694285.23
2024-10-03,2024-10-03,Supplier Payment - PackFast Fulfillment #14,Supplier Payment,Retail-NA,27993.96,0.0,USD,Fedwire,PackFast Fulfillment #14,***1476,,PO-202410-Retail-NA-0008,False,False,REF-975000,First Continental Bank,***8740,Globex Retail NA LLC,US,5666291.27
2024-10-03,2024-10-03,Client Receipt - CloudBridge Co. #49,Sales Receipt,SaaS-GL,0.0,1200.85,USD,ACH Credit,CloudBridge Co. #49,***6116,INV-202410-SaaS-GL-0019,,False,False,REF-643503,First Continental Bank,***4054,Globex Retail NA LLC,US,5667492.12
2024-10-03,2024-10-03,Client Receipt - Vertex Advisory Client #12,Sales Receipt,PS-GL,0.0,2883.21,USD,ACH Credit,Vertex Advisory Client #12,***6424,INV-202410-PS-GL-0004,,False,False,REF-335441,First Continental Bank,***3850,Globex Retail NA LLC,US,5670375.33
2024-10-03,2024-10-03,Client Receipt - CloudBridge Co. #53,Sales Receipt,SaaS-GL,0.0,8404.17,USD,Card Settlement,CloudBridge Co. #53,***5042,INV-202410-SaaS-GL-0006,,False,False,REF-564880,First Continental Bank,***6882,Globex Retail NA LLC,US,5678779.5
2024-10-03,2024-10-03,Client Receipt - CloudBridge Co. #39,Sales Receipt,SaaS-GL,0.0,14070.02,USD,Card Settlement,CloudBridge Co. #39,***4800,INV-202410-SaaS-GL-0023,,False,False,REF-121255,First Continental Bank,***6313,Globex Retail NA LLC,US,5692849.52
2024-10-03,2024-10-03,Client Receipt - CloudBridge Co. #67,Sales Receipt,SaaS-GL,0.0,14652.15,USD,Card Settlement,CloudBridge Co. #67,***4020,INV-202410-SaaS-GL-0024,,False,False,REF-246942,First Continental Bank,***5700,Globex Retail NA LLC,US,5707501.67
2024-10-03,2024-10-03,Client Receipt - ShopSphere Partner #13,Sales Receipt,Retail-NA,0.0,18828.33,USD,Card Settlement,ShopSphere Partner #13,***4426,INV-202410-Retail-NA-0011,,False,False,REF-470784,First Continental Bank,***3600,Globex Retail NA LLC,US,5726330.0
2024-10-03,2024-10-03,Client Receipt - CloudBridge Co. #32,Sales Receipt,SaaS-GL,0.0,56593.48,USD,Card Settlement,CloudBridge Co. #32,***4280,INV-202410-SaaS-GL-0008,,False,False,REF-678564,First Continental Bank,***6096,Globex Retail NA LLC,US,5782923.48
2024-10-04,2024-10-04,Supplier Payment - ExpertNet Subcontractors #15,Supplier Payment,PS-GL,5603.32,0.0,USD,ACH Debit,ExpertNet Subcontractors #15,***8037,,PO-202410-PS-GL-0004,False,False,REF-616581,First Continental Bank,***5704,Globex Retail NA LLC,US,5777320.16
2024-10-04,2024-10-04,Supplier Payment - NorthRiver Apparel Mfg #27,Supplier Payment,Retail-NA,27967.81,0.0,USD,ACH Debit,NorthRiver Apparel Mfg #27,***7495,,PO-202410-Retail-NA-0001,False,False,REF-905218,First Continental Bank,***7027,Globex Retail NA LLC,US,5749352.35
2024-10-04,2024-10-04,Client Receipt - CloudBridge Co. #31,Sales Receipt,SaaS-GL,0.0,256.7,USD,Card Settlement,CloudBridge Co. #31,***5030,INV-202410-SaaS-GL-0002,,False,False,REF-644098,First Continental Bank,***6196,Globex Retail NA LLC,US,5749609.05
2024-10-04,2024-10-04,Client Receipt - CloudBridge Co. #1,Sales Receipt,SaaS-GL,0.0,1134.19,USD,ACH Credit,CloudBridge Co. #1,***3514,INV-202410-SaaS-GL-0015,,False,False,REF-835340,First Continental Bank,***4909,Globex Retail NA LLC,US,5750743.24
2024-10-05,2024-10-05,Supplier Payment - ExpertNet Subcontractors #14,Supplier Payment,PS-GL,10801.8,0.0,USD,ACH Debit,ExpertNet Subcontractors #14,***2652,,PO-202410-PS-GL-0005,False,False,REF-749869,First Continental Bank,***1419,Globex Retail NA LLC,US,5739941.44
2024-10-06,2024-10-06,Merchant Processing Fees,Bank/Merchant Fees,ALL,2698.34,0.0,USD,Fedwire,First Continental Bank,***4087,,,False,False,REF-153426,First Continental Bank,***2519,Globex Retail NA LLC,US,5737243.1
2024-10-07,2024-10-07,Client Receipt - CloudBridge Co. #48,Sales Receipt,SaaS-GL,0.0,15588.23,USD,Card Settlement,CloudBridge Co. #48,***4851,INV-202410-SaaS-GL-0011,,False,False,REF-717066,First Continental Bank,***3417,Globex Retail NA LLC,US,5752831.33
2024-10-07,2024-10-07,Client Receipt - Vertex Advisory Client #55,Sales Receipt,PS-GL,0.0,64076.72,USD,Card Settlement,Vertex Advisory Client #55,***3709,INV-202410-PS-GL-0008,,False,False,REF-606703,First Continental Bank,***6478,Globex Retail NA LLC,US,5816908.05
2024-10-08,2024-10-08,Supplier Payment - NorthRiver Apparel Mfg #2,Supplier Payment,Retail-NA,17195.21,0.0,USD,Fedwire,NorthRiver Apparel Mfg #2,***5667,,PO-202410-Retail-NA-0004,False,False,REF-151630,First Continental Bank,***3907,Globex Retail NA LLC,US,5799712.84
2024-10-08,2024-10-08,Supplier Payment - PackFast Fulfillment #8,Supplier Payment,Retail-NA,24954.98,0.0,USD,ACH Debit,PackFast Fulfillment #8,***1724,,PO-202410-Retail-NA-0012,False,False,REF-995159,First Continental Bank,***8283,Globex Retail NA LLC,US,5774757.86
2024-10-08,2024-10-08,Client Receipt - CloudBridge Co. #48,Sales Receipt,SaaS-GL,0.0,78164.1,USD,Card Settlement,CloudBridge Co. #48,***7495,INV-202410-SaaS-GL-0001,,False,False,REF-898478,First Continental Bank,***9397,Globex Retail NA LLC,US,5852921.96
2024-10-09,2024-10-09,Supplier Payment - NorthRiver Apparel Mfg #33,Supplier Payment,Retail-NA,20177.95,0.0,USD,ACH Debit,NorthRiver Apparel Mfg #33,***3356,,PO-202410-Retail-NA-0011,False,False,REF-222875,First Continental Bank,***8312,Globex Retail NA LLC,US,5832744.01
2024-10-09,2024-10-09,Client Receipt - CloudBridge Co. #10,Sales Receipt,SaaS-GL,0.0,1683.69,USD,ACH Credit,CloudBridge Co. #10,***4179,INV-202410-SaaS-GL-0013,,False,False,REF-324318,First Continental Bank,***5409,Globex Retail NA LLC,US,5834427.7
2024-10-09,2024-10-09,Client Receipt - CloudBridge Co. #6,Sales Receipt,SaaS-GL,0.0,13405.73,USD,Card Settlement,CloudBridge Co. #6,***2767,INV-202410-SaaS-GL-0005,,False,False,REF-615972,First Continental Bank,***4807,Globex Retail NA LLC,US,5847833.43
2024-10-09,2024-10-09,Client Receipt - ShopSphere Partner #48,Sales Receipt,Retail-NA,0.0,18262.27,USD,ACH Credit,ShopSphere Partner #48,***8507,INV-202410-Retail-NA-0001,,False,False,REF-625159,First Continental Bank,***3691,Globex Retail NA LLC,US,5866095.7
2024-10-09,2024-10-09,Client Receipt - CloudBridge Co. #69,Sales Receipt,SaaS-GL,0.0,25237.3,USD,Card Settlement,CloudBridge Co. #69,***9385,INV-202410-SaaS-GL-0014,,False,False,REF-468553,First Continental Bank,***3547,Globex Retail NA LLC,US,5891333.0
2024-10-10,2024-10-10,Supplier Payment - ExpertNet Subcontractors #2,Supplier Payment,PS-GL,3948.2,0.0,USD,Fedwire,ExpertNet Subcontractors #2,***2571,,PO-202410-PS-GL-0001,False,False,REF-677447,First Continental Bank,***5514,Globex Retail NA LLC,US,5887384.8
2024-10-10,2024-10-10,Supplier Payment - ExpertNet Subcontractors #16,Supplier Payment,PS-GL,6229.84,0.0,USD,Fedwire,ExpertNet Subcontractors #16,***9251,,PO-202410-PS-GL-0006,False,False,REF-246112,First Continental Bank,***2465,Globex Retail NA LLC,US,5881154.96
2024-10-10,2024-10-10,Client Receipt - CloudBridge Co. #68,Sales Receipt,SaaS-GL,0.0,3592.66,USD,Card Settlement,CloudBridge Co. #68,***5974,INV-202410-SaaS-GL-0012,,False,False,REF-617647,First Continental Bank,***2564,Globex Retail NA LLC,US,5884747.62
2024-10-11,2024-10-11,Supplier Payment - NorthRiver Apparel Mfg #33,Supplier Payment,Retail-NA,9435.11,0.0,USD,Fedwire,NorthRiver Apparel Mfg #33,***6754,,PO-202410-Retail-NA-0007,False,False,REF-588342,First Continental Bank,***8063,Globex Retail NA LLC,US,5875312.51
2024-10-11,2024-10-11,Client Receipt - ShopSphere Partner #17,Sales Receipt,Retail-NA,0.0,35514.53,USD,Card Settlement,ShopSphere Partner #17,***5579,INV-202410-Retail-NA-0009,,False,False,REF-379887,First Continental Bank,***3500,Globex Retail NA LLC,US,5910827.04
2024-10-11,2024-10-11,Client Receipt - Card Settlement Batch #7,Sales Receipt,Retail-NA,0.0,65897.32,USD,Card Settlement,Card Settlement Batch #7,***7028,INV-202410-Retail-NA-0010,,False,False,REF-825542,First Continental Bank,***3184,Globex Retail NA LLC,US,5976724.36
2024-10-12,2024-10-12,Intercompany Settlement - Globex APAC Logistics Pte. Ltd.,Intercompany Transfer,ALL,590199.0,0.0,USD,Internal Transfer,Globex APAC Logistics Pte. Ltd.,***3910,,,True,True,REF-957338,First Continental Bank,***6370,Globex Retail NA LLC,US,5386525.36
2024-10-12,2024-10-12,Client Receipt - Vertex Advisory Client #34,Sales Receipt,PS-GL,0.0,16494.06,USD,Card Settlement,Vertex Advisory Client #34,***2548,INV-202410-PS-GL-0001,,False,False,REF-405850,First Continental Bank,***5493,Globex Retail NA LLC,US,5403019.42
2024-10-14,2024-10-14,Client Receipt - Vertex Advisory Client #30,Sales Receipt,PS-GL,0.0,22640.14,USD,Card Settlement,Vertex Advisory Client #30,***9057,INV-202410-PS-GL-0009,,False,False,REF-192479,First Continental Bank,***4903,Globex Retail NA LLC,US,5425659.56
2024-10-14,2024-10-14,Client Receipt - Vertex Advisory Client #31,Sales Receipt,PS-GL,0.0,30012.44,USD,Card Settlement,Vertex Advisory Client #31,***2745,INV-202410-PS-GL-0003,,False,False,REF-518242,First Continental Bank,***5399,Globex Retail NA LLC,US,5455672.0
2024-10-15,2024-10-15,Merchant Processing Fees,Bank/Merchant Fees,ALL,441.02,0.0,USD,Fedwire,First Continental Bank,***3295,,,False,False,REF-288038,First Continental Bank,***2870,Globex Retail NA LLC,US,5455230.98
2024-10-15,2024-10-15,Supplier Payment - ExpertNet Subcontractors #4,Supplier Payment,PS-GL,477.55,0.0,USD,Fedwire,ExpertNet Subcontractors #4,***6249,,PO-202410-PS-GL-0008,False,False,REF-170187,First Continental Bank,***4931,Globex Retail NA LLC,US,5454753.43
2024-10-15,2024-10-15,Supplier Payment - HyperCloud Infra #5,Supplier Payment,SaaS-GL,1952.7,0.0,USD,Fedwire,HyperCloud Infra #5,***1507,,PO-202410-SaaS-GL-0011,False,False,REF-921595,First Continental Bank,***3997,Globex Retail NA LLC,US,5452800.73
2024-10-15,2024-10-15,Supplier Payment - CodeCraft Contractors #8,Supplier Payment,SaaS-GL,10482.28,0.0,USD,Fedwire,CodeCraft Contractors #8,***7763,,PO-202410-SaaS-GL-0008,False,False,REF-652360,First Continental Bank,***8375,Globex Retail NA LLC,US,5442318.45
2024-10-15,2024-10-15,Client Receipt - ShopSphere Partner #50,Sales Receipt,Retail-NA,0.0,10960.06,USD,ACH Credit,ShopSphere Partner #50,***4066,INV-202410-Retail-NA-0003,,False,False,REF-176137,First Continental Bank,***6052,Globex Retail NA LLC,US,5453278.51
2024-10-15,2024-10-15,Client Receipt - CloudBridge Co. #44,Sales Receipt,SaaS-GL,0.0,11658.16,USD,Card Settlement,CloudBridge Co. #44,***6482,INV-202410-SaaS-GL-0020,,False,False,REF-858800,First Continental Bank,***8043,Globex Retail NA LLC,US,5464936.67
2024-10-16,2024-10-16,Client Receipt - Card Settlement Batch #11,Sales Receipt,Retail-NA,0.0,8623.12,USD,ACH Credit,Card Settlement Batch #11,***9453,INV-202410-Retail-NA-0012,,False,False,REF-249449,First Continental Bank,***1974,Globex Retail NA LLC,US,5473559.79
2024-10-16,2024-10-16,Client Receipt - CloudBridge Co. #26,Sales Receipt,SaaS-GL,0.0,33638.68,USD,Card Settlement,CloudBridge Co. #26,***3054,INV-202410-SaaS-GL-0003,,False,False,REF-273188,First Continental Bank,***5669,Globex Retail NA LLC,US,5507198.47
2024-10-17,2024-10-17,Supplier Payment - HyperCloud Infra #6,Supplier Payment,SaaS-GL,9353.93,0.0,USD,Fedwire,HyperCloud Infra #6,***7882,,PO-202410-SaaS-GL-0001,False,False,REF-658300,First Continental Bank,***2031,Globex Retail NA LLC,US,5497844.54
2024-10-17,2024-10-17,Client Receipt - CloudBridge Co. #38,Sales Receipt,SaaS-GL,0.0,4245.35,USD,ACH Credit,CloudBridge Co. #38,***6679,INV-202410-SaaS-GL-0007,,False,False,REF-918521,First Continental Bank,***7384,Globex Retail NA LLC,US,5502089.89
2024-10-17,2024-10-17,Client Receipt - Card Settlement Batch #15,Sales Receipt,Retail-NA,0.0,86667.74,USD,ACH Credit,Card Settlement Batch #15,***2947,INV-202410-Retail-NA-0005,,False,False,REF-827966,First Continental Bank,***4478,Globex Retail NA LLC,US,5588757.63
2024-10-18,2024-10-18,Marketing - Beacon Digital #1,Marketing,ALL,1523.05,0.0,USD,ACH Debit,Beacon Digital #1,***2164,,,False,False,REF-728445,First Continental Bank,***2733,Globex Retail NA LLC,US,5587234.58
2024-10-18,2024-10-18,Supplier Payment - HyperCloud Infra #3,Supplier Payment,SaaS-GL,7875.82,0.0,USD,Fedwire,HyperCloud Infra #3,***2591,,PO-202410-SaaS-GL-0007,False,False,REF-322197,First Continental Bank,***9144,Globex Retail NA LLC,US,5579358.76
2024-10-18,2024-10-18,Client Receipt - CloudBridge Co. #21,Sales Receipt,SaaS-GL,0.0,22117.83,USD,Card Settlement,CloudBridge Co. #21,***5845,INV-202410-SaaS-GL-0016,,False,False,REF-921814,First Continental Bank,***6067,Globex Retail NA LLC,US,5601476.59
2024-10-20,2024-10-20,Client Receipt - Vertex Advisory Client #39,Sales Receipt,PS-GL,0.0,7388.4,USD,Card Settlement,Vertex Advisory Client #39,***7555,INV-202410-PS-GL-0007,,False,False,REF-111051,First Continental Bank,***6306,Globex Retail NA LLC,US,5608864.99
2024-10-21,2024-10-21,Marketing - Beacon Digital #3,Marketing,ALL,3226.51,0.0,USD,Fedwire,Beacon Digital #3,***2536,,,False,False,REF-229684,First Continental Bank,***2976,Globex Retail NA LLC,US,5605638.48
2024-10-21,2024-10-21,Supplier Payment - NorthRiver Apparel Mfg #17,Supplier Payment,Retail-NA,11699.74,0.0,USD,Fedwire,NorthRiver Apparel Mfg #17,***3400,,PO-202410-Retail-NA-0003,False,False,REF-991463,First Continental Bank,***3051,Globex Retail NA LLC,US,5593938.74
2024-10-21,2024-10-21,Supplier Payment - NorthRiver Apparel Mfg #7,Supplier Payment,Retail-NA,62140.97,0.0,USD,Fedwire,NorthRiver Apparel Mfg #7,***1391,,PO-202410-Retail-NA-0009,False,False,REF-754581,First Continental Bank,***9096,Globex Retail NA LLC,US,5531797.77
2024-10-21,2024-10-21,VAT/GST Remittance - US IRS,Tax Payment,ALL,62624.46,0.0,USD,ACH Debit,US IRS,***8520,,,False,False,REF-892098,First Continental Bank,***4080,Globex Retail NA LLC,US,5469173.31
2024-10-21,2024-10-21,Client Receipt - CloudBridge Co. #49,Sales Receipt,SaaS-GL,0.0,6395.98,USD,ACH Credit,CloudBridge Co. #49,***9645,INV-202410-SaaS-GL-0004,,False,False,REF-945077,First Continental Bank,***2017,Globex Retail NA LLC,US,5475569.29
2024-10-21,2024-10-21,Client Receipt - CloudBridge Co. #42,Sales Receipt,SaaS-GL,0.0,14107.24,USD,ACH Credit,CloudBridge Co. #42,***5256,INV-202410-SaaS-GL-0009,,False,False,REF-210518,First Continental Bank,***2478,Globex Retail NA LLC,US,5489676.53
2024-10-21,2024-10-21,Client Receipt - Vertex Advisory Client #3,Sales Receipt,PS-GL,0.0,30129.94,USD,ACH Credit,Vertex Advisory Client #3,***6176,INV-202410-PS-GL-0010,,False,False,REF-388338,First Continental Bank,***7092,Globex Retail NA LLC,US,5519806.47
2024-10-22,2024-10-22,Supplier Payment - HyperCloud Infra #3,Supplier Payment,SaaS-GL,4924.63,0.0,USD,Fedwire,HyperCloud Infra #3,***7669,,PO-202410-SaaS-GL-0004,False,False,REF-536167,First Continental Bank,***2186,Globex Retail NA LLC,US,5514881.84
2024-10-22,2024-10-22,Supplier Payment - PackFast Fulfillment #21,Supplier Payment,Retail-NA,9282.66,0.0,USD,ACH Debit,PackFast Fulfillment #21,***4028,,PO-202410-Retail-NA-0005,False,False,REF-131509,First Continental Bank,***6749,Globex Retail NA LLC,US,5505599.18
2024-10-22,2024-10-22,Client Receipt - CloudBridge Co. #78,Sales Receipt,SaaS-GL,0.0,1783.05,USD,Card Settlement,CloudBridge Co. #78,***9643,INV-202410-SaaS-GL-0025,,False,False,REF-730017,First Continental Bank,***7812,Globex Retail NA LLC,US,5507382.23
2024-10-22,2024-10-22,Client Receipt - CloudBridge Co. #32,Sales Receipt,SaaS-GL,0.0,11438.47,USD,ACH Credit,CloudBridge Co. #32,***8633,INV-202410-SaaS-GL-0017,,False,False,REF-315670,First Continental Bank,***4101,Globex Retail NA LLC,US,5518820.7
2024-10-22,2024-10-22,Client Receipt - Vertex Advisory Client #17,Sales Receipt,PS-GL,0.0,35846.25,USD,ACH Credit,Vertex Advisory Client #17,***9131,INV-202410-PS-GL-0005,,False,False,REF-555480,First Continental Bank,***2002,Globex Retail NA LLC,US,5554666.95
2024-10-23,2024-10-23,Supplier Payment - ExpertNet Subcontractors #16,Supplier Payment,PS-GL,2196.01,0.0,USD,Fedwire,ExpertNet Subcontractors #16,***6332,,PO-202410-PS-GL-0011,False,False,REF-457707,First Continental Bank,***3152,Globex Retail NA LLC,US,5552470.94
2024-10-23,2024-10-23,Alphagrid Utilities,Rent & Utilities,ALL,8755.03,0.0,USD,Fedwire,Alphagrid Utilities,***1753,,,False,False,REF-470751,First Continental Bank,***9705,Globex Retail NA LLC,US,5543715.91
2024-10-24,2024-10-24,Supplier Payment - HyperCloud Infra #4,Supplier Payment,SaaS-GL,2476.42,0.0,USD,ACH Debit,HyperCloud Infra #4,***8983,,PO-202410-SaaS-GL-0002,False,False,REF-927116,First Continental Bank,***6639,Globex Retail NA LLC,US,5541239.49
2024-10-24,2024-10-24,Supplier Payment - ExpertNet Subcontractors #13,Supplier Payment,PS-GL,6083.98,0.0,USD,ACH Debit,ExpertNet Subcontractors #13,***1713,,PO-202410-PS-GL-0003,False,False,REF-837018,First Continental Bank,***9062,Globex Retail NA LLC,US,5535155.51
2024-10-25,2024-10-25,Supplier Payment - HyperCloud Infra #17,Supplier Payment,SaaS-GL,2022.4,0.0,USD,Fedwire,HyperCloud Infra #17,***2562,,PO-202410-SaaS-GL-0005,False,False,REF-205405,First Continental Bank,***4408,Globex Retail NA LLC,US,5533133.11
2024-10-25,2024-10-25,Supplier Payment - HyperCloud Infra #4,Supplier Payment,SaaS-GL,2932.96,0.0,USD,Fedwire,HyperCloud Infra #4,***6088,,PO-202410-SaaS-GL-0010,False,False,REF-258013,First Continental Bank,***9928,Globex Retail NA LLC,US,5530200.15
2024-10-25,2024-10-25,Supplier Payment - ExpertNet Subcontractors #17,Supplier Payment,PS-GL,5517.37,0.0,USD,ACH Debit,ExpertNet Subcontractors #17,***8069,,PO-202410-PS-GL-0002,False,False,REF-879897,First Continental Bank,***7643,Globex Retail NA LLC,US,5524682.78
2024-10-25,2024-10-25,Supplier Payment - ExpertNet Subcontractors #14,Supplier Payment,PS-GL,13027.38,0.0,USD,ACH Debit,ExpertNet Subcontractors #14,***3931,,PO-202410-PS-GL-0007,False,False,REF-379672,First Continental Bank,***7538,Globex Retail NA LLC,US,5511655.4
2024-10-25,2024-10-25,Supplier Payment - ExpertNet Subcontractors #13,Supplier Payment,PS-GL,13300.81,0.0,USD,ACH Debit,ExpertNet Subcontractors #13,***2916,,PO-202410-PS-GL-0010,False,False,REF-981192,First Continental Bank,***2910,Globex Retail NA LLC,US,5498354.59
2024-10-25,2024-10-25,Client Receipt - ShopSphere Partner #53,Sales Receipt,Retail-NA,0.0,1453.15,USD,ACH Credit,ShopSphere Partner #53,***3500,INV-202410-Retail-NA-0007,,False,False,REF-139606,First Continental Bank,***4813,Globex Retail NA LLC,US,5499807.74
2024-10-25,2024-10-25,Client Receipt - Vertex Advisory Client #30,Sales Receipt,PS-GL,0.0,12331.1,USD,Card Settlement,Vertex Advisory Client #30,***7121,INV-202410-PS-GL-0006,,False,False,REF-799170,First Continental Bank,***2338,Globex Retail NA LLC,US,5512138.84
2024-10-25,2024-10-25,Client Receipt - ShopSphere Partner #32,Sales Receipt,Retail-NA,0.0,44068.64,USD,Card Settlement,ShopSphere Partner #32,***4681,INV-202410-Retail-NA-0013,,False,False,REF-994699,First Continental Bank,***9101,Globex Retail NA LLC,US,5556207.48
2024-10-25,2024-10-25,Client Receipt - ShopSphere Partner #12,Sales Receipt,Retail-NA,0.0,85148.34,USD,ACH Credit,ShopSphere Partner #12,***4031,INV-202410-Retail-NA-0008,,False,False,REF-982972,First Continental Bank,***8952,Globex Retail NA LLC,US,5641355.82
2024-10-26,2024-10-26,Intercompany Settlement - Globex APAC Logistics Pte. Ltd.,Intercompany Transfer,ALL,214092.0,0.0,USD,Internal Transfer,Globex APAC Logistics Pte. Ltd.,***8193,,,True,True,REF-916596,First Continental Bank,***9251,Globex Retail NA LLC,US,5427263.82
2024-10-27,2024-10-27,Client Receipt - Vertex Advisory Client #42,Sales Receipt,PS-GL,0.0,25852.52,USD,Card Settlement,Vertex Advisory Client #42,***1769,INV-202410-PS-GL-0002,,False,False,REF-470431,First Continental Bank,***6400,Globex Retail NA LLC,US,5453116.34
2024-10-28,2024-10-28,Supplier Payment - PackFast Fulfillment #2,Supplier Payment,Retail-NA,6651.78,0.0,USD,ACH Debit,PackFast Fulfillment #2,***2890,,PO-202410-Retail-NA-0010,False,False,REF-165919,First Continental Bank,***7404,Globex Retail NA LLC,US,5446464.56
2024-10-28,2024-10-28,Supplier Payment - PackFast Fulfillment #3,Supplier Payment,Retail-NA,11352.24,0.0,USD,Fedwire,PackFast Fulfillment #3,***7085,,PO-202410-Retail-NA-0002,False,False,REF-649179,First Continental Bank,***8730,Globex Retail NA LLC,US,5435112.32
2024-10-28,2024-10-28,Corporate Tax Estimate,Tax Payment,ALL,47329.44,0.0,USD,SWIFT MT103,US IRS,***3634,,,False,False,REF-396262,First Continental Bank,***7602,Globex Retail NA LLC,US,5387782.88
2024-10-28,2024-10-28,Payroll - GlobalPay Services Ltd,Payroll,ALL,85564.27,0.0,USD,Fedwire,GlobalPay Services Ltd,***4043,,,False,False,REF-682235,First Continental Bank,***2004,Globex Retail NA LLC,US,5302218.61
2024-10-29,2024-10-29,Client Receipt - CloudBridge Co. #70,Sales Receipt,SaaS-GL,0.0,780.2,USD,Card Settlement,CloudBridge Co. #70,***3540,INV-202410-SaaS-GL-0010,,False,False,REF-358480,First Continental Bank,***7517,Globex Retail NA LLC,US,5302998.81
2024-10-29,2024-10-29,Client Receipt - ShopSphere Partner #72,Sales Receipt,Retail-NA,0.0,39006.83,USD,ACH Credit,ShopSphere Partner #72,***6928,INV-202410-Retail-NA-0006,,False,False,REF-396966,First Continental Bank,***1231,Globex Retail NA LLC,US,5342005.64
2024-10-30,2024-10-30,Supplier Payment - ExpertNet Subcontractors #17,Supplier Payment,PS-GL,7110.18,0.0,USD,Fedwire,ExpertNet Subcontractors #17,***1815,,PO-202410-PS-GL-0009,False,False,REF-507626,First Continental Bank,***7598,Globex Retail NA LLC,US,5334895.46
2024-10-30,2024-10-30,Supplier Payment - HyperCloud Infra #15,Supplier Payment,SaaS-GL,34458.76,0.0,USD,Fedwire,HyperCloud Infra #15,***5183,,PO-202410-SaaS-GL-0006,False,False,REF-624079,First Continental Bank,***7873,Globex Retail NA LLC,US,5300436.7
2024-10-30,2024-10-30,Payroll - GlobalPay Services Ltd,Payroll,ALL,85564.27,0.0,USD,Fedwire,GlobalPay Services Ltd,***3512,,,False,False,REF-268865,First Continental Bank,***3567,Globex Retail NA LLC,US,5214872.43
2024-10-30,2024-10-30,Client Receipt - CloudBridge Co. #29,Sales Receipt,SaaS-GL,0.0,361.38,USD,Card Settlement,CloudBridge Co. #29,***1831,INV-202410-SaaS-GL-0021,,False,False,REF-526720,First Continental Bank,***2266,Globex Retail NA LLC,US,5215233.81
2024-10-30,2024-10-30,Client Receipt - ShopSphere Partner #71,Sales Receipt,Retail-NA,0.0,4998.9,USD,Card Settlement,ShopSphere Partner #71,***9513,INV-202410-Retail-NA-0014,,False,False,REF-902412,First Continental Bank,***4490,Globex Retail NA LLC,US,5220232.71
2024-10-30,2024-10-30,Interest Earned,Interest Income,ALL,0.0,8889.79,USD,ACH Credit,First Continental Bank,***6413,,,False,False,REF-882120,First Continental Bank,***3999,Globex Retail NA LLC,US,5229122.5
2024-10-31,2024-10-31,Client Receipt - CloudBridge Co. #25,Sales Receipt,SaaS-GL,0.0,11383.14,USD,ACH Credit,CloudBridge Co. #25,***1359,INV-202410-SaaS-GL-0022,,False,False,REF-447442,First Continental Bank,***5192,Globex Retail NA LLC,US,5240505.64
2024-11-01,2024-11-01,Account Maintenance Fee,Bank/Merchant Fees,ALL,2500.0,0.0,USD,ACH Debit,First Continental Bank,***8577,,,False,False,REF-561370,First Continental Bank,***2342,Globex Retail NA LLC,US,5238005.64
2024-11-01,2024-11-01,Supplier Payment - NorthRiver Apparel Mfg #29,Supplier Payment,Retail-NA,14902.67,0.0,USD,Fedwire,NorthRiver Apparel Mfg #29,***1792,,PO-202411-Retail-NA-0005,False,False,REF-206750,First Continental Bank,***1057,Globex Retail NA LLC,US,5223102.97
2024-11-01,2024-11-01,Client Receipt - ShopSphere Partner #70,Sales Receipt,Retail-NA,0.0,3179.07,USD,Card Settlement,ShopSphere Partner #70,***6159,INV-202411-Retail-NA-0004,,False,False,REF-317953,First Continental Bank,***7342,Globex Retail NA LLC,US,5226282.04
2024-11-02,2024-11-02,Client Receipt - CloudBridge Co. #62,Sales Receipt,SaaS-GL,0.0,3911.83,USD,ACH Credit,CloudBridge Co. #62,***1039,INV-202411-SaaS-GL-0017,,False,False,REF-340344,First Continental Bank,***5584,Globex Retail NA LLC,US,5230193.87
2024-11-02,2024-11-02,Client Receipt - Vertex Advisory Client #31,Sales Receipt,PS-GL,0.0,16397.65,USD,Card Settlement,Vertex Advisory Client #31,***3242,INV-202411-PS-GL-0003,,False,False,REF-986287,First Continental Bank,***8457,Globex Retail NA LLC,US,5246591.52
2024-11-02,2024-11-02,Client Receipt - Vertex Advisory Client #30,Sales Receipt,PS-GL,0.0,19418.72,USD,Card Settlement,Vertex Advisory Client #30,***4597,INV-202411-PS-GL-0009,,False,False,REF-611602,First Continental Bank,***8266,Globex Retail NA LLC,US,5266010.24
2024-11-03,2024-11-03,Client Receipt - CloudBridge Co. #59,Sales Receipt,SaaS-GL,0.0,56072.9,USD,ACH Credit,CloudBridge Co. #59,***3608,INV-202411-SaaS-GL-0025,,False,False,REF-838783,First Continental Bank,***4163,Globex Retail NA LLC,US,5322083.14
2024-11-03,2024-11-03,Client Receipt - CloudBridge Co. #26,Sales Receipt,SaaS-GL,0.0,58463.13,USD,ACH Credit,CloudBridge Co. #26,***2972,INV-202411-SaaS-GL-0015,,False,False,REF-284667,First Continental Bank,***4317,Globex Retail NA LLC,US,5380546.27
2024-11-04,2024-11-04,Client Receipt - CloudBridge Co. #46,Sales Receipt,SaaS-GL,0.0,3352.42,USD,ACH Credit,CloudBridge Co. #46,***5599,INV-202411-SaaS-GL-0004,,False,False,REF-979070,First Continental Bank,***7500,Globex Retail NA LLC,US,5383898.69
2024-11-05,2024-11-05,Supplier Payment - CodeCraft Contractors #10,Supplier Payment,SaaS-GL,3904.92,0.0,USD,Fedwire,CodeCraft Contractors #10,***9114,,PO-202411-SaaS-GL-0006,False,False,REF-811300,First Continental Bank,***5036,Globex Retail NA LLC,US,5379993.77
2024-11-05,2024-11-05,Supplier Payment - ExpertNet Subcontractors #12,Supplier Payment,PS-GL,4679.56,0.0,USD,Fedwire,ExpertNet Subcontractors #12,***8677,,PO-202411-PS-GL-0005,False,False,REF-807167,First Continental Bank,***8417,Globex Retail NA LLC,US,5375314.21
2024-11-05,2024-11-05,Client Receipt - CloudBridge Co. #3,Sales Receipt,SaaS-GL,0.0,20977.71,USD,ACH Credit,CloudBridge Co. #3,***1582,INV-202411-SaaS-GL-0014,,False,False,REF-701145,First Continental Bank,***1971,Globex Retail NA LLC,US,5396291.92
2024-11-05,2024-11-05,Client Receipt - ShopSphere Partner #62,Sales Receipt,Retail-NA,0.0,34804.49,USD,ACH Credit,ShopSphere Partner #62,***8015,INV-202411-Retail-NA-0008,,False,False,REF-192067,First Continental Bank,***3959,Globex Retail NA LLC,US,5431096.41
2024-11-05,2024-11-05,Client Receipt - Card Settlement Batch #3,Sales Receipt,Retail-NA,0.0,124377.18,USD,Card Settlement,Card Settlement Batch #3,***8461,INV-202411-Retail-NA-0006,,False,False,REF-968845,First Continental Bank,***5164,Globex Retail NA LLC,US,5555473.59
2024-11-06,2024-11-06,Supplier Payment - ExpertNet Subcontractors #8,Supplier Payment,PS-GL,4201.88,0.0,USD,ACH Debit,ExpertNet Subcontractors #8,***6141,,PO-202411-PS-GL-0002,False,False,REF-521725,First Continental Bank,***8672,Globex Retail NA LLC,US,5551271.71
2024-11-06,2024-11-06,Metro Water & Waste,Rent & Utilities,ALL,7369.7,0.0,USD,ACH Debit,Metro Water & Waste,***1661,,,False,False,REF-755574,First Continental Bank,***5780,Globex Retail NA LLC,US,5543902.01
2024-11-06,2024-11-06,Supplier Payment - ExpertNet Subcontractors #15,Supplier Payment,PS-GL,16263.57,0.0,USD,ACH Debit,ExpertNet Subcontractors #15,***2298,,PO-202411-PS-GL-0009,False,False,REF-407113,First Continental Bank,***1432,Globex Retail NA LLC,US,5527638.44
2024-11-06,2024-11-06,Supplier Payment - HyperCloud Infra #6,Supplier Payment,SaaS-GL,16932.63,0.0,USD,ACH Debit,HyperCloud Infra #6,***9721,,PO-202411-SaaS-GL-0009,False,False,REF-866989,First Continental Bank,***1780,Globex Retail NA LLC,US,5510705.81
2024-11-06,2024-11-06,Client Receipt - CloudBridge Co. #40,Sales Receipt,SaaS-GL,0.0,52006.17,USD,Card Settlement,CloudBridge Co. #40,***7478,INV-202411-SaaS-GL-0005,,False,False,REF-113768,First Continental Bank,***5460,Globex Retail NA LLC,US,5562711.98
2024-11-07,2024-11-07,Supplier Payment - PackFast Fulfillment #5,Supplier Payment,Retail-NA,4276.72,0.0,USD,Fedwire,PackFast Fulfillment #5,***1352,,PO-202411-Retail-NA-0009,False,False,REF-445265,First Continental Bank,***4576,Globex Retail NA LLC,US,5558435.26
2024-11-07,2024-11-07,Client Receipt - CloudBridge Co. #55,Sales Receipt,SaaS-GL,0.0,615.68,USD,Card Settlement,CloudBridge Co. #55,***1084,INV-202411-SaaS-GL-0007,,False,False,REF-600336,First Continental Bank,***7462,Globex Retail NA LLC,US,5559050.94
2024-11-07,2024-11-07,Client Receipt - CloudBridge Co. #52,Sales Receipt,SaaS-GL,0.0,13157.05,USD,ACH Credit,CloudBridge Co. #52,***3409,INV-202411-SaaS-GL-0010,,False,False,REF-651933,First Continental Bank,***4764,Globex Retail NA LLC,US,5572207.99
2024-11-07,2024-11-07,Client Receipt - CloudBridge Co. #68,Sales Receipt,SaaS-GL,0.0,21123.96,USD,Card Settlement,CloudBridge Co. #68,***2152,INV-202411-SaaS-GL-0013,,False,False,REF-221587,First Continental Bank,***7186,Globex Retail NA LLC,US,5593331.95
2024-11-07,2024-11-07,Client Receipt - CloudBridge Co. #25,Sales Receipt,SaaS-GL,0.0,26308.12,USD,ACH Credit,CloudBridge Co. #25,***6417,INV-202411-SaaS-GL-0024,,False,False,REF-335552,First Continental Bank,***8081,Globex Retail NA LLC,US,5619640.07
2024-11-08,2024-11-08,Supplier Payment - ExpertNet Subcontractors #7,Supplier Payment,PS-GL,69.5,0.0,USD,ACH Debit,ExpertNet Subcontractors #7,***1708,,PO-202411-PS-GL-0008,False,False,REF-493815,First Continental Bank,***3044,Globex Retail NA LLC,US,5619570.57
2024-11-08,2024-11-08,Supplier Payment - ExpertNet Subcontractors #2,Supplier Payment,PS-GL,3370.37,0.0,USD,ACH Debit,ExpertNet Subcontractors #2,***1322,,PO-202411-PS-GL-0003,False,False,REF-998381,First Continental Bank,***2339,Globex Retail NA LLC,US,5616200.2
2024-11-08,2024-11-08,Supplier Payment - NorthRiver Apparel Mfg #22,Supplier Payment,Retail-NA,6424.72,0.0,USD,Fedwire,NorthRiver Apparel Mfg #22,***6090,,PO-202411-Retail-NA-0012,False,False,REF-751231,First Continental Bank,***7986,Globex Retail NA LLC,US,5609775.48
2024-11-08,2024-11-08,Supplier Payment - NorthRiver Apparel Mfg #22,Supplier Payment,Retail-NA,65058.72,0.0,USD,ACH Debit,NorthRiver Apparel Mfg #22,***3710,,PO-202411-Retail-NA-0003,False,False,REF-298699,First Continental Bank,***5654,Globex Retail NA LLC,US,5544716.76
2024-11-09,2024-11-09,Client Receipt - ShopSphere Partner #19,Sales Receipt,Retail-NA,0.0,83915.7,USD,Card Settlement,ShopSphere Partner #19,***9852,INV-202411-Retail-NA-0003,,False,False,REF-478630,First Continental Bank,***7175,Globex Retail NA LLC,US,5628632.46
2024-11-10,2024-11-10,Supplier Payment - ExpertNet Subcontractors #19,Supplier Payment,PS-GL,11855.21,0.0,USD,Fedwire,ExpertNet Subcontractors #19,***8426,,PO-202411-PS-GL-0007,False,False,REF-727414,First Continental Bank,***5321,Globex Retail NA LLC,US,5616777.25
2024-11-11,2024-11-11,Supplier Payment - HyperCloud Infra #16,Supplier Payment,SaaS-GL,9744.98,0.0,USD,ACH Debit,HyperCloud Infra #16,***7814,,PO-202411-SaaS-GL-0004,False,False,REF-506922,First Continental Bank,***2770,Globex Retail NA LLC,US,5607032.27
2024-11-11,2024-11-11,Client Receipt - Vertex Advisory Client #30,Sales Receipt,PS-GL,0.0,23269.08,USD,ACH Credit,Vertex Advisory Client #30,***2479,INV-202411-PS-GL-0004,,False,False,REF-433393,First Continental Bank,***5971,Globex Retail NA LLC,US,5630301.35
2024-11-11,2024-11-11,Client Receipt - CloudBridge Co. #79,Sales Receipt,SaaS-GL,0.0,28773.25,USD,ACH Credit,CloudBridge Co. #79,***4035,INV-202411-SaaS-GL-0016,,False,False,REF-425546,First Continental Bank,***9492,Globex Retail NA LLC,US,5659074.6
2024-11-12,2024-11-12,Marketing - Aurelia Media #1,Marketing,ALL,5589.98,0.0,USD,Fedwire,Aurelia Media #1,***6454,,,False,False,REF-804432,First Continental Bank,***2592,Globex Retail NA LLC,US,5653484.62
2024-11-12,2024-11-12,Intercompany Settlement - Globex EMEA Manufacturing Ltd.,Intercompany Transfer,ALL,393634.0,0.0,USD,Internal Transfer,Globex EMEA Manufacturing Ltd.,***5185,,,True,True,REF-699173,First Continental Bank,***5981,Globex Retail NA LLC,US,5259850.62
2024-11-12,2024-11-12,Client Receipt - Vertex Advisory Client #22,Sales Receipt,PS-GL,0.0,5130.25,USD,Card Settlement,Vertex Advisory Client #22,***6438,INV-202411-PS-GL-0002,,False,False,REF-360220,First Continental Bank,***3668,Globex Retail NA LLC,US,5264980.87
2024-11-12,2024-11-12,Client Receipt - CloudBridge Co. #39,Sales Receipt,SaaS-GL,0.0,22608.29,USD,ACH Credit,CloudBridge Co. #39,***3570,INV-202411-SaaS-GL-0021,,False,False,REF-453504,First Continental Bank,***9032,Globex Retail NA LLC,US,5287589.16
2024-11-12,2024-11-12,Client Receipt - Vertex Advisory Client #46,Sales Receipt,PS-GL,0.0,42469.74,USD,Card Settlement,Vertex Advisory Client #46,***9033,INV-202411-PS-GL-0006,,False,False,REF-978632,First Continental Bank,***6071,Globex Retail NA LLC,US,5330058.9
2024-11-13,2024-11-13,Supplier Payment - NorthRiver Apparel Mfg #32,Supplier Payment,Retail-NA,65874.7,0.0,USD,ACH Debit,NorthRiver Apparel Mfg #32,***1658,,PO-202411-Retail-NA-0010,False,False,REF-405661,First Continental Bank,***4938,Globex Retail NA LLC,US,5264184.2
2024-11-14,2024-11-14,Alphagrid Utilities,Rent & Utilities,ALL,2507.6,0.0,USD,Fedwire,Alphagrid Utilities,***2969,,,False,False,REF-423039,First Continental Bank,***7191,Globex Retail NA LLC,US,5261676.6
2024-11-14,2024-11-14,Supplier Payment - PackFast Fulfillment #6,Supplier Payment,Retail-NA,39153.48,0.0,USD,Fedwire,PackFast Fulfillment #6,***1407,,PO-202411-Retail-NA-0007,False,False,REF-792651,First Continental Bank,***6419,Globex Retail NA LLC,US,5222523.12
2024-11-14,2024-11-14,Client Receipt - CloudBridge Co. #8,Sales Receipt,SaaS-GL,0.0,789.23,USD,ACH Credit,CloudBridge Co. #8,***7316,INV-202411-SaaS-GL-0008,,False,False,REF-360503,First Continental Bank,***7896,Globex Retail NA LLC,US,5223312.35
2024-11-14,2024-11-14,Client Receipt - ShopSphere Partner #1,Sales Receipt,Retail-NA,0.0,33205.05,USD,Card Settlement,ShopSphere Partner #1,***4278,INV-202411-Retail-NA-0009,,False,False,REF-569698,First Continental Bank,***5087,Globex Retail NA LLC,US,5256517.4
2024-11-15,2024-11-15,Supplier Payment - NorthRiver Apparel Mfg #10,Supplier Payment,Retail-NA,27277.08,0.0,USD,Fedwire,NorthRiver Apparel Mfg #10,***1738,,PO-202411-Retail-NA-0002,False,False,REF-903226,First Continental Bank,***2170,Globex Retail NA LLC,US,5229240.32
2024-11-15,2024-11-15,Client Receipt - CloudBridge Co. #30,Sales Receipt,SaaS-GL,0.0,1311.54,USD,ACH Credit,CloudBridge Co. #30,***2366,INV-202411-SaaS-GL-0001,,False,False,REF-574331,First Continental Bank,***2095,Globex Retail NA LLC,US,5230551.86
2024-11-15,2024-11-15,Client Receipt - ShopSphere Partner #73,Sales Receipt,Retail-NA,0.0,78434.15,USD,Card Settlement,ShopSphere Partner #73,***9228,INV-202411-Retail-NA-0012,,False,False,REF-360839,First Continental Bank,***2984,Globex Retail NA LLC,US,5308986.01
2024-11-17,2024-11-17,Merchant Processing Fees,Bank/Merchant Fees,ALL,749.13,0.0,USD,ACH Debit,First Continental Bank,***1745,,,False,False,REF-299195,First Continental Bank,***4333,Globex Retail NA LLC,US,5308236.88
2024-11-18,2024-11-18,Supplier Payment - NorthRiver Apparel Mfg #8,Supplier Payment,Retail-NA,2730.41,0.0,USD,ACH Debit,NorthRiver Apparel Mfg #8,***7899,,PO-202411-Retail-NA-0004,False,False,REF-188529,First Continental Bank,***1891,Globex Retail NA LLC,US,5305506.47
2024-11-18,2024-11-18,Supplier Payment - PackFast Fulfillment #5,Supplier Payment,Retail-NA,22582.62,0.0,USD,ACH Debit,PackFast Fulfillment #5,***1936,,PO-202411-Retail-NA-0011,False,False,REF-579438,First Continental Bank,***2218,Globex Retail NA LLC,US,5282923.85
2024-11-18,2024-11-18,Client Receipt - Vertex Advisory Client #50,Sales Receipt,PS-GL,0.0,6172.93,USD,Card Settlement,Vertex Advisory Client #50,***6934,INV-202411-PS-GL-0005,,False,False,REF-411511,First Continental Bank,***7172,Globex Retail NA LLC,US,5289096.78
2024-11-18,2024-11-18,Client Receipt - CloudBridge Co. #25,Sales Receipt,SaaS-GL,0.0,12357.6,USD,Card Settlement,CloudBridge Co. #25,***2838,INV-202411-SaaS-GL-0011,,False,False,REF-141117,First Continental Bank,***6579,Globex Retail NA LLC,US,5301454.38
2024-11-18,2024-11-18,Client Receipt - Vertex Advisory Client #23,Sales Receipt,PS-GL,0.0,22394.06,USD,ACH Credit,Vertex Advisory Client #23,***8238,INV-202411-PS-GL-0008,,False,False,REF-453923,First Continental Bank,***2692,Globex Retail NA LLC,US,5323848.44
2024-11-19,2024-11-19,Supplier Payment - ExpertNet Subcontractors #8,Supplier Payment,PS-GL,6687.2,0.0,USD,Fedwire,ExpertNet Subcontractors #8,***8293,,PO-202411-PS-GL-0001,False,False,REF-268577,First Continental Bank,***6414,Globex Retail NA LLC,US,5317161.24
2024-11-19,2024-11-19,Supplier Payment - ExpertNet Subcontractors #19,Supplier Payment,PS-GL,13167.27,0.0,USD,Fedwire,ExpertNet Subcontractors #19,***2608,,PO-202411-PS-GL-0004,False,False,REF-903768,First Continental Bank,***7975,Globex Retail NA LLC,US,5303993.97
2024-11-19,2024-11-19,VAT/GST Remittance - US IRS,Tax Payment,ALL,72736.32,0.0,USD,SWIFT MT103,US IRS,***6789,,,False,False,REF-860722,First Continental Bank,***2634,Globex Retail NA LLC,US,5231257.65
2024-11-19,2024-11-19,Client Receipt - CloudBridge Co. #26,Sales Receipt,SaaS-GL,0.0,10194.03,USD,ACH Credit,CloudBridge Co. #26,***4393,INV-202411-SaaS-GL-0012,,False,False,REF-279976,First Continental Bank,***6956,Globex Retail NA LLC,US,5241451.68
2024-11-19,2024-11-19,Client Receipt - CloudBridge Co. #23,Sales Receipt,SaaS-GL,0.0,12205.45,USD,ACH Credit,CloudBridge Co. #23,***8884,INV-202411-SaaS-GL-0009,,False,False,REF-764494,First Continental Bank,***2885,Globex Retail NA LLC,US,5253657.13
2024-11-20,2024-11-20,Supplier Payment - PackFast Fulfillment #3,Supplier Payment,Retail-NA,11361.37,0.0,USD,ACH Debit,PackFast Fulfillment #3,***7877,,PO-202411-Retail-NA-0006,False,False,REF-746944,First Continental Bank,***9532,Globex Retail NA LLC,US,5242295.76
2024-11-21,2024-11-21,Supplier Payment - NorthRiver Apparel Mfg #33,Supplier Payment,Retail-NA,8564.8,0.0,USD,Fedwire,NorthRiver Apparel Mfg #33,***2639,,PO-202411-Retail-NA-0008,False,False,REF-665373,First Continental Bank,***9018,Globex Retail NA LLC,US,5233730.96
2024-11-21,2024-11-21,Marketing - Beacon Digital #3,Marketing,ALL,12010.8,0.0,USD,Fedwire,Beacon Digital #3,***6732,,,False,False,REF-779159,First Continental Bank,***2066,Globex Retail NA LLC,US,5221720.16
2024-11-21,2024-11-21,Client Receipt - CloudBridge Co. #55,Sales Receipt,SaaS-GL,0.0,5452.23,USD,ACH Credit,CloudBridge Co. #55,***6372,INV-202411-SaaS-GL-0003,,False,False,REF-176183,First Continental Bank,***4257,Globex Retail NA LLC,US,5227172.39
2024-11-21,2024-11-21,Client Receipt - CloudBridge Co. #32,Sales Receipt,SaaS-GL,0.0,8343.18,USD,Card Settlement,CloudBridge Co. #32,***6558,INV-202411-SaaS-GL-0022,,False,False,REF-559837,First Continental Bank,***2295,Globex Retail NA LLC,US,5235515.57
2024-11-21,2024-11-21,Client Receipt - ShopSphere Partner #23,Sales Receipt,Retail-NA,0.0,10322.58,USD,ACH Credit,ShopSphere Partner #23,***9473,INV-202411-Retail-NA-0010,,False,False,REF-577185,First Continental Bank,***5460,Globex Retail NA LLC,US,5245838.15
2024-11-21,2024-11-21,Client Receipt - CloudBridge Co. #52,Sales Receipt,SaaS-GL,0.0,26563.88,USD,Card Settlement,CloudBridge Co. #52,***6211,INV-202411-SaaS-GL-0002,,False,False,REF-966885,First Continental Bank,***2957,Globex Retail NA LLC,US,5272402.03
2024-11-22,2024-11-22,Merchant Processing Fees,Bank/Merchant Fees,ALL,2982.11,0.0,USD,ACH Debit,First Continental Bank,***9708,,,False,False,REF-662438,First Continental Bank,***1163,Globex Retail NA LLC,US,5269419.92
2024-11-22,2024-11-22,Supplier Payment - ExpertNet Subcontractors #16,Supplier Payment,PS-GL,5140.86,0.0,USD,ACH Debit,ExpertNet Subcontractors #16,***7081,,PO-202411-PS-GL-0010,False,False,REF-727599,First Continental Bank,***7411,Globex Retail NA LLC,US,5264279.06
2024-11-22,2024-11-22,Supplier Payment - CodeCraft Contractors #14,Supplier Payment,SaaS-GL,12133.75,0.0,USD,Fedwire,CodeCraft Contractors #14,***8053,,PO-202411-SaaS-GL-0007,False,False,REF-755034,First Continental Bank,***9932,Globex Retail NA LLC,US,5252145.31
2024-11-22,2024-11-22,Supplier Payment - NorthRiver Apparel Mfg #6,Supplier Payment,Retail-NA,15563.82,0.0,USD,ACH Debit,NorthRiver Apparel Mfg #6,***6980,,PO-202411-Retail-NA-0001,False,False,REF-662018,First Continental Bank,***9340,Globex Retail NA LLC,US,5236581.49
2024-11-22,2024-11-22,Client Receipt - ShopSphere Partner #65,Sales Receipt,Retail-NA,0.0,15273.28,USD,Card Settlement,ShopSphere Partner #65,***6784,INV-202411-Retail-NA-0001,,False,False,REF-684841,First Continental Bank,***7553,Globex Retail NA LLC,US,5251854.77
2024-11-22,2024-11-22,Client Receipt - Vertex Advisory Client #49,Sales Receipt,PS-GL,0.0,62479.8,USD,ACH Credit,Vertex Advisory Client #49,***9300,INV-202411-PS-GL-0007,,False,False,REF-599727,First Continental Bank,***2058,Globex Retail NA LLC,US,5314334.57
2024-11-25,2024-11-25,Supplier Payment - HyperCloud Infra #16,Supplier Payment,SaaS-GL,9077.92,0.0,USD,Fedwire,HyperCloud Infra #16,***7638,,PO-202411-SaaS-GL-0001,False,False,REF-375927,First Continental Bank,***6413,Globex Retail NA LLC,US,5305256.65
2024-11-25,2024-11-25,Client Receipt - Card Settlement Batch #7,Sales Receipt,Retail-NA,0.0,64966.53,USD,Card Settlement,Card Settlement Batch #7,***5553,INV-202411-Retail-NA-0002,,False,False,REF-309452,First Continental Bank,***6319,Globex Retail NA LLC,US,5370223.18
2024-11-26,2024-11-26,Supplier Payment - ExpertNet Subcontractors #14,Supplier Payment,PS-GL,18992.35,0.0,USD,Fedwire,ExpertNet Subcontractors #14,***8075,,PO-202411-PS-GL-0006,False,False,REF-698408,First Continental Bank,***1945,Globex Retail NA LLC,US,5351230.83
2024-11-26,2024-11-26,"Intercompany Settlement - Globex International Holdings, Inc.",Intercompany Transfer,ALL,323587.0,0.0,USD,Internal Transfer,"Globex International Holdings, Inc.",***7450,,,True,True,REF-799689,First Continental Bank,***8751,Globex Retail NA LLC,US,5027643.83
2024-11-26,2024-11-26,Client Receipt - ShopSphere Partner #76,Sales Receipt,Retail-NA,0.0,10938.65,USD,Card Settlement,ShopSphere Partner #76,***6696,INV-202411-Retail-NA-0011,,False,False,REF-703350,First Continental Bank,***4621,Globex Retail NA LLC,US,5038582.48
2024-11-27,2024-11-27,Supplier Payment - HyperCloud Infra #14,Supplier Payment,SaaS-GL,16008.48,0.0,USD,ACH Debit,HyperCloud Infra #14,***7098,,PO-202411-SaaS-GL-0003,False,False,REF-157813,First Continental Bank,***4609,Globex Retail NA LLC,US,5022574.0
2024-11-28,2024-11-28,Supplier Payment - HyperCloud Infra #19,Supplier Payment,SaaS-GL,6725.06,0.0,USD,ACH Debit,HyperCloud Infra #19,***9379,,PO-202411-SaaS-GL-0002,False,False,REF-250469,First Continental Bank,***7353,Globex Retail NA LLC,US,5015848.94
2024-11-28,2024-11-28,Supplier Payment - CodeCraft Contractors #3,Supplier Payment,SaaS-GL,12965.03,0.0,USD,Fedwire,CodeCraft Contractors #3,***7716,,PO-202411-SaaS-GL-0005,False,False,REF-887974,First Continental Bank,***4780,Globex Retail NA LLC,US,5002883.91
2024-11-28,2024-11-28,Payroll - GlobalPay Services Ltd,Payroll,ALL,98507.99,0.0,USD,Fedwire,GlobalPay Services Ltd,***9526,,,False,False,REF-479736,First Continental Bank,***4058,Globex Retail NA LLC,US,4904375.92
2024-11-28,2024-11-28,Client Receipt - CloudBridge Co. #4,Sales Receipt,SaaS-GL,0.0,1978.74,USD,Card Settlement,CloudBridge Co. #4,***1909,INV-202411-SaaS-GL-0020,,False,False,REF-905558,First Continental Bank,***1851,Globex Retail NA LLC,US,4906354.66
2024-11-28,2024-11-28,Client Receipt - CloudBridge Co. #64,Sales Receipt,SaaS-GL,0.0,2972.29,USD,ACH Credit,CloudBridge Co. #64,***4975,INV-202411-SaaS-GL-0018,,False,False,REF-249804,First Continental Bank,***3763,Globex Retail NA LLC,US,4909326.95
2024-11-28,2024-11-28,Client Receipt - CloudBridge Co. #53,Sales Receipt,SaaS-GL,0.0,6429.91,USD,ACH Credit,CloudBridge Co. #53,***3131,INV-202411-SaaS-GL-0023,,False,False,REF-979451,First Continental Bank,***9985,Globex Retail NA LLC,US,4915756.86
2024-11-28,2024-11-28,Client Receipt - CloudBridge Co. #12,Sales Receipt,SaaS-GL,0.0,15880.53,USD,ACH Credit,CloudBridge Co. #12,***4225,INV-202411-SaaS-GL-0019,,False,False,REF-991934,First Continental Bank,***8270,Globex Retail NA LLC,US,4931637.39
2024-11-28,2024-11-28,Client Receipt - Card Settlement Batch #17,Sales Receipt,Retail-NA,0.0,34399.88,USD,Card Settlement,Card Settlement Batch #17,***4574,INV-202411-Retail-NA-0007,,False,False,REF-714081,First Continental Bank,***5264,Globex Retail NA LLC,US,4966037.27
2024-11-28,2024-11-28,Client Receipt - Vertex Advisory Client #23,Sales Receipt,PS-GL,0.0,83693.66,USD,Card Settlement,Vertex Advisory Client #23,***8048,INV-202411-PS-GL-0001,,False,False,REF-172722,First Continental Bank,***2766,Globex Retail NA LLC,US,5049730.93
2024-11-29,2024-11-29,Marketing - Beacon Digital #8,Marketing,ALL,12587.35,0.0,USD,Fedwire,Beacon Digital #8,***9365,,,False,False,REF-744829,First Continental Bank,***7576,Globex Retail NA LLC,US,5037143.58
2024-11-29,2024-11-29,Client Receipt - CloudBridge Co. #14,Sales Receipt,SaaS-GL,0.0,10289.72,USD,ACH Credit,CloudBridge Co. #14,***3870,INV-202411-SaaS-GL-0006,,False,False,REF-118588,First Continental Bank,***6679,Globex Retail NA LLC,US,5047433.3
2024-11-29,2024-11-29,Client Receipt - ShopSphere Partner #58,Sales Receipt,Retail-NA,0.0,22130.91,USD,Card Settlement,ShopSphere Partner #58,***9011,INV-202411-Retail-NA-0005,,False,False,REF-995094,First Continental Bank,***9371,Globex Retail NA LLC,US,5069564.21
2024-11-30,2024-11-30,Supplier Payment - CodeCraft Contractors #12,Supplier Payment,SaaS-GL,5377.77,0.0,USD,Fedwire,CodeCraft Contractors #12,***4885,,PO-202411-SaaS-GL-0008,False,False,REF-394314,First Continental Bank,***5870,Globex Retail NA LLC,US,5064186.44
2024-11-30,2024-11-30,Payroll - GlobalPay Services Ltd,Payroll,ALL,98507.99,0.0,USD,Fedwire,GlobalPay Services Ltd,***7932,,,False,False,REF-544019,First Continental Bank,***6698,Globex Retail NA LLC,US,4965678.45
2024-11-30,2024-11-30,Interest Earned,Interest Income,ALL,0.0,11828.41,USD,Card Settlement,First Continental Bank,***3376,,,False,False,REF-303218,First Continental Bank,***4315,Globex Retail NA LLC,US,4977506.86
2024-12-01,2024-12-01,Account Maintenance Fee,Bank/Merchant Fees,ALL,2500.0,0.0,USD,Fedwire,First Continental Bank,***8878,,,False,False,REF-502612,First Continental Bank,***6244,Globex Retail NA LLC,US,4975006.86
2024-12-01,2024-12-01,Supplier Payment - PackFast Fulfillment #6,Supplier Payment,Retail-NA,63590.28,0.0,USD,ACH Debit,PackFast Fulfillment #6,***4016,,PO-202412-Retail-NA-0003,False,False,REF-114235,First Continental Bank,***5004,Globex Retail NA LLC,US,4911416.58
2024-12-02,2024-12-02,Supplier Payment - CodeCraft Contractors #2,Supplier Payment,SaaS-GL,20706.97,0.0,USD,Fedwire,CodeCraft Contractors #2,***1584,,PO-202412-SaaS-GL-0008,False,False,REF-807734,First Continental Bank,***2218,Globex Retail NA LLC,US,4890709.61
2024-12-02,2024-12-02,Client Receipt - Vertex Advisory Client #16,Sales Receipt,PS-GL,0.0,7295.32,USD,ACH Credit,Vertex Advisory Client #16,***9262,INV-202412-PS-GL-0005,,False,False,REF-299957,First Continental Bank,***1790,Globex Retail NA LLC,US,4898004.93
2024-12-02,2024-12-02,Client Receipt - Vertex Advisory Client #20,Sales Receipt,PS-GL,0.0,27817.04,USD,Card Settlement,Vertex Advisory Client #20,***5623,INV-202412-PS-GL-0004,,False,False,REF-962368,First Continental Bank,***5513,Globex Retail NA LLC,US,4925821.97
2024-12-03,2024-12-03,Supplier Payment - ExpertNet Subcontractors #5,Supplier Payment,PS-GL,1461.82,0.0,USD,ACH Debit,ExpertNet Subcontractors #5,***8057,,PO-202412-PS-GL-0005,False,False,REF-637239,First Continental Bank,***4629,Globex Retail NA LLC,US,4924360.15
2024-12-03,2024-12-03,Supplier Payment - PackFast Fulfillment #6,Supplier Payment,Retail-NA,27018.9,0.0,USD,ACH Debit,PackFast Fulfillment #6,***4604,,PO-202412-Retail-NA-0008,False,False,REF-365253,First Continental Bank,***6822,Globex Retail NA LLC,US,4897341.25
2024-12-03,2024-12-03,Client Receipt - CloudBridge Co. #36,Sales Receipt,SaaS-GL,0.0,22102.64,USD,Card Settlement,CloudBridge Co. #36,***2998,INV-202412-SaaS-GL-0014,,False,False,REF-140457,First Continental Bank,***2292,Globex Retail NA LLC,US,4919443.89
2024-12-04,2024-12-04,Supplier Payment - PackFast Fulfillment #4,Supplier Payment,Retail-NA,46879.07,0.0,USD,ACH Debit,PackFast Fulfillment #4,***6181,,PO-202412-Retail-NA-0006,False,False,REF-612854,First Continental Bank,***7760,Globex Retail NA LLC,US,4872564.82
2024-12-04,2024-12-04,Client Receipt - ShopSphere Partner #68,Sales Receipt,Retail-NA,0.0,22598.39,USD,Card Settlement,ShopSphere Partner #68,***2317,INV-202412-Retail-NA-0003,,False,False,REF-992498,First Continental Bank,***7706,Globex Retail NA LLC,US,4895163.21
2024-12-05,2024-12-05,Client Receipt - CloudBridge Co. #10,Sales Receipt,SaaS-GL,0.0,13757.41,USD,Card Settlement,CloudBridge Co. #10,***7438,INV-202412-SaaS-GL-0003,,False,False,REF-705623,First Continental Bank,***5310,Globex Retail NA LLC,US,4908920.62
2024-12-05,2024-12-05,Client Receipt - CloudBridge Co. #52,Sales Receipt,SaaS-GL,0.0,34520.98,USD,ACH Credit,CloudBridge Co. #52,***7969,INV-202412-SaaS-GL-0018,,False,False,REF-504797,First Continental Bank,***5976,Globex Retail NA LLC,US,4943441.6
2024-12-05,2024-12-05,Client Receipt - CloudBridge Co. #11,Sales Receipt,SaaS-GL,0.0,47317.72,USD,Card Settlement,CloudBridge Co. #11,***2182,INV-202412-SaaS-GL-0010,,False,False,REF-869660,First Continental Bank,***5670,Globex Retail NA LLC,US,4990759.32
2024-12-06,2024-12-06,Merchant Processing Fees,Bank/Merchant Fees,ALL,2636.21,0.0,USD,ACH Debit,First Continental Bank,***8770,,,False,False,REF-435384,First Continental Bank,***4278,Globex Retail NA LLC,US,4988123.11
2024-12-06,2024-12-06,Supplier Payment - ExpertNet Subcontractors #7,Supplier Payment,PS-GL,6932.39,0.0,USD,ACH Debit,ExpertNet Subcontractors #7,***6500,,PO-202412-PS-GL-0004,False,False,REF-591429,First Continental Bank,***7834,Globex Retail NA LLC,US,4981190.72
2024-12-06,2024-12-06,Supplier Payment - NorthRiver Apparel Mfg #33,Supplier Payment,Retail-NA,87566.33,0.0,USD,Fedwire,NorthRiver Apparel Mfg #33,***5751,,PO-202412-Retail-NA-0005,False,False,REF-727489,First Continental Bank,***7455,Globex Retail NA LLC,US,4893624.39
2024-12-06,2024-12-06,Client Receipt - CloudBridge Co. #9,Sales Receipt,SaaS-GL,0.0,22192.94,USD,ACH Credit,CloudBridge Co. #9,***9489,INV-202412-SaaS-GL-0002,,False,False,REF-357198,First Continental Bank,***4700,Globex Retail NA LLC,US,4915817.33
2024-12-09,2024-12-09,Supplier Payment - HyperCloud Infra #5,Supplier Payment,SaaS-GL,18871.47,0.0,USD,Fedwire,HyperCloud Infra #5,***8133,,PO-202412-SaaS-GL-0001,False,False,REF-782517,First Continental Bank,***9801,Globex Retail NA LLC,US,4896945.86
2024-12-09,2024-12-09,Client Receipt - ShopSphere Partner #27,Sales Receipt,Retail-NA,0.0,7145.36,USD,Card Settlement,ShopSphere Partner #27,***9722,INV-202412-Retail-NA-0014,,False,False,REF-134492,First Continental Bank,***7187,Globex Retail NA LLC,US,4904091.22
2024-12-09,2024-12-09,Client Receipt - Vertex Advisory Client #45,Sales Receipt,PS-GL,0.0,60223.04,USD,Card Settlement,Vertex Advisory Client #45,***7617,INV-202412-PS-GL-0009,,False,False,REF-406796,First Continental Bank,***9338,Globex Retail NA LLC,US,4964314.26
2024-12-09,2024-12-09,Client Receipt - ShopSphere Partner #72,Sales Receipt,Retail-NA,0.0,67375.99,USD,ACH Credit,ShopSphere Partner #72,***2578,INV-202412-Retail-NA-0009,,False,False,REF-558165,First Continental Bank,***6430,Globex Retail NA LLC,US,5031690.25
2024-12-10,2024-12-10,Supplier Payment - HyperCloud Infra #9,Supplier Payment,SaaS-GL,1273.58,0.0,USD,Fedwire,HyperCloud Infra #9,***8244,,PO-202412-SaaS-GL-0007,False,False,REF-890341,First Continental Bank,***6481,Globex Retail NA LLC,US,5030416.67
2024-12-10,2024-12-10,Supplier Payment - HyperCloud Infra #3,Supplier Payment,SaaS-GL,2637.21,0.0,USD,ACH Debit,HyperCloud Infra #3,***9413,,PO-202412-SaaS-GL-0004,False,False,REF-296266,First Continental Bank,***4638,Globex Retail NA LLC,US,5027779.46
2024-12-10,2024-12-10,Supplier Payment - ExpertNet Subcontractors #1,Supplier Payment,PS-GL,14623.48,0.0,USD,Fedwire,ExpertNet Subcontractors #1,***8754,,PO-202412-PS-GL-0003,False,False,REF-644519,First Continental Bank,***3998,Globex Retail NA LLC,US,5013155.98
2024-12-10,2024-12-10,Supplier Payment - CodeCraft Contractors #3,Supplier Payment,SaaS-GL,31464.92,0.0,USD,ACH Debit,CodeCraft Contractors #3,***4953,,PO-202412-SaaS-GL-0002,False,False,REF-630991,First Continental Bank,***6003,Globex Retail NA LLC,US,4981691.06
2024-12-10,2024-12-10,Client Receipt - CloudBridge Co. #5,Sales Receipt,SaaS-GL,0.0,13267.5,USD,Card Settlement,CloudBridge Co. #5,***2432,INV-202412-SaaS-GL-0009,,False,False,REF-493129,First Continental Bank,***7552,Globex Retail NA LLC,US,4994958.56
2024-12-10,2024-12-10,Client Receipt - CloudBridge Co. #15,Sales Receipt,SaaS-GL,0.0,26230.38,USD,Card Settlement,CloudBridge Co. #15,***1283,INV-202412-SaaS-GL-0020,,False,False,REF-766866,First Continental Bank,***6901,Globex Retail NA LLC,US,5021188.94
2024-12-10,2024-12-10,Client Receipt - Card Settlement Batch #8,Sales Receipt,Retail-NA,0.0,42327.67,USD,ACH Credit,Card Settlement Batch #8,***5878,INV-202412-Retail-NA-0012,,False,False,REF-409294,First Continental Bank,***2275,Globex Retail NA LLC,US,5063516.61
2024-12-10,2024-12-10,Client Receipt - CloudBridge Co. #12,Sales Receipt,SaaS-GL,0.0,62543.06,USD,Card Settlement,CloudBridge Co. #12,***6354,INV-202412-SaaS-GL-0007,,False,False,REF-900857,First Continental Bank,***4814,Globex Retail NA LLC,US,5126059.67
2024-12-11,2024-12-11,Client Receipt - Vertex Advisory Client #1,Sales Receipt,PS-GL,0.0,3147.5,USD,Card Settlement,Vertex Advisory Client #1,***4208,INV-202412-PS-GL-0001,,False,False,REF-865682,First Continental Bank,***7038,Globex Retail NA LLC,US,5129207.17
2024-12-11,2024-12-11,Client Receipt - CloudBridge Co. #56,Sales Receipt,SaaS-GL,0.0,4084.53,USD,Card Settlement,CloudBridge Co. #56,***7769,INV-202412-SaaS-GL-0004,,False,False,REF-529088,First Continental Bank,***7034,Globex Retail NA LLC,US,5133291.7
2024-12-11,2024-12-11,Client Receipt - CloudBridge Co. #69,Sales Receipt,SaaS-GL,0.0,20547.71,USD,ACH Credit,CloudBridge Co. #69,***6358,INV-202412-SaaS-GL-0017,,False,False,REF-374717,First Continental Bank,***1907,Globex Retail NA LLC,US,5153839.41
2024-12-12,2024-12-12,Supplier Payment - CodeCraft Contractors #1,Supplier Payment,SaaS-GL,5003.84,0.0,USD,ACH Debit,CodeCraft Contractors #1,***2983,,PO-202412-SaaS-GL-0010,False,False,REF-592453,First Continental Bank,***3371,Globex Retail NA LLC,US,5148835.57
2024-12-12,2024-12-12,Supplier Payment - ExpertNet Subcontractors #18,Supplier Payment,PS-GL,22713.68,0.0,USD,ACH Debit,ExpertNet Subcontractors #18,***8785,,PO-202412-PS-GL-0007,False,False,REF-999220,First Continental Bank,***9539,Globex Retail NA LLC,US,5126121.89
2024-12-12,2024-12-12,Intercompany Settlement - Globex APAC Logistics Pte. Ltd.,Intercompany Transfer,ALL,189468.0,0.0,USD,Internal Transfer,Globex APAC Logistics Pte. Ltd.,***6143,,,True,True,REF-862844,First Continental Bank,***9458,Globex Retail NA LLC,US,4936653.89
2024-12-12,2024-12-12,Client Receipt - CloudBridge Co. #18,Sales Receipt,SaaS-GL,0.0,4453.5,USD,ACH Credit,CloudBridge Co. #18,***3000,INV-202412-SaaS-GL-0019,,False,False,REF-196963,First Continental Bank,***9850,Globex Retail NA LLC,US,4941107.39
2024-12-13,2024-12-13,Supplier Payment - NorthRiver Apparel Mfg #29,Supplier Payment,Retail-NA,31496.68,0.0,USD,ACH Debit,NorthRiver Apparel Mfg #29,***7017,,PO-202412-Retail-NA-0001,False,False,REF-168767,First Continental Bank,***3063,Globex Retail NA LLC,US,4909610.71
2024-12-13,2024-12-13,Client Receipt - Vertex Advisory Client #45,Sales Receipt,PS-GL,0.0,20487.49,USD,Card Settlement,Vertex Advisory Client #45,***9364,INV-202412-PS-GL-0008,,False,False,REF-190220,First Continental Bank,***6873,Globex Retail NA LLC,US,4930098.2
2024-12-13,2024-12-13,Client Receipt - Vertex Advisory Client #32,Sales Receipt,PS-GL,0.0,21803.71,USD,ACH Credit,Vertex Advisory Client #32,***9468,INV-202412-PS-GL-0006,,False,False,REF-250215,First Continental Bank,***5621,Globex Retail NA LLC,US,4951901.91
2024-12-14,2024-12-14,Supplier Payment - NorthRiver Apparel Mfg #9,Supplier Payment,Retail-NA,52255.54,0.0,USD,ACH Debit,NorthRiver Apparel Mfg #9,***9208,,PO-202412-Retail-NA-0004,False,False,REF-783285,First Continental Bank,***1475,Globex Retail NA LLC,US,4899646.37
2024-12-15,2024-12-15,Northshore Power,Rent & Utilities,ALL,5610.77,0.0,USD,Fedwire,Northshore Power,***2273,,,False,False,REF-578909,First Continental Bank,***4401,Globex Retail NA LLC,US,4894035.6
2024-12-16,2024-12-16,Supplier Payment - ExpertNet Subcontractors #14,Supplier Payment,PS-GL,5642.95,0.0,USD,Fedwire,ExpertNet Subcontractors #14,***2530,,PO-202412-PS-GL-0008,False,False,REF-775185,First Continental Bank,***1955,Globex Retail NA LLC,US,4888392.65
2024-12-16,2024-12-16,Client Receipt - ShopSphere Partner #58,Sales Receipt,Retail-NA,0.0,21321.28,USD,ACH Credit,ShopSphere Partner #58,***3205,INV-202412-Retail-NA-0007,,False,False,REF-789234,First Continental Bank,***2172,Globex Retail NA LLC,US,4909713.93
2024-12-16,2024-12-16,Client Receipt - CloudBridge Co. #60,Sales Receipt,SaaS-GL,0.0,24176.18,USD,ACH Credit,CloudBridge Co. #60,***3551,INV-202412-SaaS-GL-0011,,False,False,REF-933023,First Continental Bank,***6363,Globex Retail NA LLC,US,4933890.11
2024-12-16,2024-12-16,Client Receipt - ShopSphere Partner #5,Sales Receipt,Retail-NA,0.0,27584.48,USD,ACH Credit,ShopSphere Partner #5,***1867,INV-202412-Retail-NA-0002,,False,False,REF-440555,First Continental Bank,***9622,Globex Retail NA LLC,US,4961474.59
2024-12-16,2024-12-16,Client Receipt - CloudBridge Co. #21,Sales Receipt,SaaS-GL,0.0,54621.94,USD,ACH Credit,CloudBridge Co. #21,***2989,INV-202412-SaaS-GL-0013,,False,False,REF-401340,First Continental Bank,***5252,Globex Retail NA LLC,US,5016096.53
2024-12-17,2024-12-17,Client Receipt - CloudBridge Co. #26,Sales Receipt,SaaS-GL,0.0,2509.49,USD,ACH Credit,CloudBridge Co. #26,***8031,INV-202412-SaaS-GL-0008,,False,False,REF-841303,First Continental Bank,***2814,Globex Retail NA LLC,US,5018606.02
2024-12-17,2024-12-17,Client Receipt - ShopSphere Partner #11,Sales Receipt,Retail-NA,0.0,33447.62,USD,ACH Credit,ShopSphere Partner #11,***4742,INV-202412-Retail-NA-0011,,False,False,REF-769038,First Continental Bank,***7161,Globex Retail NA LLC,US,5052053.64
2024-12-17,2024-12-17,Client Receipt - CloudBridge Co. #79,Sales Receipt,SaaS-GL,0.0,34210.18,USD,ACH Credit,CloudBridge Co. #79,***3208,INV-202412-SaaS-GL-0016,,False,False,REF-311264,First Continental Bank,***7451,Globex Retail NA LLC,US,5086263.82
2024-12-17,2024-12-17,Client Receipt - ShopSphere Partner #20,Sales Receipt,Retail-NA,0.0,52708.72,USD,Card Settlement,ShopSphere Partner #20,***3921,INV-202412-Retail-NA-0006,,False,False,REF-733311,First Continental Bank,***9753,Globex Retail NA LLC,US,5138972.54
2024-12-19,2024-12-19,Supplier Payment - PackFast Fulfillment #7,Supplier Payment,Retail-NA,3264.93,0.0,USD,ACH Debit,PackFast Fulfillment #7,***3236,,PO-202412-Retail-NA-0007,False,False,REF-707272,First Continental Bank,***1696,Globex Retail NA LLC,US,5135707.61
2024-12-19,2024-12-19,Supplier Payment - CodeCraft Contractors #13,Supplier Payment,SaaS-GL,10839.26,0.0,USD,ACH Debit,CodeCraft Contractors #13,***4816,,PO-202412-SaaS-GL-0006,False,False,REF-219854,First Continental Bank,***8246,Globex Retail NA LLC,US,5124868.35
2024-12-19,2024-12-19,Client Receipt - Card Settlement Batch #21,Sales Receipt,Retail-NA,0.0,60225.93,USD,ACH Credit,Card Settlement Batch #21,***4353,INV-202412-Retail-NA-0001,,False,False,REF-910922,First Continental Bank,***8631,Globex Retail NA LLC,US,5185094.28
2024-12-20,2024-12-20,Supplier Payment - ExpertNet Subcontractors #7,Supplier Payment,PS-GL,8224.88,0.0,USD,ACH Debit,ExpertNet Subcontractors #7,***1089,,PO-202412-PS-GL-0002,False,False,REF-550484,First Continental Bank,***5655,Globex Retail NA LLC,US,5176869.4
2024-12-20,2024-12-20,Marketing - Beacon Digital #8,Marketing,ALL,12641.11,0.0,USD,ACH Debit,Beacon Digital #8,***8014,,,False,False,REF-914311,First Continental Bank,***5672,Globex Retail NA LLC,US,5164228.29
2024-12-20,2024-12-20,Client Receipt - ShopSphere Partner #11,Sales Receipt,Retail-NA,0.0,42962.69,USD,ACH Credit,ShopSphere Partner #11,***3791,INV-202412-Retail-NA-0004,,False,False,REF-991445,First Continental Bank,***4179,Globex Retail NA LLC,US,5207190.98
2024-12-20,2024-12-20,Client Receipt - Vertex Advisory Client #58,Sales Receipt,PS-GL,0.0,101086.74,USD,Card Settlement,Vertex Advisory Client #58,***4654,INV-202412-PS-GL-0010,,False,False,REF-341067,First Continental Bank,***7560,Globex Retail NA LLC,US,5308277.72
2024-12-21,2024-12-21,Skyline Internet Services,Rent & Utilities,ALL,5337.82,0.0,USD,ACH Debit,Skyline Internet Services,***1118,,,False,False,REF-405538,First Continental Bank,***5681,Globex Retail NA LLC,US,5302939.9
2024-12-21,2024-12-21,VAT/GST Remittance - US IRS,Tax Payment,ALL,85297.24,0.0,USD,Fedwire,US IRS,***5037,,,False,False,REF-990123,First Continental Bank,***9322,Globex Retail NA LLC,US,5217642.66
2024-12-21,2024-12-21,Client Receipt - Vertex Advisory Client #33,Sales Receipt,PS-GL,0.0,22303.04,USD,ACH Credit,Vertex Advisory Client #33,***8253,INV-202412-PS-GL-0002,,False,False,REF-608522,First Continental Bank,***6308,Globex Retail NA LLC,US,5239945.7
2024-12-21,2024-12-21,Client Receipt - Card Settlement Batch #2,Sales Receipt,Retail-NA,0.0,84407.33,USD,Card Settlement,Card Settlement Batch #2,***7747,INV-202412-Retail-NA-0010,,False,False,REF-300433,First Continental Bank,***6689,Globex Retail NA LLC,US,5324353.03
2024-12-23,2024-12-23,Supplier Payment - ExpertNet Subcontractors #18,Supplier Payment,PS-GL,2807.62,0.0,USD,ACH Debit,ExpertNet Subcontractors #18,***8038,,PO-202412-PS-GL-0001,False,False,REF-996701,First Continental Bank,***3506,Globex Retail NA LLC,US,5321545.41
2024-12-23,2024-12-23,Supplier Payment - CodeCraft Contractors #10,Supplier Payment,SaaS-GL,6821.26,0.0,USD,Fedwire,CodeCraft Contractors #10,***6675,,PO-202412-SaaS-GL-0009,False,False,REF-625214,First Continental Bank,***4292,Globex Retail NA LLC,US,5314724.15
2024-12-23,2024-12-23,Supplier Payment - ExpertNet Subcontractors #10,Supplier Payment,PS-GL,28359.45,0.0,USD,Fedwire,ExpertNet Subcontractors #10,***1348,,PO-202412-PS-GL-0009,False,False,REF-872515,First Continental Bank,***2952,Globex Retail NA LLC,US,5286364.7
2024-12-23,2024-12-23,Client Receipt - ShopSphere Partner #35,Sales Receipt,Retail-NA,0.0,16175.45,USD,Card Settlement,ShopSphere Partner #35,***2550,INV-202412-Retail-NA-0013,,False,False,REF-620563,First Continental Bank,***4982,Globex Retail NA LLC,US,5302540.15
2024-12-23,2024-12-23,Client Receipt - Vertex Advisory Client #26,Sales Receipt,PS-GL,0.0,45327.65,USD,ACH Credit,Vertex Advisory Client #26,***4899,INV-202412-PS-GL-0003,,False,False,REF-702338,First Continental Bank,***1014,Globex Retail NA LLC,US,5347867.8
2024-12-23,2024-12-23,Client Receipt - CloudBridge Co. #47,Sales Receipt,SaaS-GL,0.0,53646.73,USD,Card Settlement,CloudBridge Co. #47,***3062,INV-202412-SaaS-GL-0015,,False,False,REF-816252,First Continental Bank,***8018,Globex Retail NA LLC,US,5401514.53
2024-12-24,2024-12-24,Client Receipt - ShopSphere Partner #47,Sales Receipt,Retail-NA,0.0,1807.98,USD,ACH Credit,ShopSphere Partner #47,***3925,INV-202412-Retail-NA-0005,,False,False,REF-541696,First Continental Bank,***5178,Globex Retail NA LLC,US,5403322.51
2024-12-24,2024-12-24,Client Receipt - CloudBridge Co. #9,Sales Receipt,SaaS-GL,0.0,2421.83,USD,ACH Credit,CloudBridge Co. #9,***7976,INV-202412-SaaS-GL-0001,,False,False,REF-378055,First Continental Bank,***3032,Globex Retail NA LLC,US,5405744.34
2024-12-25,2024-12-25,Supplier Payment - CodeCraft Contractors #3,Supplier Payment,SaaS-GL,1516.81,0.0,USD,Fedwire,CodeCraft Contractors #3,***5717,,PO-202412-SaaS-GL-0005,False,False,REF-677972,First Continental Bank,***3108,Globex Retail NA LLC,US,5404227.53
2024-12-25,2024-12-25,Client Receipt - CloudBridge Co. #79,Sales Receipt,SaaS-GL,0.0,24331.85,USD,Card Settlement,CloudBridge Co. #79,***5828,INV-202412-SaaS-GL-0012,,False,False,REF-445419,First Continental Bank,***3840,Globex Retail NA LLC,US,5428559.38
2024-12-26,2024-12-26,Supplier Payment - ExpertNet Subcontractors #14,Supplier Payment,PS-GL,3792.83,0.0,USD,ACH Debit,ExpertNet Subcontractors #14,***6504,,PO-202412-PS-GL-0006,False,False,REF-453976,First Continental Bank,***1791,Globex Retail NA LLC,US,5424766.55
2024-12-26,2024-12-26,Supplier Payment - PackFast Fulfillment #18,Supplier Payment,Retail-NA,5751.91,0.0,USD,Fedwire,PackFast Fulfillment #18,***6180,,PO-202412-Retail-NA-0002,False,False,REF-525015,First Continental Bank,***7493,Globex Retail NA LLC,US,5419014.64
2024-12-26,2024-12-26,Intercompany Settlement - Globex APAC Logistics Pte. Ltd.,Intercompany Transfer,ALL,824363.0,0.0,USD,Internal Transfer,Globex APAC Logistics Pte. Ltd.,***6442,,,True,True,REF-166707,First Continental Bank,***1388,Globex Retail NA LLC,US,4594651.64
2024-12-27,2024-12-27,Merchant Processing Fees,Bank/Merchant Fees,ALL,1246.91,0.0,USD,ACH Debit,First Continental Bank,***7538,,,False,False,REF-891617,First Continental Bank,***4289,Globex Retail NA LLC,US,4593404.73
2024-12-27,2024-12-27,Client Receipt - ShopSphere Partner #77,Sales Receipt,Retail-NA,0.0,97772.27,USD,ACH Credit,ShopSphere Partner #77,***4720,INV-202412-Retail-NA-0008,,False,False,REF-505632,First Continental Bank,***9599,Globex Retail NA LLC,US,4691177.0
2024-12-28,2024-12-28,Client Receipt - Vertex Advisory Client #27,Sales Receipt,PS-GL,0.0,5705.47,USD,ACH Credit,Vertex Advisory Client #27,***5968,INV-202412-PS-GL-0007,,False,False,REF-389900,First Continental Bank,***6228,Globex Retail NA LLC,US,4696882.47
2024-12-29,2024-12-29,Payroll - GlobalPay Services Ltd,Payroll,ALL,220559.29,0.0,USD,Fedwire,GlobalPay Services Ltd,***6963,,,False,False,REF-777538,First Continental Bank,***9476,Globex Retail NA LLC,US,4476323.18
2024-12-30,2024-12-30,Supplier Payment - HyperCloud Infra #16,Supplier Payment,SaaS-GL,4879.69,0.0,USD,Fedwire,HyperCloud Infra #16,***4146,,PO-202412-SaaS-GL-0003,False,False,REF-384254,First Continental Bank,***3876,Globex Retail NA LLC,US,4471443.49
2024-12-30,2024-12-30,Interest Earned,Interest Income,ALL,0.0,11381.06,USD,ACH Credit,First Continental Bank,***3462,,,False,False,REF-751523,First Continental Bank,***3725,Globex Retail NA LLC,US,4482824.55
2024-12-31,2024-12-31,Marketing - Aurelia Media #4,Marketing,ALL,21969.44,0.0,USD,Fedwire,Aurelia Media #4,***8932,,,False,False,REF-638534,First Continental Bank,***4778,Globex Retail NA LLC,US,4460855.11
2024-12-31,2024-12-31,Client Receipt - CloudBridge Co. #18,Sales Receipt,SaaS-GL,0.0,1396.02,USD,ACH Credit,CloudBridge Co. #18,***4008,INV-202412-SaaS-GL-0006,,False,False,REF-477026,First Continental Bank,***8021,Globex Retail NA LLC,US,4462251.13
2024-12-31,2024-12-31,Client Receipt - CloudBridge Co. #66,Sales Receipt,SaaS-GL,0.0,4462.91,USD,ACH Credit,CloudBridge Co. #66,***6494,INV-202412-SaaS-GL-0005,,False,False,REF-487443,First Continental Bank,***4954,Globex Retail NA LLC,US,4466714.04
2025-01-01,2025-01-01,Account Maintenance Fee,Bank/Merchant Fees,ALL,2500.0,0.0,USD,Fedwire,First Continental Bank,***9279,,,False,False,REF-325941,First Continental Bank,***9293,Globex Retail NA LLC,US,4464214.04
2025-01-01,2025-01-01,Supplier Payment - NorthRiver Apparel Mfg #22,Supplier Payment,Retail-NA,4231.08,0.0,USD,ACH Debit,NorthRiver Apparel Mfg #22,***5787,,PO-202501-Retail-NA-0001,False,False,REF-227173,First Continental Bank,***2750,Globex Retail NA LLC,US,4459982.96
2025-01-02,2025-01-02,Supplier Payment - ExpertNet Subcontractors #5,Supplier Payment,PS-GL,981.52,0.0,USD,Fedwire,ExpertNet Subcontractors #5,***2036,,PO-202501-PS-GL-0010,False,False,REF-841792,First Continental Bank,***2078,Globex Retail NA LLC,US,4459001.44
2025-01-02,2025-01-02,Supplier Payment - ExpertNet Subcontractors #3,Supplier Payment,PS-GL,4072.67,0.0,USD,ACH Debit,ExpertNet Subcontractors #3,***7553,,PO-202501-PS-GL-0007,False,False,REF-589950,First Continental Bank,***1684,Globex Retail NA LLC,US,4454928.77
2025-01-02,2025-01-02,Client Receipt - CloudBridge Co. #6,Sales Receipt,SaaS-GL,0.0,213.91,USD,Card Settlement,CloudBridge Co. #6,***8240,INV-202501-SaaS-GL-0013,,False,False,REF-931763,First Continental Bank,***8174,Globex Retail NA LLC,US,4455142.68
2025-01-02,2025-01-02,Client Receipt - CloudBridge Co. #71,Sales Receipt,SaaS-GL,0.0,2115.22,USD,Card Settlement,CloudBridge Co. #71,***8846,INV-202501-SaaS-GL-0026,,False,False,REF-291120,First Continental Bank,***5592,Globex Retail NA LLC,US,4457257.9
2025-01-02,2025-01-02,Client Receipt - ShopSphere Partner #5,Sales Receipt,Retail-NA,0.0,2302.47,USD,ACH Credit,ShopSphere Partner #5,***6767,INV-202501-Retail-NA-0006,,False,False,REF-543108,First Continental Bank,***5318,Globex Retail NA LLC,US,4459560.37
2025-01-02,2025-01-02,Client Receipt - CloudBridge Co. #23,Sales Receipt,SaaS-GL,0.0,3941.86,USD,Card Settlement,CloudBridge Co. #23,***5301,INV-202501-SaaS-GL-0007,,False,False,REF-622601,First Continental Bank,***6141,Globex Retail NA LLC,US,4463502.23
2025-01-02,2025-01-02,Client Receipt - CloudBridge Co. #54,Sales Receipt,SaaS-GL,0.0,17603.61,USD,ACH Credit,CloudBridge Co. #54,***9613,INV-202501-SaaS-GL-0030,,False,False,REF-291882,First Continental Bank,***3667,Globex Retail NA LLC,US,4481105.84
2025-01-03,2025-01-03,Client Receipt - CloudBridge Co. #59,Sales Receipt,SaaS-GL,0.0,1339.2,USD,ACH Credit,CloudBridge Co. #59,***4304,INV-202501-SaaS-GL-0020,,False,False,REF-208574,First Continental Bank,***1251,Globex Retail NA LLC,US,4482445.04
2025-01-03,2025-01-03,Client Receipt - CloudBridge Co. #72,Sales Receipt,SaaS-GL,0.0,24032.07,USD,ACH Credit,CloudBridge Co. #72,***7162,INV-202501-SaaS-GL-0035,,False,False,REF-379548,First Continental Bank,***1775,Globex Retail NA LLC,US,4506477.11
2025-01-05,2025-01-05,Supplier Payment - NorthRiver Apparel Mfg #33,Supplier Payment,Retail-NA,1671.18,0.0,USD,Fedwire,NorthRiver Apparel Mfg #33,***5502,,PO-202501-Retail-NA-0010,False,False,REF-590424,First Continental Bank,***5770,Globex Retail NA LLC,US,4504805.93
2025-01-05,2025-01-05,Client Receipt - Vertex Advisory Client #13,Sales Receipt,PS-GL,0.0,65410.88,USD,Card Settlement,Vertex Advisory Client #13,***2829,INV-202501-PS-GL-0003,,False,False,REF-590505,First Continental Bank,***9643,Globex Retail NA LLC,US,4570216.81
2025-01-06,2025-01-06,BluePeak Property Mgmt,Rent & Utilities,ALL,1464.98,0.0,USD,ACH Debit,BluePeak Property Mgmt,***5095,,,False,False,REF-194430,First Continental Bank,***9503,Globex Retail NA LLC,US,4568751.83
2025-01-06,2025-01-06,Supplier Payment - HyperCloud Infra #1,Supplier Payment,SaaS-GL,1728.78,0.0,USD,Fedwire,HyperCloud Infra #1,***3749,,PO-202501-SaaS-GL-0011,False,False,REF-253241,First Continental Bank,***3304,Globex Retail NA LLC,US,4567023.05
2025-01-06,2025-01-06,Supplier Payment - NorthRiver Apparel Mfg #13,Supplier Payment,Retail-NA,23846.82,0.0,USD,Fedwire,NorthRiver Apparel Mfg #13,***9015,,PO-202501-Retail-NA-0005,False,False,REF-524271,First Continental Bank,***5739,Globex Retail NA LLC,US,4543176.23
2025-01-06,2025-01-06,Client Receipt - CloudBridge Co. #68,Sales Receipt,SaaS-GL,0.0,4633.81,USD,ACH Credit,CloudBridge Co. #68,***7617,INV-202501-SaaS-GL-0022,,False,False,REF-483585,First Continental Bank,***7462,Globex Retail NA LLC,US,4547810.04
2025-01-07,2025-01-07,Supplier Payment - CodeCraft Contractors #4,Supplier Payment,SaaS-GL,479.37,0.0,USD,Fedwire,CodeCraft Contractors #4,***8176,,PO-202501-SaaS-GL-0001,False,False,REF-531711,First Continental Bank,***7135,Globex Retail NA LLC,US,4547330.67
2025-01-07,2025-01-07,Supplier Payment - HyperCloud Infra #11,Supplier Payment,SaaS-GL,3336.24,0.0,USD,Fedwire,HyperCloud Infra #11,***2225,,PO-202501-SaaS-GL-0009,False,False,REF-614282,First Continental Bank,***1652,Globex Retail NA LLC,US,4543994.43
2025-01-07,2025-01-07,Supplier Payment - ExpertNet Subcontractors #4,Supplier Payment,PS-GL,6341.43,0.0,USD,ACH Debit,ExpertNet Subcontractors #4,***9632,,PO-202501-PS-GL-0006,False,False,REF-878181,First Continental Bank,***1607,Globex Retail NA LLC,US,4537653.0
2025-01-07,2025-01-07,Supplier Payment - HyperCloud Infra #18,Supplier Payment,SaaS-GL,8673.88,0.0,USD,ACH Debit,HyperCloud Infra #18,***4260,,PO-202501-SaaS-GL-0008,False,False,REF-435591,First Continental Bank,***3725,Globex Retail NA LLC,US,4528979.12
2025-01-07,2025-01-07,Supplier Payment - PackFast Fulfillment #12,Supplier Payment,Retail-NA,13177.13,0.0,USD,Fedwire,PackFast Fulfillment #12,***2923,,PO-202501-Retail-NA-0003,False,False,REF-593601,First Continental Bank,***6719,Globex Retail NA LLC,US,4515801.99
2025-01-07,2025-01-07,Client Receipt - Card Settlement Batch #4,Sales Receipt,Retail-NA,0.0,1456.3,USD,Card Settlement,Card Settlement Batch #4,***4927,INV-202501-Retail-NA-0011,,False,False,REF-965353,First Continental Bank,***2509,Globex Retail NA LLC,US,4517258.29
2025-01-07,2025-01-07,Client Receipt - CloudBridge Co. #3,Sales Receipt,SaaS-GL,0.0,5867.28,USD,Card Settlement,CloudBridge Co. #3,***4424,INV-202501-SaaS-GL-0018,,False,False,REF-253961,First Continental Bank,***2491,Globex Retail NA LLC,US,4523125.57
2025-01-08,2025-01-08,Client Receipt - ShopSphere Partner #4,Sales Receipt,Retail-NA,0.0,2237.86,USD,ACH Credit,ShopSphere Partner #4,***5506,INV-202501-Retail-NA-0003,,False,False,REF-843964,First Continental Bank,***8310,Globex Retail NA LLC,US,4525363.43
2025-01-08,2025-01-08,Client Receipt - CloudBridge Co. #35,Sales Receipt,SaaS-GL,0.0,2301.58,USD,Card Settlement,CloudBridge Co. #35,***9432,INV-202501-SaaS-GL-0017,,False,False,REF-375713,First Continental Bank,***8283,Globex Retail NA LLC,US,4527665.01
2025-01-08,2025-01-08,Client Receipt - ShopSphere Partner #34,Sales Receipt,Retail-NA,0.0,11465.96,USD,Card Settlement,ShopSphere Partner #34,***3917,INV-202501-Retail-NA-0008,,False,False,REF-166717,First Continental Bank,***9002,Globex Retail NA LLC,US,4539130.97
2025-01-08,2025-01-08,Client Receipt - Vertex Advisory Client #13,Sales Receipt,PS-GL,0.0,17594.45,USD,Card Settlement,Vertex Advisory Client #13,***9509,INV-202501-PS-GL-0005,,False,False,REF-464153,First Continental Bank,***7363,Globex Retail NA LLC,US,4556725.42
2025-01-09,2025-01-09,Supplier Payment - ExpertNet Subcontractors #5,Supplier Payment,PS-GL,1286.95,0.0,USD,ACH Debit,ExpertNet Subcontractors #5,***4059,,PO-202501-PS-GL-0009,False,False,REF-992932,First Continental Bank,***5523,Globex Retail NA LLC,US,4555438.47
2025-01-10,2025-01-10,Supplier Payment - NorthRiver Apparel Mfg #24,Supplier Payment,Retail-NA,19172.98,0.0,USD,Fedwire,NorthRiver Apparel Mfg #24,***7400,,PO-202501-Retail-NA-0008,False,False,REF-849527,First Continental Bank,***2893,Globex Retail NA LLC,US,4536265.49
2025-01-10,2025-01-10,Client Receipt - CloudBridge Co. #32,Sales Receipt,SaaS-GL,0.0,7677.19,USD,Card Settlement,CloudBridge Co. #32,***7000,INV-202501-SaaS-GL-0006,,False,False,REF-598529,First Continental Bank,***7957,Globex Retail NA LLC,US,4543942.68
2025-01-10,2025-01-10,Client Receipt - CloudBridge Co. #69,Sales Receipt,SaaS-GL,0.0,9201.82,USD,Card Settlement,CloudBridge Co. #69,***1702,INV-202501-SaaS-GL-0015,,False,False,REF-819719,First Continental Bank,***5027,Globex Retail NA LLC,US,4553144.5
2025-01-10,2025-01-10,Client Receipt - ShopSphere Partner #44,Sales Receipt,Retail-NA,0.0,53192.55,USD,Card Settlement,ShopSphere Partner #44,***8311,INV-202501-Retail-NA-0015,,False,False,REF-608154,First Continental Bank,***1592,Globex Retail NA LLC,US,4606337.05
2025-01-11,2025-01-11,Merchant Processing Fees,Bank/Merchant Fees,ALL,1135.78,0.0,USD,ACH Debit,First Continental Bank,***4218,,,False,False,REF-350334,First Continental Bank,***3799,Globex Retail NA LLC,US,4605201.27
2025-01-11,2025-01-11,Supplier Payment - HyperCloud Infra #11,Supplier Payment,SaaS-GL,5271.09,0.0,USD,ACH Debit,HyperCloud Infra #11,***3843,,PO-202501-SaaS-GL-0005,False,False,REF-224880,First Continental Bank,***4373,Globex Retail NA LLC,US,4599930.18
2025-01-12,2025-01-12,Alphagrid Utilities,Rent & Utilities,ALL,4011.96,0.0,USD,Fedwire,Alphagrid Utilities,***9457,,,False,False,REF-107840,First Continental Bank,***3908,Globex Retail NA LLC,US,4595918.22
2025-01-12,2025-01-12,Intercompany Settlement - Globex APAC Logistics Pte. Ltd.,Intercompany Transfer,ALL,778713.0,0.0,USD,Internal Transfer,Globex APAC Logistics Pte. Ltd.,***9909,,,True,True,REF-952899,First Continental Bank,***3490,Globex Retail NA LLC,US,3817205.22
2025-01-12,2025-01-12,Client Receipt - CloudBridge Co. #13,Sales Receipt,SaaS-GL,0.0,485.23,USD,Card Settlement,CloudBridge Co. #13,***9351,INV-202501-SaaS-GL-0009,,False,False,REF-600154,First Continental Bank,***4404,Globex Retail NA LLC,US,3817690.45
2025-01-13,2025-01-13,Marketing - Aurelia Media #2,Marketing,ALL,3318.14,0.0,USD,Fedwire,Aurelia Media #2,***5328,,,False,False,REF-957028,First Continental Bank,***1341,Globex Retail NA LLC,US,3814372.31
2025-01-13,2025-01-13,Supplier Payment - PackFast Fulfillment #15,Supplier Payment,Retail-NA,33139.83,0.0,USD,Fedwire,PackFast Fulfillment #15,***7740,,PO-202501-Retail-NA-0009,False,False,REF-187575,First Continental Bank,***7044,Globex Retail NA LLC,US,3781232.48
2025-01-13,2025-01-13,Client Receipt - Vertex Advisory Client #51,Sales Receipt,PS-GL,0.0,5316.78,USD,ACH Credit,Vertex Advisory Client #51,***3575,INV-202501-PS-GL-0008,,False,False,REF-958698,First Continental Bank,***1582,Globex Retail NA LLC,US,3786549.26
2025-01-13,2025-01-13,Client Receipt - CloudBridge Co. #40,Sales Receipt,SaaS-GL,0.0,5794.98,USD,ACH Credit,CloudBridge Co. #40,***4261,INV-202501-SaaS-GL-0025,,False,False,REF-485432,First Continental Bank,***8735,Globex Retail NA LLC,US,3792344.24
2025-01-13,2025-01-13,Client Receipt - Vertex Advisory Client #24,Sales Receipt,PS-GL,0.0,13434.32,USD,ACH Credit,Vertex Advisory Client #24,***9277,INV-202501-PS-GL-0002,,False,False,REF-474585,First Continental Bank,***6416,Globex Retail NA LLC,US,3805778.56
2025-01-14,2025-01-14,Client Receipt - CloudBridge Co. #54,Sales Receipt,SaaS-GL,0.0,3128.38,USD,ACH Credit,CloudBridge Co. #54,***4166,INV-202501-SaaS-GL-0008,,False,False,REF-627885,First Continental Bank,***1659,Globex Retail NA LLC,US,3808906.94
2025-01-14,2025-01-14,Client Receipt - CloudBridge Co. #2,Sales Receipt,SaaS-GL,0.0,6997.8,USD,ACH Credit,CloudBridge Co. #2,***7015,INV-202501-SaaS-GL-0032,,False,False,REF-908522,First Continental Bank,***8562,Globex Retail NA LLC,US,3815904.74
2025-01-14,2025-01-14,Client Receipt - CloudBridge Co. #34,Sales Receipt,SaaS-GL,0.0,7132.27,USD,ACH Credit,CloudBridge Co. #34,***1696,INV-202501-SaaS-GL-0031,,False,False,REF-207378,First Continental Bank,***3447,Globex Retail NA LLC,US,3823037.01
2025-01-14,2025-01-14,Client Receipt - Vertex Advisory Client #55,Sales Receipt,PS-GL,0.0,9833.41,USD,ACH Credit,Vertex Advisory Client #55,***9896,INV-202501-PS-GL-0006,,False,False,REF-439047,First Continental Bank,***1419,Globex Retail NA LLC,US,3832870.42
2025-01-14,2025-01-14,Client Receipt - Vertex Advisory Client #9,Sales Receipt,PS-GL,0.0,16477.46,USD,Card Settlement,Vertex Advisory Client #9,***3579,INV-202501-PS-GL-0004,,False,False,REF-304246,First Continental Bank,***1074,Globex Retail NA LLC,US,3849347.88
2025-01-14,2025-01-14,Client Receipt - ShopSphere Partner #5,Sales Receipt,Retail-NA,0.0,16991.92,USD,ACH Credit,ShopSphere Partner #5,***8298,INV-202501-Retail-NA-0013,,False,False,REF-254412,First Continental Bank,***8000,Globex Retail NA LLC,US,3866339.8
2025-01-14,2025-01-14,Client Receipt - CloudBridge Co. #72,Sales Receipt,SaaS-GL,0.0,22560.06,USD,ACH Credit,CloudBridge Co. #72,***3722,INV-202501-SaaS-GL-0034,,False,False,REF-136922,First Continental Bank,***2357,Globex Retail NA LLC,US,3888899.86
2025-01-15,2025-01-15,Supplier Payment - ExpertNet Subcontractors #10,Supplier Payment,PS-GL,1706.67,0.0,USD,Fedwire,ExpertNet Subcontractors #10,***5745,,PO-202501-PS-GL-0005,False,False,REF-245575,First Continental Bank,***7945,Globex Retail NA LLC,US,3887193.19
2025-01-15,2025-01-15,Client Receipt - CloudBridge Co. #4,Sales Receipt,SaaS-GL,0.0,10965.83,USD,Card Settlement,CloudBridge Co. #4,***7211,INV-202501-SaaS-GL-0005,,False,False,REF-483208,First Continental Bank,***8806,Globex Retail NA LLC,US,3898159.02
2025-01-15,2025-01-15,Client Receipt - ShopSphere Partner #67,Sales Receipt,Retail-NA,0.0,12836.44,USD,ACH Credit,ShopSphere Partner #67,***6579,INV-202501-Retail-NA-0014,,False,False,REF-210400,First Continental Bank,***3459,Globex Retail NA LLC,US,3910995.46
2025-01-15,2025-01-15,Client Receipt - CloudBridge Co. #7,Sales Receipt,SaaS-GL,0.0,18657.6,USD,Card Settlement,CloudBridge Co. #7,***3140,INV-202501-SaaS-GL-0021,,False,False,REF-601829,First Continental Bank,***1252,Globex Retail NA LLC,US,3929653.06
2025-01-16,2025-01-16,Client Receipt - ShopSphere Partner #66,Sales Receipt,Retail-NA,0.0,6251.41,USD,ACH Credit,ShopSphere Partner #66,***7994,INV-202501-Retail-NA-0004,,False,False,REF-642215,First Continental Bank,***7690,Globex Retail NA LLC,US,3935904.47
2025-01-17,2025-01-17,Supplier Payment - NorthRiver Apparel Mfg #30,Supplier Payment,Retail-NA,5102.4,0.0,USD,Fedwire,NorthRiver Apparel Mfg #30,***8789,,PO-202501-Retail-NA-0007,False,False,REF-367602,First Continental Bank,***2658,Globex Retail NA LLC,US,3930802.07
2025-01-17,2025-01-17,Client Receipt - Vertex Advisory Client #22,Sales Receipt,PS-GL,0.0,7566.02,USD,ACH Credit,Vertex Advisory Client #22,***3003,INV-202501-PS-GL-0007,,False,False,REF-731442,First Continental Bank,***7984,Globex Retail NA LLC,US,3938368.09
2025-01-19,2025-01-19,Supplier Payment - CodeCraft Contractors #1,Supplier Payment,SaaS-GL,335.72,0.0,USD,Fedwire,CodeCraft Contractors #1,***1091,,PO-202501-SaaS-GL-0012,False,False,REF-429784,First Continental Bank,***1728,Globex Retail NA LLC,US,3938032.37
2025-01-19,2025-01-19,VAT/GST Remittance - US IRS,Tax Payment,ALL,40178.75,0.0,USD,ACH Debit,US IRS,***7392,,,False,False,REF-300686,First Continental Bank,***4260,Globex Retail NA LLC,US,3897853.62
2025-01-19,2025-01-19,Client Receipt - CloudBridge Co. #31,Sales Receipt,SaaS-GL,0.0,2492.34,USD,ACH Credit,CloudBridge Co. #31,***2174,INV-202501-SaaS-GL-0033,,False,False,REF-855654,First Continental Bank,***2771,Globex Retail NA LLC,US,3900345.96
2025-01-20,2025-01-20,Merchant Processing Fees,Bank/Merchant Fees,ALL,883.93,0.0,USD,Fedwire,First Continental Bank,***4573,,,False,False,REF-351157,First Continental Bank,***3503,Globex Retail NA LLC,US,3899462.03
2025-01-20,2025-01-20,Supplier Payment - ExpertNet Subcontractors #13,Supplier Payment,PS-GL,5882.71,0.0,USD,ACH Debit,ExpertNet Subcontractors #13,***3301,,PO-202501-PS-GL-0008,False,False,REF-478666,First Continental Bank,***1414,Globex Retail NA LLC,US,3893579.32
2025-01-20,2025-01-20,Supplier Payment - PackFast Fulfillment #21,Supplier Payment,Retail-NA,17838.06,0.0,USD,Fedwire,PackFast Fulfillment #21,***6447,,PO-202501-Retail-NA-0004,False,False,REF-511711,First Continental Bank,***7487,Globex Retail NA LLC,US,3875741.26
2025-01-20,2025-01-20,Client Receipt - CloudBridge Co. #31,Sales Receipt,SaaS-GL,0.0,1935.02,USD,Card Settlement,CloudBridge Co. #31,***2780,INV-202501-SaaS-GL-0027,,False,False,REF-540169,First Continental Bank,***7722,Globex Retail NA LLC,US,3877676.28
2025-01-21,2025-01-21,Supplier Payment - ExpertNet Subcontractors #11,Supplier Payment,PS-GL,6838.89,0.0,USD,ACH Debit,ExpertNet Subcontractors #11,***5681,,PO-202501-PS-GL-0001,False,False,REF-132187,First Continental Bank,***7622,Globex Retail NA LLC,US,3870837.39
2025-01-21,2025-01-21,Supplier Payment - ExpertNet Subcontractors #10,Supplier Payment,PS-GL,7205.9,0.0,USD,Fedwire,ExpertNet Subcontractors #10,***1348,,PO-202501-PS-GL-0002,False,False,REF-384221,First Continental Bank,***2013,Globex Retail NA LLC,US,3863631.49
2025-01-21,2025-01-21,Client Receipt - CloudBridge Co. #41,Sales Receipt,SaaS-GL,0.0,2493.28,USD,Card Settlement,CloudBridge Co. #41,***1800,INV-202501-SaaS-GL-0001,,False,False,REF-147606,First Continental Bank,***4580,Globex Retail NA LLC,US,3866124.77
2025-01-21,2025-01-21,Client Receipt - CloudBridge Co. #14,Sales Receipt,SaaS-GL,0.0,8425.68,USD,Card Settlement,CloudBridge Co. #14,***6469,INV-202501-SaaS-GL-0029,,False,False,REF-788110,First Continental Bank,***2008,Globex Retail NA LLC,US,3874550.45
2025-01-21,2025-01-21,Client Receipt - Card Settlement Batch #11,Sales Receipt,Retail-NA,0.0,13026.36,USD,Card Settlement,Card Settlement Batch #11,***1633,INV-202501-Retail-NA-0007,,False,False,REF-896817,First Continental Bank,***8257,Globex Retail NA LLC,US,3887576.81
2025-01-22,2025-01-22,Supplier Payment - HyperCloud Infra #14,Supplier Payment,SaaS-GL,2122.38,0.0,USD,Fedwire,HyperCloud Infra #14,***5420,,PO-202501-SaaS-GL-0010,False,False,REF-942438,First Continental Bank,***4291,Globex Retail NA LLC,US,3885454.43
2025-01-22,2025-01-22,Marketing - Beacon Digital #4,Marketing,ALL,4876.02,0.0,USD,Fedwire,Beacon Digital #4,***7484,,,False,False,REF-787608,First Continental Bank,***1717,Globex Retail NA LLC,US,3880578.41
2025-01-22,2025-01-22,Marketing - Aurelia Media #4,Marketing,ALL,8654.72,0.0,USD,Fedwire,Aurelia Media #4,***9610,,,False,False,REF-220645,First Continental Bank,***7093,Globex Retail NA LLC,US,3871923.69
2025-01-22,2025-01-22,Supplier Payment - ExpertNet Subcontractors #5,Supplier Payment,PS-GL,8981.5,0.0,USD,Fedwire,ExpertNet Subcontractors #5,***5444,,PO-202501-PS-GL-0003,False,False,REF-831356,First Continental Bank,***2678,Globex Retail NA LLC,US,3862942.19
2025-01-22,2025-01-22,Client Receipt - CloudBridge Co. #76,Sales Receipt,SaaS-GL,0.0,1640.24,USD,Card Settlement,CloudBridge Co. #76,***8289,INV-202501-SaaS-GL-0016,,False,False,REF-859951,First Continental Bank,***3175,Globex Retail NA LLC,US,3864582.43
2025-01-22,2025-01-22,Client Receipt - Vertex Advisory Client #4,Sales Receipt,PS-GL,0.0,10736.59,USD,Card Settlement,Vertex Advisory Client #4,***3294,INV-202501-PS-GL-0001,,False,False,REF-909783,First Continental Bank,***3206,Globex Retail NA LLC,US,3875319.02
2025-01-22,2025-01-22,Client Receipt - Card Settlement Batch #11,Sales Receipt,Retail-NA,0.0,11554.98,USD,Card Settlement,Card Settlement Batch #11,***4376,INV-202501-Retail-NA-0012,,False,False,REF-357530,First Continental Bank,***2100,Globex Retail NA LLC,US,3886874.0
2025-01-23,2025-01-23,Supplier Payment - HyperCloud Infra #17,Supplier Payment,SaaS-GL,1454.76,0.0,USD,Fedwire,HyperCloud Infra #17,***2355,,PO-202501-SaaS-GL-0002,False,False,REF-574730,First Continental Bank,***7106,Globex Retail NA LLC,US,3885419.24
2025-01-23,2025-01-23,Supplier Payment - CodeCraft Contractors #3,Supplier Payment,SaaS-GL,15761.7,0.0,USD,ACH Debit,CodeCraft Contractors #3,***9375,,PO-202501-SaaS-GL-0004,False,False,REF-490426,First Continental Bank,***3394,Globex Retail NA LLC,US,3869657.54
2025-01-23,2025-01-23,Client Receipt - CloudBridge Co. #19,Sales Receipt,SaaS-GL,0.0,3387.37,USD,Card Settlement,CloudBridge Co. #19,***2944,INV-202501-SaaS-GL-0010,,False,False,REF-989847,First Continental Bank,***5483,Globex Retail NA LLC,US,3873044.91
2025-01-23,2025-01-23,Client Receipt - CloudBridge Co. #47,Sales Receipt,SaaS-GL,0.0,4543.88,USD,ACH Credit,CloudBridge Co. #47,***2683,INV-202501-SaaS-GL-0011,,False,False,REF-129413,First Continental Bank,***9736,Globex Retail NA LLC,US,3877588.79
2025-01-23,2025-01-23,Client Receipt - CloudBridge Co. #44,Sales Receipt,SaaS-GL,0.0,8531.5,USD,Card Settlement,CloudBridge Co. #44,***2030,INV-202501-SaaS-GL-0019,,False,False,REF-899801,First Continental Bank,***7639,Globex Retail NA LLC,US,3886120.29
2025-01-23,2025-01-23,Client Receipt - CloudBridge Co. #20,Sales Receipt,SaaS-GL,0.0,11020.71,USD,ACH Credit,CloudBridge Co. #20,***5109,INV-202501-SaaS-GL-0023,,False,False,REF-243833,First Continental Bank,***1404,Globex Retail NA LLC,US,3897141.0
2025-01-24,2025-01-24,Supplier Payment - HyperCloud Infra #5,Supplier Payment,SaaS-GL,8193.35,0.0,USD,Fedwire,HyperCloud Infra #5,***3257,,PO-202501-SaaS-GL-0006,False,False,REF-683804,First Continental Bank,***5731,Globex Retail NA LLC,US,3888947.65
2025-01-24,2025-01-24,Supplier Payment - NorthRiver Apparel Mfg #5,Supplier Payment,Retail-NA,21095.86,0.0,USD,Fedwire,NorthRiver Apparel Mfg #5,***5552,,PO-202501-Retail-NA-0002,False,False,REF-825325,First Continental Bank,***5948,Globex Retail NA LLC,US,3867851.79
2025-01-24,2025-01-24,Client Receipt - CloudBridge Co. #41,Sales Receipt,SaaS-GL,0.0,5703.15,USD,ACH Credit,CloudBridge Co. #41,***4405,INV-202501-SaaS-GL-0028,,False,False,REF-773101,First Continental Bank,***4908,Globex Retail NA LLC,US,3873554.94
2025-01-24,2025-01-24,Client Receipt - CloudBridge Co. #26,Sales Receipt,SaaS-GL,0.0,11889.45,USD,Card Settlement,CloudBridge Co. #26,***8860,INV-202501-SaaS-GL-0012,,False,False,REF-408417,First Continental Bank,***5327,Globex Retail NA LLC,US,3885444.39
2025-01-26,2025-01-26,Supplier Payment - HyperCloud Infra #14,Supplier Payment,SaaS-GL,2112.37,0.0,USD,ACH Debit,HyperCloud Infra #14,***4432,,PO-202501-SaaS-GL-0003,False,False,REF-451618,First Continental Bank,***5291,Globex Retail NA LLC,US,3883332.02
2025-01-26,2025-01-26,Payroll - GlobalPay Services Ltd,Payroll,ALL,54366.65,0.0,USD,ACH Debit,GlobalPay Services Ltd,***7262,,,False,False,REF-899559,First Continental Bank,***6176,Globex Retail NA LLC,US,3828965.37
2025-01-26,2025-01-26,Intercompany Settlement - Globex EMEA Manufacturing Ltd.,Intercompany Transfer,ALL,889366.0,0.0,USD,Internal Transfer,Globex EMEA Manufacturing Ltd.,***1467,,,True,True,REF-650806,First Continental Bank,***1417,Globex Retail NA LLC,US,2939599.37
2025-01-26,2025-01-26,Client Receipt - CloudBridge Co. #8,Sales Receipt,SaaS-GL,0.0,420.48,USD,ACH Credit,CloudBridge Co. #8,***7463,INV-202501-SaaS-GL-0004,,False,False,REF-563639,First Continental Bank,***8308,Globex Retail NA LLC,US,2940019.85
2025-01-26,2025-01-26,Intercompany Reimbursement - Globex EMEA Manufacturing Ltd.,Intercompany Transfer,ALL,0.0,355746.4,USD,Internal Transfer,Globex EMEA Manufacturing Ltd.,***1088,,,True,True,REF-888585,First Continental Bank,***1378,Globex Retail NA LLC,US,3295766.25
2025-01-27,2025-01-27,Client Receipt - Vertex Advisory Client #49,Sales Receipt,PS-GL,0.0,11228.59,USD,Card Settlement,Vertex Advisory Client #49,***1682,INV-202501-PS-GL-0009,,False,False,REF-726936,First Continental Bank,***5319,Globex Retail NA LLC,US,3306994.84
2025-01-27,2025-01-27,Client Receipt - CloudBridge Co. #17,Sales Receipt,SaaS-GL,0.0,12404.44,USD,ACH Credit,CloudBridge Co. #17,***5558,INV-202501-SaaS-GL-0014,,False,False,REF-565881,First Continental Bank,***3884,Globex Retail NA LLC,US,3319399.28
2025-01-27,2025-01-27,Client Receipt - ShopSphere Partner #9,Sales Receipt,Retail-NA,0.0,30777.33,USD,ACH Credit,ShopSphere Partner #9,***9660,INV-202501-Retail-NA-0010,,False,False,REF-785015,First Continental Bank,***3576,Globex Retail NA LLC,US,3350176.61
2025-01-28,2025-01-28,Corporate Tax Estimate,Tax Payment,ALL,30286.9,0.0,USD,SWIFT MT103,State of NY DoF,***2091,,,False,False,REF-536827,First Continental Bank,***5096,Globex Retail NA LLC,US,3319889.71
2025-01-28,2025-01-28,Client Receipt - ShopSphere Partner #13,Sales Receipt,Retail-NA,0.0,6831.01,USD,ACH Credit,ShopSphere Partner #13,***9831,INV-202501-Retail-NA-0005,,False,False,REF-689091,First Continental Bank,***7438,Globex Retail NA LLC,US,3326720.72
2025-01-28,2025-01-28,Client Receipt - Card Settlement Batch #3,Sales Receipt,Retail-NA,0.0,47227.04,USD,Card Settlement,Card Settlement Batch #3,***1952,INV-202501-Retail-NA-0001,,False,False,REF-789439,First Continental Bank,***3132,Globex Retail NA LLC,US,3373947.76
2025-01-28,2025-01-28,Client Receipt - ShopSphere Partner #5,Sales Receipt,Retail-NA,0.0,50999.25,USD,Card Settlement,ShopSphere Partner #5,***3817,INV-202501-Retail-NA-0002,,False,False,REF-245342,First Continental Bank,***6849,Globex Retail NA LLC,US,3424947.01
2025-01-29,2025-01-29,Client Receipt - ShopSphere Partner #31,Sales Receipt,Retail-NA,0.0,21779.7,USD,ACH Credit,ShopSphere Partner #31,***8527,INV-202501-Retail-NA-0009,,False,False,REF-419468,First Continental Bank,***7134,Globex Retail NA LLC,US,3446726.71
2025-01-30,2025-01-30,Supplier Payment - HyperCloud Infra #3,Supplier Payment,SaaS-GL,2537.86,0.0,USD,ACH Debit,HyperCloud Infra #3,***2599,,PO-202501-SaaS-GL-0007,False,False,REF-705874,First Continental Bank,***2105,Globex Retail NA LLC,US,3444188.85
2025-01-30,2025-01-30,Supplier Payment - ExpertNet Subcontractors #2,Supplier Payment,PS-GL,3981.31,0.0,USD,Fedwire,ExpertNet Subcontractors #2,***2308,,PO-202501-PS-GL-0004,False,False,REF-617783,First Continental Bank,***1790,Globex Retail NA LLC,US,3440207.54
2025-01-30,2025-01-30,Supplier Payment - NorthRiver Apparel Mfg #23,Supplier Payment,Retail-NA,19636.48,0.0,USD,Fedwire,NorthRiver Apparel Mfg #23,***7998,,PO-202501-Retail-NA-0006,False,False,REF-448154,First Continental Bank,***5303,Globex Retail NA LLC,US,3420571.06
2025-01-30,2025-01-30,Payroll - GlobalPay Services Ltd,Payroll,ALL,54366.65,0.0,USD,ACH Debit,GlobalPay Services Ltd,***4584,,,False,False,REF-317143,First Continental Bank,***7792,Globex Retail NA LLC,US,3366204.41
2025-01-30,2025-01-30,Client Receipt - CloudBridge Co. #38,Sales Receipt,SaaS-GL,0.0,675.82,USD,Card Settlement,CloudBridge Co. #38,***3686,INV-202501-SaaS-GL-0024,,False,False,REF-358756,First Continental Bank,***3056,Globex Retail NA LLC,US,3366880.23
2025-01-30,2025-01-30,Client Receipt - CloudBridge Co. #73,Sales Receipt,SaaS-GL,0.0,1024.45,USD,ACH Credit,CloudBridge Co. #73,***8855,INV-202501-SaaS-GL-0002,,False,False,REF-350425,First Continental Bank,***8555,Globex Retail NA LLC,US,3367904.68
2025-01-30,2025-01-30,Client Receipt - CloudBridge Co. #61,Sales Receipt,SaaS-GL,0.0,5160.24,USD,ACH Credit,CloudBridge Co. #61,***3364,INV-202501-SaaS-GL-0003,,False,False,REF-880372,First Continental Bank,***3632,Globex Retail NA LLC,US,3373064.92
2025-01-30,2025-01-30,Interest Earned,Interest Income,ALL,0.0,9734.07,USD,ACH Credit,First Continental Bank,***9965,,,False,False,REF-202481,First Continental Bank,***4647,Globex Retail NA LLC,US,3382798.99
2025-02-01,2025-02-01,Account Maintenance Fee,Bank/Merchant Fees,ALL,2500.0,0.0,USD,Fedwire,First Continental Bank,***3438,,,False,False,REF-484625,First Continental Bank,***9465,Globex Retail NA LLC,US,3380298.99
2025-02-01,2025-02-01,Supplier Payment - ExpertNet Subcontractors #14,Supplier Payment,PS-GL,6214.01,0.0,USD,ACH Debit,ExpertNet Subcontractors #14,***6391,,PO-202502-PS-GL-0011,False,False,REF-388568,First Continental Bank,***9210,Globex Retail NA LLC,US,3374084.98
2025-02-01,2025-02-01,Client Receipt - CloudBridge Co. #35,Sales Receipt,SaaS-GL,0.0,8891.56,USD,ACH Credit,CloudBridge Co. #35,***4297,INV-202502-SaaS-GL-0004,,False,False,REF-664521,First Continental Bank,***6907,Globex Retail NA LLC,US,3382976.54
2025-02-01,2025-02-01,Client Receipt - Vertex Advisory Client #14,Sales Receipt,PS-GL,0.0,55084.27,USD,Card Settlement,Vertex Advisory Client #14,***8328,INV-202502-PS-GL-0007,,False,False,REF-287656,First Continental Bank,***3380,Globex Retail NA LLC,US,3438060.81
2025-02-01,2025-02-01,Client Receipt - ShopSphere Partner #38,Sales Receipt,Retail-NA,0.0,84055.8,USD,Card Settlement,ShopSphere Partner #38,***4285,INV-202502-Retail-NA-0008,,False,False,REF-977111,First Continental Bank,***5461,Globex Retail NA LLC,US,3522116.61
2025-02-02,2025-02-02,Supplier Payment - HyperCloud Infra #6,Supplier Payment,SaaS-GL,12789.32,0.0,USD,ACH Debit,HyperCloud Infra #6,***8745,,PO-202502-SaaS-GL-0007,False,False,REF-788439,First Continental Bank,***3757,Globex Retail NA LLC,US,3509327.29
2025-02-02,2025-02-02,Client Receipt - Card Settlement Batch #8,Sales Receipt,Retail-NA,0.0,845.77,USD,ACH Credit,Card Settlement Batch #8,***6668,INV-202502-Retail-NA-0002,,False,False,REF-210638,First Continental Bank,***3034,Globex Retail NA LLC,US,3510173.06
2025-02-02,2025-02-02,Client Receipt - CloudBridge Co. #8,Sales Receipt,SaaS-GL,0.0,3269.96,USD,Card Settlement,CloudBridge Co. #8,***7402,INV-202502-SaaS-GL-0013,,False,False,REF-293094,First Continental Bank,***8907,Globex Retail NA LLC,US,3513443.02
2025-02-03,2025-02-03,Supplier Payment - ExpertNet Subcontractors #10,Supplier Payment,PS-GL,4623.62,0.0,USD,Fedwire,ExpertNet Subcontractors #10,***1832,,PO-202502-PS-GL-0006,False,False,REF-310772,First Continental Bank,***1250,Globex Retail NA LLC,US,3508819.4
2025-02-03,2025-02-03,Marketing - Aurelia Media #11,Marketing,ALL,6422.01,0.0,USD,ACH Debit,Aurelia Media #11,***1887,,,False,False,REF-612465,First Continental Bank,***3857,Globex Retail NA LLC,US,3502397.39
2025-02-03,2025-02-03,Client Receipt - Vertex Advisory Client #25,Sales Receipt,PS-GL,0.0,6302.96,USD,Card Settlement,Vertex Advisory Client #25,***8192,INV-202502-PS-GL-0001,,False,False,REF-908245,First Continental Bank,***2116,Globex Retail NA LLC,US,3508700.35
2025-02-03,2025-02-03,Client Receipt - CloudBridge Co. #38,Sales Receipt,SaaS-GL,0.0,8348.79,USD,Card Settlement,CloudBridge Co. #38,***1908,INV-202502-SaaS-GL-0022,,False,False,REF-951810,First Continental Bank,***8243,Globex Retail NA LLC,US,3517049.14
2025-02-03,2025-02-03,Client Receipt - CloudBridge Co. #9,Sales Receipt,SaaS-GL,0.0,15323.18,USD,Card Settlement,CloudBridge Co. #9,***4581,INV-202502-SaaS-GL-0029,,False,False,REF-417740,First Continental Bank,***3798,Globex Retail NA LLC,US,3532372.32
2025-02-04,2025-02-04,Supplier Payment - HyperCloud Infra #17,Supplier Payment,SaaS-GL,4659.96,0.0,USD,ACH Debit,HyperCloud Infra #17,***7730,,PO-202502-SaaS-GL-0002,False,False,REF-272800,First Continental Bank,***9021,Globex Retail NA LLC,US,3527712.36
2025-02-04,2025-02-04,Client Receipt - CloudBridge Co. #76,Sales Receipt,SaaS-GL,0.0,598.83,USD,ACH Credit,CloudBridge Co. #76,***7295,INV-202502-SaaS-GL-0006,,False,False,REF-914144,First Continental Bank,***9251,Globex Retail NA LLC,US,3528311.19
2025-02-04,2025-02-04,Client Receipt - CloudBridge Co. #54,Sales Receipt,SaaS-GL,0.0,5568.96,USD,ACH Credit,CloudBridge Co. #54,***3619,INV-202502-SaaS-GL-0007,,False,False,REF-251673,First Continental Bank,***7389,Globex Retail NA LLC,US,3533880.15
2025-02-04,2025-02-04,Client Receipt - CloudBridge Co. #14,Sales Receipt,SaaS-GL,0.0,8030.53,USD,Card Settlement,CloudBridge Co. #14,***4033,INV-202502-SaaS-GL-0017,,False,False,REF-512154,First Continental Bank,***5095,Globex Retail NA LLC,US,3541910.68
2025-02-04,2025-02-04,Client Receipt - CloudBridge Co. #55,Sales Receipt,SaaS-GL,0.0,17434.39,USD,ACH Credit,CloudBridge Co. #55,***9739,INV-202502-SaaS-GL-0005,,False,False,REF-258592,First Continental Bank,***1594,Globex Retail NA LLC,US,3559345.07
2025-02-04,2025-02-04,Client Receipt - CloudBridge Co. #61,Sales Receipt,SaaS-GL,0.0,21996.46,USD,ACH Credit,CloudBridge Co. #61,***4491,INV-202502-SaaS-GL-0002,,False,False,REF-799617,First Continental Bank,***3310,Globex Retail NA LLC,US,3581341.53
2025-02-04,2025-02-04,Client Receipt - ShopSphere Partner #55,Sales Receipt,Retail-NA,0.0,61728.98,USD,Card Settlement,ShopSphere Partner #55,***7910,INV-202502-Retail-NA-0005,,False,False,REF-514353,First Continental Bank,***8155,Globex Retail NA LLC,US,3643070.51
2025-02-05,2025-02-05,Supplier Payment - PackFast Fulfillment #3,Supplier Payment,Retail-NA,2790.89,0.0,USD,ACH Debit,PackFast Fulfillment #3,***4783,,PO-202502-Retail-NA-0004,False,False,REF-592722,First Continental Bank,***2070,Globex Retail NA LLC,US,3640279.62
2025-02-05,2025-02-05,Supplier Payment - NorthRiver Apparel Mfg #31,Supplier Payment,Retail-NA,9816.46,0.0,USD,Fedwire,NorthRiver Apparel Mfg #31,***4462,,PO-202502-Retail-NA-0007,False,False,REF-667731,First Continental Bank,***4289,Globex Retail NA LLC,US,3630463.16
2025-02-05,2025-02-05,Supplier Payment - NorthRiver Apparel Mfg #21,Supplier Payment,Retail-NA,26299.99,0.0,USD,ACH Debit,NorthRiver Apparel Mfg #21,***6009,,PO-202502-Retail-NA-0006,False,False,REF-800195,First Continental Bank,***4159,Globex Retail NA LLC,US,3604163.17
2025-02-05,2025-02-05,Client Receipt - CloudBridge Co. #33,Sales Receipt,SaaS-GL,0.0,687.5,USD,ACH Credit,CloudBridge Co. #33,***8368,INV-202502-SaaS-GL-0026,,False,False,REF-287873,First Continental Bank,***3551,Globex Retail NA LLC,US,3604850.67
2025-02-05,2025-02-05,Client Receipt - CloudBridge Co. #42,Sales Receipt,SaaS-GL,0.0,3315.46,USD,ACH Credit,CloudBridge Co. #42,***8747,INV-202502-SaaS-GL-0024,,False,False,REF-565506,First Continental Bank,***2771,Globex Retail NA LLC,US,3608166.13
2025-02-06,2025-02-06,Supplier Payment - ExpertNet Subcontractors #10,Supplier Payment,PS-GL,583.23,0.0,USD,ACH Debit,ExpertNet Subcontractors #10,***2137,,PO-202502-PS-GL-0009,False,False,REF-180242,First Continental Bank,***1974,Globex Retail NA LLC,US,3607582.9
2025-02-06,2025-02-06,Supplier Payment - ExpertNet Subcontractors #8,Supplier Payment,PS-GL,2667.16,0.0,USD,Fedwire,ExpertNet Subcontractors #8,***8652,,PO-202502-PS-GL-0004,False,False,REF-465988,First Continental Bank,***4653,Globex Retail NA LLC,US,3604915.74
2025-02-06,2025-02-06,Client Receipt - ShopSphere Partner #16,Sales Receipt,Retail-NA,0.0,9930.7,USD,ACH Credit,ShopSphere Partner #16,***9128,INV-202502-Retail-NA-0009,,False,False,REF-189373,First Continental Bank,***3676,Globex Retail NA LLC,US,3614846.44
2025-02-06,2025-02-06,Client Receipt - CloudBridge Co. #69,Sales Receipt,SaaS-GL,0.0,23391.78,USD,ACH Credit,CloudBridge Co. #69,***7067,INV-202502-SaaS-GL-0014,,False,False,REF-480447,First Continental Bank,***5682,Globex Retail NA LLC,US,3638238.22
2025-02-07,2025-02-07,Supplier Payment - HyperCloud Infra #9,Supplier Payment,SaaS-GL,1332.71,0.0,USD,Fedwire,HyperCloud Infra #9,***8196,,PO-202502-SaaS-GL-0012,False,False,REF-809195,First Continental Bank,***1582,Globex Retail NA LLC,US,3636905.51
2025-02-07,2025-02-07,BluePeak Property Mgmt,Rent & Utilities,ALL,6699.37,0.0,USD,Fedwire,BluePeak Property Mgmt,***8216,,,False,False,REF-976215,First Continental Bank,***4141,Globex Retail NA LLC,US,3630206.14
2025-02-07,2025-02-07,Supplier Payment - PackFast Fulfillment #9,Supplier Payment,Retail-NA,13330.27,0.0,USD,Fedwire,PackFast Fulfillment #9,***4517,,PO-202502-Retail-NA-0003,False,False,REF-280940,First Continental Bank,***7569,Globex Retail NA LLC,US,3616875.87
2025-02-07,2025-02-07,Client Receipt - CloudBridge Co. #1,Sales Receipt,SaaS-GL,0.0,33.1,USD,ACH Credit,CloudBridge Co. #1,***2296,INV-202502-SaaS-GL-0009,,False,False,REF-726976,First Continental Bank,***9555,Globex Retail NA LLC,US,3616908.97
2025-02-07,2025-02-07,Client Receipt - Vertex Advisory Client #34,Sales Receipt,PS-GL,0.0,16355.97,USD,Card Settlement,Vertex Advisory Client #34,***4258,INV-202502-PS-GL-0010,,False,False,REF-921646,First Continental Bank,***3605,Globex Retail NA LLC,US,3633264.94
2025-02-07,2025-02-07,Client Receipt - Vertex Advisory Client #6,Sales Receipt,PS-GL,0.0,16965.74,USD,Card Settlement,Vertex Advisory Client #6,***5191,INV-202502-PS-GL-0003,,False,False,REF-673485,First Continental Bank,***2938,Globex Retail NA LLC,US,3650230.68
2025-02-07,2025-02-07,Client Receipt - Vertex Advisory Client #10,Sales Receipt,PS-GL,0.0,32342.56,USD,Card Settlement,Vertex Advisory Client #10,***9336,INV-202502-PS-GL-0006,,False,False,REF-331288,First Continental Bank,***7250,Globex Retail NA LLC,US,3682573.24
2025-02-08,2025-02-08,Supplier Payment - CodeCraft Contractors #8,Supplier Payment,SaaS-GL,15782.11,0.0,USD,ACH Debit,CodeCraft Contractors #8,***7160,,PO-202502-SaaS-GL-0011,False,False,REF-600265,First Continental Bank,***5935,Globex Retail NA LLC,US,3666791.13
2025-02-10,2025-02-10,Supplier Payment - ExpertNet Subcontractors #1,Supplier Payment,PS-GL,9345.75,0.0,USD,ACH Debit,ExpertNet Subcontractors #1,***2996,,PO-202502-PS-GL-0001,False,False,REF-516329,First Continental Bank,***6549,Globex Retail NA LLC,US,3657445.38
2025-02-10,2025-02-10,Client Receipt - ShopSphere Partner #78,Sales Receipt,Retail-NA,0.0,53906.33,USD,Card Settlement,ShopSphere Partner #78,***7215,INV-202502-Retail-NA-0007,,False,False,REF-854236,First Continental Bank,***9051,Globex Retail NA LLC,US,3711351.71
2025-02-11,2025-02-11,Supplier Payment - HyperCloud Infra #12,Supplier Payment,SaaS-GL,1522.81,0.0,USD,Fedwire,HyperCloud Infra #12,***1057,,PO-202502-SaaS-GL-0008,False,False,REF-679394,First Continental Bank,***4000,Globex Retail NA LLC,US,3709828.9
2025-02-11,2025-02-11,Client Receipt - CloudBridge Co. #71,Sales Receipt,SaaS-GL,0.0,1356.62,USD,ACH Credit,CloudBridge Co. #71,***2950,INV-202502-SaaS-GL-0028,,False,False,REF-802109,First Continental Bank,***1311,Globex Retail NA LLC,US,3711185.52
2025-02-12,2025-02-12,Merchant Processing Fees,Bank/Merchant Fees,ALL,1551.21,0.0,USD,Fedwire,First Continental Bank,***7688,,,False,False,REF-453600,First Continental Bank,***4417,Globex Retail NA LLC,US,3709634.31
2025-02-12,2025-02-12,Supplier Payment - HyperCloud Infra #2,Supplier Payment,SaaS-GL,2738.22,0.0,USD,Fedwire,HyperCloud Infra #2,***3180,,PO-202502-SaaS-GL-0006,False,False,REF-167470,First Continental Bank,***5884,Globex Retail NA LLC,US,3706896.09
2025-02-12,2025-02-12,Intercompany Settlement - Globex EMEA Manufacturing Ltd.,Intercompany Transfer,ALL,440704.0,0.0,USD,Internal Transfer,Globex EMEA Manufacturing Ltd.,***1691,,,True,True,REF-851983,First Continental Bank,***1748,Globex Retail NA LLC,US,3266192.09
2025-02-12,2025-02-12,Client Receipt - Vertex Advisory Client #50,Sales Receipt,PS-GL,0.0,5198.57,USD,Card Settlement,Vertex Advisory Client #50,***5131,INV-202502-PS-GL-0005,,False,False,REF-668919,First Continental Bank,***4627,Globex Retail NA LLC,US,3271390.66
2025-02-12,2025-02-12,Client Receipt - Vertex Advisory Client #18,Sales Receipt,PS-GL,0.0,18111.25,USD,ACH Credit,Vertex Advisory Client #18,***6334,INV-202502-PS-GL-0004,,False,False,REF-604440,First Continental Bank,***4025,Globex Retail NA LLC,US,3289501.91
2025-02-12,2025-02-12,Client Receipt - Card Settlement Batch #22,Sales Receipt,Retail-NA,0.0,25577.37,USD,ACH Credit,Card Settlement Batch #22,***6890,INV-202502-Retail-NA-0011,,False,False,REF-390508,First Continental Bank,***9246,Globex Retail NA LLC,US,3315079.28
2025-02-12,2025-02-12,Client Receipt - ShopSphere Partner #65,Sales Receipt,Retail-NA,0.0,28435.17,USD,ACH Credit,ShopSphere Partner #65,***7091,INV-202502-Retail-NA-0006,,False,False,REF-711716,First Continental Bank,***3416,Globex Retail NA LLC,US,3343514.45
2025-02-12,2025-02-12,Intercompany Reimbursement - Globex EMEA Manufacturing Ltd.,Intercompany Transfer,ALL,0.0,176281.6,USD,Internal Transfer,Globex EMEA Manufacturing Ltd.,***7790,,,True,True,REF-436709,First Continental Bank,***2781,Globex Retail NA LLC,US,3519796.05
2025-02-13,2025-02-13,Supplier Payment - PackFast Fulfillment #7,Supplier Payment,Retail-NA,47931.42,0.0,USD,ACH Debit,PackFast Fulfillment #7,***2434,,PO-202502-Retail-NA-0001,False,False,REF-292334,First Continental Bank,***3889,Globex Retail NA LLC,US,3471864.63
2025-02-13,2025-02-13,Client Receipt - CloudBridge Co. #79,Sales Receipt,SaaS-GL,0.0,5261.86,USD,ACH Credit,CloudBridge Co. #79,***9007,INV-202502-SaaS-GL-0023,,False,False,REF-831486,First Continental Bank,***6388,Globex Retail NA LLC,US,3477126.49
2025-02-14,2025-02-14,Supplier Payment - ExpertNet Subcontractors #6,Supplier Payment,PS-GL,1217.17,0.0,USD,ACH Debit,ExpertNet Subcontractors #6,***6754,,PO-202502-PS-GL-0002,False,False,REF-103449,First Continental Bank,***1494,Globex Retail NA LLC,US,3475909.32
2025-02-14,2025-02-14,Client Receipt - CloudBridge Co. #42,Sales Receipt,SaaS-GL,0.0,1683.96,USD,Card Settlement,CloudBridge Co. #42,***4497,INV-202502-SaaS-GL-0012,,False,False,REF-178045,First Continental Bank,***8412,Globex Retail NA LLC,US,3477593.28
2025-02-14,2025-02-14,Client Receipt - CloudBridge Co. #61,Sales Receipt,SaaS-GL,0.0,3448.17,USD,Card Settlement,CloudBridge Co. #61,***5445,INV-202502-SaaS-GL-0011,,False,False,REF-350561,First Continental Bank,***4495,Globex Retail NA LLC,US,3481041.45
2025-02-14,2025-02-14,Client Receipt - Vertex Advisory Client #46,Sales Receipt,PS-GL,0.0,14175.74,USD,Card Settlement,Vertex Advisory Client #46,***8619,INV-202502-PS-GL-0008,,False,False,REF-869289,First Continental Bank,***6464,Globex Retail NA LLC,US,3495217.19
2025-02-14,2025-02-14,Client Receipt - CloudBridge Co. #29,Sales Receipt,SaaS-GL,0.0,34324.61,USD,ACH Credit,CloudBridge Co. #29,***5354,INV-202502-SaaS-GL-0001,,False,False,REF-357120,First Continental Bank,***9535,Globex Retail NA LLC,US,3529541.8
2025-02-14,2025-02-14,Client Receipt - ShopSphere Partner #79,Sales Receipt,Retail-NA,0.0,41166.43,USD,ACH Credit,ShopSphere Partner #79,***7251,INV-202502-Retail-NA-0004,,False,False,REF-687080,First Continental Bank,***7592,Globex Retail NA LLC,US,3570708.23
2025-02-15,2025-02-15,Supplier Payment - PackFast Fulfillment #1,Supplier Payment,Retail-NA,46450.81,0.0,USD,Fedwire,PackFast Fulfillment #1,***1251,,PO-202502-Retail-NA-0008,False,False,REF-872567,First Continental Bank,***6609,Globex Retail NA LLC,US,3524257.42
2025-02-17,2025-02-17,Supplier Payment - CodeCraft Contractors #13,Supplier Payment,SaaS-GL,519.29,0.0,USD,Fedwire,CodeCraft Contractors #13,***3927,,PO-202502-SaaS-GL-0010,False,False,REF-942519,First Continental Bank,***7531,Globex Retail NA LLC,US,3523738.13
2025-02-17,2025-02-17,Supplier Payment - PackFast Fulfillment #6,Supplier Payment,Retail-NA,36083.84,0.0,USD,ACH Debit,PackFast Fulfillment #6,***6814,,PO-202502-Retail-NA-0005,False,False,REF-907743,First Continental Bank,***3955,Globex Retail NA LLC,US,3487654.29
2025-02-17,2025-02-17,Client Receipt - CloudBridge Co. #57,Sales Receipt,SaaS-GL,0.0,5680.06,USD,Card Settlement,CloudBridge Co. #57,***8805,INV-202502-SaaS-GL-0016,,False,False,REF-776123,First Continental Bank,***6875,Globex Retail NA LLC,US,3493334.35
2025-02-17,2025-02-17,Client Receipt - CloudBridge Co. #62,Sales Receipt,SaaS-GL,0.0,18685.66,USD,Card Settlement,CloudBridge Co. #62,***3645,INV-202502-SaaS-GL-0027,,False,False,REF-907988,First Continental Bank,***5066,Globex Retail NA LLC,US,3512020.01
2025-02-18,2025-02-18,Marketing - Aurelia Media #1,Marketing,ALL,2988.78,0.0,USD,ACH Debit,Aurelia Media #1,***8990,,,False,False,REF-184529,First Continental Bank,***8271,Globex Retail NA LLC,US,3509031.23
2025-02-18,2025-02-18,Marketing - Aurelia Media #5,Marketing,ALL,11428.66,0.0,USD,ACH Debit,Aurelia Media #5,***4608,,,False,False,REF-412543,First Continental Bank,***3371,Globex Retail NA LLC,US,3497602.57
2025-02-18,2025-02-18,Client Receipt - CloudBridge Co. #64,Sales Receipt,SaaS-GL,0.0,5264.28,USD,ACH Credit,CloudBridge Co. #64,***2424,INV-202502-SaaS-GL-0018,,False,False,REF-774181,First Continental Bank,***6741,Globex Retail NA LLC,US,3502866.85
2025-02-19,2025-02-19,Client Receipt - CloudBridge Co. #74,Sales Receipt,SaaS-GL,0.0,9.47,USD,Card Settlement,CloudBridge Co. #74,***3882,INV-202502-SaaS-GL-0008,,False,False,REF-173914,First Continental Bank,***1781,Globex Retail NA LLC,US,3502876.32
2025-02-19,2025-02-19,Client Receipt - CloudBridge Co. #25,Sales Receipt,SaaS-GL,0.0,6008.4,USD,ACH Credit,CloudBridge Co. #25,***7702,INV-202502-SaaS-GL-0010,,False,False,REF-909938,First Continental Bank,***7234,Globex Retail NA LLC,US,3508884.72
2025-02-19,2025-02-19,Client Receipt - Vertex Advisory Client #36,Sales Receipt,PS-GL,0.0,13538.73,USD,ACH Credit,Vertex Advisory Client #36,***9256,INV-202502-PS-GL-0002,,False,False,REF-493951,First Continental Bank,***5384,Globex Retail NA LLC,US,3522423.45
2025-02-20,2025-02-20,Supplier Payment - ExpertNet Subcontractors #17,Supplier Payment,PS-GL,2973.51,0.0,USD,Fedwire,ExpertNet Subcontractors #17,***1965,,PO-202502-PS-GL-0010,False,False,REF-342017,First Continental Bank,***7960,Globex Retail NA LLC,US,3519449.94
2025-02-20,2025-02-20,Supplier Payment - CodeCraft Contractors #8,Supplier Payment,SaaS-GL,7491.93,0.0,USD,Fedwire,CodeCraft Contractors #8,***2438,,PO-202502-SaaS-GL-0001,False,False,REF-352875,First Continental Bank,***4656,Globex Retail NA LLC,US,3511958.01
2025-02-20,2025-02-20,Supplier Payment - ExpertNet Subcontractors #9,Supplier Payment,PS-GL,15717.84,0.0,USD,Fedwire,ExpertNet Subcontractors #9,***2026,,PO-202502-PS-GL-0003,False,False,REF-883644,First Continental Bank,***6206,Globex Retail NA LLC,US,3496240.17
2025-02-20,2025-02-20,Client Receipt - Vertex Advisory Client #2,Sales Receipt,PS-GL,0.0,13293.82,USD,Card Settlement,Vertex Advisory Client #2,***4999,INV-202502-PS-GL-0009,,False,False,REF-506133,First Continental Bank,***4052,Globex Retail NA LLC,US,3509533.99
2025-02-21,2025-02-21,Client Receipt - Card Settlement Batch #4,Sales Receipt,Retail-NA,0.0,4399.08,USD,ACH Credit,Card Settlement Batch #4,***3556,INV-202502-Retail-NA-0003,,False,False,REF-629174,First Continental Bank,***8686,Globex Retail NA LLC,US,3513933.07
2025-02-22,2025-02-22,Supplier Payment - HyperCloud Infra #4,Supplier Payment,SaaS-GL,2736.39,0.0,USD,ACH Debit,HyperCloud Infra #4,***1533,,PO-202502-SaaS-GL-0003,False,False,REF-360159,First Continental Bank,***7195,Globex Retail NA LLC,US,3511196.68
2025-02-22,2025-02-22,VAT/GST Remittance - US IRS,Tax Payment,ALL,49397.91,0.0,USD,Fedwire,US IRS,***5378,,,False,False,REF-232331,First Continental Bank,***3678,Globex Retail NA LLC,US,3461798.77
2025-02-22,2025-02-22,Client Receipt - CloudBridge Co. #9,Sales Receipt,SaaS-GL,0.0,4672.26,USD,Card Settlement,CloudBridge Co. #9,***1219,INV-202502-SaaS-GL-0025,,False,False,REF-808628,First Continental Bank,***9768,Globex Retail NA LLC,US,3466471.03
2025-02-22,2025-02-22,Client Receipt - CloudBridge Co. #78,Sales Receipt,SaaS-GL,0.0,46761.72,USD,ACH Credit,CloudBridge Co. #78,***6391,INV-202502-SaaS-GL-0019,,False,False,REF-853673,First Continental Bank,***3471,Globex Retail NA LLC,US,3513232.75
2025-02-23,2025-02-23,Supplier Payment - ExpertNet Subcontractors #17,Supplier Payment,PS-GL,3983.2,0.0,USD,ACH Debit,ExpertNet Subcontractors #17,***4788,,PO-202502-PS-GL-0008,False,False,REF-254231,First Continental Bank,***1758,Globex Retail NA LLC,US,3509249.55
2025-02-24,2025-02-24,Client Receipt - CloudBridge Co. #51,Sales Receipt,SaaS-GL,0.0,1507.11,USD,ACH Credit,CloudBridge Co. #51,***9713,INV-202502-SaaS-GL-0020,,False,False,REF-533373,First Continental Bank,***4717,Globex Retail NA LLC,US,3510756.66
2025-02-24,2025-02-24,Client Receipt - CloudBridge Co. #77,Sales Receipt,SaaS-GL,0.0,9203.12,USD,ACH Credit,CloudBridge Co. #77,***1738,INV-202502-SaaS-GL-0015,,False,False,REF-598425,First Continental Bank,***7056,Globex Retail NA LLC,US,3519959.78
2025-02-25,2025-02-25,Supplier Payment - ExpertNet Subcontractors #3,Supplier Payment,PS-GL,5458.74,0.0,USD,Fedwire,ExpertNet Subcontractors #3,***5164,,PO-202502-PS-GL-0005,False,False,REF-854187,First Continental Bank,***9079,Globex Retail NA LLC,US,3514501.04
2025-02-25,2025-02-25,Payroll - GlobalPay Services Ltd,Payroll,ALL,131761.38,0.0,USD,ACH Debit,GlobalPay Services Ltd,***2151,,,False,False,REF-329095,First Continental Bank,***5317,Globex Retail NA LLC,US,3382739.66
2025-02-25,2025-02-25,Client Receipt - Card Settlement Batch #21,Sales Receipt,Retail-NA,0.0,39363.83,USD,ACH Credit,Card Settlement Batch #21,***2819,INV-202502-Retail-NA-0001,,False,False,REF-872438,First Continental Bank,***2481,Globex Retail NA LLC,US,3422103.49
2025-02-26,2025-02-26,Supplier Payment - ExpertNet Subcontractors #10,Supplier Payment,PS-GL,4626.65,0.0,USD,ACH Debit,ExpertNet Subcontractors #10,***9616,,PO-202502-PS-GL-0007,False,False,REF-831682,First Continental Bank,***1096,Globex Retail NA LLC,US,3417476.84
2025-02-26,2025-02-26,Supplier Payment - NorthRiver Apparel Mfg #26,Supplier Payment,Retail-NA,10260.67,0.0,USD,Fedwire,NorthRiver Apparel Mfg #26,***7987,,PO-202502-Retail-NA-0002,False,False,REF-655964,First Continental Bank,***4601,Globex Retail NA LLC,US,3407216.17
2025-02-26,2025-02-26,"Intercompany Settlement - Globex International Holdings, Inc.",Intercompany Transfer,ALL,244868.0,0.0,USD,Internal Transfer,"Globex International Holdings, Inc.",***5946,,,True,True,REF-687701,First Continental Bank,***1004,Globex Retail NA LLC,US,3162348.17
2025-02-26,2025-02-26,Client Receipt - Card Settlement Batch #4,Sales Receipt,Retail-NA,0.0,1434.82,USD,Card Settlement,Card Settlement Batch #4,***7238,INV-202502-Retail-NA-0010,,False,False,REF-852822,First Continental Bank,***4220,Globex Retail NA LLC,US,3163782.99
2025-02-26,2025-02-26,Client Receipt - CloudBridge Co. #41,Sales Receipt,SaaS-GL,0.0,19266.59,USD,ACH Credit,CloudBridge Co. #41,***2330,INV-202502-SaaS-GL-0003,,False,False,REF-284558,First Continental Bank,***7774,Globex Retail NA LLC,US,3183049.58
2025-02-27,2025-02-27,Supplier Payment - HyperCloud Infra #6,Supplier Payment,SaaS-GL,9101.53,0.0,USD,Fedwire,HyperCloud Infra #6,***6934,,PO-202502-SaaS-GL-0009,False,False,REF-907992,First Continental Bank,***8243,Globex Retail NA LLC,US,3173948.05
2025-02-28,2025-02-28,Supplier Payment - HyperCloud Infra #16,Supplier Payment,SaaS-GL,794.42,0.0,USD,ACH Debit,HyperCloud Infra #16,***3278,,PO-202502-SaaS-GL-0005,False,False,REF-855907,First Continental Bank,***9011,Globex Retail NA LLC,US,3173153.63
2025-02-28,2025-02-28,Merchant Processing Fees,Bank/Merchant Fees,ALL,989.04,0.0,USD,ACH Debit,First Continental Bank,***4025,,,False,False,REF-995160,First Continental Bank,***6642,Globex Retail NA LLC,US,3172164.59
2025-02-28,2025-02-28,Supplier Payment - CodeCraft Contractors #3,Supplier Payment,SaaS-GL,3683.28,0.0,USD,Fedwire,CodeCraft Contractors #3,***5024,,PO-202502-SaaS-GL-0004,False,False,REF-437048,First Continental Bank,***1699,Globex Retail NA LLC,US,3168481.31
2025-02-28,2025-02-28,Client Receipt - CloudBridge Co. #3,Sales Receipt,SaaS-GL,0.0,7030.02,USD,ACH Credit,CloudBridge Co. #3,***5701,INV-202502-SaaS-GL-0021,,False,False,REF-276773,First Continental Bank,***9934,Globex Retail NA LLC,US,3175511.33
2025-02-28,2025-02-28,Interest Earned,Interest Income,ALL,0.0,11914.5,USD,Card Settlement,First Continental Bank,***7852,,,False,False,REF-114891,First Continental Bank,***2202,Globex Retail NA LLC,US,3187425.83
2025-03-01,2025-03-01,Account Maintenance Fee,Bank/Merchant Fees,ALL,2500.0,0.0,USD,ACH Debit,First Continental Bank,***5731,,,False,False,REF-941059,First Continental Bank,***4943,Globex Retail NA LLC,US,3184925.83
2025-03-01,2025-03-01,Client Receipt - CloudBridge Co. #15,Sales Receipt,SaaS-GL,0.0,6946.15,USD,Card Settlement,CloudBridge Co. #15,***5423,INV-202503-SaaS-GL-0002,,False,False,REF-552026,First Continental Bank,***8570,Globex Retail NA LLC,US,3191871.98
2025-03-02,2025-03-02,Client Receipt - CloudBridge Co. #14,Sales Receipt,SaaS-GL,0.0,6855.0,USD,Card Settlement,CloudBridge Co. #14,***3406,INV-202503-SaaS-GL-0026,,False,False,REF-958226,First Continental Bank,***1181,Globex Retail NA LLC,US,3198726.98
2025-03-02,2025-03-02,Client Receipt - CloudBridge Co. #79,Sales Receipt,SaaS-GL,0.0,7589.92,USD,ACH Credit,CloudBridge Co. #79,***1514,INV-202503-SaaS-GL-0030,,False,False,REF-948488,First Continental Bank,***4206,Globex Retail NA LLC,US,3206316.9
2025-03-02,2025-03-02,Client Receipt - ShopSphere Partner #47,Sales Receipt,Retail-NA,0.0,47305.98,USD,ACH Credit,ShopSphere Partner #47,***6634,INV-202503-Retail-NA-0003,,False,False,REF-295308,First Continental Bank,***6961,Globex Retail NA LLC,US,3253622.88
2025-03-03,2025-03-03,Supplier Payment - ExpertNet Subcontractors #15,Supplier Payment,PS-GL,3799.55,0.0,USD,Fedwire,ExpertNet Subcontractors #15,***5454,,PO-202503-PS-GL-0001,False,False,REF-462763,First Continental Bank,***5807,Globex Retail NA LLC,US,3249823.33
2025-03-03,2025-03-03,Client Receipt - CloudBridge Co. #24,Sales Receipt,SaaS-GL,0.0,1659.61,USD,ACH Credit,CloudBridge Co. #24,***2088,INV-202503-SaaS-GL-0034,,False,False,REF-184356,First Continental Bank,***6481,Globex Retail NA LLC,US,3251482.94
2025-03-03,2025-03-03,Client Receipt - Vertex Advisory Client #35,Sales Receipt,PS-GL,0.0,6044.81,USD,ACH Credit,Vertex Advisory Client #35,***1229,INV-202503-PS-GL-0002,,False,False,REF-574820,First Continental Bank,***8331,Globex Retail NA LLC,US,3257527.75
2025-03-04,2025-03-04,Supplier Payment - ExpertNet Subcontractors #8,Supplier Payment,PS-GL,10877.33,0.0,USD,ACH Debit,ExpertNet Subcontractors #8,***5459,,PO-202503-PS-GL-0002,False,False,REF-200728,First Continental Bank,***4273,Globex Retail NA LLC,US,3246650.42
2025-03-04,2025-03-04,Client Receipt - ShopSphere Partner #28,Sales Receipt,Retail-NA,0.0,13310.66,USD,ACH Credit,ShopSphere Partner #28,***2416,INV-202503-Retail-NA-0004,,False,False,REF-876682,First Continental Bank,***6312,Globex Retail NA LLC,US,3259961.08
2025-03-04,2025-03-04,Client Receipt - CloudBridge Co. #38,Sales Receipt,SaaS-GL,0.0,15356.06,USD,ACH Credit,CloudBridge Co. #38,***5859,INV-202503-SaaS-GL-0013,,False,False,REF-234719,First Continental Bank,***5309,Globex Retail NA LLC,US,3275317.14
2025-03-05,2025-03-05,Supplier Payment - ExpertNet Subcontractors #8,Supplier Payment,PS-GL,2143.79,0.0,USD,Fedwire,ExpertNet Subcontractors #8,***5490,,PO-202503-PS-GL-0011,False,False,REF-145817,First Continental Bank,***8581,Globex Retail NA LLC,US,3273173.35
2025-03-05,2025-03-05,Supplier Payment - CodeCraft Contractors #7,Supplier Payment,SaaS-GL,25980.33,0.0,USD,Fedwire,CodeCraft Contractors #7,***1593,,PO-202503-SaaS-GL-0008,False,False,REF-589793,First Continental Bank,***2005,Globex Retail NA LLC,US,3247193.02
2025-03-05,2025-03-05,Client Receipt - CloudBridge Co. #3,Sales Receipt,SaaS-GL,0.0,2131.02,USD,Card Settlement,CloudBridge Co. #3,***1691,INV-202503-SaaS-GL-0007,,False,False,REF-855172,First Continental Bank,***4346,Globex Retail NA LLC,US,3249324.04
2025-03-05,2025-03-05,Client Receipt - ShopSphere Partner #3,Sales Receipt,Retail-NA,0.0,11380.77,USD,Card Settlement,ShopSphere Partner #3,***9860,INV-202503-Retail-NA-0007,,False,False,REF-833420,First Continental Bank,***9056,Globex Retail NA LLC,US,3260704.81
2025-03-06,2025-03-06,Supplier Payment - NorthRiver Apparel Mfg #6,Supplier Payment,Retail-NA,2077.95,0.0,USD,Fedwire,NorthRiver Apparel Mfg #6,***4972,,PO-202503-Retail-NA-0002,False,False,REF-748022,First Continental Bank,***2631,Globex Retail NA LLC,US,3258626.86
2025-03-06,2025-03-06,Client Receipt - CloudBridge Co. #28,Sales Receipt,SaaS-GL,0.0,9820.51,USD,ACH Credit,CloudBridge Co. #28,***2176,INV-202503-SaaS-GL-0024,,False,False,REF-540920,First Continental Bank,***6592,Globex Retail NA LLC,US,3268447.37
2025-03-06,2025-03-06,Client Receipt - CloudBridge Co. #15,Sales Receipt,SaaS-GL,0.0,13115.2,USD,ACH Credit,CloudBridge Co. #15,***3430,INV-202503-SaaS-GL-0023,,False,False,REF-879471,First Continental Bank,***9191,Globex Retail NA LLC,US,3281562.57
2025-03-06,2025-03-06,Client Receipt - Vertex Advisory Client #29,Sales Receipt,PS-GL,0.0,23111.78,USD,ACH Credit,Vertex Advisory Client #29,***6608,INV-202503-PS-GL-0007,,False,False,REF-629939,First Continental Bank,***4118,Globex Retail NA LLC,US,3304674.35
2025-03-07,2025-03-07,Supplier Payment - NorthRiver Apparel Mfg #23,Supplier Payment,Retail-NA,34015.68,0.0,USD,ACH Debit,NorthRiver Apparel Mfg #23,***1272,,PO-202503-Retail-NA-0004,False,False,REF-875608,First Continental Bank,***6911,Globex Retail NA LLC,US,3270658.67
2025-03-07,2025-03-07,Client Receipt - CloudBridge Co. #76,Sales Receipt,SaaS-GL,0.0,5203.79,USD,Card Settlement,CloudBridge Co. #76,***1682,INV-202503-SaaS-GL-0014,,False,False,REF-780926,First Continental Bank,***1729,Globex Retail NA LLC,US,3275862.46
2025-03-10,2025-03-10,Supplier Payment - CodeCraft Contractors #5,Supplier Payment,SaaS-GL,1609.75,0.0,USD,ACH Debit,CodeCraft Contractors #5,***4343,,PO-202503-SaaS-GL-0001,False,False,REF-244186,First Continental Bank,***5764,Globex Retail NA LLC,US,3274252.71
2025-03-10,2025-03-10,Merchant Processing Fees,Bank/Merchant Fees,ALL,2068.41,0.0,USD,Fedwire,First Continental Bank,***4603,,,False,False,REF-344431,First Continental Bank,***8287,Globex Retail NA LLC,US,3272184.3
2025-03-10,2025-03-10,Supplier Payment - ExpertNet Subcontractors #6,Supplier Payment,PS-GL,3303.34,0.0,USD,ACH Debit,ExpertNet Subcontractors #6,***9244,,PO-202503-PS-GL-0004,False,False,REF-804005,First Continental Bank,***1721,Globex Retail NA LLC,US,3268880.96
2025-03-10,2025-03-10,Supplier Payment - HyperCloud Infra #2,Supplier Payment,SaaS-GL,10720.33,0.0,USD,Fedwire,HyperCloud Infra #2,***5666,,PO-202503-SaaS-GL-0006,False,False,REF-915522,First Continental Bank,***1701,Globex Retail NA LLC,US,3258160.63
2025-03-10,2025-03-10,Supplier Payment - PackFast Fulfillment #14,Supplier Payment,Retail-NA,11828.54,0.0,USD,Fedwire,PackFast Fulfillment #14,***4583,,PO-202503-Retail-NA-0001,False,False,REF-301962,First Continental Bank,***9077,Globex Retail NA LLC,US,3246332.09
2025-03-10,2025-03-10,Client Receipt - CloudBridge Co. #60,Sales Receipt,SaaS-GL,0.0,10008.2,USD,ACH Credit,CloudBridge Co. #60,***7964,INV-202503-SaaS-GL-0010,,False,False,REF-765120,First Continental Bank,***6433,Globex Retail NA LLC,US,3256340.29
2025-03-10,2025-03-10,Client Receipt - CloudBridge Co. #45,Sales Receipt,SaaS-GL,0.0,16002.66,USD,ACH Credit,CloudBridge Co. #45,***1200,INV-202503-SaaS-GL-0031,,False,False,REF-288357,First Continental Bank,***5205,Globex Retail NA LLC,US,3272342.95
2025-03-10,2025-03-10,Client Receipt - Card Settlement Batch #9,Sales Receipt,Retail-NA,0.0,59760.66,USD,ACH Credit,Card Settlement Batch #9,***3096,INV-202503-Retail-NA-0014,,False,False,REF-576865,First Continental Bank,***3723,Globex Retail NA LLC,US,3332103.61
2025-03-11,2025-03-11,Supplier Payment - ExpertNet Subcontractors #12,Supplier Payment,PS-GL,6926.92,0.0,USD,Fedwire,ExpertNet Subcontractors #12,***5595,,PO-202503-PS-GL-0007,False,False,REF-573991,First Continental Bank,***7381,Globex Retail NA LLC,US,3325176.69
2025-03-11,2025-03-11,Supplier Payment - ExpertNet Subcontractors #9,Supplier Payment,PS-GL,7347.16,0.0,USD,ACH Debit,ExpertNet Subcontractors #9,***7925,,PO-202503-PS-GL-0009,False,False,REF-524321,First Continental Bank,***9769,Globex Retail NA LLC,US,3317829.53
2025-03-11,2025-03-11,Marketing - Aurelia Media #4,Marketing,ALL,21625.37,0.0,USD,ACH Debit,Aurelia Media #4,***7316,,,False,False,REF-296832,First Continental Bank,***3292,Globex Retail NA LLC,US,3296204.16
2025-03-11,2025-03-11,Supplier Payment - PackFast Fulfillment #18,Supplier Payment,Retail-NA,23420.09,0.0,USD,ACH Debit,PackFast Fulfillment #18,***7823,,PO-202503-Retail-NA-0006,False,False,REF-754697,First Continental Bank,***9004,Globex Retail NA LLC,US,3272784.07
2025-03-11,2025-03-11,Client Receipt - CloudBridge Co. #2,Sales Receipt,SaaS-GL,0.0,760.58,USD,Card Settlement,CloudBridge Co. #2,***4710,INV-202503-SaaS-GL-0029,,False,False,REF-693272,First Continental Bank,***2028,Globex Retail NA LLC,US,3273544.65
2025-03-11,2025-03-11,Client Receipt - CloudBridge Co. #40,Sales Receipt,SaaS-GL,0.0,1422.98,USD,ACH Credit,CloudBridge Co. #40,***8273,INV-202503-SaaS-GL-0015,,False,False,REF-883757,First Continental Bank,***3569,Globex Retail NA LLC,US,3274967.63
2025-03-11,2025-03-11,Client Receipt - Vertex Advisory Client #44,Sales Receipt,PS-GL,0.0,7223.78,USD,ACH Credit,Vertex Advisory Client #44,***7141,INV-202503-PS-GL-0011,,False,False,REF-774595,First Continental Bank,***6375,Globex Retail NA LLC,US,3282191.41
2025-03-11,2025-03-11,Client Receipt - Vertex Advisory Client #5,Sales Receipt,PS-GL,0.0,11586.43,USD,ACH Credit,Vertex Advisory Client #5,***9981,INV-202503-PS-GL-0008,,False,False,REF-995262,First Continental Bank,***3651,Globex Retail NA LLC,US,3293777.84
2025-03-12,2025-03-12,Supplier Payment - HyperCloud Infra #7,Supplier Payment,SaaS-GL,3055.53,0.0,USD,Fedwire,HyperCloud Infra #7,***3708,,PO-202503-SaaS-GL-0007,False,False,REF-549138,First Continental Bank,***6438,Globex Retail NA LLC,US,3290722.31
2025-03-12,2025-03-12,Supplier Payment - HyperCloud Infra #6,Supplier Payment,SaaS-GL,7592.54,0.0,USD,ACH Debit,HyperCloud Infra #6,***6522,,PO-202503-SaaS-GL-0005,False,False,REF-967784,First Continental Bank,***4332,Globex Retail NA LLC,US,3283129.77
2025-03-12,2025-03-12,Supplier Payment - CodeCraft Contractors #14,Supplier Payment,SaaS-GL,11202.59,0.0,USD,ACH Debit,CodeCraft Contractors #14,***2388,,PO-202503-SaaS-GL-0002,False,False,REF-378936,First Continental Bank,***5260,Globex Retail NA LLC,US,3271927.18
2025-03-12,2025-03-12,"Intercompany Settlement - Globex International Holdings, Inc.",Intercompany Transfer,ALL,339206.0,0.0,USD,Internal Transfer,"Globex International Holdings, Inc.",***5894,,,True,True,REF-547660,First Continental Bank,***2443,Globex Retail NA LLC,US,2932721.18
2025-03-13,2025-03-13,Supplier Payment - HyperCloud Infra #1,Supplier Payment,SaaS-GL,1251.39,0.0,USD,Fedwire,HyperCloud Infra #1,***7279,,PO-202503-SaaS-GL-0003,False,False,REF-732321,First Continental Bank,***1270,Globex Retail NA LLC,US,2931469.79
2025-03-13,2025-03-13,Supplier Payment - PackFast Fulfillment #9,Supplier Payment,Retail-NA,45761.29,0.0,USD,Fedwire,PackFast Fulfillment #9,***7391,,PO-202503-Retail-NA-0007,False,False,REF-489830,First Continental Bank,***9793,Globex Retail NA LLC,US,2885708.5
2025-03-13,2025-03-13,Client Receipt - CloudBridge Co. #18,Sales Receipt,SaaS-GL,0.0,1849.25,USD,ACH Credit,CloudBridge Co. #18,***5562,INV-202503-SaaS-GL-0019,,False,False,REF-153302,First Continental Bank,***7172,Globex Retail NA LLC,US,2887557.75
2025-03-13,2025-03-13,Client Receipt - Card Settlement Batch #24,Sales Receipt,Retail-NA,0.0,2042.02,USD,Card Settlement,Card Settlement Batch #24,***2099,INV-202503-Retail-NA-0013,,False,False,REF-401118,First Continental Bank,***8374,Globex Retail NA LLC,US,2889599.77
2025-03-14,2025-03-14,Client Receipt - CloudBridge Co. #71,Sales Receipt,SaaS-GL,0.0,5760.66,USD,ACH Credit,CloudBridge Co. #71,***9538,INV-202503-SaaS-GL-0033,,False,False,REF-818027,First Continental Bank,***3402,Globex Retail NA LLC,US,2895360.43
2025-03-14,2025-03-14,Client Receipt - CloudBridge Co. #24,Sales Receipt,SaaS-GL,0.0,7598.88,USD,ACH Credit,CloudBridge Co. #24,***8054,INV-202503-SaaS-GL-0032,,False,False,REF-390378,First Continental Bank,***7087,Globex Retail NA LLC,US,2902959.31
2025-03-16,2025-03-16,Client Receipt - Vertex Advisory Client #6,Sales Receipt,PS-GL,0.0,37428.02,USD,ACH Credit,Vertex Advisory Client #6,***2321,INV-202503-PS-GL-0004,,False,False,REF-974776,First Continental Bank,***5300,Globex Retail NA LLC,US,2940387.33
2025-03-16,2025-03-16,Client Receipt - ShopSphere Partner #44,Sales Receipt,Retail-NA,0.0,56198.11,USD,Card Settlement,ShopSphere Partner #44,***7013,INV-202503-Retail-NA-0006,,False,False,REF-157518,First Continental Bank,***7404,Globex Retail NA LLC,US,2996585.44
2025-03-17,2025-03-17,Merchant Processing Fees,Bank/Merchant Fees,ALL,652.52,0.0,USD,Fedwire,First Continental Bank,***6584,,,False,False,REF-748118,First Continental Bank,***4863,Globex Retail NA LLC,US,2995932.92
2025-03-17,2025-03-17,Supplier Payment - ExpertNet Subcontractors #4,Supplier Payment,PS-GL,2701.14,0.0,USD,ACH Debit,ExpertNet Subcontractors #4,***6592,,PO-202503-PS-GL-0003,False,False,REF-274783,First Continental Bank,***1755,Globex Retail NA LLC,US,2993231.78
2025-03-17,2025-03-17,Client Receipt - Vertex Advisory Client #35,Sales Receipt,PS-GL,0.0,22281.61,USD,ACH Credit,Vertex Advisory Client #35,***4996,INV-202503-PS-GL-0005,,False,False,REF-943306,First Continental Bank,***1155,Globex Retail NA LLC,US,3015513.39
2025-03-18,2025-03-18,Northshore Power,Rent & Utilities,ALL,4862.86,0.0,USD,ACH Debit,Northshore Power,***3344,,,False,False,REF-723354,First Continental Bank,***8227,Globex Retail NA LLC,US,3010650.53
2025-03-18,2025-03-18,Supplier Payment - HyperCloud Infra #13,Supplier Payment,SaaS-GL,9169.15,0.0,USD,ACH Debit,HyperCloud Infra #13,***6222,,PO-202503-SaaS-GL-0004,False,False,REF-365610,First Continental Bank,***5913,Globex Retail NA LLC,US,3001481.38
2025-03-18,2025-03-18,Client Receipt - CloudBridge Co. #20,Sales Receipt,SaaS-GL,0.0,685.85,USD,ACH Credit,CloudBridge Co. #20,***7357,INV-202503-SaaS-GL-0005,,False,False,REF-936933,First Continental Bank,***2628,Globex Retail NA LLC,US,3002167.23
2025-03-18,2025-03-18,Client Receipt - CloudBridge Co. #6,Sales Receipt,SaaS-GL,0.0,1203.63,USD,ACH Credit,CloudBridge Co. #6,***4927,INV-202503-SaaS-GL-0008,,False,False,REF-387899,First Continental Bank,***6012,Globex Retail NA LLC,US,3003370.86
2025-03-18,2025-03-18,Client Receipt - Card Settlement Batch #10,Sales Receipt,Retail-NA,0.0,56326.58,USD,Card Settlement,Card Settlement Batch #10,***9313,INV-202503-Retail-NA-0001,,False,False,REF-203913,First Continental Bank,***1988,Globex Retail NA LLC,US,3059697.44
2025-03-19,2025-03-19,Marketing - Beacon Digital #6,Marketing,ALL,2068.68,0.0,USD,Fedwire,Beacon Digital #6,***3087,,,False,False,REF-829277,First Continental Bank,***9805,Globex Retail NA LLC,US,3057628.76
2025-03-19,2025-03-19,Supplier Payment - ExpertNet Subcontractors #13,Supplier Payment,PS-GL,5784.72,0.0,USD,ACH Debit,ExpertNet Subcontractors #13,***1095,,PO-202503-PS-GL-0006,False,False,REF-740618,First Continental Bank,***1807,Globex Retail NA LLC,US,3051844.04
2025-03-19,2025-03-19,Client Receipt - CloudBridge Co. #33,Sales Receipt,SaaS-GL,0.0,2055.6,USD,ACH Credit,CloudBridge Co. #33,***8253,INV-202503-SaaS-GL-0001,,False,False,REF-357404,First Continental Bank,***5095,Globex Retail NA LLC,US,3053899.64
2025-03-19,2025-03-19,Client Receipt - CloudBridge Co. #35,Sales Receipt,SaaS-GL,0.0,2338.96,USD,ACH Credit,CloudBridge Co. #35,***6964,INV-202503-SaaS-GL-0017,,False,False,REF-746767,First Continental Bank,***7399,Globex Retail NA LLC,US,3056238.6
2025-03-19,2025-03-19,Client Receipt - ShopSphere Partner #61,Sales Receipt,Retail-NA,0.0,8389.84,USD,ACH Credit,ShopSphere Partner #61,***4718,INV-202503-Retail-NA-0012,,False,False,REF-281093,First Continental Bank,***6057,Globex Retail NA LLC,US,3064628.44
2025-03-20,2025-03-20,Supplier Payment - ExpertNet Subcontractors #2,Supplier Payment,PS-GL,3721.51,0.0,USD,ACH Debit,ExpertNet Subcontractors #2,***2811,,PO-202503-PS-GL-0010,False,False,REF-992278,First Continental Bank,***9359,Globex Retail NA LLC,US,3060906.93
2025-03-20,2025-03-20,Client Receipt - CloudBridge Co. #3,Sales Receipt,SaaS-GL,0.0,1742.56,USD,Card Settlement,CloudBridge Co. #3,***8716,INV-202503-SaaS-GL-0011,,False,False,REF-932147,First Continental Bank,***4781,Globex Retail NA LLC,US,3062649.49
2025-03-20,2025-03-20,Client Receipt - ShopSphere Partner #17,Sales Receipt,Retail-NA,0.0,21242.36,USD,Card Settlement,ShopSphere Partner #17,***2599,INV-202503-Retail-NA-0015,,False,False,REF-819133,First Continental Bank,***3985,Globex Retail NA LLC,US,3083891.85
2025-03-20,2025-03-20,Client Receipt - ShopSphere Partner #25,Sales Receipt,Retail-NA,0.0,26185.11,USD,Card Settlement,ShopSphere Partner #25,***3300,INV-202503-Retail-NA-0011,,False,False,REF-354355,First Continental Bank,***9791,Globex Retail NA LLC,US,3110076.96
2025-03-20,2025-03-20,Client Receipt - CloudBridge Co. #72,Sales Receipt,SaaS-GL,0.0,28374.84,USD,ACH Credit,CloudBridge Co. #72,***8534,INV-202503-SaaS-GL-0018,,False,False,REF-617117,First Continental Bank,***4649,Globex Retail NA LLC,US,3138451.8
2025-03-21,2025-03-21,Supplier Payment - NorthRiver Apparel Mfg #12,Supplier Payment,Retail-NA,5824.47,0.0,USD,Fedwire,NorthRiver Apparel Mfg #12,***6111,,PO-202503-Retail-NA-0005,False,False,REF-741772,First Continental Bank,***3097,Globex Retail NA LLC,US,3132627.33
2025-03-21,2025-03-21,VAT/GST Remittance - US IRS,Tax Payment,ALL,55023.45,0.0,USD,ACH Debit,US IRS,***5318,,,False,False,REF-195858,First Continental Bank,***8014,Globex Retail NA LLC,US,3077603.88
2025-03-21,2025-03-21,Client Receipt - CloudBridge Co. #12,Sales Receipt,SaaS-GL,0.0,2830.24,USD,Card Settlement,CloudBridge Co. #12,***9580,INV-202503-SaaS-GL-0006,,False,False,REF-238637,First Continental Bank,***9943,Globex Retail NA LLC,US,3080434.12
2025-03-21,2025-03-21,Client Receipt - CloudBridge Co. #45,Sales Receipt,SaaS-GL,0.0,4218.91,USD,ACH Credit,CloudBridge Co. #45,***4226,INV-202503-SaaS-GL-0012,,False,False,REF-991843,First Continental Bank,***7880,Globex Retail NA LLC,US,3084653.03
2025-03-21,2025-03-21,Client Receipt - ShopSphere Partner #76,Sales Receipt,Retail-NA,0.0,51968.11,USD,ACH Credit,ShopSphere Partner #76,***5634,INV-202503-Retail-NA-0002,,False,False,REF-121633,First Continental Bank,***2210,Globex Retail NA LLC,US,3136621.14
2025-03-23,2025-03-23,Supplier Payment - PackFast Fulfillment #16,Supplier Payment,Retail-NA,20693.93,0.0,USD,Fedwire,PackFast Fulfillment #16,***2127,,PO-202503-Retail-NA-0003,False,False,REF-692153,First Continental Bank,***3402,Globex Retail NA LLC,US,3115927.21
2025-03-24,2025-03-24,Client Receipt - ShopSphere Partner #4,Sales Receipt,Retail-NA,0.0,7040.23,USD,ACH Credit,ShopSphere Partner #4,***8004,INV-202503-Retail-NA-0005,,False,False,REF-334267,First Continental Bank,***1183,Globex Retail NA LLC,US,3122967.44
2025-03-25,2025-03-25,Supplier Payment - ExpertNet Subcontractors #12,Supplier Payment,PS-GL,17157.64,0.0,USD,Fedwire,ExpertNet Subcontractors #12,***4598,,PO-202503-PS-GL-0008,False,False,REF-590935,First Continental Bank,***2120,Globex Retail NA LLC,US,3105809.8
2025-03-25,2025-03-25,Client Receipt - Vertex Advisory Client #43,Sales Receipt,PS-GL,0.0,4484.53,USD,ACH Credit,Vertex Advisory Client #43,***5178,INV-202503-PS-GL-0003,,False,False,REF-749347,First Continental Bank,***6544,Globex Retail NA LLC,US,3110294.33
2025-03-25,2025-03-25,Client Receipt - Vertex Advisory Client #50,Sales Receipt,PS-GL,0.0,12429.23,USD,Card Settlement,Vertex Advisory Client #50,***5992,INV-202503-PS-GL-0006,,False,False,REF-497608,First Continental Bank,***7677,Globex Retail NA LLC,US,3122723.56
2025-03-25,2025-03-25,Client Receipt - ShopSphere Partner #59,Sales Receipt,Retail-NA,0.0,15286.65,USD,ACH Credit,ShopSphere Partner #59,***3007,INV-202503-Retail-NA-0009,,False,False,REF-750765,First Continental Bank,***3357,Globex Retail NA LLC,US,3138010.21
2025-03-25,2025-03-25,Client Receipt - CloudBridge Co. #35,Sales Receipt,SaaS-GL,0.0,19744.5,USD,Card Settlement,CloudBridge Co. #35,***6374,INV-202503-SaaS-GL-0009,,False,False,REF-676761,First Continental Bank,***7679,Globex Retail NA LLC,US,3157754.71
2025-03-25,2025-03-25,Client Receipt - CloudBridge Co. #49,Sales Receipt,SaaS-GL,0.0,26819.54,USD,Card Settlement,CloudBridge Co. #49,***7429,INV-202503-SaaS-GL-0027,,False,False,REF-149960,First Continental Bank,***7882,Globex Retail NA LLC,US,3184574.25
2025-03-26,2025-03-26,Alphagrid Utilities,Rent & Utilities,ALL,2497.32,0.0,USD,ACH Debit,Alphagrid Utilities,***8967,,,False,False,REF-737644,First Continental Bank,***7483,Globex Retail NA LLC,US,3182076.93
2025-03-26,2025-03-26,Payroll - GlobalPay Services Ltd,Payroll,ALL,74366.43,0.0,USD,Fedwire,GlobalPay Services Ltd,***7126,,,False,False,REF-487657,First Continental Bank,***2807,Globex Retail NA LLC,US,3107710.5
2025-03-26,2025-03-26,Payroll - GlobalPay Services Ltd,Payroll,ALL,74366.43,0.0,USD,ACH Debit,GlobalPay Services Ltd,***8544,,,False,False,REF-724569,First Continental Bank,***7758,Globex Retail NA LLC,US,3033344.07
2025-03-26,2025-03-26,Intercompany Settlement - Globex APAC Logistics Pte. Ltd.,Intercompany Transfer,ALL,200521.0,0.0,USD,Internal Transfer,Globex APAC Logistics Pte. Ltd.,***1301,,,True,True,REF-977845,First Continental Bank,***5391,Globex Retail NA LLC,US,2832823.07
2025-03-26,2025-03-26,Client Receipt - ShopSphere Partner #51,Sales Receipt,Retail-NA,0.0,8690.61,USD,Card Settlement,ShopSphere Partner #51,***8883,INV-202503-Retail-NA-0008,,False,False,REF-733332,First Continental Bank,***2666,Globex Retail NA LLC,US,2841513.68
2025-03-26,2025-03-26,Client Receipt - Vertex Advisory Client #42,Sales Receipt,PS-GL,0.0,73409.78,USD,ACH Credit,Vertex Advisory Client #42,***3552,INV-202503-PS-GL-0001,,False,False,REF-536488,First Continental Bank,***7336,Globex Retail NA LLC,US,2914923.46
2025-03-27,2025-03-27,Client Receipt - CloudBridge Co. #63,Sales Receipt,SaaS-GL,0.0,8140.2,USD,ACH Credit,CloudBridge Co. #63,***1988,INV-202503-SaaS-GL-0028,,False,False,REF-221723,First Continental Bank,***5090,Globex Retail NA LLC,US,2923063.66
2025-03-27,2025-03-27,Client Receipt - CloudBridge Co. #40,Sales Receipt,SaaS-GL,0.0,8599.14,USD,Card Settlement,CloudBridge Co. #40,***2558,INV-202503-SaaS-GL-0035,,False,False,REF-858764,First Continental Bank,***6610,Globex Retail NA LLC,US,2931662.8
2025-03-27,2025-03-27,Client Receipt - CloudBridge Co. #70,Sales Receipt,SaaS-GL,0.0,11398.63,USD,Card Settlement,CloudBridge Co. #70,***4429,INV-202503-SaaS-GL-0003,,False,False,REF-665536,First Continental Bank,***6896,Globex Retail NA LLC,US,2943061.43
2025-03-28,2025-03-28,Supplier Payment - ExpertNet Subcontractors #4,Supplier Payment,PS-GL,402.0,0.0,USD,Fedwire,ExpertNet Subcontractors #4,***3710,,PO-202503-PS-GL-0005,False,False,REF-613122,First Continental Bank,***7266,Globex Retail NA LLC,US,2942659.43
2025-03-28,2025-03-28,Supplier Payment - PackFast Fulfillment #15,Supplier Payment,Retail-NA,9953.85,0.0,USD,Fedwire,PackFast Fulfillment #15,***9912,,PO-202503-Retail-NA-0009,False,False,REF-674372,First Continental Bank,***1506,Globex Retail NA LLC,US,2932705.58
2025-03-28,2025-03-28,Client Receipt - Vertex Advisory Client #59,Sales Receipt,PS-GL,0.0,12930.87,USD,ACH Credit,Vertex Advisory Client #59,***3346,INV-202503-PS-GL-0010,,False,False,REF-605583,First Continental Bank,***6663,Globex Retail NA LLC,US,2945636.45
2025-03-28,2025-03-28,Client Receipt - CloudBridge Co. #51,Sales Receipt,SaaS-GL,0.0,19825.89,USD,ACH Credit,CloudBridge Co. #51,***1570,INV-202503-SaaS-GL-0021,,False,False,REF-673011,First Continental Bank,***8107,Globex Retail NA LLC,US,2965462.34
2025-03-29,2025-03-29,Supplier Payment - PackFast Fulfillment #12,Supplier Payment,Retail-NA,62090.24,0.0,USD,Fedwire,PackFast Fulfillment #12,***8660,,PO-202503-Retail-NA-0008,False,False,REF-952586,First Continental Bank,***6633,Globex Retail NA LLC,US,2903372.1
2025-03-29,2025-03-29,Client Receipt - CloudBridge Co. #69,Sales Receipt,SaaS-GL,0.0,868.36,USD,Card Settlement,CloudBridge Co. #69,***6644,INV-202503-SaaS-GL-0020,,False,False,REF-760963,First Continental Bank,***4506,Globex Retail NA LLC,US,2904240.46
2025-03-30,2025-03-30,Interest Earned,Interest Income,ALL,0.0,12571.65,USD,Card Settlement,First Continental Bank,***9921,,,False,False,REF-404530,First Continental Bank,***8802,Globex Retail NA LLC,US,2916812.11
2025-03-31,2025-03-31,Client Receipt - Vertex Advisory Client #35,Sales Receipt,PS-GL,0.0,2952.84,USD,ACH Credit,Vertex Advisory Client #35,***7630,INV-202503-PS-GL-0009,,False,False,REF-960566,First Continental Bank,***8836,Globex Retail NA LLC,US,2919764.95
2025-03-31,2025-03-31,Client Receipt - CloudBridge Co. #45,Sales Receipt,SaaS-GL,0.0,5949.03,USD,ACH Credit,CloudBridge Co. #45,***5667,INV-202503-SaaS-GL-0025,,False,False,REF-100207,First Continental Bank,***7431,Globex Retail NA LLC,US,2925713.98
2025-03-31,2025-03-31,Client Receipt - ShopSphere Partner #30,Sales Receipt,Retail-NA,0.0,6992.39,USD,ACH Credit,ShopSphere Partner #30,***4886,INV-202503-Retail-NA-0010,,False,False,REF-676450,First Continental Bank,***7623,Globex Retail NA LLC,US,2932706.37
2025-03-31,2025-03-31,Client Receipt - CloudBridge Co. #3,Sales Receipt,SaaS-GL,0.0,11862.14,USD,ACH Credit,CloudBridge Co. #3,***3882,INV-202503-SaaS-GL-0022,,False,False,REF-226249,First Continental Bank,***4828,Globex Retail NA LLC,US,2944568.51
2025-03-31,2025-03-31,Client Receipt - CloudBridge Co. #7,Sales Receipt,SaaS-GL,0.0,16330.56,USD,ACH Credit,CloudBridge Co. #7,***4930,INV-202503-SaaS-GL-0016,,False,False,REF-531060,First Continental Bank,***1092,Globex Retail NA LLC,US,2960899.07
2025-03-31,2025-03-31,Client Receipt - CloudBridge Co. #31,Sales Receipt,SaaS-GL,0.0,35756.47,USD,ACH Credit,CloudBridge Co. #31,***6181,INV-202503-SaaS-GL-0004,,False,False,REF-525284,First Continental Bank,***1360,Globex Retail NA LLC,US,2996655.54
2025-04-01,2025-04-01,Merchant Processing Fees,Bank/Merchant Fees,ALL,1959.99,0.0,USD,ACH Debit,First Continental Bank,***5518,,,False,False,REF-506603,First Continental Bank,***4790,Globex Retail NA LLC,US,2994695.55
2025-04-01,2025-04-01,Account Maintenance Fee,Bank/Merchant Fees,ALL,2500.0,0.0,USD,Fedwire,First Continental Bank,***9711,,,False,False,REF-897405,First Continental Bank,***7975,Globex Retail NA LLC,US,2992195.55
2025-04-01,2025-04-01,Client Receipt - Vertex Advisory Client #9,Sales Receipt,PS-GL,0.0,1818.54,USD,ACH Credit,Vertex Advisory Client #9,***9817,INV-202504-PS-GL-0005,,False,False,REF-389926,First Continental Bank,***3627,Globex Retail NA LLC,US,2994014.09
2025-04-02,2025-04-02,Client Receipt - ShopSphere Partner #34,Sales Receipt,Retail-NA,0.0,18358.91,USD,Card Settlement,ShopSphere Partner #34,***5196,INV-202504-Retail-NA-0011,,False,False,REF-331472,First Continental Bank,***3720,Globex Retail NA LLC,US,3012373.0
2025-04-02,2025-04-02,Client Receipt - CloudBridge Co. #67,Sales Receipt,SaaS-GL,0.0,26947.3,USD,ACH Credit,CloudBridge Co. #67,***7113,INV-202504-SaaS-GL-0022,,False,False,REF-174105,First Continental Bank,***8533,Globex Retail NA LLC,US,3039320.3
2025-04-02,2025-04-02,Client Receipt - ShopSphere Partner #59,Sales Receipt,Retail-NA,0.0,34958.52,USD,ACH Credit,ShopSphere Partner #59,***3616,INV-202504-Retail-NA-0002,,False,False,REF-445092,First Continental Bank,***2854,Globex Retail NA LLC,US,3074278.82
2025-04-03,2025-04-03,Supplier Payment - ExpertNet Subcontractors #2,Supplier Payment,PS-GL,5138.75,0.0,USD,Fedwire,ExpertNet Subcontractors #2,***5030,,PO-202504-PS-GL-0007,False,False,REF-248230,First Continental Bank,***6034,Globex Retail NA LLC,US,3069140.07
2025-04-03,2025-04-03,Supplier Payment - CodeCraft Contractors #4,Supplier Payment,SaaS-GL,18745.27,0.0,USD,ACH Debit,CodeCraft Contractors #4,***9195,,PO-202504-SaaS-GL-0003,False,False,REF-662750,First Continental Bank,***1185,Globex Retail NA LLC,US,3050394.8
2025-04-03,2025-04-03,Supplier Payment - NorthRiver Apparel Mfg #6,Supplier Payment,Retail-NA,37969.16,0.0,USD,Fedwire,NorthRiver Apparel Mfg #6,***1408,,PO-202504-Retail-NA-0007,False,False,REF-872845,First Continental Bank,***5669,Globex Retail NA LLC,US,3012425.64
2025-04-03,2025-04-03,Client Receipt - CloudBridge Co. #55,Sales Receipt,SaaS-GL,0.0,1072.43,USD,ACH Credit,CloudBridge Co. #55,***1494,INV-202504-SaaS-GL-0017,,False,False,REF-373640,First Continental Bank,***5365,Globex Retail NA LLC,US,3013498.07
2025-04-03,2025-04-03,Client Receipt - CloudBridge Co. #34,Sales Receipt,SaaS-GL,0.0,9896.58,USD,ACH Credit,CloudBridge Co. #34,***1985,INV-202504-SaaS-GL-0020,,False,False,REF-904631,First Continental Bank,***7466,Globex Retail NA LLC,US,3023394.65
2025-04-03,2025-04-03,Client Receipt - CloudBridge Co. #14,Sales Receipt,SaaS-GL,0.0,12210.99,USD,ACH Credit,CloudBridge Co. #14,***9279,INV-202504-SaaS-GL-0011,,False,False,REF-722890,First Continental Bank,***1180,Globex Retail NA LLC,US,3035605.64
2025-04-04,2025-04-04,Supplier Payment - ExpertNet Subcontractors #6,Supplier Payment,PS-GL,2089.61,0.0,USD,ACH Debit,ExpertNet Subcontractors #6,***9256,,PO-202504-PS-GL-0001,False,False,REF-736583,First Continental Bank,***1650,Globex Retail NA LLC,US,3033516.03
2025-04-04,2025-04-04,Supplier Payment - ExpertNet Subcontractors #10,Supplier Payment,PS-GL,3173.39,0.0,USD,ACH Debit,ExpertNet Subcontractors #10,***5164,,PO-202504-PS-GL-0008,False,False,REF-924679,First Continental Bank,***3116,Globex Retail NA LLC,US,3030342.64
2025-04-04,2025-04-04,Client Receipt - ShopSphere Partner #3,Sales Receipt,Retail-NA,0.0,15636.19,USD,ACH Credit,ShopSphere Partner #3,***4144,INV-202504-Retail-NA-0001,,False,False,REF-170253,First Continental Bank,***4472,Globex Retail NA LLC,US,3045978.83
2025-04-04,2025-04-04,Client Receipt - Vertex Advisory Client #4,Sales Receipt,PS-GL,0.0,78916.39,USD,ACH Credit,Vertex Advisory Client #4,***5756,INV-202504-PS-GL-0008,,False,False,REF-230739,First Continental Bank,***3018,Globex Retail NA LLC,US,3124895.22
2025-04-05,2025-04-05,Client Receipt - Vertex Advisory Client #30,Sales Receipt,PS-GL,0.0,9975.4,USD,Card Settlement,Vertex Advisory Client #30,***4372,INV-202504-PS-GL-0003,,False,False,REF-601249,First Continental Bank,***5774,Globex Retail NA LLC,US,3134870.62
2025-04-06,2025-04-06,Client Receipt - ShopSphere Partner #77,Sales Receipt,Retail-NA,0.0,2291.24,USD,ACH Credit,ShopSphere Partner #77,***5283,INV-202504-Retail-NA-0007,,False,False,REF-322992,First Continental Bank,***6925,Globex Retail NA LLC,US,3137161.86
2025-04-06,2025-04-06,Client Receipt - CloudBridge Co. #7,Sales Receipt,SaaS-GL,0.0,5594.41,USD,ACH Credit,CloudBridge Co. #7,***6012,INV-202504-SaaS-GL-0001,,False,False,REF-847298,First Continental Bank,***7165,Globex Retail NA LLC,US,3142756.27
2025-04-06,2025-04-06,Client Receipt - ShopSphere Partner #66,Sales Receipt,Retail-NA,0.0,31053.23,USD,Card Settlement,ShopSphere Partner #66,***7339,INV-202504-Retail-NA-0009,,False,False,REF-886889,First Continental Bank,***7477,Globex Retail NA LLC,US,3173809.5
2025-04-07,2025-04-07,Supplier Payment - HyperCloud Infra #11,Supplier Payment,SaaS-GL,13002.76,0.0,USD,Fedwire,HyperCloud Infra #11,***9725,,PO-202504-SaaS-GL-0004,False,False,REF-549662,First Continental Bank,***9104,Globex Retail NA LLC,US,3160806.74
2025-04-07,2025-04-07,Client Receipt - Vertex Advisory Client #48,Sales Receipt,PS-GL,0.0,36106.78,USD,ACH Credit,Vertex Advisory Client #48,***6449,INV-202504-PS-GL-0004,,False,False,REF-509148,First Continental Bank,***3987,Globex Retail NA LLC,US,3196913.52
2025-04-08,2025-04-08,Supplier Payment - HyperCloud Infra #6,Supplier Payment,SaaS-GL,1271.95,0.0,USD,ACH Debit,HyperCloud Infra #6,***1769,,PO-202504-SaaS-GL-0008,False,False,REF-555227,First Continental Bank,***6480,Globex Retail NA LLC,US,3195641.57
2025-04-08,2025-04-08,Supplier Payment - ExpertNet Subcontractors #19,Supplier Payment,PS-GL,2841.38,0.0,USD,Fedwire,ExpertNet Subcontractors #19,***5532,,PO-202504-PS-GL-0002,False,False,REF-641455,First Continental Bank,***6088,Globex Retail NA LLC,US,3192800.19
2025-04-08,2025-04-08,Supplier Payment - NorthRiver Apparel Mfg #2,Supplier Payment,Retail-NA,21100.72,0.0,USD,Fedwire,NorthRiver Apparel Mfg #2,***3524,,PO-202504-Retail-NA-0004,False,False,REF-891553,First Continental Bank,***9073,Globex Retail NA LLC,US,3171699.47
2025-04-09,2025-04-09,Supplier Payment - NorthRiver Apparel Mfg #9,Supplier Payment,Retail-NA,17658.62,0.0,USD,Fedwire,NorthRiver Apparel Mfg #9,***2331,,PO-202504-Retail-NA-0006,False,False,REF-163172,First Continental Bank,***1750,Globex Retail NA LLC,US,3154040.85
2025-04-09,2025-04-09,Client Receipt - CloudBridge Co. #78,Sales Receipt,SaaS-GL,0.0,12905.84,USD,Card Settlement,CloudBridge Co. #78,***1873,INV-202504-SaaS-GL-0034,,False,False,REF-103803,First Continental Bank,***1748,Globex Retail NA LLC,US,3166946.69
2025-04-10,2025-04-10,Supplier Payment - NorthRiver Apparel Mfg #33,Supplier Payment,Retail-NA,5520.78,0.0,USD,Fedwire,NorthRiver Apparel Mfg #33,***9465,,PO-202504-Retail-NA-0008,False,False,REF-669274,First Continental Bank,***5093,Globex Retail NA LLC,US,3161425.91
2025-04-10,2025-04-10,Client Receipt - Vertex Advisory Client #57,Sales Receipt,PS-GL,0.0,27689.05,USD,ACH Credit,Vertex Advisory Client #57,***8830,INV-202504-PS-GL-0007,,False,False,REF-161687,First Continental Bank,***3663,Globex Retail NA LLC,US,3189114.96
2025-04-11,2025-04-11,Client Receipt - CloudBridge Co. #63,Sales Receipt,SaaS-GL,0.0,1572.56,USD,Card Settlement,CloudBridge Co. #63,***6680,INV-202504-SaaS-GL-0015,,False,False,REF-703587,First Continental Bank,***1248,Globex Retail NA LLC,US,3190687.52
2025-04-11,2025-04-11,Client Receipt - CloudBridge Co. #44,Sales Receipt,SaaS-GL,0.0,1828.02,USD,Card Settlement,CloudBridge Co. #44,***5016,INV-202504-SaaS-GL-0016,,False,False,REF-464399,First Continental Bank,***3213,Globex Retail NA LLC,US,3192515.54
2025-04-11,2025-04-11,Client Receipt - CloudBridge Co. #6,Sales Receipt,SaaS-GL,0.0,2750.66,USD,ACH Credit,CloudBridge Co. #6,***1353,INV-202504-SaaS-GL-0013,,False,False,REF-407395,First Continental Bank,***9305,Globex Retail NA LLC,US,3195266.2
2025-04-11,2025-04-11,Client Receipt - CloudBridge Co. #11,Sales Receipt,SaaS-GL,0.0,35832.31,USD,ACH Credit,CloudBridge Co. #11,***9331,INV-202504-SaaS-GL-0029,,False,False,REF-888290,First Continental Bank,***4578,Globex Retail NA LLC,US,3231098.51
2025-04-12,2025-04-12,Intercompany Settlement - Globex APAC Logistics Pte. Ltd.,Intercompany Transfer,ALL,512539.0,0.0,USD,Internal Transfer,Globex APAC Logistics Pte. Ltd.,***9583,,,True,True,REF-110650,First Continental Bank,***5693,Globex Retail NA LLC,US,2718559.51
2025-04-12,2025-04-12,Client Receipt - CloudBridge Co. #54,Sales Receipt,SaaS-GL,0.0,12224.27,USD,Card Settlement,CloudBridge Co. #54,***6569,INV-202504-SaaS-GL-0005,,False,False,REF-538144,First Continental Bank,***7707,Globex Retail NA LLC,US,2730783.78
2025-04-13,2025-04-13,Merchant Processing Fees,Bank/Merchant Fees,ALL,1011.3,0.0,USD,Fedwire,First Continental Bank,***1802,,,False,False,REF-772026,First Continental Bank,***6287,Globex Retail NA LLC,US,2729772.48
2025-04-13,2025-04-13,Supplier Payment - ExpertNet Subcontractors #18,Supplier Payment,PS-GL,2870.34,0.0,USD,ACH Debit,ExpertNet Subcontractors #18,***4520,,PO-202504-PS-GL-0005,False,False,REF-232106,First Continental Bank,***7842,Globex Retail NA LLC,US,2726902.14
2025-04-14,2025-04-14,Supplier Payment - PackFast Fulfillment #21,Supplier Payment,Retail-NA,3351.34,0.0,USD,Fedwire,PackFast Fulfillment #21,***7542,,PO-202504-Retail-NA-0002,False,False,REF-330021,First Continental Bank,***1826,Globex Retail NA LLC,US,2723550.8
2025-04-14,2025-04-14,Client Receipt - ShopSphere Partner #16,Sales Receipt,Retail-NA,0.0,32152.01,USD,Card Settlement,ShopSphere Partner #16,***8896,INV-202504-Retail-NA-0003,,False,False,REF-419794,First Continental Bank,***3537,Globex Retail NA LLC,US,2755702.81
2025-04-15,2025-04-15,Marketing - Beacon Digital #1,Marketing,ALL,5181.04,0.0,USD,ACH Debit,Beacon Digital #1,***2084,,,False,False,REF-833665,First Continental Bank,***4829,Globex Retail NA LLC,US,2750521.77
2025-04-15,2025-04-15,Supplier Payment - ExpertNet Subcontractors #18,Supplier Payment,PS-GL,8292.66,0.0,USD,Fedwire,ExpertNet Subcontractors #18,***4244,,PO-202504-PS-GL-0009,False,False,REF-335868,First Continental Bank,***4517,Globex Retail NA LLC,US,2742229.11
2025-04-16,2025-04-16,Client Receipt - Vertex Advisory Client #18,Sales Receipt,PS-GL,0.0,34083.53,USD,ACH Credit,Vertex Advisory Client #18,***2565,INV-202504-PS-GL-0006,,False,False,REF-479205,First Continental Bank,***7900,Globex Retail NA LLC,US,2776312.64
2025-04-17,2025-04-17,Marketing - Beacon Digital #7,Marketing,ALL,18823.51,0.0,USD,Fedwire,Beacon Digital #7,***5688,,,False,False,REF-922796,First Continental Bank,***4462,Globex Retail NA LLC,US,2757489.13
2025-04-17,2025-04-17,Client Receipt - ShopSphere Partner #34,Sales Receipt,Retail-NA,0.0,2076.3,USD,Card Settlement,ShopSphere Partner #34,***1019,INV-202504-Retail-NA-0008,,False,False,REF-681501,First Continental Bank,***5508,Globex Retail NA LLC,US,2759565.43
2025-04-17,2025-04-17,Client Receipt - CloudBridge Co. #72,Sales Receipt,SaaS-GL,0.0,9062.06,USD,ACH Credit,CloudBridge Co. #72,***4926,INV-202504-SaaS-GL-0014,,False,False,REF-599125,First Continental Bank,***3644,Globex Retail NA LLC,US,2768627.49
2025-04-17,2025-04-17,Client Receipt - CloudBridge Co. #53,Sales Receipt,SaaS-GL,0.0,20191.63,USD,Card Settlement,CloudBridge Co. #53,***6465,INV-202504-SaaS-GL-0018,,False,False,REF-278430,First Continental Bank,***2691,Globex Retail NA LLC,US,2788819.12
2025-04-17,2025-04-17,Client Receipt - Vertex Advisory Client #28,Sales Receipt,PS-GL,0.0,28397.7,USD,ACH Credit,Vertex Advisory Client #28,***4747,INV-202504-PS-GL-0001,,False,False,REF-850815,First Continental Bank,***3733,Globex Retail NA LLC,US,2817216.82
2025-04-18,2025-04-18,Client Receipt - CloudBridge Co. #42,Sales Receipt,SaaS-GL,0.0,4906.6,USD,Card Settlement,CloudBridge Co. #42,***5981,INV-202504-SaaS-GL-0002,,False,False,REF-257692,First Continental Bank,***4667,Globex Retail NA LLC,US,2822123.42
2025-04-18,2025-04-18,Client Receipt - CloudBridge Co. #37,Sales Receipt,SaaS-GL,0.0,6540.03,USD,Card Settlement,CloudBridge Co. #37,***5056,INV-202504-SaaS-GL-0021,,False,False,REF-126146,First Continental Bank,***9976,Globex Retail NA LLC,US,2828663.45
2025-04-18,2025-04-18,Client Receipt - CloudBridge Co. #20,Sales Receipt,SaaS-GL,0.0,13100.43,USD,ACH Credit,CloudBridge Co. #20,***2353,INV-202504-SaaS-GL-0010,,False,False,REF-169317,First Continental Bank,***6080,Globex Retail NA LLC,US,2841763.88
2025-04-19,2025-04-19,VAT/GST Remittance - US IRS,Tax Payment,ALL,60570.66,0.0,USD,SWIFT MT103,US IRS,***9485,,,False,False,REF-398589,First Continental Bank,***1041,Globex Retail NA LLC,US,2781193.22
2025-04-20,2025-04-20,Supplier Payment - PackFast Fulfillment #13,Supplier Payment,Retail-NA,55461.49,0.0,USD,Fedwire,PackFast Fulfillment #13,***7813,,PO-202504-Retail-NA-0003,False,False,REF-223388,First Continental Bank,***9014,Globex Retail NA LLC,US,2725731.73
2025-04-21,2025-04-21,Supplier Payment - CodeCraft Contractors #12,Supplier Payment,SaaS-GL,2598.17,0.0,USD,Fedwire,CodeCraft Contractors #12,***4704,,PO-202504-SaaS-GL-0005,False,False,REF-596082,First Continental Bank,***9984,Globex Retail NA LLC,US,2723133.56
2025-04-21,2025-04-21,Supplier Payment - ExpertNet Subcontractors #17,Supplier Payment,PS-GL,13931.76,0.0,USD,ACH Debit,ExpertNet Subcontractors #17,***1851,,PO-202504-PS-GL-0006,False,False,REF-340032,First Continental Bank,***1905,Globex Retail NA LLC,US,2709201.8
2025-04-21,2025-04-21,Client Receipt - CloudBridge Co. #36,Sales Receipt,SaaS-GL,0.0,1078.91,USD,ACH Credit,CloudBridge Co. #36,***4399,INV-202504-SaaS-GL-0009,,False,False,REF-570678,First Continental Bank,***3989,Globex Retail NA LLC,US,2710280.71
2025-04-21,2025-04-21,Client Receipt - CloudBridge Co. #6,Sales Receipt,SaaS-GL,0.0,15986.72,USD,Card Settlement,CloudBridge Co. #6,***4972,INV-202504-SaaS-GL-0027,,False,False,REF-764174,First Continental Bank,***2371,Globex Retail NA LLC,US,2726267.43
2025-04-22,2025-04-22,Supplier Payment - CodeCraft Contractors #1,Supplier Payment,SaaS-GL,1432.19,0.0,USD,ACH Debit,CodeCraft Contractors #1,***5964,,PO-202504-SaaS-GL-0007,False,False,REF-100700,First Continental Bank,***8462,Globex Retail NA LLC,US,2724835.24
2025-04-22,2025-04-22,Supplier Payment - CodeCraft Contractors #1,Supplier Payment,SaaS-GL,3734.77,0.0,USD,ACH Debit,CodeCraft Contractors #1,***2902,,PO-202504-SaaS-GL-0006,False,False,REF-492745,First Continental Bank,***4621,Globex Retail NA LLC,US,2721100.47
2025-04-22,2025-04-22,Client Receipt - CloudBridge Co. #49,Sales Receipt,SaaS-GL,0.0,7827.17,USD,Card Settlement,CloudBridge Co. #49,***6326,INV-202504-SaaS-GL-0004,,False,False,REF-756419,First Continental Bank,***1131,Globex Retail NA LLC,US,2728927.64
2025-04-22,2025-04-22,Client Receipt - Vertex Advisory Client #4,Sales Receipt,PS-GL,0.0,8153.32,USD,ACH Credit,Vertex Advisory Client #4,***1084,INV-202504-PS-GL-0002,,False,False,REF-986793,First Continental Bank,***5434,Globex Retail NA LLC,US,2737080.96
2025-04-22,2025-04-22,Client Receipt - ShopSphere Partner #26,Sales Receipt,Retail-NA,0.0,13688.47,USD,ACH Credit,ShopSphere Partner #26,***6984,INV-202504-Retail-NA-0010,,False,False,REF-792348,First Continental Bank,***2293,Globex Retail NA LLC,US,2750769.43
2025-04-22,2025-04-22,Client Receipt - Card Settlement Batch #22,Sales Receipt,Retail-NA,0.0,81396.78,USD,ACH Credit,Card Settlement Batch #22,***5282,INV-202504-Retail-NA-0012,,False,False,REF-556169,First Continental Bank,***3982,Globex Retail NA LLC,US,2832166.21
2025-04-23,2025-04-23,Supplier Payment - PackFast Fulfillment #21,Supplier Payment,Retail-NA,18816.81,0.0,USD,ACH Debit,PackFast Fulfillment #21,***8279,,PO-202504-Retail-NA-0005,False,False,REF-150977,First Continental Bank,***7648,Globex Retail NA LLC,US,2813349.4
2025-04-23,2025-04-23,Client Receipt - CloudBridge Co. #67,Sales Receipt,SaaS-GL,0.0,4286.24,USD,Card Settlement,CloudBridge Co. #67,***3705,INV-202504-SaaS-GL-0033,,False,False,REF-252463,First Continental Bank,***1556,Globex Retail NA LLC,US,2817635.64
2025-04-23,2025-04-23,Client Receipt - CloudBridge Co. #66,Sales Receipt,SaaS-GL,0.0,4333.17,USD,Card Settlement,CloudBridge Co. #66,***7292,INV-202504-SaaS-GL-0008,,False,False,REF-507686,First Continental Bank,***1025,Globex Retail NA LLC,US,2821968.81
2025-04-23,2025-04-23,Client Receipt - CloudBridge Co. #69,Sales Receipt,SaaS-GL,0.0,29876.57,USD,Card Settlement,CloudBridge Co. #69,***4273,INV-202504-SaaS-GL-0007,,False,False,REF-464308,First Continental Bank,***3787,Globex Retail NA LLC,US,2851845.38
2025-04-24,2025-04-24,Supplier Payment - HyperCloud Infra #18,Supplier Payment,SaaS-GL,20392.92,0.0,USD,Fedwire,HyperCloud Infra #18,***1247,,PO-202504-SaaS-GL-0002,False,False,REF-185993,First Continental Bank,***6252,Globex Retail NA LLC,US,2831452.46
2025-04-24,2025-04-24,Client Receipt - CloudBridge Co. #45,Sales Receipt,SaaS-GL,0.0,50.75,USD,ACH Credit,CloudBridge Co. #45,***8087,INV-202504-SaaS-GL-0019,,False,False,REF-520204,First Continental Bank,***4495,Globex Retail NA LLC,US,2831503.21
2025-04-24,2025-04-24,Client Receipt - CloudBridge Co. #64,Sales Receipt,SaaS-GL,0.0,448.06,USD,Card Settlement,CloudBridge Co. #64,***4891,INV-202504-SaaS-GL-0025,,False,False,REF-808462,First Continental Bank,***2653,Globex Retail NA LLC,US,2831951.27
2025-04-25,2025-04-25,Supplier Payment - ExpertNet Subcontractors #17,Supplier Payment,PS-GL,3522.28,0.0,USD,Fedwire,ExpertNet Subcontractors #17,***4276,,PO-202504-PS-GL-0003,False,False,REF-754660,First Continental Bank,***8771,Globex Retail NA LLC,US,2828428.99
2025-04-25,2025-04-25,Metro Water & Waste,Rent & Utilities,ALL,7708.28,0.0,USD,Fedwire,Metro Water & Waste,***4081,,,False,False,REF-717767,First Continental Bank,***5163,Globex Retail NA LLC,US,2820720.71
2025-04-25,2025-04-25,Client Receipt - CloudBridge Co. #59,Sales Receipt,SaaS-GL,0.0,15710.25,USD,Card Settlement,CloudBridge Co. #59,***3640,INV-202504-SaaS-GL-0003,,False,False,REF-498059,First Continental Bank,***1334,Globex Retail NA LLC,US,2836430.96
2025-04-25,2025-04-25,Client Receipt - CloudBridge Co. #24,Sales Receipt,SaaS-GL,0.0,20905.58,USD,Card Settlement,CloudBridge Co. #24,***4625,INV-202504-SaaS-GL-0028,,False,False,REF-832695,First Continental Bank,***6790,Globex Retail NA LLC,US,2857336.54
2025-04-26,2025-04-26,Supplier Payment - NorthRiver Apparel Mfg #32,Supplier Payment,Retail-NA,67137.97,0.0,USD,ACH Debit,NorthRiver Apparel Mfg #32,***2480,,PO-202504-Retail-NA-0001,False,False,REF-914388,First Continental Bank,***4950,Globex Retail NA LLC,US,2790198.57
2025-04-26,2025-04-26,Payroll - GlobalPay Services Ltd,Payroll,ALL,78742.95,0.0,USD,ACH Debit,GlobalPay Services Ltd,***3898,,,False,False,REF-839182,First Continental Bank,***3739,Globex Retail NA LLC,US,2711455.62
2025-04-26,2025-04-26,Intercompany Settlement - Globex EMEA Manufacturing Ltd.,Intercompany Transfer,ALL,623185.0,0.0,USD,Internal Transfer,Globex EMEA Manufacturing Ltd.,***1687,,,True,True,REF-256571,First Continental Bank,***2869,Globex Retail NA LLC,US,2088270.62
2025-04-27,2025-04-27,Client Receipt - ShopSphere Partner #34,Sales Receipt,Retail-NA,0.0,118991.64,USD,ACH Credit,ShopSphere Partner #34,***8267,INV-202504-Retail-NA-0005,,False,False,REF-178839,First Continental Bank,***8330,Globex Retail NA LLC,US,2207262.26
2025-04-28,2025-04-28,Supplier Payment - CodeCraft Contractors #5,Supplier Payment,SaaS-GL,13118.41,0.0,USD,ACH Debit,CodeCraft Contractors #5,***6360,,PO-202504-SaaS-GL-0001,False,False,REF-152583,First Continental Bank,***1481,Globex Retail NA LLC,US,2194143.85
2025-04-28,2025-04-28,Supplier Payment - ExpertNet Subcontractors #13,Supplier Payment,PS-GL,25682.04,0.0,USD,ACH Debit,ExpertNet Subcontractors #13,***9013,,PO-202504-PS-GL-0004,False,False,REF-310879,First Continental Bank,***8476,Globex Retail NA LLC,US,2168461.81
2025-04-28,2025-04-28,Corporate Tax Estimate,Tax Payment,ALL,43490.59,0.0,USD,SWIFT MT103,State of NY DoF,***6192,,,False,False,REF-725385,First Continental Bank,***3091,Globex Retail NA LLC,US,2124971.22
2025-04-28,2025-04-28,Client Receipt - CloudBridge Co. #42,Sales Receipt,SaaS-GL,0.0,7807.16,USD,Card Settlement,CloudBridge Co. #42,***7841,INV-202504-SaaS-GL-0031,,False,False,REF-742302,First Continental Bank,***2909,Globex Retail NA LLC,US,2132778.38
2025-04-28,2025-04-28,Client Receipt - CloudBridge Co. #19,Sales Receipt,SaaS-GL,0.0,11589.84,USD,ACH Credit,CloudBridge Co. #19,***2154,INV-202504-SaaS-GL-0023,,False,False,REF-405237,First Continental Bank,***7198,Globex Retail NA LLC,US,2144368.22
2025-04-28,2025-04-28,Client Receipt - CloudBridge Co. #69,Sales Receipt,SaaS-GL,0.0,31982.28,USD,Card Settlement,CloudBridge Co. #69,***3563,INV-202504-SaaS-GL-0026,,False,False,REF-402893,First Continental Bank,***3412,Globex Retail NA LLC,US,2176350.5
2025-04-28,2025-04-28,Client Receipt - ShopSphere Partner #12,Sales Receipt,Retail-NA,0.0,48780.4,USD,Card Settlement,ShopSphere Partner #12,***2741,INV-202504-Retail-NA-0004,,False,False,REF-842248,First Continental Bank,***8685,Globex Retail NA LLC,US,2225130.9
2025-04-29,2025-04-29,Payroll - GlobalPay Services Ltd,Payroll,ALL,78742.95,0.0,USD,ACH Debit,GlobalPay Services Ltd,***6377,,,False,False,REF-225097,First Continental Bank,***7106,Globex Retail NA LLC,US,2146387.95
2025-04-29,2025-04-29,Client Receipt - CloudBridge Co. #42,Sales Receipt,SaaS-GL,0.0,854.09,USD,ACH Credit,CloudBridge Co. #42,***7432,INV-202504-SaaS-GL-0030,,False,False,REF-437394,First Continental Bank,***7116,Globex Retail NA LLC,US,2147242.04
2025-04-29,2025-04-29,Client Receipt - CloudBridge Co. #72,Sales Receipt,SaaS-GL,0.0,1370.08,USD,Card Settlement,CloudBridge Co. #72,***5319,INV-202504-SaaS-GL-0024,,False,False,REF-798316,First Continental Bank,***5657,Globex Retail NA LLC,US,2148612.12
2025-04-29,2025-04-29,Client Receipt - CloudBridge Co. #13,Sales Receipt,SaaS-GL,0.0,2871.29,USD,ACH Credit,CloudBridge Co. #13,***9048,INV-202504-SaaS-GL-0032,,False,False,REF-239852,First Continental Bank,***5743,Globex Retail NA LLC,US,2151483.41
2025-04-29,2025-04-29,Client Receipt - CloudBridge Co. #35,Sales Receipt,SaaS-GL,0.0,4039.95,USD,Card Settlement,CloudBridge Co. #35,***2561,INV-202504-SaaS-GL-0006,,False,False,REF-423400,First Continental Bank,***5980,Globex Retail NA LLC,US,2155523.36
2025-04-29,2025-04-29,Client Receipt - ShopSphere Partner #66,Sales Receipt,Retail-NA,0.0,13374.28,USD,ACH Credit,ShopSphere Partner #66,***8046,INV-202504-Retail-NA-0006,,False,False,REF-202008,First Continental Bank,***3118,Globex Retail NA LLC,US,2168897.64
2025-04-30,2025-04-30,Client Receipt - CloudBridge Co. #28,Sales Receipt,SaaS-GL,0.0,56.84,USD,Card Settlement,CloudBridge Co. #28,***3805,INV-202504-SaaS-GL-0012,,False,False,REF-633435,First Continental Bank,***9505,Globex Retail NA LLC,US,2168954.48
2025-04-30,2025-04-30,Interest Earned,Interest Income,ALL,0.0,10029.65,USD,Card Settlement,First Continental Bank,***4433,,,False,False,REF-788851,First Continental Bank,***4030,Globex Retail NA LLC,US,2178984.13
2025-05-01,2025-05-01,Account Maintenance Fee,Bank/Merchant Fees,ALL,2500.0,0.0,USD,Fedwire,First Continental Bank,***2108,,,False,False,REF-334302,First Continental Bank,***1635,Globex Retail NA LLC,US,2176484.13
2025-05-01,2025-05-01,Client Receipt - Vertex Advisory Client #45,Sales Receipt,PS-GL,0.0,5882.66,USD,Card Settlement,Vertex Advisory Client #45,***7270,INV-202505-PS-GL-0008,,False,False,REF-463882,First Continental Bank,***1400,Globex Retail NA LLC,US,2182366.79
2025-05-02,2025-05-02,Merchant Processing Fees,Bank/Merchant Fees,ALL,94.74,0.0,USD,Fedwire,First Continental Bank,***2136,,,False,False,REF-274495,First Continental Bank,***8817,Globex Retail NA LLC,US,2182272.05
2025-05-02,2025-05-02,Supplier Payment - ExpertNet Subcontractors #12,Supplier Payment,PS-GL,8812.8,0.0,USD,Fedwire,ExpertNet Subcontractors #12,***1535,,PO-202505-PS-GL-0007,False,False,REF-539576,First Continental Bank,***6199,Globex Retail NA LLC,US,2173459.25
2025-05-02,2025-05-02,Client Receipt - ShopSphere Partner #19,Sales Receipt,Retail-NA,0.0,29409.24,USD,ACH Credit,ShopSphere Partner #19,***8725,INV-202505-Retail-NA-0004,,False,False,REF-158065,First Continental Bank,***4015,Globex Retail NA LLC,US,2202868.49
2025-05-03,2025-05-03,Supplier Payment - CodeCraft Contractors #4,Supplier Payment,SaaS-GL,12541.45,0.0,USD,Fedwire,CodeCraft Contractors #4,***2803,,PO-202505-SaaS-GL-0002,False,False,REF-951218,First Continental Bank,***7938,Globex Retail NA LLC,US,2190327.04
2025-05-04,2025-05-04,Supplier Payment - NorthRiver Apparel Mfg #8,Supplier Payment,Retail-NA,38029.91,0.0,USD,ACH Debit,NorthRiver Apparel Mfg #8,***7686,,PO-202505-Retail-NA-0005,False,False,REF-301820,First Continental Bank,***6109,Globex Retail NA LLC,US,2152297.13
2025-05-04,2025-05-04,Client Receipt - CloudBridge Co. #46,Sales Receipt,SaaS-GL,0.0,4806.2,USD,ACH Credit,CloudBridge Co. #46,***6743,INV-202505-SaaS-GL-0020,,False,False,REF-589811,First Continental Bank,***8003,Globex Retail NA LLC,US,2157103.33
2025-05-04,2025-05-04,Client Receipt - Card Settlement Batch #5,Sales Receipt,Retail-NA,0.0,11495.87,USD,ACH Credit,Card Settlement Batch #5,***9725,INV-202505-Retail-NA-0018,,False,False,REF-505970,First Continental Bank,***6696,Globex Retail NA LLC,US,2168599.2
2025-05-05,2025-05-05,Supplier Payment - HyperCloud Infra #12,Supplier Payment,SaaS-GL,2313.97,0.0,USD,Fedwire,HyperCloud Infra #12,***1908,,PO-202505-SaaS-GL-0005,False,False,REF-821642,First Continental Bank,***3641,Globex Retail NA LLC,US,2166285.23
2025-05-05,2025-05-05,Supplier Payment - PackFast Fulfillment #10,Supplier Payment,Retail-NA,4649.38,0.0,USD,Fedwire,PackFast Fulfillment #10,***6844,,PO-202505-Retail-NA-0006,False,False,REF-381937,First Continental Bank,***2519,Globex Retail NA LLC,US,2161635.85
2025-05-05,2025-05-05,Supplier Payment - PackFast Fulfillment #3,Supplier Payment,Retail-NA,46086.79,0.0,USD,Fedwire,PackFast Fulfillment #3,***9426,,PO-202505-Retail-NA-0003,False,False,REF-698313,First Continental Bank,***5458,Globex Retail NA LLC,US,2115549.06
2025-05-05,2025-05-05,Client Receipt - ShopSphere Partner #11,Sales Receipt,Retail-NA,0.0,21435.59,USD,Card Settlement,ShopSphere Partner #11,***1850,INV-202505-Retail-NA-0009,,False,False,REF-746688,First Continental Bank,***4684,Globex Retail NA LLC,US,2136984.65
2025-05-05,2025-05-05,Client Receipt - ShopSphere Partner #35,Sales Receipt,Retail-NA,0.0,42425.76,USD,Card Settlement,ShopSphere Partner #35,***9446,INV-202505-Retail-NA-0011,,False,False,REF-891557,First Continental Bank,***8996,Globex Retail NA LLC,US,2179410.41
2025-05-06,2025-05-06,Supplier Payment - NorthRiver Apparel Mfg #2,Supplier Payment,Retail-NA,27272.46,0.0,USD,ACH Debit,NorthRiver Apparel Mfg #2,***1500,,PO-202505-Retail-NA-0001,False,False,REF-483361,First Continental Bank,***2658,Globex Retail NA LLC,US,2152137.95
2025-05-06,2025-05-06,Client Receipt - CloudBridge Co. #38,Sales Receipt,SaaS-GL,0.0,4219.79,USD,ACH Credit,CloudBridge Co. #38,***2023,INV-202505-SaaS-GL-0024,,False,False,REF-130564,First Continental Bank,***3293,Globex Retail NA LLC,US,2156357.74
2025-05-06,2025-05-06,Client Receipt - CloudBridge Co. #14,Sales Receipt,SaaS-GL,0.0,16906.71,USD,Card Settlement,CloudBridge Co. #14,***6791,INV-202505-SaaS-GL-0013,,False,False,REF-511069,First Continental Bank,***2220,Globex Retail NA LLC,US,2173264.45
2025-05-06,2025-05-06,Client Receipt - CloudBridge Co. #31,Sales Receipt,SaaS-GL,0.0,17599.18,USD,ACH Credit,CloudBridge Co. #31,***4992,INV-202505-SaaS-GL-0007,,False,False,REF-797183,First Continental Bank,***1875,Globex Retail NA LLC,US,2190863.63
2025-05-06,2025-05-06,Client Receipt - Vertex Advisory Client #44,Sales Receipt,PS-GL,0.0,29941.75,USD,ACH Credit,Vertex Advisory Client #44,***9713,INV-202505-PS-GL-0001,,False,False,REF-151747,First Continental Bank,***7319,Globex Retail NA LLC,US,2220805.38
2025-05-07,2025-05-07,Supplier Payment - HyperCloud Infra #15,Supplier Payment,SaaS-GL,2994.93,0.0,USD,Fedwire,HyperCloud Infra #15,***2198,,PO-202505-SaaS-GL-0008,False,False,REF-486668,First Continental Bank,***1866,Globex Retail NA LLC,US,2217810.45
2025-05-07,2025-05-07,Client Receipt - Vertex Advisory Client #57,Sales Receipt,PS-GL,0.0,34685.81,USD,ACH Credit,Vertex Advisory Client #57,***6811,INV-202505-PS-GL-0010,,False,False,REF-451141,First Continental Bank,***1540,Globex Retail NA LLC,US,2252496.26
2025-05-08,2025-05-08,Supplier Payment - ExpertNet Subcontractors #13,Supplier Payment,PS-GL,1456.13,0.0,USD,ACH Debit,ExpertNet Subcontractors #13,***5539,,PO-202505-PS-GL-0003,False,False,REF-334981,First Continental Bank,***6918,Globex Retail NA LLC,US,2251040.13
2025-05-08,2025-05-08,Client Receipt - ShopSphere Partner #16,Sales Receipt,Retail-NA,0.0,13458.18,USD,Card Settlement,ShopSphere Partner #16,***5765,INV-202505-Retail-NA-0005,,False,False,REF-146173,First Continental Bank,***2144,Globex Retail NA LLC,US,2264498.31
2025-05-09,2025-05-09,Client Receipt - CloudBridge Co. #29,Sales Receipt,SaaS-GL,0.0,32991.17,USD,Card Settlement,CloudBridge Co. #29,***2519,INV-202505-SaaS-GL-0011,,False,False,REF-340934,First Continental Bank,***2160,Globex Retail NA LLC,US,2297489.48
2025-05-11,2025-05-11,Client Receipt - CloudBridge Co. #53,Sales Receipt,SaaS-GL,0.0,21436.68,USD,ACH Credit,CloudBridge Co. #53,***3904,INV-202505-SaaS-GL-0008,,False,False,REF-835579,First Continental Bank,***8278,Globex Retail NA LLC,US,2318926.16
2025-05-12,2025-05-12,Supplier Payment - ExpertNet Subcontractors #4,Supplier Payment,PS-GL,6734.42,0.0,USD,Fedwire,ExpertNet Subcontractors #4,***9988,,PO-202505-PS-GL-0001,False,False,REF-433133,First Continental Bank,***5193,Globex Retail NA LLC,US,2312191.74
2025-05-12,2025-05-12,Supplier Payment - ExpertNet Subcontractors #3,Supplier Payment,PS-GL,12345.91,0.0,USD,Fedwire,ExpertNet Subcontractors #3,***3538,,PO-202505-PS-GL-0004,False,False,REF-544736,First Continental Bank,***7614,Globex Retail NA LLC,US,2299845.83
2025-05-12,2025-05-12,"Intercompany Settlement - Globex International Holdings, Inc.",Intercompany Transfer,ALL,456198.0,0.0,USD,Internal Transfer,"Globex International Holdings, Inc.",***6877,,,True,True,REF-588260,First Continental Bank,***4697,Globex Retail NA LLC,US,1843647.83
2025-05-12,2025-05-12,Client Receipt - ShopSphere Partner #70,Sales Receipt,Retail-NA,0.0,3404.51,USD,Card Settlement,ShopSphere Partner #70,***6945,INV-202505-Retail-NA-0013,,False,False,REF-706286,First Continental Bank,***8601,Globex Retail NA LLC,US,1847052.34
2025-05-13,2025-05-13,Supplier Payment - ExpertNet Subcontractors #1,Supplier Payment,PS-GL,8117.78,0.0,USD,Fedwire,ExpertNet Subcontractors #1,***5738,,PO-202505-PS-GL-0005,False,False,REF-193432,First Continental Bank,***1978,Globex Retail NA LLC,US,1838934.56
2025-05-13,2025-05-13,Client Receipt - CloudBridge Co. #3,Sales Receipt,SaaS-GL,0.0,14524.63,USD,Card Settlement,CloudBridge Co. #3,***6790,INV-202505-SaaS-GL-0022,,False,False,REF-403914,First Continental Bank,***7379,Globex Retail NA LLC,US,1853459.19
2025-05-13,2025-05-13,Client Receipt - Vertex Advisory Client #7,Sales Receipt,PS-GL,0.0,28862.94,USD,ACH Credit,Vertex Advisory Client #7,***1383,INV-202505-PS-GL-0009,,False,False,REF-409239,First Continental Bank,***7145,Globex Retail NA LLC,US,1882322.13
2025-05-14,2025-05-14,Supplier Payment - ExpertNet Subcontractors #17,Supplier Payment,PS-GL,11251.97,0.0,USD,Fedwire,ExpertNet Subcontractors #17,***1032,,PO-202505-PS-GL-0009,False,False,REF-490935,First Continental Bank,***1469,Globex Retail NA LLC,US,1871070.16
2025-05-14,2025-05-14,Supplier Payment - HyperCloud Infra #6,Supplier Payment,SaaS-GL,17255.1,0.0,USD,Fedwire,HyperCloud Infra #6,***6676,,PO-202505-SaaS-GL-0001,False,False,REF-685773,First Continental Bank,***4570,Globex Retail NA LLC,US,1853815.06
2025-05-14,2025-05-14,Client Receipt - CloudBridge Co. #77,Sales Receipt,SaaS-GL,0.0,2882.2,USD,ACH Credit,CloudBridge Co. #77,***9247,INV-202505-SaaS-GL-0009,,False,False,REF-314036,First Continental Bank,***2409,Globex Retail NA LLC,US,1856697.26
2025-05-14,2025-05-14,Client Receipt - ShopSphere Partner #31,Sales Receipt,Retail-NA,0.0,52974.49,USD,Card Settlement,ShopSphere Partner #31,***3924,INV-202505-Retail-NA-0002,,False,False,REF-326822,First Continental Bank,***9254,Globex Retail NA LLC,US,1909671.75
2025-05-15,2025-05-15,Supplier Payment - ExpertNet Subcontractors #9,Supplier Payment,PS-GL,3137.31,0.0,USD,ACH Debit,ExpertNet Subcontractors #9,***8127,,PO-202505-PS-GL-0010,False,False,REF-955405,First Continental Bank,***5341,Globex Retail NA LLC,US,1906534.44
2025-05-15,2025-05-15,Supplier Payment - PackFast Fulfillment #7,Supplier Payment,Retail-NA,15518.96,0.0,USD,ACH Debit,PackFast Fulfillment #7,***2483,,PO-202505-Retail-NA-0008,False,False,REF-500643,First Continental Bank,***7965,Globex Retail NA LLC,US,1891015.48
2025-05-15,2025-05-15,Client Receipt - CloudBridge Co. #76,Sales Receipt,SaaS-GL,0.0,6646.12,USD,Card Settlement,CloudBridge Co. #76,***5802,INV-202505-SaaS-GL-0002,,False,False,REF-933694,First Continental Bank,***1695,Globex Retail NA LLC,US,1897661.6
2025-05-15,2025-05-15,Client Receipt - CloudBridge Co. #51,Sales Receipt,SaaS-GL,0.0,7538.18,USD,Card Settlement,CloudBridge Co. #51,***9937,INV-202505-SaaS-GL-0016,,False,False,REF-703257,First Continental Bank,***4388,Globex Retail NA LLC,US,1905199.78
2025-05-15,2025-05-15,Client Receipt - CloudBridge Co. #68,Sales Receipt,SaaS-GL,0.0,10112.88,USD,Card Settlement,CloudBridge Co. #68,***8584,INV-202505-SaaS-GL-0017,,False,False,REF-750331,First Continental Bank,***9543,Globex Retail NA LLC,US,1915312.66
2025-05-15,2025-05-15,Client Receipt - CloudBridge Co. #40,Sales Receipt,SaaS-GL,0.0,10558.19,USD,ACH Credit,CloudBridge Co. #40,***7442,INV-202505-SaaS-GL-0014,,False,False,REF-467954,First Continental Bank,***2529,Globex Retail NA LLC,US,1925870.85
2025-05-16,2025-05-16,Supplier Payment - CodeCraft Contractors #8,Supplier Payment,SaaS-GL,84.25,0.0,USD,Fedwire,CodeCraft Contractors #8,***6864,,PO-202505-SaaS-GL-0007,False,False,REF-366980,First Continental Bank,***1125,Globex Retail NA LLC,US,1925786.6
2025-05-16,2025-05-16,Client Receipt - Card Settlement Batch #16,Sales Receipt,Retail-NA,0.0,19109.24,USD,ACH Credit,Card Settlement Batch #16,***7087,INV-202505-Retail-NA-0006,,False,False,REF-474643,First Continental Bank,***1344,Globex Retail NA LLC,US,1944895.84
2025-05-17,2025-05-17,Supplier Payment - ExpertNet Subcontractors #12,Supplier Payment,PS-GL,4812.33,0.0,USD,Fedwire,ExpertNet Subcontractors #12,***7100,,PO-202505-PS-GL-0008,False,False,REF-418256,First Continental Bank,***1634,Globex Retail NA LLC,US,1940083.51
2025-05-17,2025-05-17,Supplier Payment - NorthRiver Apparel Mfg #32,Supplier Payment,Retail-NA,50658.39,0.0,USD,ACH Debit,NorthRiver Apparel Mfg #32,***4202,,PO-202505-Retail-NA-0002,False,False,REF-856539,First Continental Bank,***8658,Globex Retail NA LLC,US,1889425.12
2025-05-18,2025-05-18,Merchant Processing Fees,Bank/Merchant Fees,ALL,2877.98,0.0,USD,Fedwire,First Continental Bank,***7602,,,False,False,REF-511083,First Continental Bank,***4150,Globex Retail NA LLC,US,1886547.14
2025-05-18,2025-05-18,Client Receipt - ShopSphere Partner #64,Sales Receipt,Retail-NA,0.0,12045.52,USD,Card Settlement,ShopSphere Partner #64,***5988,INV-202505-Retail-NA-0008,,False,False,REF-152985,First Continental Bank,***4577,Globex Retail NA LLC,US,1898592.66
2025-05-19,2025-05-19,Supplier Payment - HyperCloud Infra #15,Supplier Payment,SaaS-GL,3350.75,0.0,USD,Fedwire,HyperCloud Infra #15,***9884,,PO-202505-SaaS-GL-0003,False,False,REF-233205,First Continental Bank,***7769,Globex Retail NA LLC,US,1895241.91
2025-05-19,2025-05-19,Marketing - Beacon Digital #6,Marketing,ALL,5515.41,0.0,USD,Fedwire,Beacon Digital #6,***5202,,,False,False,REF-696946,First Continental Bank,***6074,Globex Retail NA LLC,US,1889726.5
2025-05-19,2025-05-19,Client Receipt - CloudBridge Co. #23,Sales Receipt,SaaS-GL,0.0,2933.99,USD,Card Settlement,CloudBridge Co. #23,***3099,INV-202505-SaaS-GL-0015,,False,False,REF-354045,First Continental Bank,***4202,Globex Retail NA LLC,US,1892660.49
2025-05-19,2025-05-19,Client Receipt - ShopSphere Partner #56,Sales Receipt,Retail-NA,0.0,17961.91,USD,ACH Credit,ShopSphere Partner #56,***6088,INV-202505-Retail-NA-0012,,False,False,REF-475471,First Continental Bank,***6510,Globex Retail NA LLC,US,1910622.4
2025-05-20,2025-05-20,Supplier Payment - ExpertNet Subcontractors #15,Supplier Payment,PS-GL,5222.02,0.0,USD,ACH Debit,ExpertNet Subcontractors #15,***2729,,PO-202505-PS-GL-0006,False,False,REF-946164,First Continental Bank,***3132,Globex Retail NA LLC,US,1905400.38
2025-05-20,2025-05-20,Supplier Payment - PackFast Fulfillment #17,Supplier Payment,Retail-NA,40467.39,0.0,USD,Fedwire,PackFast Fulfillment #17,***5934,,PO-202505-Retail-NA-0004,False,False,REF-529239,First Continental Bank,***9114,Globex Retail NA LLC,US,1864932.99
2025-05-21,2025-05-21,Marketing - Beacon Digital #1,Marketing,ALL,19562.93,0.0,USD,Fedwire,Beacon Digital #1,***3791,,,False,False,REF-506761,First Continental Bank,***7430,Globex Retail NA LLC,US,1845370.06
2025-05-21,2025-05-21,VAT/GST Remittance - US IRS,Tax Payment,ALL,62460.18,0.0,USD,ACH Debit,US IRS,***6519,,,False,False,REF-240314,First Continental Bank,***7694,Globex Retail NA LLC,US,1782909.88
2025-05-21,2025-05-21,Client Receipt - CloudBridge Co. #27,Sales Receipt,SaaS-GL,0.0,3391.11,USD,ACH Credit,CloudBridge Co. #27,***8352,INV-202505-SaaS-GL-0005,,False,False,REF-364072,First Continental Bank,***4499,Globex Retail NA LLC,US,1786300.99
2025-05-21,2025-05-21,Client Receipt - CloudBridge Co. #38,Sales Receipt,SaaS-GL,0.0,7113.23,USD,Card Settlement,CloudBridge Co. #38,***9192,INV-202505-SaaS-GL-0003,,False,False,REF-453117,First Continental Bank,***9715,Globex Retail NA LLC,US,1793414.22
2025-05-21,2025-05-21,Client Receipt - CloudBridge Co. #43,Sales Receipt,SaaS-GL,0.0,26262.94,USD,Card Settlement,CloudBridge Co. #43,***4982,INV-202505-SaaS-GL-0018,,False,False,REF-647194,First Continental Bank,***5513,Globex Retail NA LLC,US,1819677.16
2025-05-21,2025-05-21,Client Receipt - ShopSphere Partner #22,Sales Receipt,Retail-NA,0.0,50127.16,USD,ACH Credit,ShopSphere Partner #22,***9635,INV-202505-Retail-NA-0001,,False,False,REF-541731,First Continental Bank,***5717,Globex Retail NA LLC,US,1869804.32
2025-05-21,2025-05-21,Client Receipt - Vertex Advisory Client #16,Sales Receipt,PS-GL,0.0,68137.01,USD,Card Settlement,Vertex Advisory Client #16,***1358,INV-202505-PS-GL-0005,,False,False,REF-676562,First Continental Bank,***2715,Globex Retail NA LLC,US,1937941.33
2025-05-22,2025-05-22,Client Receipt - Vertex Advisory Client #14,Sales Receipt,PS-GL,0.0,625.23,USD,Card Settlement,Vertex Advisory Client #14,***1178,INV-202505-PS-GL-0006,,False,False,REF-730734,First Continental Bank,***2437,Globex Retail NA LLC,US,1938566.56
2025-05-22,2025-05-22,Client Receipt - CloudBridge Co. #3,Sales Receipt,SaaS-GL,0.0,20678.24,USD,ACH Credit,CloudBridge Co. #3,***5148,INV-202505-SaaS-GL-0004,,False,False,REF-752400,First Continental Bank,***3702,Globex Retail NA LLC,US,1959244.8
2025-05-22,2025-05-22,Client Receipt - ShopSphere Partner #74,Sales Receipt,Retail-NA,0.0,35046.18,USD,ACH Credit,ShopSphere Partner #74,***8268,INV-202505-Retail-NA-0016,,False,False,REF-263098,First Continental Bank,***8306,Globex Retail NA LLC,US,1994290.98
2025-05-23,2025-05-23,Client Receipt - Vertex Advisory Client #10,Sales Receipt,PS-GL,0.0,6785.65,USD,Card Settlement,Vertex Advisory Client #10,***4196,INV-202505-PS-GL-0007,,False,False,REF-725626,First Continental Bank,***7922,Globex Retail NA LLC,US,2001076.63
2025-05-23,2025-05-23,Client Receipt - ShopSphere Partner #13,Sales Receipt,Retail-NA,0.0,24854.78,USD,Card Settlement,ShopSphere Partner #13,***7618,INV-202505-Retail-NA-0017,,False,False,REF-974437,First Continental Bank,***7644,Globex Retail NA LLC,US,2025931.41
2025-05-23,2025-05-23,Client Receipt - ShopSphere Partner #17,Sales Receipt,Retail-NA,0.0,31304.58,USD,Card Settlement,ShopSphere Partner #17,***9152,INV-202505-Retail-NA-0010,,False,False,REF-253122,First Continental Bank,***8378,Globex Retail NA LLC,US,2057235.99
2025-05-25,2025-05-25,BluePeak Property Mgmt,Rent & Utilities,ALL,2191.17,0.0,USD,Fedwire,BluePeak Property Mgmt,***3710,,,False,False,REF-103935,First Continental Bank,***2949,Globex Retail NA LLC,US,2055044.82
2025-05-25,2025-05-25,Supplier Payment - ExpertNet Subcontractors #16,Supplier Payment,PS-GL,4517.99,0.0,USD,Fedwire,ExpertNet Subcontractors #16,***5800,,PO-202505-PS-GL-0002,False,False,REF-929844,First Continental Bank,***8125,Globex Retail NA LLC,US,2050526.83
2025-05-25,2025-05-25,Payroll - GlobalPay Services Ltd,Payroll,ALL,81259.09,0.0,USD,ACH Debit,GlobalPay Services Ltd,***4441,,,False,False,REF-462634,First Continental Bank,***3729,Globex Retail NA LLC,US,1969267.74
2025-05-26,2025-05-26,Marketing - Beacon Digital #4,Marketing,ALL,686.84,0.0,USD,Fedwire,Beacon Digital #4,***3781,,,False,False,REF-365747,First Continental Bank,***5161,Globex Retail NA LLC,US,1968580.9
2025-05-26,2025-05-26,Supplier Payment - CodeCraft Contractors #5,Supplier Payment,SaaS-GL,32674.58,0.0,USD,Fedwire,CodeCraft Contractors #5,***7965,,PO-202505-SaaS-GL-0006,False,False,REF-498157,First Continental Bank,***7691,Globex Retail NA LLC,US,1935906.32
2025-05-26,2025-05-26,Payroll - GlobalPay Services Ltd,Payroll,ALL,81259.09,0.0,USD,ACH Debit,GlobalPay Services Ltd,***6506,,,False,False,REF-166892,First Continental Bank,***9246,Globex Retail NA LLC,US,1854647.23
2025-05-26,2025-05-26,"Intercompany Settlement - Globex International Holdings, Inc.",Intercompany Transfer,ALL,259942.0,0.0,USD,Internal Transfer,"Globex International Holdings, Inc.",***5531,,,True,True,REF-165389,First Continental Bank,***2815,Globex Retail NA LLC,US,1594705.23
2025-05-26,2025-05-26,Client Receipt - ShopSphere Partner #12,Sales Receipt,Retail-NA,0.0,484.1,USD,ACH Credit,ShopSphere Partner #12,***8848,INV-202505-Retail-NA-0003,,False,False,REF-528271,First Continental Bank,***6627,Globex Retail NA LLC,US,1595189.33
2025-05-26,2025-05-26,Client Receipt - CloudBridge Co. #36,Sales Receipt,SaaS-GL,0.0,2868.1,USD,Card Settlement,CloudBridge Co. #36,***1700,INV-202505-SaaS-GL-0019,,False,False,REF-498593,First Continental Bank,***3878,Globex Retail NA LLC,US,1598057.43
2025-05-26,2025-05-26,Client Receipt - CloudBridge Co. #12,Sales Receipt,SaaS-GL,0.0,9259.68,USD,Card Settlement,CloudBridge Co. #12,***3727,INV-202505-SaaS-GL-0006,,False,False,REF-651049,First Continental Bank,***6682,Globex Retail NA LLC,US,1607317.11
2025-05-27,2025-05-27,Client Receipt - CloudBridge Co. #13,Sales Receipt,SaaS-GL,0.0,2998.22,USD,Card Settlement,CloudBridge Co. #13,***2035,INV-202505-SaaS-GL-0023,,False,False,REF-606999,First Continental Bank,***9011,Globex Retail NA LLC,US,1610315.33
2025-05-27,2025-05-27,Client Receipt - ShopSphere Partner #6,Sales Receipt,Retail-NA,0.0,26646.22,USD,ACH Credit,ShopSphere Partner #6,***4644,INV-202505-Retail-NA-0015,,False,False,REF-231297,First Continental Bank,***5920,Globex Retail NA LLC,US,1636961.55
2025-05-28,2025-05-28,Metro Water & Waste,Rent & Utilities,ALL,6000.01,0.0,USD,Fedwire,Metro Water & Waste,***3348,,,False,False,REF-931339,First Continental Bank,***7817,Globex Retail NA LLC,US,1630961.54
2025-05-28,2025-05-28,Client Receipt - CloudBridge Co. #41,Sales Receipt,SaaS-GL,0.0,5978.51,USD,Card Settlement,CloudBridge Co. #41,***7149,INV-202505-SaaS-GL-0001,,False,False,REF-635386,First Continental Bank,***1034,Globex Retail NA LLC,US,1636940.05
2025-05-28,2025-05-28,Client Receipt - Vertex Advisory Client #34,Sales Receipt,PS-GL,0.0,8089.25,USD,ACH Credit,Vertex Advisory Client #34,***5119,INV-202505-PS-GL-0003,,False,False,REF-200740,First Continental Bank,***2461,Globex Retail NA LLC,US,1645029.3
2025-05-28,2025-05-28,Client Receipt - CloudBridge Co. #73,Sales Receipt,SaaS-GL,0.0,16426.53,USD,ACH Credit,CloudBridge Co. #73,***2382,INV-202505-SaaS-GL-0021,,False,False,REF-515728,First Continental Bank,***3719,Globex Retail NA LLC,US,1661455.83
2025-05-28,2025-05-28,Client Receipt - CloudBridge Co. #62,Sales Receipt,SaaS-GL,0.0,22737.93,USD,Card Settlement,CloudBridge Co. #62,***8581,INV-202505-SaaS-GL-0010,,False,False,REF-689397,First Continental Bank,***6795,Globex Retail NA LLC,US,1684193.76
2025-05-29,2025-05-29,Supplier Payment - ExpertNet Subcontractors #19,Supplier Payment,PS-GL,4510.66,0.0,USD,ACH Debit,ExpertNet Subcontractors #19,***5581,,PO-202505-PS-GL-0011,False,False,REF-668872,First Continental Bank,***4070,Globex Retail NA LLC,US,1679683.1
2025-05-29,2025-05-29,Client Receipt - ShopSphere Partner #69,Sales Receipt,Retail-NA,0.0,35093.52,USD,ACH Credit,ShopSphere Partner #69,***3511,INV-202505-Retail-NA-0007,,False,False,REF-664404,First Continental Bank,***6056,Globex Retail NA LLC,US,1714776.62
2025-05-30,2025-05-30,Supplier Payment - CodeCraft Contractors #8,Supplier Payment,SaaS-GL,6796.23,0.0,USD,Fedwire,CodeCraft Contractors #8,***7915,,PO-202505-SaaS-GL-0004,False,False,REF-290944,First Continental Bank,***4628,Globex Retail NA LLC,US,1707980.39
2025-05-30,2025-05-30,Supplier Payment - NorthRiver Apparel Mfg #22,Supplier Payment,Retail-NA,15684.45,0.0,USD,ACH Debit,NorthRiver Apparel Mfg #22,***6554,,PO-202505-Retail-NA-0007,False,False,REF-695298,First Continental Bank,***5635,Globex Retail NA LLC,US,1692295.94
2025-05-30,2025-05-30,Client Receipt - Vertex Advisory Client #11,Sales Receipt,PS-GL,0.0,5495.16,USD,ACH Credit,Vertex Advisory Client #11,***1089,INV-202505-PS-GL-0002,,False,False,REF-369351,First Continental Bank,***9489,Globex Retail NA LLC,US,1697791.1
2025-05-30,2025-05-30,Client Receipt - ShopSphere Partner #54,Sales Receipt,Retail-NA,0.0,6119.02,USD,Card Settlement,ShopSphere Partner #54,***6180,INV-202505-Retail-NA-0014,,False,False,REF-745316,First Continental Bank,***7599,Globex Retail NA LLC,US,1703910.12
2025-05-30,2025-05-30,Interest Earned,Interest Income,ALL,0.0,10136.22,USD,ACH Credit,First Continental Bank,***7432,,,False,False,REF-432164,First Continental Bank,***6641,Globex Retail NA LLC,US,1714046.34
2025-05-30,2025-05-30,Client Receipt - CloudBridge Co. #76,Sales Receipt,SaaS-GL,0.0,83726.21,USD,Card Settlement,CloudBridge Co. #76,***5077,INV-202505-SaaS-GL-0012,,False,False,REF-280716,First Continental Bank,***9998,Globex Retail NA LLC,US,1797772.55
2025-05-31,2025-05-31,Client Receipt - Vertex Advisory Client #18,Sales Receipt,PS-GL,0.0,47892.29,USD,ACH Credit,Vertex Advisory Client #18,***8360,INV-202505-PS-GL-0004,,False,False,REF-345311,First Continental Bank,***5397,Globex Retail NA LLC,US,1845664.84
2025-06-01,2025-06-01,Account Maintenance Fee,Bank/Merchant Fees,ALL,2500.0,0.0,USD,ACH Debit,First Continental Bank,***4283,,,False,False,REF-238152,First Continental Bank,***1208,Globex Retail NA LLC,US,1843164.84
2025-06-01,2025-06-01,Client Receipt - CloudBridge Co. #72,Sales Receipt,SaaS-GL,0.0,4896.67,USD,ACH Credit,CloudBridge Co. #72,***2405,INV-202506-SaaS-GL-0018,,False,False,REF-160969,First Continental Bank,***8976,Globex Retail NA LLC,US,1848061.51
2025-06-02,2025-06-02,Client Receipt - CloudBridge Co. #21,Sales Receipt,SaaS-GL,0.0,476.69,USD,Card Settlement,CloudBridge Co. #21,***2425,INV-202506-SaaS-GL-0022,,False,False,REF-562725,First Continental Bank,***9656,Globex Retail NA LLC,US,1848538.2
2025-06-02,2025-06-02,Client Receipt - CloudBridge Co. #38,Sales Receipt,SaaS-GL,0.0,56346.43,USD,Card Settlement,CloudBridge Co. #38,***2685,INV-202506-SaaS-GL-0007,,False,False,REF-286399,First Continental Bank,***2123,Globex Retail NA LLC,US,1904884.63
2025-06-03,2025-06-03,Supplier Payment - HyperCloud Infra #11,Supplier Payment,SaaS-GL,6277.45,0.0,USD,Fedwire,HyperCloud Infra #11,***2823,,PO-202506-SaaS-GL-0003,False,False,REF-493811,First Continental Bank,***9295,Globex Retail NA LLC,US,1898607.18
2025-06-03,2025-06-03,Client Receipt - CloudBridge Co. #10,Sales Receipt,SaaS-GL,0.0,2460.05,USD,ACH Credit,CloudBridge Co. #10,***2816,INV-202506-SaaS-GL-0012,,False,False,REF-438720,First Continental Bank,***5453,Globex Retail NA LLC,US,1901067.23
2025-06-03,2025-06-03,Client Receipt - ShopSphere Partner #38,Sales Receipt,Retail-NA,0.0,3985.4,USD,ACH Credit,ShopSphere Partner #38,***7608,INV-202506-Retail-NA-0010,,False,False,REF-347440,First Continental Bank,***5607,Globex Retail NA LLC,US,1905052.63
2025-06-03,2025-06-03,Client Receipt - ShopSphere Partner #60,Sales Receipt,Retail-NA,0.0,12983.07,USD,ACH Credit,ShopSphere Partner #60,***9109,INV-202506-Retail-NA-0011,,False,False,REF-433698,First Continental Bank,***5306,Globex Retail NA LLC,US,1918035.7
2025-06-03,2025-06-03,Client Receipt - CloudBridge Co. #44,Sales Receipt,SaaS-GL,0.0,23235.51,USD,Card Settlement,CloudBridge Co. #44,***4876,INV-202506-SaaS-GL-0019,,False,False,REF-707224,First Continental Bank,***9398,Globex Retail NA LLC,US,1941271.21
2025-06-03,2025-06-03,Client Receipt - CloudBridge Co. #10,Sales Receipt,SaaS-GL,0.0,23283.56,USD,Card Settlement,CloudBridge Co. #10,***3830,INV-202506-SaaS-GL-0014,,False,False,REF-644632,First Continental Bank,***3102,Globex Retail NA LLC,US,1964554.77
2025-06-03,2025-06-03,Client Receipt - ShopSphere Partner #4,Sales Receipt,Retail-NA,0.0,34438.75,USD,ACH Credit,ShopSphere Partner #4,***6768,INV-202506-Retail-NA-0013,,False,False,REF-866167,First Continental Bank,***5461,Globex Retail NA LLC,US,1998993.52
2025-06-04,2025-06-04,Supplier Payment - ExpertNet Subcontractors #2,Supplier Payment,PS-GL,12898.63,0.0,USD,Fedwire,ExpertNet Subcontractors #2,***4845,,PO-202506-PS-GL-0005,False,False,REF-662596,First Continental Bank,***2423,Globex Retail NA LLC,US,1986094.89
2025-06-04,2025-06-04,Marketing - Beacon Digital #3,Marketing,ALL,16088.76,0.0,USD,ACH Debit,Beacon Digital #3,***9980,,,False,False,REF-556526,First Continental Bank,***6367,Globex Retail NA LLC,US,1970006.13
2025-06-04,2025-06-04,Client Receipt - CloudBridge Co. #5,Sales Receipt,SaaS-GL,0.0,11043.59,USD,Card Settlement,CloudBridge Co. #5,***7430,INV-202506-SaaS-GL-0009,,False,False,REF-986681,First Continental Bank,***1444,Globex Retail NA LLC,US,1981049.72
2025-06-04,2025-06-04,Client Receipt - Vertex Advisory Client #45,Sales Receipt,PS-GL,0.0,58874.2,USD,Card Settlement,Vertex Advisory Client #45,***7511,INV-202506-PS-GL-0008,,False,False,REF-134174,First Continental Bank,***4707,Globex Retail NA LLC,US,2039923.92
2025-06-05,2025-06-05,Client Receipt - ShopSphere Partner #56,Sales Receipt,Retail-NA,0.0,7708.85,USD,Card Settlement,ShopSphere Partner #56,***8835,INV-202506-Retail-NA-0004,,False,False,REF-269450,First Continental Bank,***7084,Globex Retail NA LLC,US,2047632.77
2025-06-05,2025-06-05,Client Receipt - Card Settlement Batch #4,Sales Receipt,Retail-NA,0.0,11140.38,USD,Card Settlement,Card Settlement Batch #4,***1268,INV-202506-Retail-NA-0003,,False,False,REF-285507,First Continental Bank,***5875,Globex Retail NA LLC,US,2058773.15
2025-06-05,2025-06-05,Client Receipt - Vertex Advisory Client #51,Sales Receipt,PS-GL,0.0,21494.94,USD,Card Settlement,Vertex Advisory Client #51,***4300,INV-202506-PS-GL-0006,,False,False,REF-824024,First Continental Bank,***6028,Globex Retail NA LLC,US,2080268.09
2025-06-05,2025-06-05,Client Receipt - Vertex Advisory Client #5,Sales Receipt,PS-GL,0.0,45473.65,USD,Card Settlement,Vertex Advisory Client #5,***1863,INV-202506-PS-GL-0009,,False,False,REF-866155,First Continental Bank,***1409,Globex Retail NA LLC,US,2125741.74
2025-06-06,2025-06-06,Supplier Payment - PackFast Fulfillment #2,Supplier Payment,Retail-NA,36358.98,0.0,USD,ACH Debit,PackFast Fulfillment #2,***3649,,PO-202506-Retail-NA-0006,False,False,REF-535311,First Continental Bank,***7816,Globex Retail NA LLC,US,2089382.76
2025-06-06,2025-06-06,Client Receipt - CloudBridge Co. #52,Sales Receipt,SaaS-GL,0.0,2296.68,USD,Card Settlement,CloudBridge Co. #52,***9501,INV-202506-SaaS-GL-0001,,False,False,REF-203089,First Continental Bank,***1092,Globex Retail NA LLC,US,2091679.44
2025-06-06,2025-06-06,Client Receipt - CloudBridge Co. #48,Sales Receipt,SaaS-GL,0.0,18218.73,USD,ACH Credit,CloudBridge Co. #48,***7180,INV-202506-SaaS-GL-0011,,False,False,REF-141979,First Continental Bank,***2735,Globex Retail NA LLC,US,2109898.17
2025-06-06,2025-06-06,Client Receipt - Card Settlement Batch #15,Sales Receipt,Retail-NA,0.0,68705.09,USD,Card Settlement,Card Settlement Batch #15,***9101,INV-202506-Retail-NA-0014,,False,False,REF-390578,First Continental Bank,***7966,Globex Retail NA LLC,US,2178603.26
2025-06-06,2025-06-06,Client Receipt - ShopSphere Partner #3,Sales Receipt,Retail-NA,0.0,83427.17,USD,ACH Credit,ShopSphere Partner #3,***9764,INV-202506-Retail-NA-0001,,False,False,REF-448551,First Continental Bank,***3462,Globex Retail NA LLC,US,2262030.43
2025-06-08,2025-06-08,Client Receipt - Card Settlement Batch #16,Sales Receipt,Retail-NA,0.0,16323.23,USD,ACH Credit,Card Settlement Batch #16,***6356,INV-202506-Retail-NA-0008,,False,False,REF-677908,First Continental Bank,***4659,Globex Retail NA LLC,US,2278353.66
2025-06-09,2025-06-09,Supplier Payment - PackFast Fulfillment #16,Supplier Payment,Retail-NA,11189.41,0.0,USD,ACH Debit,PackFast Fulfillment #16,***4248,,PO-202506-Retail-NA-0011,False,False,REF-907592,First Continental Bank,***1895,Globex Retail NA LLC,US,2267164.25
2025-06-09,2025-06-09,Client Receipt - CloudBridge Co. #10,Sales Receipt,SaaS-GL,0.0,1267.89,USD,Card Settlement,CloudBridge Co. #10,***5756,INV-202506-SaaS-GL-0003,,False,False,REF-140089,First Continental Bank,***2177,Globex Retail NA LLC,US,2268432.14
2025-06-10,2025-06-10,Supplier Payment - ExpertNet Subcontractors #15,Supplier Payment,PS-GL,2215.04,0.0,USD,Fedwire,ExpertNet Subcontractors #15,***2684,,PO-202506-PS-GL-0002,False,False,REF-785457,First Continental Bank,***4629,Globex Retail NA LLC,US,2266217.1
2025-06-10,2025-06-10,Supplier Payment - ExpertNet Subcontractors #4,Supplier Payment,PS-GL,5285.64,0.0,USD,Fedwire,ExpertNet Subcontractors #4,***3063,,PO-202506-PS-GL-0006,False,False,REF-317992,First Continental Bank,***8326,Globex Retail NA LLC,US,2260931.46
2025-06-10,2025-06-10,Supplier Payment - CodeCraft Contractors #9,Supplier Payment,SaaS-GL,13069.95,0.0,USD,Fedwire,CodeCraft Contractors #9,***5462,,PO-202506-SaaS-GL-0006,False,False,REF-176792,First Continental Bank,***7073,Globex Retail NA LLC,US,2247861.51
2025-06-10,2025-06-10,Supplier Payment - HyperCloud Infra #7,Supplier Payment,SaaS-GL,13889.83,0.0,USD,ACH Debit,HyperCloud Infra #7,***7407,,PO-202506-SaaS-GL-0009,False,False,REF-900850,First Continental Bank,***7688,Globex Retail NA LLC,US,2233971.68
2025-06-10,2025-06-10,Client Receipt - CloudBridge Co. #61,Sales Receipt,SaaS-GL,0.0,48774.47,USD,ACH Credit,CloudBridge Co. #61,***1848,INV-202506-SaaS-GL-0005,,False,False,REF-511256,First Continental Bank,***3217,Globex Retail NA LLC,US,2282746.15
2025-06-11,2025-06-11,Merchant Processing Fees,Bank/Merchant Fees,ALL,1959.21,0.0,USD,ACH Debit,First Continental Bank,***5254,,,False,False,REF-677575,First Continental Bank,***7804,Globex Retail NA LLC,US,2280786.94
2025-06-11,2025-06-11,Client Receipt - ShopSphere Partner #62,Sales Receipt,Retail-NA,0.0,2411.38,USD,ACH Credit,ShopSphere Partner #62,***4008,INV-202506-Retail-NA-0005,,False,False,REF-351207,First Continental Bank,***1182,Globex Retail NA LLC,US,2283198.32
2025-06-11,2025-06-11,Client Receipt - CloudBridge Co. #24,Sales Receipt,SaaS-GL,0.0,2535.4,USD,ACH Credit,CloudBridge Co. #24,***4774,INV-202506-SaaS-GL-0016,,False,False,REF-460254,First Continental Bank,***5570,Globex Retail NA LLC,US,2285733.72
2025-06-11,2025-06-11,Client Receipt - ShopSphere Partner #1,Sales Receipt,Retail-NA,0.0,17534.81,USD,Card Settlement,ShopSphere Partner #1,***9902,INV-202506-Retail-NA-0006,,False,False,REF-373693,First Continental Bank,***9847,Globex Retail NA LLC,US,2303268.53
2025-06-11,2025-06-11,Client Receipt - ShopSphere Partner #20,Sales Receipt,Retail-NA,0.0,28532.97,USD,ACH Credit,ShopSphere Partner #20,***3002,INV-202506-Retail-NA-0017,,False,False,REF-376906,First Continental Bank,***5856,Globex Retail NA LLC,US,2331801.5
2025-06-12,2025-06-12,Marketing - Aurelia Media #2,Marketing,ALL,731.42,0.0,USD,ACH Debit,Aurelia Media #2,***1894,,,False,False,REF-523518,First Continental Bank,***9967,Globex Retail NA LLC,US,2331070.08
2025-06-12,2025-06-12,Intercompany Settlement - Globex EMEA Manufacturing Ltd.,Intercompany Transfer,ALL,227727.0,0.0,USD,Internal Transfer,Globex EMEA Manufacturing Ltd.,***5572,,,True,True,REF-992544,First Continental Bank,***7026,Globex Retail NA LLC,US,2103343.08
2025-06-13,2025-06-13,Supplier Payment - CodeCraft Contractors #10,Supplier Payment,SaaS-GL,6181.98,0.0,USD,ACH Debit,CodeCraft Contractors #10,***7735,,PO-202506-SaaS-GL-0005,False,False,REF-503982,First Continental Bank,***2567,Globex Retail NA LLC,US,2097161.1
2025-06-13,2025-06-13,Supplier Payment - NorthRiver Apparel Mfg #25,Supplier Payment,Retail-NA,11152.67,0.0,USD,ACH Debit,NorthRiver Apparel Mfg #25,***5094,,PO-202506-Retail-NA-0002,False,False,REF-167014,First Continental Bank,***4104,Globex Retail NA LLC,US,2086008.43
2025-06-13,2025-06-13,Client Receipt - Vertex Advisory Client #3,Sales Receipt,PS-GL,0.0,21739.15,USD,Card Settlement,Vertex Advisory Client #3,***9111,INV-202506-PS-GL-0005,,False,False,REF-768192,First Continental Bank,***2156,Globex Retail NA LLC,US,2107747.58
2025-06-14,2025-06-14,Supplier Payment - ExpertNet Subcontractors #1,Supplier Payment,PS-GL,5462.42,0.0,USD,Fedwire,ExpertNet Subcontractors #1,***7209,,PO-202506-PS-GL-0011,False,False,REF-364134,First Continental Bank,***4673,Globex Retail NA LLC,US,2102285.16
2025-06-15,2025-06-15,Client Receipt - Vertex Advisory Client #22,Sales Receipt,PS-GL,0.0,22725.83,USD,Card Settlement,Vertex Advisory Client #22,***8228,INV-202506-PS-GL-0001,,False,False,REF-337827,First Continental Bank,***2293,Globex Retail NA LLC,US,2125010.99
2025-06-16,2025-06-16,Supplier Payment - ExpertNet Subcontractors #1,Supplier Payment,PS-GL,2209.71,0.0,USD,Fedwire,ExpertNet Subcontractors #1,***8506,,PO-202506-PS-GL-0010,False,False,REF-562671,First Continental Bank,***8560,Globex Retail NA LLC,US,2122801.28
2025-06-16,2025-06-16,Supplier Payment - ExpertNet Subcontractors #2,Supplier Payment,PS-GL,3820.5,0.0,USD,Fedwire,ExpertNet Subcontractors #2,***4769,,PO-202506-PS-GL-0004,False,False,REF-413172,First Continental Bank,***9558,Globex Retail NA LLC,US,2118980.78
2025-06-16,2025-06-16,Marketing - Beacon Digital #3,Marketing,ALL,8827.51,0.0,USD,ACH Debit,Beacon Digital #3,***9162,,,False,False,REF-882766,First Continental Bank,***7818,Globex Retail NA LLC,US,2110153.27
2025-06-16,2025-06-16,Supplier Payment - PackFast Fulfillment #19,Supplier Payment,Retail-NA,32387.07,0.0,USD,ACH Debit,PackFast Fulfillment #19,***8623,,PO-202506-Retail-NA-0005,False,False,REF-903512,First Continental Bank,***5627,Globex Retail NA LLC,US,2077766.2
2025-06-16,2025-06-16,Supplier Payment - NorthRiver Apparel Mfg #11,Supplier Payment,Retail-NA,54607.72,0.0,USD,Fedwire,NorthRiver Apparel Mfg #11,***2487,,PO-202506-Retail-NA-0003,False,False,REF-630051,First Continental Bank,***6567,Globex Retail NA LLC,US,2023158.48
2025-06-16,2025-06-16,Client Receipt - ShopSphere Partner #49,Sales Receipt,Retail-NA,0.0,14755.04,USD,ACH Credit,ShopSphere Partner #49,***4468,INV-202506-Retail-NA-0016,,False,False,REF-456143,First Continental Bank,***8185,Globex Retail NA LLC,US,2037913.52
2025-06-17,2025-06-17,Supplier Payment - PackFast Fulfillment #4,Supplier Payment,Retail-NA,3530.05,0.0,USD,Fedwire,PackFast Fulfillment #4,***6761,,PO-202506-Retail-NA-0007,False,False,REF-899947,First Continental Bank,***7684,Globex Retail NA LLC,US,2034383.47
2025-06-17,2025-06-17,Supplier Payment - NorthRiver Apparel Mfg #22,Supplier Payment,Retail-NA,36138.53,0.0,USD,ACH Debit,NorthRiver Apparel Mfg #22,***7562,,PO-202506-Retail-NA-0004,False,False,REF-990110,First Continental Bank,***4724,Globex Retail NA LLC,US,1998244.94
2025-06-17,2025-06-17,Client Receipt - CloudBridge Co. #43,Sales Receipt,SaaS-GL,0.0,17601.0,USD,ACH Credit,CloudBridge Co. #43,***2495,INV-202506-SaaS-GL-0004,,False,False,REF-193132,First Continental Bank,***8109,Globex Retail NA LLC,US,2015845.94
2025-06-17,2025-06-17,Client Receipt - Vertex Advisory Client #45,Sales Receipt,PS-GL,0.0,34202.44,USD,ACH Credit,Vertex Advisory Client #45,***3103,INV-202506-PS-GL-0007,,False,False,REF-235438,First Continental Bank,***4460,Globex Retail NA LLC,US,2050048.38
2025-06-18,2025-06-18,Supplier Payment - PackFast Fulfillment #18,Supplier Payment,Retail-NA,992.26,0.0,USD,Fedwire,PackFast Fulfillment #18,***8651,,PO-202506-Retail-NA-0001,False,False,REF-890576,First Continental Bank,***5876,Globex Retail NA LLC,US,2049056.12
2025-06-18,2025-06-18,Supplier Payment - HyperCloud Infra #3,Supplier Payment,SaaS-GL,9350.34,0.0,USD,ACH Debit,HyperCloud Infra #3,***1250,,PO-202506-SaaS-GL-0010,False,False,REF-836856,First Continental Bank,***8202,Globex Retail NA LLC,US,2039705.78
2025-06-18,2025-06-18,Supplier Payment - NorthRiver Apparel Mfg #24,Supplier Payment,Retail-NA,13113.4,0.0,USD,ACH Debit,NorthRiver Apparel Mfg #24,***7073,,PO-202506-Retail-NA-0008,False,False,REF-589005,First Continental Bank,***4189,Globex Retail NA LLC,US,2026592.38
2025-06-18,2025-06-18,Client Receipt - ShopSphere Partner #11,Sales Receipt,Retail-NA,0.0,14129.13,USD,Card Settlement,ShopSphere Partner #11,***8711,INV-202506-Retail-NA-0012,,False,False,REF-621371,First Continental Bank,***5809,Globex Retail NA LLC,US,2040721.51
2025-06-18,2025-06-18,Client Receipt - CloudBridge Co. #28,Sales Receipt,SaaS-GL,0.0,30685.18,USD,Card Settlement,CloudBridge Co. #28,***4265,INV-202506-SaaS-GL-0006,,False,False,REF-294854,First Continental Bank,***7124,Globex Retail NA LLC,US,2071406.69
2025-06-18,2025-06-18,Client Receipt - ShopSphere Partner #78,Sales Receipt,Retail-NA,0.0,44656.17,USD,ACH Credit,ShopSphere Partner #78,***9935,INV-202506-Retail-NA-0015,,False,False,REF-537533,First Continental Bank,***8809,Globex Retail NA LLC,US,2116062.86
2025-06-20,2025-06-20,Supplier Payment - HyperCloud Infra #8,Supplier Payment,SaaS-GL,1812.82,0.0,USD,ACH Debit,HyperCloud Infra #8,***2518,,PO-202506-SaaS-GL-0002,False,False,REF-999113,First Continental Bank,***2844,Globex Retail NA LLC,US,2114250.04
2025-06-20,2025-06-20,Supplier Payment - CodeCraft Contractors #8,Supplier Payment,SaaS-GL,3041.4,0.0,USD,ACH Debit,CodeCraft Contractors #8,***4707,,PO-202506-SaaS-GL-0011,False,False,REF-890482,First Continental Bank,***7078,Globex Retail NA LLC,US,2111208.64
2025-06-20,2025-06-20,Supplier Payment - ExpertNet Subcontractors #18,Supplier Payment,PS-GL,3082.82,0.0,USD,ACH Debit,ExpertNet Subcontractors #18,***5000,,PO-202506-PS-GL-0007,False,False,REF-817317,First Continental Bank,***2516,Globex Retail NA LLC,US,2108125.82
2025-06-20,2025-06-20,Supplier Payment - ExpertNet Subcontractors #7,Supplier Payment,PS-GL,6364.39,0.0,USD,ACH Debit,ExpertNet Subcontractors #7,***9728,,PO-202506-PS-GL-0003,False,False,REF-703911,First Continental Bank,***2935,Globex Retail NA LLC,US,2101761.43
2025-06-20,2025-06-20,Client Receipt - Vertex Advisory Client #17,Sales Receipt,PS-GL,0.0,11440.22,USD,ACH Credit,Vertex Advisory Client #17,***5400,INV-202506-PS-GL-0003,,False,False,REF-501007,First Continental Bank,***9119,Globex Retail NA LLC,US,2113201.65
2025-06-22,2025-06-22,VAT/GST Remittance - US IRS,Tax Payment,ALL,59675.72,0.0,USD,SWIFT MT103,US IRS,***2352,,,False,False,REF-417399,First Continental Bank,***4646,Globex Retail NA LLC,US,2053525.93
2025-06-23,2025-06-23,Supplier Payment - ExpertNet Subcontractors #15,Supplier Payment,PS-GL,2495.61,0.0,USD,ACH Debit,ExpertNet Subcontractors #15,***7503,,PO-202506-PS-GL-0001,False,False,REF-935119,First Continental Bank,***2445,Globex Retail NA LLC,US,2051030.32
2025-06-23,2025-06-23,Supplier Payment - ExpertNet Subcontractors #13,Supplier Payment,PS-GL,7146.05,0.0,USD,ACH Debit,ExpertNet Subcontractors #13,***4632,,PO-202506-PS-GL-0008,False,False,REF-885917,First Continental Bank,***8941,Globex Retail NA LLC,US,2043884.27
2025-06-23,2025-06-23,Client Receipt - CloudBridge Co. #11,Sales Receipt,SaaS-GL,0.0,2298.74,USD,Card Settlement,CloudBridge Co. #11,***7964,INV-202506-SaaS-GL-0015,,False,False,REF-335472,First Continental Bank,***4523,Globex Retail NA LLC,US,2046183.01
2025-06-23,2025-06-23,Client Receipt - Vertex Advisory Client #33,Sales Receipt,PS-GL,0.0,6660.95,USD,ACH Credit,Vertex Advisory Client #33,***8353,INV-202506-PS-GL-0004,,False,False,REF-196962,First Continental Bank,***2433,Globex Retail NA LLC,US,2052843.96
2025-06-23,2025-06-23,Client Receipt - CloudBridge Co. #79,Sales Receipt,SaaS-GL,0.0,11996.96,USD,ACH Credit,CloudBridge Co. #79,***8443,INV-202506-SaaS-GL-0008,,False,False,REF-710109,First Continental Bank,***5026,Globex Retail NA LLC,US,2064840.92
2025-06-23,2025-06-23,Client Receipt - CloudBridge Co. #39,Sales Receipt,SaaS-GL,0.0,15539.1,USD,Card Settlement,CloudBridge Co. #39,***4280,INV-202506-SaaS-GL-0002,,False,False,REF-863283,First Continental Bank,***5433,Globex Retail NA LLC,US,2080380.02
2025-06-23,2025-06-23,Client Receipt - CloudBridge Co. #31,Sales Receipt,SaaS-GL,0.0,35183.78,USD,ACH Credit,CloudBridge Co. #31,***5634,INV-202506-SaaS-GL-0013,,False,False,REF-145674,First Continental Bank,***3562,Globex Retail NA LLC,US,2115563.8
2025-06-24,2025-06-24,Client Receipt - CloudBridge Co. #3,Sales Receipt,SaaS-GL,0.0,3111.44,USD,Card Settlement,CloudBridge Co. #3,***1643,INV-202506-SaaS-GL-0017,,False,False,REF-762858,First Continental Bank,***8958,Globex Retail NA LLC,US,2118675.24
2025-06-25,2025-06-25,Supplier Payment - CodeCraft Contractors #2,Supplier Payment,SaaS-GL,2495.4,0.0,USD,Fedwire,CodeCraft Contractors #2,***9485,,PO-202506-SaaS-GL-0001,False,False,REF-714598,First Continental Bank,***3077,Globex Retail NA LLC,US,2116179.84
2025-06-25,2025-06-25,Client Receipt - ShopSphere Partner #12,Sales Receipt,Retail-NA,0.0,5303.2,USD,Card Settlement,ShopSphere Partner #12,***2148,INV-202506-Retail-NA-0007,,False,False,REF-805964,First Continental Bank,***4588,Globex Retail NA LLC,US,2121483.04
2025-06-25,2025-06-25,Client Receipt - ShopSphere Partner #20,Sales Receipt,Retail-NA,0.0,55223.54,USD,ACH Credit,ShopSphere Partner #20,***2734,INV-202506-Retail-NA-0009,,False,False,REF-147465,First Continental Bank,***7242,Globex Retail NA LLC,US,2176706.58
2025-06-26,2025-06-26,Merchant Processing Fees,Bank/Merchant Fees,ALL,1126.25,0.0,USD,ACH Debit,First Continental Bank,***5000,,,False,False,REF-433134,First Continental Bank,***9213,Globex Retail NA LLC,US,2175580.33
2025-06-26,2025-06-26,Supplier Payment - HyperCloud Infra #9,Supplier Payment,SaaS-GL,6350.77,0.0,USD,ACH Debit,HyperCloud Infra #9,***8582,,PO-202506-SaaS-GL-0004,False,False,REF-173476,First Continental Bank,***9038,Globex Retail NA LLC,US,2169229.56
2025-06-26,2025-06-26,Supplier Payment - CodeCraft Contractors #8,Supplier Payment,SaaS-GL,7041.15,0.0,USD,ACH Debit,CodeCraft Contractors #8,***3659,,PO-202506-SaaS-GL-0007,False,False,REF-288826,First Continental Bank,***8989,Globex Retail NA LLC,US,2162188.41
2025-06-26,2025-06-26,Supplier Payment - NorthRiver Apparel Mfg #2,Supplier Payment,Retail-NA,8603.81,0.0,USD,Fedwire,NorthRiver Apparel Mfg #2,***7183,,PO-202506-Retail-NA-0010,False,False,REF-999029,First Continental Bank,***2388,Globex Retail NA LLC,US,2153584.6
2025-06-26,2025-06-26,Payroll - GlobalPay Services Ltd,Payroll,ALL,164237.2,0.0,USD,Fedwire,GlobalPay Services Ltd,***5329,,,False,False,REF-456557,First Continental Bank,***4916,Globex Retail NA LLC,US,1989347.4
2025-06-26,2025-06-26,Intercompany Settlement - Globex EMEA Manufacturing Ltd.,Intercompany Transfer,ALL,862223.0,0.0,USD,Internal Transfer,Globex EMEA Manufacturing Ltd.,***8147,,,True,True,REF-314298,First Continental Bank,***3321,Globex Retail NA LLC,US,1127124.4
2025-06-26,2025-06-26,Client Receipt - CloudBridge Co. #60,Sales Receipt,SaaS-GL,0.0,23773.83,USD,Card Settlement,CloudBridge Co. #60,***6266,INV-202506-SaaS-GL-0010,,False,False,REF-285317,First Continental Bank,***6095,Globex Retail NA LLC,US,1150898.23
2025-06-27,2025-06-27,Alphagrid Utilities,Rent & Utilities,ALL,2863.67,0.0,USD,Fedwire,Alphagrid Utilities,***2410,,,False,False,REF-920850,First Continental Bank,***2596,Globex Retail NA LLC,US,1148034.56
2025-06-27,2025-06-27,Skyline Internet Services,Rent & Utilities,ALL,5404.62,0.0,USD,Fedwire,Skyline Internet Services,***1001,,,False,False,REF-237993,First Continental Bank,***1138,Globex Retail NA LLC,US,1142629.94
2025-06-27,2025-06-27,Supplier Payment - PackFast Fulfillment #9,Supplier Payment,Retail-NA,30293.83,0.0,USD,ACH Debit,PackFast Fulfillment #9,***7983,,PO-202506-Retail-NA-0009,False,False,REF-641380,First Continental Bank,***1205,Globex Retail NA LLC,US,1112336.11
2025-06-27,2025-06-27,Client Receipt - ShopSphere Partner #17,Sales Receipt,Retail-NA,0.0,7670.69,USD,ACH Credit,ShopSphere Partner #17,***7678,INV-202506-Retail-NA-0002,,False,False,REF-789085,First Continental Bank,***5672,Globex Retail NA LLC,US,1120006.8
2025-06-27,2025-06-27,Client Receipt - CloudBridge Co. #67,Sales Receipt,SaaS-GL,0.0,9347.05,USD,Card Settlement,CloudBridge Co. #67,***9501,INV-202506-SaaS-GL-0020,,False,False,REF-932584,First Continental Bank,***8871,Globex Retail NA LLC,US,1129353.85
2025-06-28,2025-06-28,Supplier Payment - ExpertNet Subcontractors #17,Supplier Payment,PS-GL,19938.51,0.0,USD,ACH Debit,ExpertNet Subcontractors #17,***6751,,PO-202506-PS-GL-0009,False,False,REF-465667,First Continental Bank,***7703,Globex Retail NA LLC,US,1109415.34
2025-06-29,2025-06-29,Supplier Payment - CodeCraft Contractors #2,Supplier Payment,SaaS-GL,8500.17,0.0,USD,Fedwire,CodeCraft Contractors #2,***6272,,PO-202506-SaaS-GL-0008,False,False,REF-407629,First Continental Bank,***8980,Globex Retail NA LLC,US,1100915.17
2025-06-30,2025-06-30,Client Receipt - Card Settlement Batch #9,Sales Receipt,Retail-NA,0.0,4467.0,USD,Card Settlement,Card Settlement Batch #9,***8879,INV-202506-Retail-NA-0018,,False,False,REF-168541,First Continental Bank,***3902,Globex Retail NA LLC,US,1105382.17
2025-06-30,2025-06-30,Interest Earned,Interest Income,ALL,0.0,9684.18,USD,ACH Credit,First Continental Bank,***8756,,,False,False,REF-578397,First Continental Bank,***1667,Globex Retail NA LLC,US,1115066.35
2025-06-30,2025-06-30,Client Receipt - CloudBridge Co. #20,Sales Receipt,SaaS-GL,0.0,10223.87,USD,Card Settlement,CloudBridge Co. #20,***3698,INV-202506-SaaS-GL-0021,,False,False,REF-138776,First Continental Bank,***1547,Globex Retail NA LLC,US,1125290.22
2025-06-30,2025-06-30,Client Receipt - Vertex Advisory Client #59,Sales Receipt,PS-GL,0.0,13786.37,USD,ACH Credit,Vertex Advisory Client #59,***2319,INV-202506-PS-GL-0002,,False,False,REF-194643,First Continental Bank,***9479,Globex Retail NA LLC,US,1139076.59
2025-07-01,2025-07-01,Merchant Processing Fees,Bank/Merchant Fees,ALL,764.17,0.0,USD,ACH Debit,First Continental Bank,***3041,,,False,False,REF-435409,First Continental Bank,***2253,Globex Retail NA LLC,US,1138312.42
2025-07-01,2025-07-01,Account Maintenance Fee,Bank/Merchant Fees,ALL,2500.0,0.0,USD,Fedwire,First Continental Bank,***8453,,,False,False,REF-631405,First Continental Bank,***8004,Globex Retail NA LLC,US,1135812.42
2025-07-01,2025-07-01,Supplier Payment - ExpertNet Subcontractors #5,Supplier Payment,PS-GL,3154.28,0.0,USD,ACH Debit,ExpertNet Subcontractors #5,***6690,,PO-202507-PS-GL-0002,False,False,REF-172074,First Continental Bank,***5502,Globex Retail NA LLC,US,1132658.14
2025-07-01,2025-07-01,Client Receipt - CloudBridge Co. #61,Sales Receipt,SaaS-GL,0.0,1929.95,USD,ACH Credit,CloudBridge Co. #61,***8826,INV-202507-SaaS-GL-0017,,False,False,REF-160078,First Continental Bank,***1285,Globex Retail NA LLC,US,1134588.09
2025-07-01,2025-07-01,Client Receipt - CloudBridge Co. #49,Sales Receipt,SaaS-GL,0.0,25348.88,USD,Card Settlement,CloudBridge Co. #49,***5750,INV-202507-SaaS-GL-0012,,False,False,REF-116669,First Continental Bank,***6403,Globex Retail NA LLC,US,1159936.97
2025-07-02,2025-07-02,Supplier Payment - NorthRiver Apparel Mfg #9,Supplier Payment,Retail-NA,38293.85,0.0,USD,Fedwire,NorthRiver Apparel Mfg #9,***3680,,PO-202507-Retail-NA-0006,False,False,REF-114840,First Continental Bank,***5949,Globex Retail NA LLC,US,1121643.12
2025-07-02,2025-07-02,Client Receipt - CloudBridge Co. #24,Sales Receipt,SaaS-GL,0.0,609.79,USD,Card Settlement,CloudBridge Co. #24,***3209,INV-202507-SaaS-GL-0007,,False,False,REF-980025,First Continental Bank,***5064,Globex Retail NA LLC,US,1122252.91
2025-07-02,2025-07-02,Client Receipt - CloudBridge Co. #22,Sales Receipt,SaaS-GL,0.0,11678.36,USD,Card Settlement,CloudBridge Co. #22,***1093,INV-202507-SaaS-GL-0024,,False,False,REF-632839,First Continental Bank,***4745,Globex Retail NA LLC,US,1133931.27
2025-07-02,2025-07-02,Client Receipt - Vertex Advisory Client #13,Sales Receipt,PS-GL,0.0,51060.86,USD,ACH Credit,Vertex Advisory Client #13,***4490,INV-202507-PS-GL-0008,,False,False,REF-248645,First Continental Bank,***6714,Globex Retail NA LLC,US,1184992.13
2025-07-03,2025-07-03,Supplier Payment - HyperCloud Infra #16,Supplier Payment,SaaS-GL,6847.91,0.0,USD,ACH Debit,HyperCloud Infra #16,***1923,,PO-202507-SaaS-GL-0003,False,False,REF-350918,First Continental Bank,***5497,Globex Retail NA LLC,US,1178144.22
2025-07-05,2025-07-05,Supplier Payment - CodeCraft Contractors #13,Supplier Payment,SaaS-GL,25413.89,0.0,USD,ACH Debit,CodeCraft Contractors #13,***9053,,PO-202507-SaaS-GL-0007,False,False,REF-697664,First Continental Bank,***4435,Globex Retail NA LLC,US,1152730.33
2025-07-05,2025-07-05,Client Receipt - CloudBridge Co. #77,Sales Receipt,SaaS-GL,0.0,12865.23,USD,Card Settlement,CloudBridge Co. #77,***5937,INV-202507-SaaS-GL-0026,,False,False,REF-113482,First Continental Bank,***5771,Globex Retail NA LLC,US,1165595.56
2025-07-06,2025-07-06,Client Receipt - CloudBridge Co. #73,Sales Receipt,SaaS-GL,0.0,2542.38,USD,Card Settlement,CloudBridge Co. #73,***3134,INV-202507-SaaS-GL-0014,,False,False,REF-250549,First Continental Bank,***4257,Globex Retail NA LLC,US,1168137.94
2025-07-07,2025-07-07,Supplier Payment - ExpertNet Subcontractors #17,Supplier Payment,PS-GL,1290.43,0.0,USD,Fedwire,ExpertNet Subcontractors #17,***2641,,PO-202507-PS-GL-0008,False,False,REF-820650,First Continental Bank,***2831,Globex Retail NA LLC,US,1166847.51
2025-07-07,2025-07-07,Client Receipt - CloudBridge Co. #46,Sales Receipt,SaaS-GL,0.0,5146.93,USD,ACH Credit,CloudBridge Co. #46,***3149,INV-202507-SaaS-GL-0020,,False,False,REF-174189,First Continental Bank,***5517,Globex Retail NA LLC,US,1171994.44
2025-07-07,2025-07-07,Client Receipt - CloudBridge Co. #53,Sales Receipt,SaaS-GL,0.0,8077.72,USD,ACH Credit,CloudBridge Co. #53,***3860,INV-202507-SaaS-GL-0001,,False,False,REF-144043,First Continental Bank,***9837,Globex Retail NA LLC,US,1180072.16
2025-07-07,2025-07-07,Client Receipt - CloudBridge Co. #73,Sales Receipt,SaaS-GL,0.0,8120.79,USD,Card Settlement,CloudBridge Co. #73,***7412,INV-202507-SaaS-GL-0011,,False,False,REF-253996,First Continental Bank,***2983,Globex Retail NA LLC,US,1188192.95
2025-07-07,2025-07-07,Client Receipt - CloudBridge Co. #60,Sales Receipt,SaaS-GL,0.0,8774.0,USD,Card Settlement,CloudBridge Co. #60,***3693,INV-202507-SaaS-GL-0005,,False,False,REF-260256,First Continental Bank,***6778,Globex Retail NA LLC,US,1196966.95
2025-07-08,2025-07-08,Supplier Payment - CodeCraft Contractors #9,Supplier Payment,SaaS-GL,5140.11,0.0,USD,ACH Debit,CodeCraft Contractors #9,***4422,,PO-202507-SaaS-GL-0009,False,False,REF-997754,First Continental Bank,***9031,Globex Retail NA LLC,US,1191826.84
2025-07-08,2025-07-08,Supplier Payment - HyperCloud Infra #1,Supplier Payment,SaaS-GL,5200.59,0.0,USD,Fedwire,HyperCloud Infra #1,***3456,,PO-202507-SaaS-GL-0006,False,False,REF-960607,First Continental Bank,***9445,Globex Retail NA LLC,US,1186626.25
2025-07-08,2025-07-08,Client Receipt - CloudBridge Co. #33,Sales Receipt,SaaS-GL,0.0,608.38,USD,ACH Credit,CloudBridge Co. #33,***3957,INV-202507-SaaS-GL-0021,,False,False,REF-152533,First Continental Bank,***2358,Globex Retail NA LLC,US,1187234.63
2025-07-08,2025-07-08,Client Receipt - CloudBridge Co. #63,Sales Receipt,SaaS-GL,0.0,2689.54,USD,Card Settlement,CloudBridge Co. #63,***3327,INV-202507-SaaS-GL-0006,,False,False,REF-338597,First Continental Bank,***8698,Globex Retail NA LLC,US,1189924.17
2025-07-09,2025-07-09,Supplier Payment - HyperCloud Infra #19,Supplier Payment,SaaS-GL,9269.37,0.0,USD,ACH Debit,HyperCloud Infra #19,***4379,,PO-202507-SaaS-GL-0004,False,False,REF-436068,First Continental Bank,***4675,Globex Retail NA LLC,US,1180654.8
2025-07-09,2025-07-09,Client Receipt - ShopSphere Partner #54,Sales Receipt,Retail-NA,0.0,32108.16,USD,ACH Credit,ShopSphere Partner #54,***8064,INV-202507-Retail-NA-0005,,False,False,REF-973001,First Continental Bank,***5032,Globex Retail NA LLC,US,1212762.96
2025-07-10,2025-07-10,Supplier Payment - HyperCloud Infra #2,Supplier Payment,SaaS-GL,4367.46,0.0,USD,ACH Debit,HyperCloud Infra #2,***5624,,PO-202507-SaaS-GL-0002,False,False,REF-907126,First Continental Bank,***8666,Globex Retail NA LLC,US,1208395.5
2025-07-10,2025-07-10,Supplier Payment - NorthRiver Apparel Mfg #1,Supplier Payment,Retail-NA,63281.42,0.0,USD,Fedwire,NorthRiver Apparel Mfg #1,***2668,,PO-202507-Retail-NA-0005,False,False,REF-197773,First Continental Bank,***7355,Globex Retail NA LLC,US,1145114.08
2025-07-10,2025-07-10,Client Receipt - Vertex Advisory Client #31,Sales Receipt,PS-GL,0.0,14020.96,USD,Card Settlement,Vertex Advisory Client #31,***6824,INV-202507-PS-GL-0001,,False,False,REF-167884,First Continental Bank,***1736,Globex Retail NA LLC,US,1159135.04
2025-07-10,2025-07-10,Client Receipt - CloudBridge Co. #5,Sales Receipt,SaaS-GL,0.0,18451.91,USD,Card Settlement,CloudBridge Co. #5,***6900,INV-202507-SaaS-GL-0003,,False,False,REF-479958,First Continental Bank,***3902,Globex Retail NA LLC,US,1177586.95
2025-07-11,2025-07-11,Northshore Power,Rent & Utilities,ALL,4126.11,0.0,USD,Fedwire,Northshore Power,***1675,,,False,False,REF-178477,First Continental Bank,***7320,Globex Retail NA LLC,US,1173460.84
2025-07-11,2025-07-11,Supplier Payment - NorthRiver Apparel Mfg #26,Supplier Payment,Retail-NA,11803.46,0.0,USD,ACH Debit,NorthRiver Apparel Mfg #26,***9985,,PO-202507-Retail-NA-0003,False,False,REF-259624,First Continental Bank,***6694,Globex Retail NA LLC,US,1161657.38
2025-07-11,2025-07-11,Client Receipt - ShopSphere Partner #33,Sales Receipt,Retail-NA,0.0,531.78,USD,ACH Credit,ShopSphere Partner #33,***3462,INV-202507-Retail-NA-0006,,False,False,REF-541825,First Continental Bank,***6780,Globex Retail NA LLC,US,1162189.16
2025-07-11,2025-07-11,Client Receipt - ShopSphere Partner #37,Sales Receipt,Retail-NA,0.0,17237.76,USD,Card Settlement,ShopSphere Partner #37,***5993,INV-202507-Retail-NA-0012,,False,False,REF-431297,First Continental Bank,***3221,Globex Retail NA LLC,US,1179426.92
2025-07-11,2025-07-11,Client Receipt - CloudBridge Co. #23,Sales Receipt,SaaS-GL,0.0,23531.35,USD,ACH Credit,CloudBridge Co. #23,***4983,INV-202507-SaaS-GL-0010,,False,False,REF-179784,First Continental Bank,***8293,Globex Retail NA LLC,US,1202958.27
2025-07-11,2025-07-11,Client Receipt - Card Settlement Batch #18,Sales Receipt,Retail-NA,0.0,34227.92,USD,ACH Credit,Card Settlement Batch #18,***8952,INV-202507-Retail-NA-0008,,False,False,REF-483846,First Continental Bank,***1491,Globex Retail NA LLC,US,1237186.19
2025-07-11,2025-07-11,Client Receipt - Vertex Advisory Client #39,Sales Receipt,PS-GL,0.0,35968.72,USD,Card Settlement,Vertex Advisory Client #39,***6951,INV-202507-PS-GL-0003,,False,False,REF-607825,First Continental Bank,***1230,Globex Retail NA LLC,US,1273154.91
2025-07-12,2025-07-12,Intercompany Settlement - Globex Consulting UK Ltd.,Intercompany Transfer,ALL,679562.0,0.0,USD,Internal Transfer,Globex Consulting UK Ltd.,***3525,,,True,True,REF-498005,First Continental Bank,***3697,Globex Retail NA LLC,US,593592.91
2025-07-13,2025-07-13,Metro Water & Waste,Rent & Utilities,ALL,3876.19,0.0,USD,ACH Debit,Metro Water & Waste,***7985,,,False,False,REF-775469,First Continental Bank,***4048,Globex Retail NA LLC,US,589716.72
2025-07-14,2025-07-14,Supplier Payment - HyperCloud Infra #1,Supplier Payment,SaaS-GL,6157.84,0.0,USD,Fedwire,HyperCloud Infra #1,***1430,,PO-202507-SaaS-GL-0005,False,False,REF-313679,First Continental Bank,***2859,Globex Retail NA LLC,US,583558.88
2025-07-14,2025-07-14,Supplier Payment - NorthRiver Apparel Mfg #27,Supplier Payment,Retail-NA,51570.99,0.0,USD,ACH Debit,NorthRiver Apparel Mfg #27,***4284,,PO-202507-Retail-NA-0004,False,False,REF-654821,First Continental Bank,***6417,Globex Retail NA LLC,US,531987.89
2025-07-14,2025-07-14,Client Receipt - CloudBridge Co. #78,Sales Receipt,SaaS-GL,0.0,2213.67,USD,Card Settlement,CloudBridge Co. #78,***3944,INV-202507-SaaS-GL-0025,,False,False,REF-644889,First Continental Bank,***5568,Globex Retail NA LLC,US,534201.56
2025-07-14,2025-07-14,Client Receipt - Vertex Advisory Client #38,Sales Receipt,PS-GL,0.0,27194.95,USD,ACH Credit,Vertex Advisory Client #38,***3438,INV-202507-PS-GL-0004,,False,False,REF-574818,First Continental Bank,***2224,Globex Retail NA LLC,US,561396.51
2025-07-15,2025-07-15,Supplier Payment - PackFast Fulfillment #9,Supplier Payment,Retail-NA,3472.69,0.0,USD,Fedwire,PackFast Fulfillment #9,***9787,,PO-202507-Retail-NA-0001,False,False,REF-644445,First Continental Bank,***5370,Globex Retail NA LLC,US,557923.82
2025-07-15,2025-07-15,Client Receipt - CloudBridge Co. #7,Sales Receipt,SaaS-GL,0.0,659.98,USD,Card Settlement,CloudBridge Co. #7,***6549,INV-202507-SaaS-GL-0002,,False,False,REF-866320,First Continental Bank,***8265,Globex Retail NA LLC,US,558583.8
2025-07-15,2025-07-15,Client Receipt - CloudBridge Co. #66,Sales Receipt,SaaS-GL,0.0,17823.05,USD,Card Settlement,CloudBridge Co. #66,***8862,INV-202507-SaaS-GL-0023,,False,False,REF-569523,First Continental Bank,***5513,Globex Retail NA LLC,US,576406.85
2025-07-15,2025-07-15,Client Receipt - CloudBridge Co. #18,Sales Receipt,SaaS-GL,0.0,20114.31,USD,ACH Credit,CloudBridge Co. #18,***1236,INV-202507-SaaS-GL-0004,,False,False,REF-218334,First Continental Bank,***7451,Globex Retail NA LLC,US,596521.16
2025-07-16,2025-07-16,Client Receipt - ShopSphere Partner #58,Sales Receipt,Retail-NA,0.0,3313.17,USD,Card Settlement,ShopSphere Partner #58,***2081,INV-202507-Retail-NA-0011,,False,False,REF-206958,First Continental Bank,***6112,Globex Retail NA LLC,US,599834.33
2025-07-16,2025-07-16,Client Receipt - CloudBridge Co. #21,Sales Receipt,SaaS-GL,0.0,3597.32,USD,ACH Credit,CloudBridge Co. #21,***4510,INV-202507-SaaS-GL-0019,,False,False,REF-273972,First Continental Bank,***6773,Globex Retail NA LLC,US,603431.65
2025-07-16,2025-07-16,Client Receipt - CloudBridge Co. #40,Sales Receipt,SaaS-GL,0.0,36545.84,USD,ACH Credit,CloudBridge Co. #40,***1219,INV-202507-SaaS-GL-0022,,False,False,REF-513537,First Continental Bank,***1987,Globex Retail NA LLC,US,639977.49
2025-07-16,2025-07-16,Client Receipt - ShopSphere Partner #64,Sales Receipt,Retail-NA,0.0,69017.17,USD,Card Settlement,ShopSphere Partner #64,***4974,INV-202507-Retail-NA-0009,,False,False,REF-347243,First Continental Bank,***6882,Globex Retail NA LLC,US,708994.66
2025-07-18,2025-07-18,Marketing - Aurelia Media #4,Marketing,ALL,16695.66,0.0,USD,ACH Debit,Aurelia Media #4,***9183,,,False,False,REF-909650,First Continental Bank,***3098,Globex Retail NA LLC,US,692299.0
2025-07-18,2025-07-18,Client Receipt - CloudBridge Co. #27,Sales Receipt,SaaS-GL,0.0,12355.64,USD,ACH Credit,CloudBridge Co. #27,***3241,INV-202507-SaaS-GL-0009,,False,False,REF-611237,First Continental Bank,***7487,Globex Retail NA LLC,US,704654.64
2025-07-20,2025-07-20,Supplier Payment - ExpertNet Subcontractors #17,Supplier Payment,PS-GL,9825.21,0.0,USD,ACH Debit,ExpertNet Subcontractors #17,***6440,,PO-202507-PS-GL-0006,False,False,REF-335602,First Continental Bank,***5089,Globex Retail NA LLC,US,694829.43
2025-07-21,2025-07-21,Supplier Payment - ExpertNet Subcontractors #5,Supplier Payment,PS-GL,3900.9,0.0,USD,ACH Debit,ExpertNet Subcontractors #5,***3016,,PO-202507-PS-GL-0005,False,False,REF-546657,First Continental Bank,***2828,Globex Retail NA LLC,US,690928.53
2025-07-21,2025-07-21,Supplier Payment - NorthRiver Apparel Mfg #5,Supplier Payment,Retail-NA,25347.19,0.0,USD,ACH Debit,NorthRiver Apparel Mfg #5,***2527,,PO-202507-Retail-NA-0007,False,False,REF-454764,First Continental Bank,***8894,Globex Retail NA LLC,US,665581.34
2025-07-21,2025-07-21,Client Receipt - Vertex Advisory Client #49,Sales Receipt,PS-GL,0.0,21584.34,USD,ACH Credit,Vertex Advisory Client #49,***1401,INV-202507-PS-GL-0006,,False,False,REF-776515,First Continental Bank,***8803,Globex Retail NA LLC,US,687165.68
2025-07-22,2025-07-22,Supplier Payment - CodeCraft Contractors #6,Supplier Payment,SaaS-GL,4147.99,0.0,USD,ACH Debit,CodeCraft Contractors #6,***5873,,PO-202507-SaaS-GL-0001,False,False,REF-493682,First Continental Bank,***5757,Globex Retail NA LLC,US,683017.69
2025-07-22,2025-07-22,Marketing - Aurelia Media #7,Marketing,ALL,7443.83,0.0,USD,Fedwire,Aurelia Media #7,***2365,,,False,False,REF-395424,First Continental Bank,***3840,Globex Retail NA LLC,US,675573.86
2025-07-22,2025-07-22,VAT/GST Remittance - US IRS,Tax Payment,ALL,57790.8,0.0,USD,SWIFT MT103,US IRS,***5794,,,False,False,REF-120681,First Continental Bank,***1397,Globex Retail NA LLC,US,617783.06
2025-07-22,2025-07-22,Client Receipt - ShopSphere Partner #65,Sales Receipt,Retail-NA,0.0,381.25,USD,ACH Credit,ShopSphere Partner #65,***8971,INV-202507-Retail-NA-0007,,False,False,REF-800553,First Continental Bank,***9662,Globex Retail NA LLC,US,618164.31
2025-07-22,2025-07-22,Client Receipt - Vertex Advisory Client #45,Sales Receipt,PS-GL,0.0,11457.88,USD,ACH Credit,Vertex Advisory Client #45,***2005,INV-202507-PS-GL-0007,,False,False,REF-863580,First Continental Bank,***5770,Globex Retail NA LLC,US,629622.19
2025-07-23,2025-07-23,Supplier Payment - ExpertNet Subcontractors #2,Supplier Payment,PS-GL,14113.2,0.0,USD,Fedwire,ExpertNet Subcontractors #2,***6996,,PO-202507-PS-GL-0007,False,False,REF-221051,First Continental Bank,***1533,Globex Retail NA LLC,US,615508.99
2025-07-23,2025-07-23,Client Receipt - Vertex Advisory Client #11,Sales Receipt,PS-GL,0.0,7228.47,USD,Card Settlement,Vertex Advisory Client #11,***1234,INV-202507-PS-GL-0009,,False,False,REF-832118,First Continental Bank,***7609,Globex Retail NA LLC,US,622737.46
2025-07-23,2025-07-23,Client Receipt - Card Settlement Batch #22,Sales Receipt,Retail-NA,0.0,11425.96,USD,Card Settlement,Card Settlement Batch #22,***8625,INV-202507-Retail-NA-0001,,False,False,REF-980786,First Continental Bank,***4831,Globex Retail NA LLC,US,634163.42
2025-07-23,2025-07-23,Client Receipt - CloudBridge Co. #71,Sales Receipt,SaaS-GL,0.0,16648.54,USD,Card Settlement,CloudBridge Co. #71,***8481,INV-202507-SaaS-GL-0027,,False,False,REF-449051,First Continental Bank,***7983,Globex Retail NA LLC,US,650811.96
2025-07-24,2025-07-24,Supplier Payment - ExpertNet Subcontractors #17,Supplier Payment,PS-GL,7402.45,0.0,USD,ACH Debit,ExpertNet Subcontractors #17,***7233,,PO-202507-PS-GL-0003,False,False,REF-863027,First Continental Bank,***8852,Globex Retail NA LLC,US,643409.51
2025-07-25,2025-07-25,Client Receipt - CloudBridge Co. #22,Sales Receipt,SaaS-GL,0.0,32036.72,USD,ACH Credit,CloudBridge Co. #22,***5010,INV-202507-SaaS-GL-0015,,False,False,REF-799810,First Continental Bank,***2045,Globex Retail NA LLC,US,675446.23
2025-07-25,2025-07-25,Client Receipt - ShopSphere Partner #41,Sales Receipt,Retail-NA,0.0,75129.53,USD,Card Settlement,ShopSphere Partner #41,***8196,INV-202507-Retail-NA-0004,,False,False,REF-538332,First Continental Bank,***6030,Globex Retail NA LLC,US,750575.76
2025-07-26,2025-07-26,Payroll - GlobalPay Services Ltd,Payroll,ALL,156424.39,0.0,USD,Fedwire,GlobalPay Services Ltd,***9434,,,False,False,REF-939554,First Continental Bank,***6717,Globex Retail NA LLC,US,594151.37
2025-07-26,2025-07-26,Intercompany Settlement - Globex EMEA Manufacturing Ltd.,Intercompany Transfer,ALL,618463.0,0.0,USD,Internal Transfer,Globex EMEA Manufacturing Ltd.,***2861,,,True,True,REF-362845,First Continental Bank,***9888,Globex Retail NA LLC,US,-24311.63
2025-07-26,2025-07-26,Client Receipt - CloudBridge Co. #20,Sales Receipt,SaaS-GL,0.0,31963.79,USD,Card Settlement,CloudBridge Co. #20,***4860,INV-202507-SaaS-GL-0008,,False,False,REF-336077,First Continental Bank,***2706,Globex Retail NA LLC,US,7652.16
2025-07-26,2025-07-26,Intercompany Reimbursement - Globex EMEA Manufacturing Ltd.,Intercompany Transfer,ALL,0.0,247385.2,USD,Internal Transfer,Globex EMEA Manufacturing Ltd.,***4243,,,True,True,REF-158100,First Continental Bank,***2543,Globex Retail NA LLC,US,255037.36
2025-07-27,2025-07-27,Client Receipt - CloudBridge Co. #40,Sales Receipt,SaaS-GL,0.0,2468.86,USD,Card Settlement,CloudBridge Co. #40,***7996,INV-202507-SaaS-GL-0018,,False,False,REF-972176,First Continental Bank,***4395,Globex Retail NA LLC,US,257506.22
2025-07-28,2025-07-28,Supplier Payment - ExpertNet Subcontractors #2,Supplier Payment,PS-GL,9893.49,0.0,USD,Fedwire,ExpertNet Subcontractors #2,***1417,,PO-202507-PS-GL-0001,False,False,REF-232603,First Continental Bank,***3030,Globex Retail NA LLC,US,247612.73
2025-07-28,2025-07-28,Supplier Payment - PackFast Fulfillment #9,Supplier Payment,Retail-NA,10406.44,0.0,USD,Fedwire,PackFast Fulfillment #9,***5722,,PO-202507-Retail-NA-0009,False,False,REF-309009,First Continental Bank,***6075,Globex Retail NA LLC,US,237206.29
2025-07-28,2025-07-28,Supplier Payment - NorthRiver Apparel Mfg #30,Supplier Payment,Retail-NA,10440.09,0.0,USD,Fedwire,NorthRiver Apparel Mfg #30,***5317,,PO-202507-Retail-NA-0008,False,False,REF-267935,First Continental Bank,***9447,Globex Retail NA LLC,US,226766.2
2025-07-28,2025-07-28,Corporate Tax Estimate,Tax Payment,ALL,43138.42,0.0,USD,ACH Debit,State of NY DoF,***5732,,,False,False,REF-563984,First Continental Bank,***9871,Globex Retail NA LLC,US,183627.78
2025-07-28,2025-07-28,Client Receipt - Card Settlement Batch #3,Sales Receipt,Retail-NA,0.0,22360.03,USD,ACH Credit,Card Settlement Batch #3,***3654,INV-202507-Retail-NA-0003,,False,False,REF-648070,First Continental Bank,***8340,Globex Retail NA LLC,US,205987.81
2025-07-29,2025-07-29,Client Receipt - CloudBridge Co. #55,Sales Receipt,SaaS-GL,0.0,14829.0,USD,ACH Credit,CloudBridge Co. #55,***4155,INV-202507-SaaS-GL-0013,,False,False,REF-654991,First Continental Bank,***7850,Globex Retail NA LLC,US,220816.81
2025-07-29,2025-07-29,Client Receipt - CloudBridge Co. #69,Sales Receipt,SaaS-GL,0.0,16079.14,USD,Card Settlement,CloudBridge Co. #69,***8710,INV-202507-SaaS-GL-0016,,False,False,REF-325743,First Continental Bank,***6409,Globex Retail NA LLC,US,236895.95
2025-07-29,2025-07-29,Client Receipt - Vertex Advisory Client #28,Sales Receipt,PS-GL,0.0,17139.95,USD,ACH Credit,Vertex Advisory Client #28,***6518,INV-202507-PS-GL-0002,,False,False,REF-289484,First Continental Bank,***2686,Globex Retail NA LLC,US,254035.9
2025-07-29,2025-07-29,Client Receipt - Vertex Advisory Client #32,Sales Receipt,PS-GL,0.0,39484.58,USD,Card Settlement,Vertex Advisory Client #32,***6812,INV-202507-PS-GL-0005,,False,False,REF-807391,First Continental Bank,***3186,Globex Retail NA LLC,US,293520.48
2025-07-30,2025-07-30,Merchant Processing Fees,Bank/Merchant Fees,ALL,2219.72,0.0,USD,ACH Debit,First Continental Bank,***1668,,,False,False,REF-974270,First Continental Bank,***2304,Globex Retail NA LLC,US,291300.76
2025-07-30,2025-07-30,Supplier Payment - HyperCloud Infra #1,Supplier Payment,SaaS-GL,7751.28,0.0,USD,Fedwire,HyperCloud Infra #1,***7129,,PO-202507-SaaS-GL-0008,False,False,REF-870779,First Continental Bank,***6134,Globex Retail NA LLC,US,283549.48
2025-07-30,2025-07-30,Supplier Payment - ExpertNet Subcontractors #4,Supplier Payment,PS-GL,17962.25,0.0,USD,Fedwire,ExpertNet Subcontractors #4,***2153,,PO-202507-PS-GL-0004,False,False,REF-953016,First Continental Bank,***9250,Globex Retail NA LLC,US,265587.23
2025-07-30,2025-07-30,Interest Earned,Interest Income,ALL,0.0,10524.13,USD,Card Settlement,First Continental Bank,***8826,,,False,False,REF-551835,First Continental Bank,***4993,Globex Retail NA LLC,US,276111.36
2025-07-30,2025-07-30,Client Receipt - Card Settlement Batch #22,Sales Receipt,Retail-NA,0.0,123373.27,USD,Card Settlement,Card Settlement Batch #22,***3447,INV-202507-Retail-NA-0002,,False,False,REF-245508,First Continental Bank,***2929,Globex Retail NA LLC,US,399484.63
2025-07-31,2025-07-31,Supplier Payment - PackFast Fulfillment #5,Supplier Payment,Retail-NA,12400.76,0.0,USD,Fedwire,PackFast Fulfillment #5,***2239,,PO-202507-Retail-NA-0002,False,False,REF-599908,First Continental Bank,***2592,Globex Retail NA LLC,US,387083.87
2025-07-31,2025-07-31,Client Receipt - ShopSphere Partner #58,Sales Receipt,Retail-NA,0.0,23651.97,USD,ACH Credit,ShopSphere Partner #58,***3770,INV-202507-Retail-NA-0010,,False,False,REF-841034,First Continental Bank,***9986,Globex Retail NA LLC,US,410735.84
2025-08-01,2025-08-01,Merchant Processing Fees,Bank/Merchant Fees,ALL,1398.55,0.0,USD,Fedwire,First Continental Bank,***9567,,,False,False,REF-281373,First Continental Bank,***1387,Globex Retail NA LLC,US,409337.29
2025-08-01,2025-08-01,Account Maintenance Fee,Bank/Merchant Fees,ALL,2500.0,0.0,USD,Fedwire,First Continental Bank,***3972,,,False,False,REF-416288,First Continental Bank,***9917,Globex Retail NA LLC,US,406837.29
2025-08-01,2025-08-01,Client Receipt - CloudBridge Co. #34,Sales Receipt,SaaS-GL,0.0,48680.27,USD,Card Settlement,CloudBridge Co. #34,***6944,INV-202508-SaaS-GL-0018,,False,False,REF-577576,First Continental Bank,***4122,Globex Retail NA LLC,US,455517.56
2025-08-02,2025-08-02,Client Receipt - ShopSphere Partner #11,Sales Receipt,Retail-NA,0.0,37060.86,USD,ACH Credit,ShopSphere Partner #11,***7559,INV-202508-Retail-NA-0015,,False,False,REF-217773,First Continental Bank,***9934,Globex Retail NA LLC,US,492578.42
2025-08-03,2025-08-03,Metro Water & Waste,Rent & Utilities,ALL,2129.2,0.0,USD,Fedwire,Metro Water & Waste,***7051,,,False,False,REF-862728,First Continental Bank,***8290,Globex Retail NA LLC,US,490449.22
2025-08-03,2025-08-03,Client Receipt - Card Settlement Batch #16,Sales Receipt,Retail-NA,0.0,52406.24,USD,Card Settlement,Card Settlement Batch #16,***2977,INV-202508-Retail-NA-0002,,False,False,REF-666939,First Continental Bank,***8564,Globex Retail NA LLC,US,542855.46
2025-08-04,2025-08-04,Client Receipt - ShopSphere Partner #17,Sales Receipt,Retail-NA,0.0,3271.93,USD,ACH Credit,ShopSphere Partner #17,***5756,INV-202508-Retail-NA-0003,,False,False,REF-351701,First Continental Bank,***7868,Globex Retail NA LLC,US,546127.39
2025-08-05,2025-08-05,Northshore Power,Rent & Utilities,ALL,5316.0,0.0,USD,ACH Debit,Northshore Power,***6247,,,False,False,REF-219233,First Continental Bank,***6336,Globex Retail NA LLC,US,540811.39
2025-08-05,2025-08-05,Client Receipt - Vertex Advisory Client #41,Sales Receipt,PS-GL,0.0,2088.91,USD,Card Settlement,Vertex Advisory Client #41,***9643,INV-202508-PS-GL-0001,,False,False,REF-943837,First Continental Bank,***2128,Globex Retail NA LLC,US,542900.3
2025-08-06,2025-08-06,Supplier Payment - NorthRiver Apparel Mfg #8,Supplier Payment,Retail-NA,6229.67,0.0,USD,Fedwire,NorthRiver Apparel Mfg #8,***3332,,PO-202508-Retail-NA-0003,False,False,REF-374962,First Continental Bank,***8520,Globex Retail NA LLC,US,536670.63
2025-08-06,2025-08-06,Marketing - Beacon Digital #7,Marketing,ALL,11504.58,0.0,USD,ACH Debit,Beacon Digital #7,***9806,,,False,False,REF-287525,First Continental Bank,***7251,Globex Retail NA LLC,US,525166.05
2025-08-06,2025-08-06,Supplier Payment - PackFast Fulfillment #9,Supplier Payment,Retail-NA,42179.43,0.0,USD,ACH Debit,PackFast Fulfillment #9,***5881,,PO-202508-Retail-NA-0011,False,False,REF-898284,First Continental Bank,***9052,Globex Retail NA LLC,US,482986.62
2025-08-06,2025-08-06,Client Receipt - CloudBridge Co. #16,Sales Receipt,SaaS-GL,0.0,7633.28,USD,Card Settlement,CloudBridge Co. #16,***1504,INV-202508-SaaS-GL-0001,,False,False,REF-464176,First Continental Bank,***2608,Globex Retail NA LLC,US,490619.9
2025-08-06,2025-08-06,Client Receipt - Vertex Advisory Client #39,Sales Receipt,PS-GL,0.0,8510.49,USD,ACH Credit,Vertex Advisory Client #39,***7821,INV-202508-PS-GL-0009,,False,False,REF-776791,First Continental Bank,***1797,Globex Retail NA LLC,US,499130.39
2025-08-06,2025-08-06,Client Receipt - Vertex Advisory Client #31,Sales Receipt,PS-GL,0.0,30616.87,USD,Card Settlement,Vertex Advisory Client #31,***5826,INV-202508-PS-GL-0008,,False,False,REF-474495,First Continental Bank,***4656,Globex Retail NA LLC,US,529747.26
2025-08-06,2025-08-06,Client Receipt - Vertex Advisory Client #46,Sales Receipt,PS-GL,0.0,39987.91,USD,Card Settlement,Vertex Advisory Client #46,***5997,INV-202508-PS-GL-0006,,False,False,REF-534272,First Continental Bank,***3596,Globex Retail NA LLC,US,569735.17
2025-08-07,2025-08-07,Client Receipt - CloudBridge Co. #56,Sales Receipt,SaaS-GL,0.0,2073.34,USD,Card Settlement,CloudBridge Co. #56,***5106,INV-202508-SaaS-GL-0003,,False,False,REF-455172,First Continental Bank,***1337,Globex Retail NA LLC,US,571808.51
2025-08-07,2025-08-07,Client Receipt - ShopSphere Partner #54,Sales Receipt,Retail-NA,0.0,39652.49,USD,ACH Credit,ShopSphere Partner #54,***5514,INV-202508-Retail-NA-0013,,False,False,REF-900948,First Continental Bank,***7244,Globex Retail NA LLC,US,611461.0
2025-08-08,2025-08-08,Supplier Payment - PackFast Fulfillment #1,Supplier Payment,Retail-NA,20006.27,0.0,USD,Fedwire,PackFast Fulfillment #1,***3728,,PO-202508-Retail-NA-0008,False,False,REF-410947,First Continental Bank,***7370,Globex Retail NA LLC,US,591454.73
2025-08-08,2025-08-08,Client Receipt - ShopSphere Partner #23,Sales Receipt,Retail-NA,0.0,39530.36,USD,ACH Credit,ShopSphere Partner #23,***9436,INV-202508-Retail-NA-0012,,False,False,REF-316795,First Continental Bank,***3717,Globex Retail NA LLC,US,630985.09
2025-08-09,2025-08-09,Client Receipt - CloudBridge Co. #34,Sales Receipt,SaaS-GL,0.0,13327.66,USD,Card Settlement,CloudBridge Co. #34,***8358,INV-202508-SaaS-GL-0007,,False,False,REF-906153,First Continental Bank,***3376,Globex Retail NA LLC,US,644312.75
2025-08-10,2025-08-10,Supplier Payment - NorthRiver Apparel Mfg #15,Supplier Payment,Retail-NA,17240.31,0.0,USD,Fedwire,NorthRiver Apparel Mfg #15,***4883,,PO-202508-Retail-NA-0010,False,False,REF-397627,First Continental Bank,***8230,Globex Retail NA LLC,US,627072.44
2025-08-11,2025-08-11,Supplier Payment - PackFast Fulfillment #20,Supplier Payment,Retail-NA,7094.15,0.0,USD,ACH Debit,PackFast Fulfillment #20,***1960,,PO-202508-Retail-NA-0007,False,False,REF-352901,First Continental Bank,***5778,Globex Retail NA LLC,US,619978.29
2025-08-11,2025-08-11,Client Receipt - CloudBridge Co. #70,Sales Receipt,SaaS-GL,0.0,2302.48,USD,ACH Credit,CloudBridge Co. #70,***3480,INV-202508-SaaS-GL-0019,,False,False,REF-471739,First Continental Bank,***6319,Globex Retail NA LLC,US,622280.77
2025-08-11,2025-08-11,Client Receipt - CloudBridge Co. #19,Sales Receipt,SaaS-GL,0.0,8457.79,USD,ACH Credit,CloudBridge Co. #19,***6681,INV-202508-SaaS-GL-0017,,False,False,REF-580778,First Continental Bank,***8272,Globex Retail NA LLC,US,630738.56
2025-08-11,2025-08-11,Client Receipt - CloudBridge Co. #63,Sales Receipt,SaaS-GL,0.0,10209.17,USD,ACH Credit,CloudBridge Co. #63,***1178,INV-202508-SaaS-GL-0002,,False,False,REF-232183,First Continental Bank,***3945,Globex Retail NA LLC,US,640947.73
2025-08-11,2025-08-11,Client Receipt - CloudBridge Co. #54,Sales Receipt,SaaS-GL,0.0,33024.02,USD,Card Settlement,CloudBridge Co. #54,***2554,INV-202508-SaaS-GL-0009,,False,False,REF-740647,First Continental Bank,***4694,Globex Retail NA LLC,US,673971.75
2025-08-11,2025-08-11,Client Receipt - ShopSphere Partner #25,Sales Receipt,Retail-NA,0.0,38889.52,USD,Card Settlement,ShopSphere Partner #25,***4280,INV-202508-Retail-NA-0005,,False,False,REF-124582,First Continental Bank,***2605,Globex Retail NA LLC,US,712861.27
2025-08-12,2025-08-12,Supplier Payment - NorthRiver Apparel Mfg #3,Supplier Payment,Retail-NA,6560.1,0.0,USD,ACH Debit,NorthRiver Apparel Mfg #3,***8188,,PO-202508-Retail-NA-0005,False,False,REF-391996,First Continental Bank,***4240,Globex Retail NA LLC,US,706301.17
2025-08-12,2025-08-12,Supplier Payment - CodeCraft Contractors #3,Supplier Payment,SaaS-GL,17408.94,0.0,USD,ACH Debit,CodeCraft Contractors #3,***4655,,PO-202508-SaaS-GL-0005,False,False,REF-859424,First Continental Bank,***4323,Globex Retail NA LLC,US,688892.23
2025-08-12,2025-08-12,Intercompany Settlement - Globex APAC Logistics Pte. Ltd.,Intercompany Transfer,ALL,876533.0,0.0,USD,Internal Transfer,Globex APAC Logistics Pte. Ltd.,***9014,,,True,True,REF-514218,First Continental Bank,***2044,Globex Retail NA LLC,US,-187640.77
2025-08-12,2025-08-12,Client Receipt - CloudBridge Co. #35,Sales Receipt,SaaS-GL,0.0,22447.66,USD,ACH Credit,CloudBridge Co. #35,***3866,INV-202508-SaaS-GL-0015,,False,False,REF-934791,First Continental Bank,***7900,Globex Retail NA LLC,US,-165193.11
2025-08-12,2025-08-12,Client Receipt - ShopSphere Partner #5,Sales Receipt,Retail-NA,0.0,41210.21,USD,Card Settlement,ShopSphere Partner #5,***8503,INV-202508-Retail-NA-0004,,False,False,REF-181028,First Continental Bank,***5079,Globex Retail NA LLC,US,-123982.9
2025-08-12,2025-08-12,Intercompany Reimbursement - Globex APAC Logistics Pte. Ltd.,Intercompany Transfer,ALL,0.0,350613.2,USD,Internal Transfer,Globex APAC Logistics Pte. Ltd.,***4166,,,True,True,REF-234686,First Continental Bank,***5414,Globex Retail NA LLC,US,226630.3
2025-08-13,2025-08-13,Supplier Payment - NorthRiver Apparel Mfg #4,Supplier Payment,Retail-NA,18983.82,0.0,USD,Fedwire,NorthRiver Apparel Mfg #4,***6837,,PO-202508-Retail-NA-0006,False,False,REF-998280,First Continental Bank,***2287,Globex Retail NA LLC,US,207646.48
2025-08-13,2025-08-13,Client Receipt - CloudBridge Co. #2,Sales Receipt,SaaS-GL,0.0,9962.1,USD,Card Settlement,CloudBridge Co. #2,***4341,INV-202508-SaaS-GL-0012,,False,False,REF-408804,First Continental Bank,***4355,Globex Retail NA LLC,US,217608.58
2025-08-13,2025-08-13,Client Receipt - ShopSphere Partner #53,Sales Receipt,Retail-NA,0.0,53326.87,USD,ACH Credit,ShopSphere Partner #53,***2779,INV-202508-Retail-NA-0001,,False,False,REF-414909,First Continental Bank,***2075,Globex Retail NA LLC,US,270935.45
2025-08-14,2025-08-14,Supplier Payment - HyperCloud Infra #9,Supplier Payment,SaaS-GL,4258.15,0.0,USD,Fedwire,HyperCloud Infra #9,***9652,,PO-202508-SaaS-GL-0008,False,False,REF-893036,First Continental Bank,***8620,Globex Retail NA LLC,US,266677.3
2025-08-14,2025-08-14,Client Receipt - ShopSphere Partner #71,Sales Receipt,Retail-NA,0.0,12018.35,USD,Card Settlement,ShopSphere Partner #71,***7102,INV-202508-Retail-NA-0006,,False,False,REF-186178,First Continental Bank,***6583,Globex Retail NA LLC,US,278695.65
2025-08-14,2025-08-14,Client Receipt - CloudBridge Co. #74,Sales Receipt,SaaS-GL,0.0,15076.06,USD,ACH Credit,CloudBridge Co. #74,***5459,INV-202508-SaaS-GL-0005,,False,False,REF-957858,First Continental Bank,***5462,Globex Retail NA LLC,US,293771.71
2025-08-15,2025-08-15,Client Receipt - CloudBridge Co. #64,Sales Receipt,SaaS-GL,0.0,2974.17,USD,ACH Credit,CloudBridge Co. #64,***2380,INV-202508-SaaS-GL-0021,,False,False,REF-647413,First Continental Bank,***7718,Globex Retail NA LLC,US,296745.88
2025-08-15,2025-08-15,Client Receipt - CloudBridge Co. #17,Sales Receipt,SaaS-GL,0.0,5005.95,USD,ACH Credit,CloudBridge Co. #17,***2413,INV-202508-SaaS-GL-0004,,False,False,REF-167270,First Continental Bank,***7245,Globex Retail NA LLC,US,301751.83
2025-08-15,2025-08-15,Client Receipt - CloudBridge Co. #7,Sales Receipt,SaaS-GL,0.0,18674.84,USD,Card Settlement,CloudBridge Co. #7,***2989,INV-202508-SaaS-GL-0011,,False,False,REF-887751,First Continental Bank,***4210,Globex Retail NA LLC,US,320426.67
2025-08-16,2025-08-16,Client Receipt - Vertex Advisory Client #55,Sales Receipt,PS-GL,0.0,48269.33,USD,ACH Credit,Vertex Advisory Client #55,***2210,INV-202508-PS-GL-0005,,False,False,REF-351256,First Continental Bank,***3383,Globex Retail NA LLC,US,368696.0
2025-08-17,2025-08-17,Supplier Payment - HyperCloud Infra #10,Supplier Payment,SaaS-GL,9202.38,0.0,USD,ACH Debit,HyperCloud Infra #10,***2913,,PO-202508-SaaS-GL-0002,False,False,REF-639188,First Continental Bank,***6510,Globex Retail NA LLC,US,359493.62
2025-08-18,2025-08-18,Supplier Payment - ExpertNet Subcontractors #1,Supplier Payment,PS-GL,1992.12,0.0,USD,Fedwire,ExpertNet Subcontractors #1,***2563,,PO-202508-PS-GL-0002,False,False,REF-795337,First Continental Bank,***1628,Globex Retail NA LLC,US,357501.5
2025-08-18,2025-08-18,Supplier Payment - ExpertNet Subcontractors #18,Supplier Payment,PS-GL,8550.46,0.0,USD,ACH Debit,ExpertNet Subcontractors #18,***7114,,PO-202508-PS-GL-0006,False,False,REF-509873,First Continental Bank,***8160,Globex Retail NA LLC,US,348951.04
2025-08-18,2025-08-18,Client Receipt - ShopSphere Partner #29,Sales Receipt,Retail-NA,0.0,4692.55,USD,Card Settlement,ShopSphere Partner #29,***5002,INV-202508-Retail-NA-0007,,False,False,REF-175438,First Continental Bank,***7674,Globex Retail NA LLC,US,353643.59
2025-08-18,2025-08-18,Client Receipt - CloudBridge Co. #74,Sales Receipt,SaaS-GL,0.0,59055.52,USD,ACH Credit,CloudBridge Co. #74,***3530,INV-202508-SaaS-GL-0014,,False,False,REF-270731,First Continental Bank,***3079,Globex Retail NA LLC,US,412699.11
2025-08-19,2025-08-19,Supplier Payment - CodeCraft Contractors #2,Supplier Payment,SaaS-GL,2478.72,0.0,USD,Fedwire,CodeCraft Contractors #2,***6521,,PO-202508-SaaS-GL-0007,False,False,REF-475428,First Continental Bank,***1742,Globex Retail NA LLC,US,410220.39
2025-08-19,2025-08-19,Supplier Payment - CodeCraft Contractors #9,Supplier Payment,SaaS-GL,9405.36,0.0,USD,ACH Debit,CodeCraft Contractors #9,***5270,,PO-202508-SaaS-GL-0009,False,False,REF-334092,First Continental Bank,***2941,Globex Retail NA LLC,US,400815.03
2025-08-19,2025-08-19,Supplier Payment - NorthRiver Apparel Mfg #2,Supplier Payment,Retail-NA,11166.13,0.0,USD,Fedwire,NorthRiver Apparel Mfg #2,***5582,,PO-202508-Retail-NA-0009,False,False,REF-261455,First Continental Bank,***3704,Globex Retail NA LLC,US,389648.9
2025-08-19,2025-08-19,Supplier Payment - NorthRiver Apparel Mfg #4,Supplier Payment,Retail-NA,30279.03,0.0,USD,ACH Debit,NorthRiver Apparel Mfg #4,***4686,,PO-202508-Retail-NA-0002,False,False,REF-878246,First Continental Bank,***4844,Globex Retail NA LLC,US,359369.87
2025-08-19,2025-08-19,VAT/GST Remittance - US IRS,Tax Payment,ALL,57522.5,0.0,USD,Fedwire,US IRS,***6446,,,False,False,REF-371866,First Continental Bank,***4538,Globex Retail NA LLC,US,301847.37
2025-08-19,2025-08-19,Client Receipt - Vertex Advisory Client #28,Sales Receipt,PS-GL,0.0,4126.67,USD,Card Settlement,Vertex Advisory Client #28,***2514,INV-202508-PS-GL-0010,,False,False,REF-921084,First Continental Bank,***8175,Globex Retail NA LLC,US,305974.04
2025-08-19,2025-08-19,Client Receipt - ShopSphere Partner #74,Sales Receipt,Retail-NA,0.0,27928.2,USD,Card Settlement,ShopSphere Partner #74,***2856,INV-202508-Retail-NA-0014,,False,False,REF-867705,First Continental Bank,***5191,Globex Retail NA LLC,US,333902.24
2025-08-20,2025-08-20,Supplier Payment - ExpertNet Subcontractors #4,Supplier Payment,PS-GL,13603.04,0.0,USD,Fedwire,ExpertNet Subcontractors #4,***4847,,PO-202508-PS-GL-0003,False,False,REF-190088,First Continental Bank,***5848,Globex Retail NA LLC,US,320299.2
2025-08-20,2025-08-20,Client Receipt - CloudBridge Co. #55,Sales Receipt,SaaS-GL,0.0,17251.97,USD,Card Settlement,CloudBridge Co. #55,***9051,INV-202508-SaaS-GL-0013,,False,False,REF-618854,First Continental Bank,***2900,Globex Retail NA LLC,US,337551.17
2025-08-21,2025-08-21,Supplier Payment - PackFast Fulfillment #16,Supplier Payment,Retail-NA,3197.76,0.0,USD,ACH Debit,PackFast Fulfillment #16,***2457,,PO-202508-Retail-NA-0001,False,False,REF-761173,First Continental Bank,***4471,Globex Retail NA LLC,US,334353.41
2025-08-21,2025-08-21,Client Receipt - CloudBridge Co. #60,Sales Receipt,SaaS-GL,0.0,2165.73,USD,Card Settlement,CloudBridge Co. #60,***9048,INV-202508-SaaS-GL-0022,,False,False,REF-861254,First Continental Bank,***6568,Globex Retail NA LLC,US,336519.14
2025-08-21,2025-08-21,Client Receipt - ShopSphere Partner #39,Sales Receipt,Retail-NA,0.0,2732.63,USD,Card Settlement,ShopSphere Partner #39,***9629,INV-202508-Retail-NA-0009,,False,False,REF-241667,First Continental Bank,***6872,Globex Retail NA LLC,US,339251.77
2025-08-21,2025-08-21,Client Receipt - ShopSphere Partner #42,Sales Receipt,Retail-NA,0.0,3616.47,USD,ACH Credit,ShopSphere Partner #42,***5080,INV-202508-Retail-NA-0008,,False,False,REF-292883,First Continental Bank,***2288,Globex Retail NA LLC,US,342868.24
2025-08-21,2025-08-21,Client Receipt - Card Settlement Batch #4,Sales Receipt,Retail-NA,0.0,10300.25,USD,Card Settlement,Card Settlement Batch #4,***9953,INV-202508-Retail-NA-0011,,False,False,REF-672942,First Continental Bank,***7413,Globex Retail NA LLC,US,353168.49
2025-08-22,2025-08-22,Merchant Processing Fees,Bank/Merchant Fees,ALL,1463.84,0.0,USD,Fedwire,First Continental Bank,***2432,,,False,False,REF-721065,First Continental Bank,***3245,Globex Retail NA LLC,US,351704.65
2025-08-22,2025-08-22,Supplier Payment - CodeCraft Contractors #6,Supplier Payment,SaaS-GL,12007.16,0.0,USD,Fedwire,CodeCraft Contractors #6,***8668,,PO-202508-SaaS-GL-0001,False,False,REF-782856,First Continental Bank,***7489,Globex Retail NA LLC,US,339697.49
2025-08-22,2025-08-22,Supplier Payment - NorthRiver Apparel Mfg #24,Supplier Payment,Retail-NA,13562.64,0.0,USD,ACH Debit,NorthRiver Apparel Mfg #24,***7181,,PO-202508-Retail-NA-0004,False,False,REF-254631,First Continental Bank,***7803,Globex Retail NA LLC,US,326134.85
2025-08-22,2025-08-22,Client Receipt - CloudBridge Co. #46,Sales Receipt,SaaS-GL,0.0,6927.62,USD,Card Settlement,CloudBridge Co. #46,***5294,INV-202508-SaaS-GL-0008,,False,False,REF-490764,First Continental Bank,***8737,Globex Retail NA LLC,US,333062.47
2025-08-22,2025-08-22,Client Receipt - Vertex Advisory Client #2,Sales Receipt,PS-GL,0.0,11617.03,USD,ACH Credit,Vertex Advisory Client #2,***9758,INV-202508-PS-GL-0011,,False,False,REF-620959,First Continental Bank,***6647,Globex Retail NA LLC,US,344679.5
2025-08-23,2025-08-23,Supplier Payment - HyperCloud Infra #13,Supplier Payment,SaaS-GL,4760.38,0.0,USD,Fedwire,HyperCloud Infra #13,***9450,,PO-202508-SaaS-GL-0006,False,False,REF-697982,First Continental Bank,***8513,Globex Retail NA LLC,US,339919.12
2025-08-23,2025-08-23,Marketing - Aurelia Media #4,Marketing,ALL,7004.77,0.0,USD,ACH Debit,Aurelia Media #4,***1800,,,False,False,REF-460979,First Continental Bank,***1579,Globex Retail NA LLC,US,332914.35
2025-08-25,2025-08-25,Supplier Payment - HyperCloud Infra #10,Supplier Payment,SaaS-GL,1826.38,0.0,USD,ACH Debit,HyperCloud Infra #10,***2840,,PO-202508-SaaS-GL-0003,False,False,REF-600236,First Continental Bank,***5412,Globex Retail NA LLC,US,331087.97
2025-08-25,2025-08-25,Supplier Payment - ExpertNet Subcontractors #9,Supplier Payment,PS-GL,9228.16,0.0,USD,ACH Debit,ExpertNet Subcontractors #9,***1131,,PO-202508-PS-GL-0008,False,False,REF-477198,First Continental Bank,***4870,Globex Retail NA LLC,US,321859.81
2025-08-25,2025-08-25,Payroll - GlobalPay Services Ltd,Payroll,ALL,149644.89,0.0,USD,ACH Debit,GlobalPay Services Ltd,***9612,,,False,False,REF-171768,First Continental Bank,***6264,Globex Retail NA LLC,US,172214.92
2025-08-25,2025-08-25,Client Receipt - Vertex Advisory Client #3,Sales Receipt,PS-GL,0.0,7878.39,USD,Card Settlement,Vertex Advisory Client #3,***1146,INV-202508-PS-GL-0004,,False,False,REF-482296,First Continental Bank,***6355,Globex Retail NA LLC,US,180093.31
2025-08-26,2025-08-26,Supplier Payment - ExpertNet Subcontractors #3,Supplier Payment,PS-GL,886.9,0.0,USD,Fedwire,ExpertNet Subcontractors #3,***3045,,PO-202508-PS-GL-0007,False,False,REF-254548,First Continental Bank,***3987,Globex Retail NA LLC,US,179206.41
2025-08-26,2025-08-26,Intercompany Settlement - Globex APAC Logistics Pte. Ltd.,Intercompany Transfer,ALL,804625.0,0.0,USD,Internal Transfer,Globex APAC Logistics Pte. Ltd.,***3075,,,True,True,REF-667064,First Continental Bank,***8324,Globex Retail NA LLC,US,-625418.59
2025-08-26,2025-08-26,Client Receipt - Card Settlement Batch #6,Sales Receipt,Retail-NA,0.0,25483.15,USD,ACH Credit,Card Settlement Batch #6,***4810,INV-202508-Retail-NA-0010,,False,False,REF-386379,First Continental Bank,***9335,Globex Retail NA LLC,US,-599935.44
2025-08-27,2025-08-27,Supplier Payment - ExpertNet Subcontractors #6,Supplier Payment,PS-GL,8176.46,0.0,USD,Fedwire,ExpertNet Subcontractors #6,***5225,,PO-202508-PS-GL-0001,False,False,REF-992290,First Continental Bank,***6902,Globex Retail NA LLC,US,-608111.9
2025-08-27,2025-08-27,Client Receipt - CloudBridge Co. #50,Sales Receipt,SaaS-GL,0.0,24245.55,USD,ACH Credit,CloudBridge Co. #50,***2760,INV-202508-SaaS-GL-0016,,False,False,REF-444283,First Continental Bank,***3820,Globex Retail NA LLC,US,-583866.35
2025-08-28,2025-08-28,Marketing - Beacon Digital #7,Marketing,ALL,4458.41,0.0,USD,Fedwire,Beacon Digital #7,***9615,,,False,False,REF-851728,First Continental Bank,***5311,Globex Retail NA LLC,US,-588324.76
2025-08-28,2025-08-28,Supplier Payment - HyperCloud Infra #18,Supplier Payment,SaaS-GL,9234.14,0.0,USD,ACH Debit,HyperCloud Infra #18,***8044,,PO-202508-SaaS-GL-0004,False,False,REF-881379,First Continental Bank,***1123,Globex Retail NA LLC,US,-597558.9
2025-08-28,2025-08-28,Supplier Payment - NorthRiver Apparel Mfg #26,Supplier Payment,Retail-NA,39166.73,0.0,USD,ACH Debit,NorthRiver Apparel Mfg #26,***5742,,PO-202508-Retail-NA-0012,False,False,REF-914291,First Continental Bank,***6195,Globex Retail NA LLC,US,-636725.63
2025-08-28,2025-08-28,Client Receipt - CloudBridge Co. #12,Sales Receipt,SaaS-GL,0.0,419.58,USD,Card Settlement,CloudBridge Co. #12,***3642,INV-202508-SaaS-GL-0006,,False,False,REF-559185,First Continental Bank,***1604,Globex Retail NA LLC,US,-636306.05
2025-08-28,2025-08-28,Client Receipt - Vertex Advisory Client #24,Sales Receipt,PS-GL,0.0,11806.56,USD,Card Settlement,Vertex Advisory Client #24,***4132,INV-202508-PS-GL-0007,,False,False,REF-169027,First Continental Bank,***5674,Globex Retail NA LLC,US,-624499.49
2025-08-28,2025-08-28,Client Receipt - Vertex Advisory Client #3,Sales Receipt,PS-GL,0.0,40846.24,USD,Card Settlement,Vertex Advisory Client #3,***2685,INV-202508-PS-GL-0003,,False,False,REF-940858,First Continental Bank,***8130,Globex Retail NA LLC,US,-583653.25
2025-08-29,2025-08-29,Supplier Payment - ExpertNet Subcontractors #11,Supplier Payment,PS-GL,9257.99,0.0,USD,ACH Debit,ExpertNet Subcontractors #11,***9813,,PO-202508-PS-GL-0005,False,False,REF-733990,First Continental Bank,***6181,Globex Retail NA LLC,US,-592911.24
2025-08-29,2025-08-29,Supplier Payment - ExpertNet Subcontractors #8,Supplier Payment,PS-GL,12469.97,0.0,USD,ACH Debit,ExpertNet Subcontractors #8,***6587,,PO-202508-PS-GL-0004,False,False,REF-355485,First Continental Bank,***3139,Globex Retail NA LLC,US,-605381.21
2025-08-29,2025-08-29,Client Receipt - CloudBridge Co. #5,Sales Receipt,SaaS-GL,0.0,3698.8,USD,Card Settlement,CloudBridge Co. #5,***9352,INV-202508-SaaS-GL-0020,,False,False,REF-597216,First Continental Bank,***9667,Globex Retail NA LLC,US,-601682.41
2025-08-29,2025-08-29,Client Receipt - Vertex Advisory Client #55,Sales Receipt,PS-GL,0.0,8135.28,USD,Card Settlement,Vertex Advisory Client #55,***1583,INV-202508-PS-GL-0002,,False,False,REF-570609,First Continental Bank,***7067,Globex Retail NA LLC,US,-593547.13
2025-08-30,2025-08-30,Interest Earned,Interest Income,ALL,0.0,12873.22,USD,Card Settlement,First Continental Bank,***7184,,,False,False,REF-226314,First Continental Bank,***9371,Globex Retail NA LLC,US,-580673.91
2025-08-31,2025-08-31,Client Receipt - CloudBridge Co. #22,Sales Receipt,SaaS-GL,0.0,7211.96,USD,ACH Credit,CloudBridge Co. #22,***3506,INV-202508-SaaS-GL-0010,,False,False,REF-811186,First Continental Bank,***5705,Globex Retail NA LLC,US,-573461.95
